"","id_cliente_enc","total_productos","productos_distintos","dias_activos","compras_por_semana","compras_entre_semana","compras_fin_de_semana","kmeans_cluster","hc_cluster"
"1","0000595d5253705a2bf0c6f05ccbb800",101,63,63,11.2222222222222,72,29,2,1
"2","000420e88d1d6032d2a9957576177fee",29,29,0,29,0,29,1,2
"3","0004d0d0b37a6bb1624bfa3981eb159f",55,55,0,55,0,55,1,2
"4","00054553b480893c05f2e044625074ae",18,18,0,18,18,0,1,2
"5","0006ef2f1c591a406fe01da160466230",70,42,9,54.4444444444444,46,24,1,2
"6","0007144f84dec495b2efa9c44fffaae2",2,1,1,14,2,0,1,2
"7","000be44cf2378041e456e9ef21076f32",23,23,0,23,23,0,1,2
"8","000c6c7893fe5d999f9bf2a33094e73e",20,20,0,20,20,0,1,2
"9","000c75b30bb0b237ec817d203e88a54f",44,38,77,4,44,0,2,1
"10","00143712a013f73eef3a8ec1e52b9ef5",26,24,32,5.6875,8,18,2,1
"11","00196f62ac27cc336d2dfa40d73d17e2",172,120,58,20.7586206896552,120,52,3,3
"12","001ee0217c89aff2b727d7faa2447679",27,27,0,27,27,0,1,2
"13","001f016e041f01d40fc8fea87466648e",21,16,21,7,0,21,2,1
"14","002867cbb9f0de2b4678b73bc8d8b3d9",59,51,48,8.60416666666667,45,14,2,1
"15","0029751b7fcfb4dd553d7155370c0198",28,9,55,3.56363636363636,13,15,2,1
"16","002a19892cb891665ec0b77d3730f237",4,4,0,4,4,0,1,2
"17","002b38d6c352e7cbeb439b4e85fb349d",26,26,0,26,26,0,1,2
"18","002b87a72cb020a5d6f5c2008f8b7d36",8,8,0,8,8,0,1,2
"19","002c67b522d2ebb1c89f6fcf18ae7a3f",38,38,0,38,38,0,1,2
"20","002fcad093ac3fa5988b59e53788fd61",10,10,0,10,10,0,1,2
"21","00314f3d0a9d4f4109f66c1206c211a7",123,79,65,13.2461538461538,99,24,3,1
"22","00322c1d439808b60d1e5717956afa8e",27,27,0,27,0,27,1,2
"23","00339bd0db8a3a3070c85e793ca7dd43",41,41,0,41,0,41,1,2
"24","0033f6b64fd807c3ddde4a5b5e3b5f9b",188,109,68,19.3529411764706,151,37,3,3
"25","00341ca1bf2dd3066c42f50685697f31",119,81,49,17,73,46,3,3
"26","00348337ef9c4396c312d06f7cadfbd6",22,22,0,22,22,0,1,2
"27","0036c5bab60f98a6b50e04e81575b9f9",19,19,0,19,19,0,1,2
"28","00374cb7f0170153c519747b4062201b",100,89,40,17.5,100,0,3,3
"29","003bf37f219e80db497e4d15d0e9bb7b",34,34,0,34,34,0,1,2
"30","003d3ebe117cb786a4d73fea8d17319b",148,106,30,34.5333333333333,148,0,3,3
"31","003fa3344cb647a6af3ab9c765e86ad0",118,55,54,15.2962962962963,118,0,3,3
"32","00430a0ba38f0744700f811a45957ff8",93,58,64,10.171875,93,0,2,3
"33","0044a6a27228c3f3022ccda30ebad8a1",20,20,0,20,0,20,1,2
"34","0044a91daa38ca4f9677179baf1e6324",12,12,0,12,0,12,1,2
"35","0045485fae7394dbd5242684564113b2",50,28,67,5.22388059701493,50,0,2,1
"36","00481cf3e91879592a2b8c57eee4f7db",113,84,20,39.55,113,0,3,3
"37","004c295640c8d688391908667270aa31",116,59,88,9.22727272727273,100,16,3,1
"38","004c59dafb02a53e4e2ca68b66053df4",26,26,0,26,26,0,1,2
"39","004c726a1f31128ad5b9f70b9f6f000d",43,43,0,43,43,0,1,2
"40","0050903400103984041efdc280d8da21",93,54,63,10.3333333333333,93,0,2,3
"41","0051bc212b8aa6fda30ecd3f157a08e9",4,4,0,4,4,0,1,2
"42","0051cf4b346d004ad485f15f3948e0a7",18,18,0,18,18,0,1,2
"43","00536f672ef77ce43cc3509ca672e0cd",22,22,0,22,22,0,1,2
"44","00537326bca29d951445cd364b8b5151",72,48,86,5.86046511627907,37,35,2,1
"45","005489dd6890d9947744045d5cdaf630",51,51,0,51,51,0,1,2
"46","0054b10cdd4c0b6272caa58ac0906931",12,12,0,12,12,0,1,2
"47","0055706d5150d3ef95af9023def53033",49,36,42,8.16666666666667,49,0,2,1
"48","005657f891fe26a59ff7c86ecdb3540f",53,43,67,5.53731343283582,53,0,2,1
"49","00565b7300fe472b8ee35c89596b413e",120,87,77,10.9090909090909,120,0,3,3
"50","00581eee4acd753e70eea3bd02139b54",113,69,76,10.4078947368421,113,0,3,3
"51","005a76a5b25a5903ba09f08e41dc2258",33,33,0,33,33,0,1,2
"52","005e6021f9fdda5e1c3a0225cf7102d2",89,65,70,8.9,89,0,2,3
"53","0060a6437f6889b40c6e28330f5022ba",41,41,0,41,41,0,1,2
"54","006170c4fb70220e499415f83a59ef23",94,66,43,15.3023255813953,94,0,2,3
"55","00621b050938aa94253b4907ca3a423c",72,55,40,12.6,72,0,2,3
"56","0068bed782963cd2778a56520a464311",61,37,83,5.14457831325301,45,16,2,1
"57","0068d9eba21504a810eb95043e1a8183",54,54,0,54,54,0,1,2
"58","006943e45e018b299391c85d64609b6e",51,51,0,51,51,0,1,2
"59","006b4dccb949a465d4226584f7f0a7c9",12,12,0,12,12,0,1,2
"60","006d88722f2a0c3b42368a165d918124",55,46,42,9.16666666666667,55,0,2,1
"61","006e1d7694bc4d644adb57585679058f",22,22,0,22,0,22,1,2
"62","00723ea93efad2f4c7b36491a50662b4",22,22,0,22,0,22,1,2
"63","0074424721dab005b017c33a20d42ca0",27,27,0,27,27,0,1,2
"64","0079984b08316a6c59ffc60f2bf2f0fe",146,98,49,20.8571428571429,146,0,3,3
"65","007a7a53e4dbf2be926e1674bd3a471d",12,7,79,1.06329113924051,12,0,2,1
"66","007b62b4c2649d618fcc5fd8413bfcf2",215,119,75,20.0666666666667,208,7,3,3
"67","007bf88e60d8c07bdda696c9ea30fb05",19,19,0,19,19,0,1,2
"68","007e107c419d56f77ee4184799ca8681",50,40,37,9.45945945945946,50,0,2,1
"69","0080422d8ae594ea199ab00659f692cd",151,76,75,14.0933333333333,107,44,3,3
"70","008150ec8b155f32934aeacc578c6f9e",19,19,0,19,19,0,1,2
"71","0081c4cd8a89ed39c1951057e862dfc8",191,90,54,24.7592592592593,191,0,3,3
"72","008274042dc16dba5eaba4eceb7f1313",240,102,77,21.8181818181818,198,42,3,3
"73","00836b98935cc16d3b312c049c57253a",30,25,42,5,0,30,2,1
"74","0084b04f862edbfe9f47e7509c3ecc46",32,32,0,32,32,0,1,2
"75","008627714a75a38c25921ddd208b9d27",28,27,5,39.2,28,0,1,2
"76","0086ba87cb67c80a1e565542f135ea99",22,22,0,22,0,22,1,2
"77","0087cac244a1ce322096a477364f390d",106,82,75,9.89333333333333,106,0,3,3
"78","008a3ed7f5c452b35d7e2f89531b4e40",115,77,35,23,115,0,3,3
"79","008b303d0d819fc99da25c39d42b5e04",31,31,0,31,31,0,1,2
"80","008c694c2477e1a38083c6253f573756",114,78,49,16.2857142857143,114,0,3,3
"81","008eae973088bfdbfb468ffc37d6582d",135,86,27,35,135,0,3,3
"82","00958a22ef3693d3d6934de502ed66a4",212,135,66,22.4848484848485,159,53,3,3
"83","00966047b728d4fe20b60d0d2d25cda5",1,1,0,1,0,1,1,2
"84","0096b145979530ec29b289d05e34d2f8",174,74,86,14.1627906976744,138,36,3,3
"85","0097b3cb2da118aeea2ad9bd2976253c",96,80,58,11.5862068965517,66,30,2,1
"86","009c3f4f114e5150ef8d8663670df60a",184,120,67,19.2238805970149,145,39,3,3
"87","009e7578519824754fad4e17c6569372",4,4,0,4,4,0,1,2
"88","009e91c280e5742d8009b9a3417c19f3",26,17,71,2.56338028169014,26,0,2,1
"89","009f5fe6b557854af99fc59e900245f1",54,46,56,6.75,54,0,2,1
"90","00a2a3ba64bf707e4073b5d42accceac",152,108,61,17.4426229508197,152,0,3,3
"91","00a2e7caacd9bc2dd7d0cd844136d487",8,8,0,8,8,0,1,2
"92","00a6153f68d9cb79514bce57e3dce474",16,16,0,16,16,0,1,2
"93","00a736ee6deb7d8b6de7c8701fbfb276",111,58,76,10.2236842105263,111,0,3,3
"94","00a7621250bfbcd783e476f8f829c998",23,23,0,23,23,0,1,2
"95","00a79e61250cbb98453a901540c82aa0",23,23,0,23,0,23,1,2
"96","00a8f692918c6fbada0e3d763353384a",17,17,0,17,17,0,1,2
"97","00abab2d6d24ec7092b71eb31312a561",39,39,0,39,39,0,1,2
"98","00ad0e40a64e60fea4ee345c1a441280",66,54,58,7.96551724137931,66,0,2,1
"99","00ae694d81a199a390cd0c6954abb070",77,57,28,19.25,77,0,2,1
"100","00b0f6eadb0d8e62e9048dbea5580e46",67,50,74,6.33783783783784,56,11,2,1
"101","00b3d995c6bd6c2caa1270ebd82741c8",8,8,0,8,0,8,1,2
"102","00b3e87c014db217475535de8f76a3b7",194,115,58,23.4137931034483,194,0,3,3
"103","00b54625083cd831dc93fb05bb492394",3,2,6,3.5,3,0,1,1
"104","00b7fbd8a76e2f91a59363333d7af94a",36,36,0,36,36,0,1,2
"105","00b8c37fd3617b2b58261785dd22044e",38,38,0,38,0,38,1,2
"106","00bba0548dcff6c684fd956fc0ec7cc4",132,81,54,17.1111111111111,86,46,3,3
"107","00beec225f1530ca3700029b2eb7cc2f",134,108,52,18.0384615384615,134,0,3,3
"108","00c028cba42fa353966abe28d12834eb",126,90,77,11.4545454545455,126,0,3,3
"109","00c29f0e6b4404a0df36e8538124dba9",11,11,0,11,11,0,1,2
"110","00c2cacef5e78a02cb4fb56cb65f57c3",66,52,67,6.8955223880597,50,16,2,1
"111","00c2e7e0817d3dd043f6626a8223956a",36,36,0,36,36,0,1,2
"112","00c5e197332798a74910d3dd84433c01",20,19,14,10,20,0,1,1
"113","00c8f1db97a57f4ed837b34f21167e53",28,28,0,28,28,0,1,2
"114","00d120f76d0826a47e664f86449e6147",4,4,0,4,0,4,1,2
"115","00d2e4b996a53e737a314c644dffb596",79,60,64,8.640625,79,0,2,3
"116","00d5b0cfc45df385d8aa06c817ca6e04",63,46,28,15.75,63,0,2,1
"117","00d8f59e05d4fc602c2b60ef1f5c96b0",49,35,25,13.72,49,0,2,1
"118","00dc562aa3358d32137ec679cf1dff65",39,32,56,4.875,39,0,2,1
"119","00dd721560ec13f4c8c94e2156662abc",47,47,0,47,47,0,1,2
"120","00ddbabbbe7ea845c60a1f365278761c",68,55,18,26.4444444444444,68,0,1,2
"121","00de9fea9c64c34947f5e4628f3b89df",19,19,0,19,19,0,1,2
"122","00dfad20efe5b87a65a040e2001bf7c3",186,92,79,16.4810126582278,186,0,3,3
"123","00e00a4b719b4d0293e1afb8c7d1ec97",188,111,74,17.7837837837838,164,24,3,3
"124","00e1c9eb4bf398d3c79b3c2161902c9f",40,40,0,40,40,0,1,2
"125","00e4101e6b9034564c1afff043825a9f",60,43,53,7.92452830188679,42,18,2,1
"126","00e4c6295b6b13f9e0ff9e3cbee7317b",63,61,17,25.9411764705882,63,0,1,1
"127","00e4e49669e76521df4e62fe4391a4ce",24,24,0,24,24,0,1,2
"128","00e5828a8bfee3fb438f3adf8b0b41e5",54,45,53,7.13207547169811,54,0,2,1
"129","00e67fd6cffb7670d5181c66e863fc39",83,55,63,9.22222222222222,83,0,2,3
"130","00e7dc9e62b27a5af794c1d9d6d8cb28",34,34,0,34,34,0,1,2
"131","00e9284603630c55b80fd38eebacde57",73,57,78,6.55128205128205,61,12,2,1
"132","00e9c71f0153690a041bf98e4617f282",9,9,0,9,9,0,1,2
"133","00e9f71c178d5b284e3c0fd0878bc199",49,36,26,13.1923076923077,49,0,2,1
"134","00ecfdf106f1723581dd4fbf27d26ba2",11,9,41,1.8780487804878,11,0,2,1
"135","00ef5b1896a86d9a001efb727c2cc962",23,23,0,23,23,0,1,2
"136","00f0971c1d6850eedfc0edfa6e8db1c9",23,23,0,23,23,0,1,2
"137","00f169451bea188e1b5fc2c06734a542",82,50,80,7.175,82,0,2,3
"138","00f24d3c714d477a823a376aa112e318",81,62,36,15.75,81,0,2,1
"139","00f2aa8ff5d133098cb5a9ac242091c2",80,45,82,6.82926829268293,65,15,2,1
"140","00f4f0c3fabb488e8ff013e087242e34",24,24,0,24,0,24,1,2
"141","00f6cb882247551107aa6b97f33a6447",13,5,58,1.56896551724138,13,0,2,1
"142","00f8d8c877b797e53ea8de4888c8a0f0",4,4,0,4,4,0,1,2
"143","00fc26fa93ebac51369d81e6008c8d9b",15,15,0,15,15,0,1,2
"144","00fe24f586fa6a3fa1af4a9b6338520b",40,32,22,12.7272727272727,40,0,2,1
"145","00fec8b424bd9003ee5c6eea0a0c1a54",46,41,17,18.9411764705882,46,0,1,1
"146","00fee70117b2bf30aaeeed67e2bae1a5",225,144,84,18.75,174,51,3,3
"147","010116034fa8d80d682e966ac731e9b5",57,25,89,4.48314606741573,57,0,2,1
"148","0101b91e4ffe0d48edf5e7135c16af44",65,54,32,14.21875,65,0,2,1
"149","01054da50fd5e4de74287bd765859eac",74,59,34,15.2352941176471,74,0,2,1
"150","0106a1ee8583132cfdecc48f8a76a612",21,21,0,21,21,0,1,2
"151","0107da214fb0a1d662ff70d4977d4200",40,34,61,4.59016393442623,23,17,2,1
"152","010a078f0f7cc2665c8979267d8f3298",35,35,0,35,35,0,1,2
"153","010b7b7f5317e7d651fb6b680818e7f7",28,28,0,28,28,0,1,2
"154","010c2be1e82fe2da4fa5f6698e679a34",1,1,0,1,1,0,1,2
"155","01119551e774d4d925728160270e3ec6",58,46,46,8.82608695652174,58,0,2,1
"156","0111c92fd3494221da6e2c9f57ea560d",2,2,0,2,2,0,1,2
"157","0114f7935458391c5460e9509f86a494",32,21,65,3.44615384615385,32,0,2,1
"158","011b220b31c956eab56942fe13250a81",74,64,10,51.8,41,33,1,2
"159","011b2769b1fb71e46ec895d59f4ea7df",50,50,0,50,50,0,1,2
"160","011c5c921213da2f084011083192c3a7",26,26,0,26,26,0,1,2
"161","011c8592b8ba26f99d885620b6e42cf0",12,9,81,1.03703703703704,12,0,2,1
"162","011d9b8ea48c6e103aabed4a86b4598d",83,55,50,11.62,83,0,2,3
"163","011e3017b3bbd2e84f12b75b53312f8b",32,32,0,32,32,0,1,2
"164","01218877a11597f3291d3be8fbf34693",72,48,74,6.81081081081081,72,0,2,3
"165","012326d08825a9239ee48016a7fd5d2a",113,89,68,11.6323529411765,113,0,3,3
"166","0125bb8b0c84dad6e3d71095b00f3824",45,45,0,45,45,0,1,2
"167","01295b7edbad32cdb52a21ab588197c3",38,38,0,38,38,0,1,2
"168","01296f1eb90bd2fce6d5e8103ce813a5",22,22,0,22,0,22,1,2
"169","012a9b7a6616c6120a561c2470d82769",37,37,0,37,37,0,1,2
"170","012b4cb444254a0c8eb6ab630b7c7f77",155,130,67,16.1940298507463,117,38,3,3
"171","012c53f5397021b11b87113d2cded03b",27,27,0,27,27,0,1,2
"172","012e9024523cb63c0baf3c26d1bacfae",60,47,61,6.88524590163934,35,25,2,1
"173","01369e9d36628c742dc319bbf0a88259",14,14,0,14,14,0,1,2
"174","01400d0edda2774f46732259da9340d7",19,19,0,19,19,0,1,2
"175","01426e3fbf6f4d20c8c4b255fc695b14",42,31,58,5.06896551724138,42,0,2,1
"176","0143ffcceeaaff51b02d66d64e5057bd",167,102,83,14.0843373493976,167,0,3,3
"177","0144fe9e05b99706a88984fbf0e1b5fa",13,13,0,13,13,0,1,2
"178","01461fb2e92672094bde96174899dd1e",24,24,0,24,24,0,1,2
"179","014635187859f855633649a0e853940b",99,56,58,11.948275862069,68,31,2,1
"180","0148786245b4a5eb2e6312b63975a0fe",48,48,0,48,0,48,1,2
"181","014a667a904721b1eec8941617a37983",115,63,65,12.3846153846154,99,16,3,1
"182","014d40a2f3f2a69dcb4b6e1710f2a1b6",95,38,76,8.75,72,23,2,1
"183","015668bde0fe67b5f2b69363df0b8ee4",19,19,0,19,19,0,1,2
"184","015674975686150065be65d527d7dc95",15,15,0,15,15,0,1,2
"185","01597bd49ddea6a772935c29663aa864",56,48,34,11.5294117647059,56,0,2,1
"186","01597c5518b2bbb08c4a8ecf81d5f0dd",51,46,52,6.86538461538461,51,0,2,1
"187","01599b295eb7a50450ea74b9a82ad693",105,66,73,10.0684931506849,63,42,2,3
"188","015b8c00ac1668c3c81f733fc9f0698d",54,32,66,5.72727272727273,54,0,2,1
"189","015be0cae058e56a1873b8cd19ce6173",39,39,0,39,39,0,1,2
"190","015c40d7c7cf4a005806e7af3988a81c",21,21,0,21,0,21,1,2
"191","015cb0e40bdee3fad9d5e8181306747c",16,16,0,16,0,16,1,2
"192","015d378bd4d2c42b30a5847da3c8d4d3",18,18,0,18,18,0,1,2
"193","015d6818ed811f6acb386b47d9d64671",29,29,0,29,0,29,1,2
"194","015debfa4398a9bbb5f8717560d78740",119,67,68,12.25,119,0,3,3
"195","0160c215b086cdcd435db935c37b8a73",68,58,41,11.609756097561,39,29,2,1
"196","0160f36758f314794e86184310316231",143,78,90,11.1222222222222,121,22,3,3
"197","0161a124a13a10a36bdfc42004bbe62a",30,26,9,23.3333333333333,30,0,1,2
"198","0161ba439d5ae412cdbbfd48ed9bdc7c",60,50,84,5,60,0,2,3
"199","016218ff3094a80efea55ec030fcf923",143,85,61,16.4098360655738,99,44,3,3
"200","01635985b044035738661d2a98e40af8",31,31,0,31,31,0,1,2
"201","016381714f92f72c74c616b02c3b6c4b",20,20,0,20,20,0,1,2
"202","016461a2eb3ed80039cc549f0a68e9f7",61,48,49,8.71428571428571,61,0,2,1
"203","016523e7292d8ea780644499ac6b6a2d",78,48,61,8.95081967213115,59,19,2,1
"204","0166bc5e93e3e140d071fdcb4b7a1e03",32,32,0,32,0,32,1,2
"205","0167b70fe0ab2d36c5950962e1bd5966",125,93,71,12.3239436619718,98,27,3,1
"206","016a3c555240e96875145ac82e9e2d2c",108,78,79,9.56962025316456,76,32,3,1
"207","016d83958f16b96521f8cd4320a3eedc",172,91,38,31.6842105263158,172,0,3,3
"208","016dddc23cc5ffd6ba3862e3079ff7b4",50,37,24,14.5833333333333,50,0,2,1
"209","016f1458e3282f8fc752d5820acf33f4",11,11,0,11,11,0,1,2
"210","016fbc6e94414ce879b75834d4fc0403",22,22,0,22,22,0,1,2
"211","017023f8d806abfaffc481a4b2a7c604",14,12,58,1.68965517241379,8,6,2,1
"212","0172f32168ee467a6eb8dc7f3430eb1a",210,117,74,19.8648648648649,210,0,3,3
"213","0173279f33124095c2b1c1e0e11ec95c",56,56,0,56,56,0,1,2
"214","01734d619251b5b7c5e0c73db0d214ef",23,23,0,23,23,0,1,2
"215","01739ec6a9f5d91ecc94ea509c50b44a",88,64,35,17.6,46,42,2,3
"216","01747eb404ca0d07ca97f05338feb610",12,12,0,12,0,12,1,2
"217","0174b9559db88e4e4defd83548fa63d8",26,26,0,26,26,0,1,2
"218","0175f6e65ef5532fb3d09295ca98af67",88,65,63,9.77777777777778,88,0,2,3
"219","0177026248d407202ee791b8404c2658",137,93,49,19.5714285714286,137,0,3,3
"220","017af3a3f45d24c017220f2f92145da3",90,75,55,11.4545454545455,90,0,2,3
"221","017cbedf5937860b274f46945bc7cbd8",16,16,0,16,16,0,1,2
"222","017da4b4f9f783557aa4e33b7cbe8783",40,34,36,7.77777777777778,40,0,2,1
"223","017ea65830268bd44bf6e5d209e72455",128,87,88,10.1818181818182,128,0,3,3
"224","017ec97354fc3b5dd5c7381d432d086b",51,48,16,22.3125,51,0,1,1
"225","017efdab151a7d2012c1326f449f10e4",49,37,48,7.14583333333333,49,0,2,1
"226","017f6c74b3c7ee24b29be300dc2fc550",81,36,46,12.3260869565217,33,48,2,1
"227","0182758e9207c6b64751800028043110",27,27,0,27,27,0,1,2
"228","018491d3892ac934e57db1cfc884227e",163,84,75,15.2133333333333,116,47,3,3
"229","01857b9dc90cb1ae64d92e2369ca2d2e",174,102,64,19.03125,174,0,3,3
"230","0185fdcfd756a8715b3c213b8134246e",11,11,0,11,0,11,1,2
"231","0186bdff091ff215716f7714cc8527ae",104,71,77,9.45454545454546,72,32,2,3
"232","0189bbfacd4a0677837175907eeec246",172,82,62,19.4193548387097,172,0,3,3
"233","018a30985b136d2a4e1f30c095f2ec42",49,49,0,49,49,0,1,2
"234","018b6f180007e76140d2a8b9d9debad0",92,25,76,8.47368421052632,92,0,2,1
"235","018dfae11e082f64c4cf812751a5466b",59,40,46,8.97826086956522,31,28,2,1
"236","018e9ea4070e4df6b1e3e4137f8f42f0",13,11,43,2.11627906976744,13,0,2,1
"237","018f8506e2f8d2673164c07b0f66d515",161,109,70,16.1,108,53,3,3
"238","0195a2df8f9286e15cfce0bd9693c8be",36,36,0,36,36,0,1,2
"239","0199ec854b2b3d0c285eb34db94c7528",4,4,0,4,4,0,1,2
"240","019af1f0b2c89f89ea51a41feb45972d",17,17,0,17,17,0,1,2
"241","019cf11509d168b23e915cb441cded0e",42,42,0,42,42,0,1,2
"242","019e22e814fba9bf8ba22c57358ae7e3",10,10,0,10,10,0,1,2
"243","01a08c56824b59fba0b69b27342efb85",33,33,0,33,33,0,1,2
"244","01a21c09e3aa7a7b33f84b2906139031",23,23,0,23,23,0,1,2
"245","01a247953015c71aa8b2d17fa8fe94b2",21,21,0,21,0,21,1,2
"246","01a60d17b9ddef63ee7e3d432daf3f9c",35,35,0,35,35,0,1,2
"247","01a7a60c5c41646abf905002b5743494",36,36,0,36,0,36,1,2
"248","01a8b4783ff1f37288e8213b029a4ed4",48,48,0,48,0,48,1,2
"249","01ae848110251a33a74328e79393f608",8,8,0,8,8,0,1,2
"250","01ae904a65d6e70d3c09ff3eb00ee7a9",95,86,67,9.92537313432836,70,25,3,1
"251","01af3905e8590efd1b2b4fbdda9ed93d",28,28,0,28,28,0,1,2
"252","01b19e93c09cab04f5aaae3c95560597",22,22,0,22,22,0,1,2
"253","01b241d31f5cb00108a6114e5f276223",5,5,0,5,5,0,1,2
"254","01b407186e965bc810f816ed18742dbc",84,58,72,8.16666666666667,33,51,2,3
"255","01b87c2f70c8806206d61929c5dae86a",8,8,0,8,8,0,1,2
"256","01b9cd10336b29c0695a959606e7ed3a",124,90,63,13.7777777777778,85,39,3,3
"257","01bd469da2ad05b45e23142072253c12",31,31,0,31,31,0,1,2
"258","01bd5a51c0b7e6d836b54358713aaf9c",29,29,0,29,29,0,1,2
"259","01c0c56d49b48bebba920628066d4824",72,54,65,7.75384615384615,49,23,2,1
"260","01c268cd65305f00ae691903f30ffe98",37,37,0,37,0,37,1,2
"261","01c37cdf5f284c4aab2c8ca8c77eb3f8",103,65,21,34.3333333333333,103,0,3,3
"262","01c3a379e029f541cc580dc1fddb0e8f",21,21,0,21,21,0,1,2
"263","01c733b4501e434b78e0bf6a678440fe",49,44,22,15.5909090909091,49,0,2,1
"264","01ce81eb415488a641554906594ef949",5,5,0,5,5,0,1,2
"265","01cfa36d3f53e51434df7b22fa9ac047",112,61,66,11.8787878787879,112,0,3,3
"266","01d12aa9b55edb6518fefec5737763d0",94,45,21,31.3333333333333,94,0,1,2
"267","01d218aadad730fa56a7ce1d483ea8a1",92,46,42,15.3333333333333,92,0,2,3
"268","01d7b2b9880d87cca390088adf7cc829",14,10,43,2.27906976744186,11,3,2,1
"269","01d81f945ed2c620f5570410e9a1b0e1",10,10,0,10,10,0,1,2
"270","01d87a8dec57e4f945945416646539f6",46,46,0,46,46,0,1,2
"271","01d87e6d090f4d8e3b8fc3662e0e69a3",13,13,0,13,13,0,1,2
"272","01d8ad78d095adcb1867f4abe60f3c2a",34,34,0,34,0,34,1,2
"273","01d8cff2d368b1d6f21d7b7f23cf2280",33,33,0,33,33,0,1,2
"274","01da301552bf05066725bb2261508150",197,121,50,27.58,197,0,3,3
"275","01dbdbc27b4904cf9d26978409fad3b4",19,19,0,19,19,0,1,2
"276","01dcb64394eed4d1f9e3e3dd736c341e",73,58,38,13.4473684210526,30,43,2,1
"277","01dcc33f2185cf4b3b780fe20388d215",31,28,57,3.80701754385965,17,14,2,1
"278","01dd91e8bc8ce8aa6215b98c997616ab",63,54,35,12.6,63,0,2,3
"279","01dd96fdf225fe12fd15448ec31fe142",8,8,0,8,8,0,1,2
"280","01deaf75c91b7b262cc6da19bdbaf2d4",33,33,0,33,33,0,1,2
"281","01dfb107e6ae4fea7231108d9a87b6c3",43,39,14,21.5,43,0,1,1
"282","01dfda7bb3b0af2569ac1ce10cb0eb08",18,18,0,18,0,18,1,2
"283","01dff2de0f1bda0d6a4d7d9c324c1452",44,26,49,6.28571428571429,44,0,2,1
"284","01e201c147ba4a58df19468036e2048f",62,48,60,7.23333333333333,62,0,2,3
"285","01e72668e571dbc6a1c8c08bc46c9887",29,29,0,29,29,0,1,2
"286","01e7f5245299bdbe4fc49c6f182048bd",36,36,0,36,36,0,1,2
"287","01e886a01b075fe1a5970e442c4e7817",88,80,31,19.8709677419355,88,0,2,3
"288","01e9717d493dae120363ca9a8df6affa",83,53,65,8.93846153846154,49,34,2,1
"289","01e9dec935b9cd32d494c14a682cf72c",26,17,18,10.1111111111111,15,11,1,1
"290","01ea4b53adae003d2d7451c65ae5ea9e",166,122,73,15.9178082191781,135,31,3,3
"291","01ed1caed0c89ef6fd2f4a7b71ddff3c",50,41,50,7,50,0,2,1
"292","01eee73ab8d528c94552ba07fdcbd23c",12,12,0,12,12,0,1,2
"293","01f20007e6eda24402213967b516305f",108,77,30,25.2,53,55,3,3
"294","01f2bc4014030805aab677e5a05b43d2",99,72,21,33,99,0,3,3
"295","01f42c0b96bb14286cdf6beb20bbf76f",126,58,42,21,126,0,3,3
"296","01f48b5d7a3d04f71683f6cfa6a2631e",24,24,0,24,0,24,1,2
"297","01f538058225c3293b0058d9dda3221c",200,97,75,18.6666666666667,171,29,3,3
"298","01f89c9273cd4d1c16e84265b2a342fd",27,23,14,13.5,27,0,1,1
"299","0202db1be6c97c7aa12174e2555b77ac",6,6,3,14,6,0,1,2
"300","02062c58dc38bbc67f88e3b314f45742",111,50,69,11.2608695652174,111,0,2,3
"301","0207b742b9fa30cfd656351a745a1a82",16,16,0,16,16,0,1,2
"302","020896434583f2160339b9e20c0c424b",6,3,56,0.75,6,0,2,1
"303","0208b2566a5760db57b63f74edc32f8b",39,39,45,6.06666666666667,6,33,2,1
"304","020914cd34c55f46673a4c85a6a510a2",43,43,0,43,0,43,1,2
"305","0209a173a5032a016de658b78bebe1ff",17,17,0,17,0,17,1,2
"306","020aea392659955d53764b742105ffb1",76,63,42,12.6666666666667,76,0,2,3
"307","020dcd38222eb51265ff9086dfa18f50",30,30,0,30,30,0,1,2
"308","020f7628b5fed5479eef29e9f6cd4eb2",42,42,0,42,42,0,1,2
"309","020fe3c0b8eded2d501a3f727a948dc8",17,17,0,17,17,0,1,2
"310","021106ad9457c59fb08950ed482db228",80,51,28,20,80,0,2,1
"311","021130f2cb0b48a1ec4dc31fd95e528d",12,12,0,12,12,0,1,2
"312","02116948fdaac231e31448ca0be1fb34",15,15,0,15,15,0,1,2
"313","02116a416d3aa8456c93e12d53672a4d",191,89,88,15.1931818181818,191,0,3,3
"314","0213d1ac8383cee0460d49fc93e315b3",14,14,0,14,14,0,1,2
"315","021444327a21e32bde4c6513eaeca892",87,52,65,9.36923076923077,66,21,2,1
"316","0219648b555ead892fc43d0255696d76",111,77,69,11.2608695652174,68,43,3,3
"317","021c3f4713f090bb86dd5ee9cc210018",33,33,0,33,33,0,1,2
"318","02204680676e91e797650418e664b1d9",188,103,50,26.32,188,0,3,3
"319","022053d5ea18b49be9c25c7312e1e5ae",60,46,56,7.5,60,0,2,1
"320","02236575bc8225955cb1ff2f7e3d4b4c",214,107,78,19.2051282051282,186,28,3,3
"321","02248a68a2c42040765a3521a3f224dd",92,65,13,49.5384615384615,54,38,1,2
"322","0224fea4f86ca43c28e44cbce8c3fa5c",22,22,0,22,22,0,1,2
"323","0225be8593176cc536d207b9472e556d",40,35,16,17.5,40,0,1,1
"324","0226597d999fe50ce62a687b1eb2655b",179,122,58,21.6034482758621,179,0,3,3
"325","0226b5b8372bf056d314f1257933106c",69,53,15,32.2,27,42,1,1
"326","022779392062a416417b037da7170c7f",14,14,0,14,14,0,1,2
"327","0227af82202bf267a1e0af5984ef8ce1",30,30,0,30,30,0,1,2
"328","0227fed17eead41ff28aa42378e16bd8",18,18,0,18,18,0,1,2
"329","02295ec5cb4a68b8351136337e527331",20,20,0,20,20,0,1,2
"330","0229a45f44ab0c7c137c32c27138c415",12,9,62,1.35483870967742,5,7,2,1
"331","022a2f6f1eca2dba8b4755687aa682fc",136,37,80,11.9,136,0,3,3
"332","022d1f15341f12515f50fcc4dfe5cd70",35,28,14,17.5,35,0,1,1
"333","022fc3bdf08b3e4ed9a6e1beaaf95cc6",37,37,0,37,37,0,1,2
"334","023042c5980fa615f1974a3150490b8d",31,31,0,31,31,0,1,2
"335","0230dcbdb6e7d3a49dcc8a3b9d209678",37,37,0,37,0,37,1,2
"336","02315c579e26e580df04f785b76a0fc6",20,20,0,20,20,0,1,2
"337","023311c8c7668dae069dea0334fb8ae7",105,38,56,13.125,105,0,2,3
"338","0235454d22eb99d3dc7477221d659b3b",30,30,0,30,0,30,1,2
"339","0235953ad7a5dfaa348a6db4337cb3de",23,23,0,23,23,0,1,2
"340","02367c6b93886be682330459697b0292",28,28,0,28,28,0,1,2
"341","0237be24a74d8838f4fa0c843997b4ee",16,16,0,16,16,0,1,2
"342","02391630963d2908e51662cdd690c402",72,55,60,8.4,72,0,2,3
"343","023a5c62362eea1d8783f82c13300f14",43,38,7,43,43,0,1,2
"344","023b72f0b9fa53cd175a7cc88dd8f77a",35,35,0,35,35,0,1,2
"345","023c9bb68b6527dd26102bcbf27802b7",129,47,81,11.1481481481481,129,0,3,3
"346","02400d1e6f992b44be16901375f87ba1",164,104,57,20.140350877193,113,51,3,3
"347","024114e0a4e0f086a65a43f14b5d6af9",14,13,6,16.3333333333333,14,0,1,2
"348","0241473bfad8fa22272225708c1d814d",80,46,63,8.88888888888889,80,0,2,3
"349","0241c04d48fff8f1a99ae16df87d7216",8,5,77,0.727272727272727,6,2,2,1
"350","02425f5a40849aa0338b328da310d650",47,42,25,13.16,21,26,2,1
"351","0246b39b0d9abd45668680f3fe28b799",20,20,0,20,20,0,1,2
"352","02486d4a32390ae3e33ec8530574a037",24,11,62,2.70967741935484,24,0,2,1
"353","0248ffe9cca5639209305eb77986ca46",88,63,49,12.5714285714286,88,0,2,3
"354","024be805fdb152a0d6da8e6ce325e949",84,67,61,9.63934426229508,35,49,2,3
"355","024c38176ba53c57a61011e5cfcf8613",83,74,48,12.1041666666667,83,0,2,3
"356","024e8c717e0209863d9717743751c5fa",9,9,0,9,9,0,1,2
"357","024f82a2270e7cfe83640e935a587161",7,7,0,7,7,0,1,2
"358","02546ced3b48e5242a02a91e7f56318c",26,26,0,26,0,26,1,2
"359","02548ceef5d9eaca7455c99667aa1bb4",57,49,10,39.9,30,27,1,2
"360","0256768dd2f0f691320971f7cc5c0fe3",55,48,42,9.16666666666667,55,0,2,1
"361","0257834acf2245da07506ac019d9aeba",20,20,0,20,20,0,1,2
"362","0259d9c5911655c017f811f52d2b1487",129,82,74,12.2027027027027,100,29,3,1
"363","025aba266fd3acfc735482c5ea8bb560",52,52,0,52,52,0,1,2
"364","025af887c8866efa794e1bd4ab753d50",34,34,0,34,0,34,1,2
"365","025fadaca239339e929c0186f673b2cb",19,19,0,19,19,0,1,2
"366","026032e0bf579ce61729dc512a415d18",123,90,74,11.6351351351351,77,46,3,3
"367","02609de2e5cd2824e2cf15e998a9a3cc",96,57,69,9.73913043478261,69,27,2,1
"368","0260af8aee60d460d1d3f5f49d2dc697",53,53,0,53,53,0,1,2
"369","02639e6eedf53e008650532fcc67c605",27,27,0,27,27,0,1,2
"370","026425bea76a9f7488f1724ede4388ed",201,134,85,16.5529411764706,201,0,3,3
"371","0268ce6f9a718bbe6362428aee1ad6a1",213,110,54,27.6111111111111,213,0,3,3
"372","026bb13909bbbef126d5b111a4c9a46d",38,38,0,38,38,0,1,2
"373","026c9f825a08d954a6226734417344e6",83,50,39,14.8974358974359,83,0,2,3
"374","026f9dd665dfb3a14c0bb1d061861c02",59,44,50,8.26,59,0,2,1
"375","02716f79bfa2dc3c579be2efc87b3f1d",18,18,0,18,18,0,1,2
"376","027299947c42d3b84f37c08edf083224",3,3,0,3,3,0,1,2
"377","027338b970b312651e08244a3ae0b6ec",27,27,0,27,0,27,1,2
"378","02745f7d1837e132d2f3014861a028a9",155,112,77,14.0909090909091,155,0,3,3
"379","0275e8122ce4ed2571163a7ba85257cb",70,41,72,6.80555555555556,45,25,2,1
"380","02763e76efc4630a2be10c19be0cc128",114,79,63,12.6666666666667,114,0,3,3
"381","027722f357390f8b7ea32ebe0d696a1d",8,8,0,8,0,8,1,2
"382","02781562bb204fc114a97188381ec133",43,43,0,43,43,0,1,2
"383","02798a3b159bf3cc62891dd8bcb7fa25",249,103,81,21.5185185185185,212,37,3,3
"384","027b1cd8b8d5f68d98d061dba5c4f750",22,22,0,22,22,0,1,2
"385","027e50d6ce86da94c72535de2bc9513e",120,74,64,13.125,120,0,3,3
"386","0280f26a2ae9490c08102b7651f9c7a0",173,69,49,24.7142857142857,130,43,3,3
"387","02853ec9e41d862de6e05201ba1ff651",187,97,63,20.7777777777778,187,0,3,3
"388","02855559d24aef4515afb23c36e7082b",14,14,0,14,14,0,1,2
"389","02858cf293ec6f85551e132fed5bb4e0",77,59,48,11.2291666666667,29,48,2,1
"390","028bf17d4a7df45e30177ecaa51ab468",127,67,81,10.9753086419753,127,0,3,3
"391","028caf00478f7119082994a7f1b309f6",116,81,70,11.6,77,39,3,3
"392","028e374093690191ca4ea24e56da53dc",34,34,0,34,34,0,1,2
"393","02919dd5d21aa2c38045b6e7902399e3",45,45,0,45,45,0,1,2
"394","0293c5cfe5e3f336731a6f3709d0f557",105,77,36,20.4166666666667,105,0,3,3
"395","02960bd19b4179386088cb23b4df29c9",95,80,58,11.4655172413793,95,0,3,3
"396","02969bd3c06c3e861cdca7487a09ac7e",76,73,55,9.67272727272727,76,0,2,3
"397","0298d2e165df35d14ab870bf6bebc668",1,1,0,1,1,0,1,2
"398","0299ce6ed2575e83f803026b72c79f29",52,44,31,11.741935483871,52,0,2,1
"399","029b31a17172f24ad496990f2dbd15bd",47,37,45,7.31111111111111,47,0,2,1
"400","029d363f578feac62ae5b54a6c293c5a",17,17,0,17,0,17,1,2
"401","029f95806f85387e96c4b4477032dc2b",30,30,0,30,30,0,1,2
"402","02a3c1461203a33dc6a9f7d18517d279",91,63,56,11.375,91,0,2,3
"403","02a5cfe8cb6eef10fd29d5fb3e3155c1",12,12,0,12,12,0,1,2
"404","02a85c1a74a0a962c88a5c03d2113030",22,22,0,22,22,0,1,2
"405","02aaeb937f70bfcbe668245abb238004",36,36,0,36,36,0,1,2
"406","02abaf7b7c62daa18c673f44be9f1eb3",58,40,58,7,42,16,2,1
"407","02acb59a2e41cbe34d5ec11d59e3fe1b",186,123,79,16.4810126582278,186,0,3,3
"408","02ad0f13555bd8552458eea9d2f7b7a5",13,13,0,13,13,0,1,2
"409","02b572f63c38920f89ebfd4ba4f21696",39,32,38,7.18421052631579,39,0,2,1
"410","02b65f64522f7eb9c9fb2bc513a5a3df",95,47,73,9.10958904109589,77,18,2,1
"411","02b67673cc4adfa24b2a834c660e821d",20,20,0,20,20,0,1,2
"412","02b7d70e0db65f0b46ecb808a5d6c53d",47,47,0,47,47,0,1,2
"413","02b87716b8d4a91a48d9c27323649a05",17,17,0,17,17,0,1,2
"414","02b96f6c45f1ae8e556fdc27d8510b15",164,68,73,15.7260273972603,164,0,3,3
"415","02bc124234e820425ef0d28f9ba98963",143,66,71,14.0985915492958,143,0,3,3
"416","02bcfe5d4bff369678cf97ad7e7710b3",102,88,70,10.2,102,0,3,3
"417","02c112b6f00a8199c0a3e6a66a353cea",4,4,0,4,4,0,1,2
"418","02c74b0608420816cc0f56fdbc9dd77d",23,19,31,5.19354838709677,23,0,2,1
"419","02c93169669814ef137629d13fb6a83b",32,27,44,5.09090909090909,20,12,2,1
"420","02cdbcd836334fc7af94b4c692baae09",49,49,0,49,49,0,1,2
"421","02ce82769f81f154f96c00f115d7c09b",23,23,0,23,23,0,1,2
"422","02cf05c759f7fd6badff0888a34d219f",39,17,74,3.68918918918919,30,9,2,1
"423","02d063daabc815b560d0fa1be872cb43",53,28,59,6.28813559322034,53,0,2,1
"424","02d0e16fce6fa57d2451f8a0f3d719cf",162,91,90,12.6,162,0,3,3
"425","02d2733509b3f7b9ef8eb6562d9cc77b",6,6,0,6,6,0,1,2
"426","02d71f520346a1db67c69c744d8b989b",4,4,0,4,4,0,1,2
"427","02d93e7e745edc8010ea92cb4eb873b2",57,37,72,5.54166666666667,50,7,2,1
"428","02d9a9314ed6d68d3fd76c6d53cb4ab2",53,43,68,5.45588235294118,53,0,2,1
"429","02db84bcbd1117be7353bc517cda911a",69,55,30,16.1,37,32,2,1
"430","02ddfa2b01c516b6b66924bbed3dad37",107,84,62,12.0806451612903,107,0,3,3
"431","02e073526c47f94fd4a1d1d48e1da31e",78,63,79,6.91139240506329,78,0,2,3
"432","02e3cacb2ba20f04aa9168436bf1328b",23,23,0,23,23,0,1,2
"433","02e44596631077f4a23291842168333a",83,73,49,11.8571428571429,83,0,2,3
"434","02e5d00220882284574ec6c2d899494b",200,105,77,18.1818181818182,200,0,3,3
"435","02e6df17a948be152d6222eddd64dcb9",185,122,68,19.0441176470588,140,45,3,3
"436","02e9d47b471b0ba97dba362f5cde3095",151,87,80,13.2125,100,51,3,3
"437","02ea81b5494822b25cf29aeff142026a",21,21,0,21,21,0,1,2
"438","02ebf0f66d9eb0741d1206ba2d40941e",49,43,51,6.72549019607843,27,22,2,1
"439","02edf57d306605a7eccfe21f41194c97",89,59,77,8.09090909090909,89,0,2,3
"440","02ee9965cade8a20a4149a5b044fc568",19,19,0,19,0,19,1,2
"441","02f07398b5bb0e64a701fcd25ef42ba5",17,17,0,17,17,0,1,2
"442","02f1a362c3fa233a56ce86f8a482bbaf",25,19,84,2.08333333333333,25,0,2,1
"443","02f382162d6b377b5e206be3794f9b20",121,83,35,24.2,121,0,3,3
"444","02f7f390651babd24e0c8edc34715563",33,33,0,33,33,0,1,2
"445","02f8c4841cae59412bf9ed9d6191b04a",16,15,7,16,16,0,1,2
"446","02fa0d8be5c017d6debd569685496013",19,19,0,19,19,0,1,2
"447","02fd6d39a859c12d18ef374fc3f9f65f",11,11,0,11,11,0,1,2
"448","02fe2ea01ff5b39f960358eda789206e",35,35,0,35,35,0,1,2
"449","02fe33e77551df09f510f46aa208c51c",129,91,56,16.125,129,0,3,3
"450","02fe77f345b82fcd0031916deaaf8131",53,53,0,53,53,0,1,2
"451","02ff35f66fbce784407a01b0fdd7c8db",14,14,0,14,14,0,1,2
"452","02ff5edaa057b63ea0a0010c5402205c",53,53,0,53,53,0,1,2
"453","02ff8a954bd520a1efeb2482c3547c14",51,50,59,6.05084745762712,51,0,2,1
"454","02ffcb0efb4ab92558ac5e73e8635068",50,47,38,9.21052631578947,50,0,2,1
"455","0300fb8190feef124d7f8236cb66dc22",40,32,51,5.49019607843137,40,0,2,1
"456","030113f7bc0fd37d3488d8cb481be341",76,56,41,12.9756097560976,76,0,2,3
"457","030192b34ceb515936c9b3558bcf56e8",160,76,67,16.7164179104478,131,29,3,3
"458","0308fb87556476aa63e6a3e1c75b1065",22,22,0,22,22,0,1,2
"459","030deb3cd885ba3d7d34f029d695ff2c",45,45,0,45,45,0,1,2
"460","030ff423a24f005d3e5e2113caf6f1a8",71,50,34,14.6176470588235,71,0,2,1
"461","03138b9bc68531411bd606d238ede7f4",38,29,10,26.6,38,0,1,2
"462","03139dce41183df982a56317075a8cb2",27,27,0,27,27,0,1,2
"463","0313e0a02d017812b4347883c59843a1",6,6,0,6,6,0,1,2
"464","0316bdb9c4372b80ad4ea5f3d8dde17b",22,22,0,22,0,22,1,2
"465","03196aef4971aee6a618ac147aa1962b",99,84,56,12.375,99,0,3,3
"466","031bb26d4191c7998a20ecfc3e1305e9",58,49,57,7.12280701754386,58,0,2,1
"467","031be2fc3bc75453ec31a79e370cd170",78,49,54,10.1111111111111,52,26,2,1
"468","0324230efd2c561c6ff93e0cdbe9555a",40,26,81,3.45679012345679,24,16,2,1
"469","032974332b391bddd5442ec7a3122759",25,25,0,25,25,0,1,2
"470","032d8e3b67c55b9ba6f36bdaf5565d76",26,26,0,26,26,0,1,2
"471","032e72d04a131024f76fc8e00d5420eb",131,90,70,13.1,92,39,3,3
"472","032ea03347ccc20e98c7208b3af26774",33,33,0,33,33,0,1,2
"473","032ecb8af79aeeb01ee4a4940720a3cc",27,20,4,47.25,27,0,1,2
"474","033285012c8c2daca707ffb7a52ff12c",19,19,0,19,19,0,1,2
"475","0334409d92e00b4c2a2afd6df4d05d53",8,8,0,8,8,0,1,2
"476","03364d4201f69992006ac057abdedc9b",47,40,49,6.71428571428571,47,0,2,1
"477","033a3b19b7e8d7f97ff048b78151f476",19,19,0,19,19,0,1,2
"478","033beab8d32d59e863fe022e1f4fbe25",82,66,68,8.44117647058824,82,0,2,3
"479","033d2ae99fabbc8dee957e4814701640",39,39,0,39,39,0,1,2
"480","03435e4cfe1b479a3f86ca6cc6a1af24",61,33,63,6.77777777777778,61,0,2,1
"481","0343954a374eae50bef272b6cb4b46a3",158,71,73,15.1506849315068,130,28,3,3
"482","03498105230d7ba335f30a09925af4e8",40,33,64,4.375,24,16,2,1
"483","034ab5c6fc47394b279d26371cc87d40",44,36,6,51.3333333333333,44,0,1,2
"484","034ac9354d20128509901d2ff75beb89",46,42,49,6.57142857142857,0,46,2,1
"485","034ae66acc0bd6fb5329a302df72fa49",30,24,42,5,30,0,2,1
"486","034d8125de904e8aeb829aa2dbcf1ddd",8,8,0,8,8,0,1,2
"487","035149572f5bd99a554b7665c64455de",99,55,62,11.1774193548387,99,0,2,3
"488","0353fb83ee6a2300a51761e6262eae67",29,29,0,29,29,0,1,2
"489","0354dbd81ab63c0eb234a23e29240895",77,62,70,7.7,55,22,2,1
"490","0355bc96dd36f6827912c12a85effb4f",19,19,0,19,19,0,1,2
"491","0357d191c21fd0c6b65d7f29ad4771c5",28,19,69,2.84057971014493,28,0,2,1
"492","0362d29104a503d8295544f5b1ea4706",43,39,68,4.42647058823529,43,0,2,1
"493","036677a31d59073a7a2155bb890ccbe0",25,25,0,25,25,0,1,2
"494","036718bfd0018b15655d9182c5303643",10,10,0,10,10,0,1,2
"495","03675f025869ce4707125a3e8e2b7cf1",27,23,22,8.59090909090909,27,0,2,1
"496","03683d79d8f7c11fcabe1be80d9aa4e0",14,14,0,14,14,0,1,2
"497","036a9a165619648a201d720a3b094e66",10,10,0,10,10,0,1,2
"498","036db132790df3a4ac82ca104bb30fbb",3,3,0,3,3,0,1,2
"499","036dd25540bf69249c3ff3598579c3c4",48,40,38,8.84210526315789,48,0,2,1
"500","0370182dbe79b6a49cfefd76292985d2",51,27,57,6.26315789473684,51,0,2,1
"501","0370ea0799501688d7f8a3ff82c606be",14,11,29,3.37931034482759,14,0,2,1
"502","0371909d076d3d4819f21ad79aad0ecd",15,15,0,15,15,0,1,2
"503","037569d1fff085f290bc336ec280c9b2",11,11,0,11,11,0,1,2
"504","0376cd67caf908f1578245b6a549ff68",106,82,35,21.2,78,28,3,3
"505","03783b03544f676c2499b86e2a4d4819",36,36,0,36,36,0,1,2
"506","0378a27fc7276970e37c85a7d2ddf345",19,19,0,19,19,0,1,2
"507","0378b0f3f21bae93a13039ab9ad737d4",47,37,59,5.57627118644068,47,0,2,1
"508","0379f7453377f7ad5f01a0caee4ff65e",47,47,0,47,47,0,1,2
"509","037c96c588e5d9c0d2ba38f07ab3464e",35,35,0,35,35,0,1,2
"510","037ce11383676471f039a77a03aa776f",9,9,0,9,9,0,1,2
"511","037f565c2017196f99162c09abb88822",139,108,56,17.375,139,0,3,3
"512","037ff11d73cccb487ee1a1eaa3170486",84,39,64,9.1875,57,27,2,1
"513","0380f1a9d3b8b14df2e3e0515b3877fb",1,1,0,1,1,0,1,2
"514","038143c67ce660fdbb4322e034d0b39b",129,57,85,10.6235294117647,77,52,3,3
"515","03827376d818e366a10a3b073cda4554",133,76,59,15.7796610169492,102,31,3,1
"516","03827ed4c42623f25b67d21c55825f04",196,112,76,18.0526315789474,170,26,3,3
"517","03866ebad3980646d025841147012f5a",4,4,0,4,4,0,1,2
"518","038753ff139f4c79545745f213f0422b",21,21,0,21,0,21,1,2
"519","038b02a42efd85247fa9391a39e86ba0",46,46,0,46,46,0,1,2
"520","038ee7262ed2db2a087757e504c650e3",34,33,80,2.975,24,10,2,1
"521","0394195a79230114861d85d45574291b",4,4,0,4,4,0,1,2
"522","03944cfaa55a4ec6351fe3cb4b8766cc",19,19,0,19,19,0,1,2
"523","0394cb2ca1e0623a0b4babc7c08879c9",76,62,52,10.2307692307692,76,0,2,3
"524","039554c579e7ea8613dea680bc0409d2",21,19,24,6.125,21,0,2,1
"525","0396dcb3278fa405d6022ee33999fb3d",57,50,64,6.234375,57,0,2,3
"526","039724f01d57bda48a89f913d1675528",42,33,14,21,42,0,1,1
"527","0398f1d4ee748b57fcdabc9bfd296ab1",188,123,46,28.6086956521739,188,0,3,3
"528","03992e1d82ef40a4c30200350c60b079",170,93,89,13.3707865168539,170,0,3,3
"529","039b7c8d250d665fac6687a02b0a9a9d",56,56,0,56,56,0,1,2
"530","039c243ebfc0f755e7ef53fe48201c6e",31,31,0,31,31,0,1,2
"531","03ab86afa7c96b8abdc5d8cd2b3c178c",97,74,82,8.28048780487805,97,0,3,3
"532","03b3c04cfa554eda4947d568a3338d36",25,25,0,25,25,0,1,2
"533","03b4ccc106f2ef28e200b24453be9391",30,30,0,30,30,0,1,2
"534","03b62d603b5685539f16010073cd80ee",23,23,0,23,23,0,1,2
"535","03b8ec3502c618d10e1a591d726b6eb8",18,18,14,9,18,0,1,1
"536","03bdcdc7ca07b66a455cda5030e6f4d9",23,20,31,5.19354838709677,15,8,2,1
"537","03c3ad10ab47e6c7a27fc40c3bef0d93",90,71,47,13.4042553191489,61,29,2,1
"538","03c480de3560b5a4cb1a2df060ea6708",36,36,0,36,36,0,1,2
"539","03c640d9e62a114470c8b2ba8d43517e",11,11,0,11,11,0,1,2
"540","03c650aaf639738ba04077aadc427d4e",29,29,0,29,29,0,1,2
"541","03cac177b39ac99b07be49447db06bb6",48,36,13,25.8461538461538,48,0,1,1
"542","03cc635bee41b4abdb1d01a037129f67",65,47,63,7.22222222222222,65,0,2,3
"543","03cd6df187debb5af62956fd09581802",70,52,17,28.8235294117647,70,0,1,2
"544","03d0607da764c4a514082627f5359b13",46,36,13,24.7692307692308,46,0,1,1
"545","03db87842388b02cac90f74a61827674",26,26,0,26,26,0,1,2
"546","03dc9d56dd45ba8509173810ecf35f04",31,31,0,31,31,0,1,2
"547","03ddbf5a54d103316e7c56f6b71dcf6b",239,77,81,20.6543209876543,194,45,3,3
"548","03e001a4e9862742302b2df3a465395b",116,80,35,23.2,61,55,3,3
"549","03e04dc27cdea20a7194a07a9a271cba",29,29,0,29,29,0,1,2
"550","03e1c3bae1893658d7e76a9a5d8f869b",18,18,0,18,18,0,1,2
"551","03e28541743f8b001fcb72bd8bd185e6",9,9,0,9,9,0,1,2
"552","03e4b91fe2b1b2c8f1fd82fdc8f3cd3d",155,78,89,12.1910112359551,155,0,3,3
"553","03e539caaa8475b1ae2e989e4c8eefb8",172,107,88,13.6818181818182,153,19,3,3
"554","03e8a412feac35d552db990dac737fcd",35,35,0,35,35,0,1,2
"555","03e8a487154c28c93c6491b5646b450d",90,77,56,11.25,90,0,2,3
"556","03ea64dd39fac59d256f493e0533cfa4",182,110,65,19.6,182,0,3,3
"557","03eb77845798d9551f584ebded5f962c",51,38,62,5.75806451612903,51,0,2,1
"558","03eda7c2f03e241c152790be384d5026",121,83,30,28.2333333333333,121,0,3,3
"559","03f348ac661a8603af064190c3aec7ba",49,49,0,49,0,49,1,2
"560","03f37242e8bde089ea235ceb74343128",48,38,35,9.6,48,0,2,1
"561","03f434eadcf9055fceb2fd488e768833",126,75,66,13.3636363636364,126,0,3,3
"562","03f4fcb223d9f3af546d21d01da568a3",100,72,75,9.33333333333333,63,37,2,3
"563","03f7c73f24d5f6270b698439bdbe93e4",128,62,84,10.6666666666667,128,0,3,3
"564","03f81c8f00e87b966f5bc97baf5c9f88",21,21,0,21,21,0,1,2
"565","03f8ab2fd2a7cd86cdff76fbc30fa556",108,67,55,13.7454545454545,108,0,3,3
"566","03fa1127edf0c6c9337e6f975fb009f4",139,90,83,11.7228915662651,139,0,3,3
"567","03fb6f8e5ebdb803c7ab9eac1e127753",5,5,0,5,5,0,1,2
"568","03fd4827cde4be60b7cc55ffcafc475a",35,27,82,2.98780487804878,35,0,2,1
"569","040160049b8e4fc1f03518e93fad5fc8",182,98,68,18.7352941176471,165,17,3,3
"570","04042a3dd692dd875d10f380e47fb633",10,9,2,35,10,0,1,2
"571","0405250ad7b9fa21cf612c6ef344f8c3",17,17,0,17,17,0,1,2
"572","0406aeb0d41eaa0646b6d16e7bd66bc4",37,37,0,37,37,0,1,2
"573","04092735dbb4074feebe1197147e71b9",44,35,57,5.40350877192982,44,0,2,1
"574","04098174ed0c62f9cd0020deafee0cf5",1,1,0,1,1,0,1,2
"575","040a14b059c9b3fdab2c15dd6e672eda",59,45,47,8.78723404255319,29,30,2,1
"576","040a59d9f7d49b9671e063f73d24cf82",59,55,57,7.24561403508772,59,0,2,1
"577","040cb3931e307a07900c4e18059c19fb",18,18,0,18,18,0,1,2
"578","040d450f74ef64941ad1475966629abb",1,1,0,1,1,0,1,2
"579","040fda55d974d7121a7b3bb52e8209c2",45,41,27,11.6666666666667,45,0,2,1
"580","04141e2a8d3f83fe28912ba7010d7f7e",137,96,82,11.6951219512195,137,0,3,3
"581","0415d78012ff50de524324cbf5154a98",55,49,24,16.0416666666667,34,21,2,1
"582","041959735614fe208776f8e1a71709df",121,80,47,18.0212765957447,121,0,3,3
"583","041eab0a24583b9c03687c530bb2cc02",43,43,0,43,43,0,1,2
"584","04222c1c138ea27352458b9b41d1d44a",88,72,39,15.7948717948718,88,0,2,3
"585","042362c41b8fd96ddaeb2aaea9de9175",52,42,43,8.46511627906977,52,0,2,1
"586","042497d26c7f4da7b85ba71a854f0fde",28,25,53,3.69811320754717,12,16,2,1
"587","042590445018321442d360075aab43aa",128,44,68,13.1764705882353,128,0,3,3
"588","04263457e8fb73aeb352f633bcd868b2",13,13,0,13,13,0,1,2
"589","0427110dc4545670afa7ce114313d8ec",21,21,0,21,21,0,1,2
"590","0427cffe085b77a0e961dd24fa75d214",1,1,0,1,1,0,1,2
"591","0427f70295327d28110a53455df4f6f8",21,16,66,2.22727272727273,10,11,2,1
"592","04286780566978de1e210b50ab0abda5",50,44,23,15.2173913043478,30,20,2,1
"593","042982e9e565b85147f5d46f71c58aa8",50,40,43,8.13953488372093,22,28,2,1
"594","04298ddb1dcf4225fbbe92e0882c2ac0",57,42,55,7.25454545454545,57,0,2,1
"595","042a43b0a432e83bcf7bff94c187f976",137,78,63,15.2222222222222,109,28,3,1
"596","042b8f9e7d19c0be1a55d1031413af44",54,54,0,54,54,0,1,2
"597","042e8884aef52286cd7f9e440eb294df",28,28,0,28,28,0,1,2
"598","042ed1e59cc9339f76d038d4910d8605",36,35,6,42,36,0,1,2
"599","0430c4f4605f71e8578cc9b1e34a209a",113,31,84,9.41666666666667,113,0,2,3
"600","0432487f9937169f8684e2a5d4f9d6c0",10,10,0,10,0,10,1,2
"601","043389eafcf89eb7462618f1d767c874",21,17,29,5.06896551724138,21,0,2,1
"602","043447cdb3de4d04b0455bf1d6502707",94,75,50,13.16,94,0,2,3
"603","0435c7fcd2f6b75bbf17bb1151bf60a0",30,30,0,30,30,0,1,2
"604","0439e3dcc72753cd93bdba4e27a63684",64,53,62,7.2258064516129,64,0,2,3
"605","043d48a0b5aa4f160a659686f106cd52",72,55,70,7.2,72,0,2,3
"606","043fa756cb794f612bb977e28828b63e",46,43,68,4.73529411764706,46,0,2,1
"607","0441e00ffd65c3a12658d0dd56116830",33,33,0,33,33,0,1,2
"608","044a3ff2d01179573c657d04e8eacd81",9,9,0,9,9,0,1,2
"609","044b402b6fc4e1fc85ca68b63f7c71c8",95,66,65,10.2307692307692,95,0,2,3
"610","044cd6ea02665c8b56b00411bde8d91c",31,27,48,4.52083333333333,31,0,2,1
"611","044d461921913fe11fca5d87c8c63875",46,38,45,7.15555555555556,46,0,2,1
"612","044f36ebc91a4654fcfbc5302f527f7e",121,73,62,13.6612903225806,88,33,3,3
"613","044f65aed5c0c9a70570246e057a8f89",48,43,41,8.19512195121951,48,0,2,1
"614","045044a15cedf2d6168e4e05ad223309",15,15,0,15,15,0,1,2
"615","0452a3d74cacbcb2a928ec5a20f73698",53,49,70,5.3,53,0,2,1
"616","0455cdd4a0f9d0bc76848b5b4dcc063f",104,82,60,12.1333333333333,69,35,3,3
"617","04574ab3f67142b9e7107b40af4d3251",72,50,61,8.26229508196721,72,0,2,3
"618","04578630f8a4091c2754b264fdc687d7",41,30,70,4.1,41,0,2,1
"619","0458269934679efd0979264d8a80518a",6,6,0,6,6,0,1,2
"620","045a442abc02cb9f647bfc5ae16a8ab6",47,47,0,47,47,0,1,2
"621","045c04885273fdbf9847bd3a53a3618b",49,49,0,49,0,49,1,2
"622","045f95be08be3bfe91eca066953696f3",65,55,31,14.6774193548387,65,0,2,1
"623","045fa4cf4f580b89321de79c70c58644",96,63,41,16.390243902439,96,0,2,3
"624","04653d743f838552f0a28bffe5288335",31,23,82,2.64634146341463,31,0,2,1
"625","0469affe3a95aadd69c5a2e4785ccdb4",78,56,36,15.1666666666667,78,0,2,1
"626","0470a085f4d24a961a65eec0feabe0be",65,57,27,16.8518518518519,27,38,2,1
"627","0470d6285ba45c6189cb3825cf9d9f69",34,34,0,34,34,0,1,2
"628","0473e87e9058115f9a19085b44d5e348",149,67,75,13.9066666666667,149,0,3,3
"629","0477adb6943f24cb2367dd316c6ab11e",44,16,89,3.46067415730337,44,0,2,1
"630","0478f72aff758399e3c0ba7e93e45d93",51,33,74,4.82432432432432,41,10,2,1
"631","047c98bd94342ef927d26621ed84f0a4",139,99,74,13.1486486486486,139,0,3,3
"632","047f47cafaab13fc858cf3c8ce0a470c",33,33,0,33,0,33,1,2
"633","0481748670897b807cb1e3819e6ec550",83,63,48,12.1041666666667,83,0,2,3
"634","0481fe540d4d23e5fd41e4f9ad97c990",115,52,70,11.5,115,0,3,3
"635","04835cec82a5b4dd8cab10ac6e94727f",27,27,0,27,27,0,1,2
"636","0483fc32cb5155e263527a838513c83b",47,47,0,47,47,0,1,2
"637","048433f7662e9c7d7b8bb3f03a206727",28,28,0,28,28,0,1,2
"638","0484eeddb99c6db95aa64126f919b390",65,52,71,6.40845070422535,65,0,2,3
"639","04870042a7b656f5ca111a87b42f939d",87,66,17,35.8235294117647,44,43,1,1
"640","04899cfead0af6f9ae9ee5e2732fa6b7",21,21,0,21,21,0,1,2
"641","048afd2a0e61195ba2fa82d3da7f1c57",114,49,63,12.6666666666667,75,39,2,1
"642","048b9eb4400d764dc166df1dc4d81e6f",127,73,64,13.890625,78,49,3,3
"643","048d2a9a7efefcffa40790ab84c4f25a",1,1,0,1,1,0,1,2
"644","048f00432bc5372576e66592e10d5a5e",47,47,0,47,47,0,1,2
"645","048fdbbf4398fd120fa284ec9b4e8131",77,54,56,9.625,77,0,2,3
"646","0491280b56384c16776a2e679da43d69",32,32,0,32,0,32,1,2
"647","0491b331dcc0f6a42c2903dde72d0e3e",29,29,0,29,29,0,1,2
"648","04937996f36659f7327ed69987384056",30,30,0,30,0,30,1,2
"649","049503cfcc38fa9b154a30b4e6fabb5f",52,52,0,52,52,0,1,2
"650","049a7f3cc897e39fa4f3c171f5c41790",68,49,42,11.3333333333333,68,0,2,3
"651","049aaaf8dc444362c867b35b022074af",21,21,0,21,21,0,1,2
"652","049f2411e16de5e89217e8f7262642b1",109,74,56,13.625,54,55,3,3
"653","04a032898e8f218a8cc0a72c1b54801c",119,67,63,13.2222222222222,119,0,3,3
"654","04a1c4ecd07af0fc98b5f411deb965fa",220,138,65,23.6923076923077,171,49,3,3
"655","04a44b8eb4b31b523f7ad751fa042096",1,1,0,1,1,0,1,2
"656","04a71f635821d69711d71c9f78b06e0e",67,55,28,16.75,67,0,2,1
"657","04a77b78f33ca7e7b8d2a05e46e44aa1",17,17,0,17,17,0,1,2
"658","04a79204a1d0ea8b14192bbb4831c108",28,28,0,28,28,0,1,2
"659","04a92624d6811e9958f79a7f95385536",92,65,67,9.61194029850746,92,0,2,3
"660","04ab2f508020793bbb5e375b0194e459",63,45,48,9.1875,36,27,2,1
"661","04ad35427c80c69ce329f18d29207072",8,8,0,8,8,0,1,2
"662","04ad90df3746f73f845125ec4638d138",47,37,70,4.7,47,0,2,1
"663","04b09d61119e76fc56372c074745fbae",97,74,61,11.1311475409836,62,35,2,3
"664","04b13891530e4b7347837c29b4447554",128,87,46,19.4782608695652,128,0,3,3
"665","04b293216a7e701dd58367552435d463",48,36,25,13.44,24,24,2,1
"666","04b6716c7ed95609b9350f3a867e4102",61,52,43,9.93023255813953,61,0,2,3
"667","04b78cb35e7543fea63c8ba60009cdde",26,26,0,26,26,0,1,2
"668","04b95c737ebb3319bd45ae5ba111e922",30,30,0,30,30,0,1,2
"669","04bc715957b26fd17165c3bf912bd687",16,16,0,16,16,0,1,2
"670","04bda197096f07d2b99b5be91d64fbeb",200,123,64,21.875,160,40,3,3
"671","04be3d5dc8c47db812ab74087bf32a7e",6,6,0,6,6,0,1,2
"672","04bf0779cbc15cf3a30ce67958f6ae8d",89,49,68,9.16176470588235,75,14,2,1
"673","04c3387d81c389c15cce8364539cd13d",213,132,83,17.9638554216867,213,0,3,3
"674","04c41879375a3d4aba8a6a57a06b1520",82,63,33,17.3939393939394,37,45,2,1
"675","04c58a6be6604a9a7a9195d6cd5f6f34",29,29,0,29,29,0,1,2
"676","04c65971cda831483d8d2fcd1ffbb21a",10,10,0,10,10,0,1,2
"677","04c86d688345bd24d628a08e8ea6a260",20,20,0,20,20,0,1,2
"678","04d56edaf7ca82e5cc075e4ea832cd43",173,68,65,18.6307692307692,173,0,3,3
"679","04d67d90726c19f41bd76ca612d2843c",24,24,0,24,24,0,1,2
"680","04d6f9d9f13a758e63923a9eeb5a2ef9",5,5,0,5,5,0,1,2
"681","04d823c2912acf915d91b157e839416b",45,45,0,45,45,0,1,2
"682","04db1b0d56fa5077203a209cae5c12d3",73,47,83,6.1566265060241,73,0,2,3
"683","04db3b97de472c6b737c819415f8b3dd",31,31,0,31,31,0,1,2
"684","04db5c8185a9f1d6d17fd663d4fdf85a",142,84,67,14.8358208955224,142,0,3,3
"685","04db65565c0d56dee8987766e9638518",171,76,73,16.3972602739726,171,0,3,3
"686","04dcb6ee64b37f5193dd03d9668357c6",46,46,0,46,46,0,1,2
"687","04dcd87d10ec0278df760e972fa00c61",71,52,63,7.88888888888889,46,25,2,1
"688","04deee7c0159cabe79a0b16dc0f79829",173,101,71,17.056338028169,173,0,3,3
"689","04df87e9474e5726c2b635eb49a3f99a",120,69,61,13.7704918032787,120,0,3,3
"690","04e243e4d6e38bfbfb91d252e0afed86",34,34,0,34,34,0,1,2
"691","04e34837a69fe6fcd0bcb430bde2f9d7",134,83,49,19.1428571428571,134,0,3,3
"692","04e373e5285e3113ea39b1ffeb08950c",107,60,56,13.375,107,0,2,3
"693","04e65631ebd6476b7f7c28d01128df14",52,41,84,4.33333333333333,34,18,2,1
"694","04e9cfbe49cf573a2c4821474e71eda3",18,18,0,18,18,0,1,2
"695","04ebc65667a797ed01efabc8546f8ca4",6,6,0,6,6,0,1,2
"696","04ec0e44930cff1c39d2174c7def2aac",24,24,0,24,0,24,1,2
"697","04ec71f6029817708abb6ccd4b5e782b",62,50,51,8.50980392156863,45,17,2,1
"698","04ed9e318acfbb205b14de6f86a0e219",28,28,0,28,28,0,1,2
"699","04ef9a7aab056f44b779c7a8a3dd1390",98,72,71,9.66197183098592,98,0,2,3
"700","04f5a1b2f49ca1e1f250ca6f4a96468b",79,67,22,25.1363636363636,79,0,2,2
"701","04f608ebcbf0f997654ea5983fb3713e",46,32,66,4.87878787878788,46,0,2,1
"702","04fa92b4bb305e0c0ccf84c8bf05b06b",20,20,0,20,20,0,1,2
"703","04fdf24660fae8bc0b207d73f2ce6754",39,39,0,39,0,39,1,2
"704","04ff57b4ee7848e90b946c8e5af73ece",24,17,49,3.42857142857143,12,12,2,1
"705","050253dc6b01c79ee01169184db54572",237,121,74,22.4189189189189,194,43,3,3
"706","0508099be6a2d2d0a017c096c8eff976",170,135,80,14.875,144,26,3,3
"707","05089cff19b2165e441162fabfa420b1",94,54,59,11.1525423728814,94,0,2,3
"708","0509698908a99ee0d392983dcc32dc50",29,29,0,29,29,0,1,2
"709","050a48b7d89cf1eb0c5dfc65111c760f",28,27,5,39.2,28,0,1,2
"710","050a9a800971f7468356ad6fdc7f094e",20,20,0,20,0,20,1,2
"711","050cd6bc16c4e576414a872719839865",51,45,16,22.3125,51,0,1,1
"712","050e279a27b9c8e922ad5a0a8a5d87f8",24,24,0,24,0,24,1,2
"713","0512a268a098956a47aad506816f9cdf",172,85,67,17.9701492537313,139,33,3,3
"714","051351e49aaecaba612fa348d56a6032",55,49,63,6.11111111111111,0,55,2,1
"715","0514e36afcdd286385ac40ed0aae0f96",18,7,84,1.5,0,18,2,1
"716","05169bf55c2ef1f40ebb36392e2b6026",66,47,44,10.5,66,0,2,1
"717","051f42c178575b6fbac9447f43428f80",52,42,44,8.27272727272727,52,0,2,1
"718","05228beefca579b24ed2150682c60c35",21,21,0,21,21,0,1,2
"719","0524f0e617c7551e2dafb6df901846fb",21,21,0,21,21,0,1,2
"720","05256ca3e12c80b4f8f90168a5567f5e",6,6,0,6,6,0,1,2
"721","0525d2cd6f0f2372a8f787f7a15be6ab",97,71,34,19.9705882352941,97,0,2,3
"722","0526b1e0f82a36363e348349a54d5324",69,64,10,48.3,69,0,1,2
"723","0529f7708631e92fdd5a28943279562e",5,5,0,5,5,0,1,2
"724","052d2d85f1dcdaac043ec111ebf70ede",169,104,64,18.484375,169,0,3,3
"725","052e3cdef43bdadb508fa8d6198bad8e",175,104,65,18.8461538461538,175,0,3,3
"726","052f80e7522d819ae1ede6f2e2842b6c",18,18,0,18,18,0,1,2
"727","053465996800fb5f8e3cc8cb148a571e",21,21,0,21,21,0,1,2
"728","0536bf769c26bf7f2d94b5f10dd0d74e",41,41,0,41,41,0,1,2
"729","0537bf81547ccfe38aa996f4bb566401",41,41,0,41,41,0,1,2
"730","053888931e912a44b6ad2fcbaed8b1a4",129,88,56,16.125,129,0,3,3
"731","05389f275544c9e35265b9a1c67904ae",26,26,0,26,26,0,1,2
"732","053a1638b3e11fb894d182ef66939e39",20,20,0,20,0,20,1,2
"733","053a91e66b24ff37af3783a56a5146dd",13,13,0,13,13,0,1,2
"734","053ac78247d33e6cc7ac93a0a9777d5c",49,49,0,49,49,0,1,2
"735","053e3fa482c687bc63d88f02c41ef645",40,31,30,9.33333333333333,40,0,2,1
"736","053ea723f5a758f0ed492b8a29bcdf6b",130,91,79,11.5189873417722,100,30,3,3
"737","053f3169f15fb604965390e52573e658",111,80,43,18.0697674418605,111,0,3,3
"738","05402be64e115c66249f6ef747872a3f",66,52,47,9.82978723404255,66,0,2,3
"739","0540e7e2c14fd16b36824c1c1b20a07f",23,23,0,23,0,23,1,2
"740","05426f8183d3060b5bf6d141677028a7",146,94,61,16.7540983606557,146,0,3,3
"741","0544e1c16c79284019d00c17c1853db7",44,38,21,14.6666666666667,44,0,1,1
"742","0546ac698095e8892098a10e75f0062f",31,29,5,43.4,31,0,1,2
"743","054a7bb91b7487b8ec743bf95b8add41",36,36,0,36,36,0,1,2
"744","054aa4aa8a6006ae57cf98ca806697d9",38,38,0,38,38,0,1,2
"745","054ab4385e3e7fd09ce8a9e6454d0a7a",22,22,0,22,22,0,1,2
"746","054ded2958698ec60089b3c11475c9f9",64,50,49,9.14285714285714,64,0,2,3
"747","054e0e7fe55057e9d6ad733cc57c9418",46,46,0,46,46,0,1,2
"748","054e2a278585ef43c93e3802883a26e6",44,41,33,9.33333333333333,31,13,2,1
"749","0552e1bd645e238ba38a2e4d7fe28ab2",133,97,63,14.7777777777778,83,50,3,3
"750","05564a40172813ca8a11bf504cf5606f",116,34,65,12.4923076923077,116,0,2,3
"751","055806564805b951bab8716bca09ffe1",72,44,42,12,42,30,2,1
"752","05592e60b7d5c40168e171c6dfc1a742",18,18,0,18,18,0,1,2
"753","055978d7571ba3a572f62788a1ba2429",9,9,0,9,9,0,1,2
"754","055a89b4b97ef6040cdf815d611b7799",34,34,0,34,34,0,1,2
"755","055b9ba56a3d70f933a2e2a8e0f486b5",40,27,59,4.74576271186441,40,0,2,1
"756","055bce272d000df55c6906adb15608c7",87,41,64,9.515625,87,0,2,3
"757","055c557e80ed7922d345baa265ee1ca0",51,41,20,17.85,25,26,2,1
"758","055ca05c7a3744e4f4928f4a820fe262",51,45,18,19.8333333333333,51,0,1,1
"759","055d573048b7dafedda7c1ef41a42d78",102,88,73,9.78082191780822,72,30,3,1
"760","055f46f60219fe6153b3342461a0f988",17,10,63,1.88888888888889,17,0,2,1
"761","0561368b682544aa71a387d9824f7cbb",27,27,0,27,27,0,1,2
"762","05619966ca2087b17b1670e5ec374ccb",106,87,76,9.76315789473684,106,0,3,3
"763","05645f53a8504eaa0972bc833ca73c7d",29,26,63,3.22222222222222,29,0,2,1
"764","0564eb92551ab870aeefdd965b0452d4",33,33,0,33,33,0,1,2
"765","0566dbf84a0141eea849c9db9e6d5f8c",23,23,0,23,23,0,1,2
"766","05687e8221eb504fee12b481f1a7d252",27,27,0,27,27,0,1,2
"767","05690121fa531512868584a637aa734f",12,12,0,12,12,0,1,2
"768","056ac61dfcf3ea2d04d39e8b39fb9831",155,103,26,41.7307692307692,114,41,3,3
"769","056bc84090005fc87dcd5d6be307269c",209,123,68,21.5147058823529,209,0,3,3
"770","056bf926cd99d5d62c3a6fe4a21ca06d",26,26,0,26,0,26,1,2
"771","056f28409b3327c276c3abfdcd9c5942",82,36,63,9.11111111111111,69,13,2,1
"772","05736898e2de1a35f50a34246e3993c8",28,23,53,3.69811320754717,28,0,2,1
"773","0575872b559ea7907ea987fcd966b784",26,26,0,26,26,0,1,2
"774","05762afd690c3ad3807d89389e1ed2c1",47,47,0,47,47,0,1,2
"775","0576381f893561267ebe90d9ed07eed2",106,60,71,10.4507042253521,106,0,2,3
"776","0576cc45de28eb2f3eaae5e5f7679f53",9,9,0,9,9,0,1,2
"777","0576cf49778253161204f95d618ad3a9",21,21,0,21,0,21,1,2
"778","057a1e1454a927283c2f84b8cce98258",83,59,38,15.2894736842105,43,40,2,1
"779","057afd80dbf5a63974633274d6226f01",52,41,36,10.1111111111111,52,0,2,1
"780","057b53b22b2ee039b2b7e25453c92816",36,33,36,7,36,0,2,1
"781","057c4a4d9581f1d12c5620499592d55b",114,90,29,27.5172413793103,114,0,3,3
"782","057e1ba6bfb936e919a8211f20938aab",25,25,0,25,25,0,1,2
"783","057eaaa8ad2bed2fb74d5db7104f75f8",53,44,20,18.55,53,0,1,1
"784","057ff095757d5c1a0c46bfc63f5ddc6d",22,16,19,8.10526315789474,14,8,1,1
"785","05817d85ee8070e303aa8d897b0f8929",35,28,40,6.125,15,20,2,1
"786","0582c92fd349c83242177cd00079bc46",30,30,0,30,0,30,1,2
"787","0585d084da5c75f33d959fd6b0656d80",103,58,58,12.4310344827586,103,0,2,3
"788","0587114b7b0b9a4b6cb2a00430b70501",1,1,0,1,1,0,1,2
"789","0589ff4c4ee31d97a9a27d9bcf00c100",99,39,77,9,99,0,2,3
"790","058a51e0a7fc9581b0350a9d9385f8b7",70,48,26,18.8461538461538,27,43,2,1
"791","058b19ea8693912671e5c3b9b7be704b",22,22,0,22,22,0,1,2
"792","058e175d70283defd075c629174d72eb",17,17,0,17,17,0,1,2
"793","058f8200c7d9d29c4aee55d350c27597",82,67,36,15.9444444444444,56,26,2,1
"794","05919dc793a159cd99f1f4332cb3cfe6",35,35,0,35,0,35,1,2
"795","059484ed74983bb6112b8ac03888cf83",69,55,33,14.6363636363636,69,0,2,1
"796","05977650e664127b196d68e88624fd9d",76,44,74,7.18918918918919,39,37,2,1
"797","0597a326eb5ffcfdd9abae958ab5028b",148,74,62,16.7096774193548,148,0,3,3
"798","05986acb69b9c19442e65bda75a946eb",171,121,50,23.94,171,0,3,3
"799","059886aa8c50458e71cdb6669a17fb59",40,40,0,40,40,0,1,2
"800","059fea4c4b3ff1cb35abb49c2ea8dd6b",22,22,0,22,22,0,1,2
"801","05a0fe60c66b67e0bb617dafdd19f0fe",86,62,56,10.75,86,0,2,3
"802","05a170c196c36f6572c45f5b6a3c81c9",25,25,0,25,25,0,1,2
"803","05a1edd44f3420a50a6f9b8daf91df3b",52,52,0,52,52,0,1,2
"804","05a402d92af3efe70fbca8b7bbd79fc8",54,54,0,54,0,54,1,2
"805","05a9dd82429a42e8727bf3bd3dc7d13d",34,31,9,26.4444444444444,34,0,1,2
"806","05ae0dbf012fa49ba5fa4802ddb71ff5",105,89,42,17.5,105,0,3,3
"807","05aeeb0f30f19946e5d528617423264e",51,44,7,51,0,51,1,2
"808","05afd0e436ef48b53d2395a0dc10130c",51,46,37,9.64864864864865,33,18,2,1
"809","05b0b14964277bcb75d5f7701291fc05",113,87,65,12.1692307692308,72,41,3,3
"810","05b1da384488699b08a702b4bfcc8578",27,27,0,27,0,27,1,2
"811","05b6971c2b1085949d0eac9f55696a27",18,18,0,18,18,0,1,2
"812","05b718727399572fb876fe25ee170ce1",179,70,79,15.8607594936709,162,17,3,3
"813","05b770ccc0b75243d92d660828f2cdf4",32,29,20,11.2,32,0,1,1
"814","05b97eca9aaf7c81f03b971dc801f2e3",152,97,82,12.9756097560976,152,0,3,3
"815","05ba642ec1505b5f011c6b3858bb9e43",34,34,0,34,0,34,1,2
"816","05ba991f99d737f79dab837421d6c5c9",127,68,51,17.4313725490196,102,25,3,1
"817","05bc275d623a3e67bebf77581a838185",124,90,51,17.0196078431373,94,30,3,3
"818","05bcc35c53400ae658a5d20d406eda1e",92,78,63,10.2222222222222,92,0,2,3
"819","05bcdffb4f5109fd58d96408c0d5969e",23,23,0,23,23,0,1,2
"820","05bd2b0c9368cf4bdae3bf39da47dcab",121,84,28,30.25,121,0,3,3
"821","05bda78b2d1251c9f1e58f0f8996bd93",34,34,0,34,34,0,1,2
"822","05bdbcb317c95759d181339913069043",99,65,56,12.375,99,0,2,3
"823","05be3cd047517027a9df955b829478db",44,44,0,44,44,0,1,2
"824","05bee08be3c75980c48cfa962457a572",21,21,0,21,21,0,1,2
"825","05c049db4a85b81aacc01ab564242ee2",53,39,13,28.5384615384615,53,0,1,1
"826","05c07778f1902c186a5097b93a124d8a",49,42,56,6.125,49,0,2,1
"827","05c084534f472ea57f764195abe5d96f",32,26,67,3.34328358208955,32,0,2,1
"828","05c11a7d61fd65a3ac6048388be49119",14,7,75,1.30666666666667,14,0,2,1
"829","05c1c8934457380060d6ae68532bd815",42,39,8,36.75,42,0,1,2
"830","05c28a2bdf0c90fa436e6aa0da3a6a3c",31,31,0,31,31,0,1,2
"831","05c30530ee1d11b44f3d706b5ab85304",54,49,51,7.41176470588235,54,0,2,1
"832","05c59e0f02e7a01d85e1143df1f434bf",77,64,81,6.65432098765432,77,0,2,3
"833","05c6991cfe9ce8b95e67a2821c6ba43b",11,11,0,11,11,0,1,2
"834","05c9385ff0800874dec7e10d76910f82",60,47,37,11.3513513513514,60,0,2,1
"835","05c9e3781f73556ecffbbab22fc8d017",123,85,53,16.2452830188679,123,0,3,3
"836","05cac48aff4ee1f0e15f61b249750c91",20,20,4,35,20,0,1,2
"837","05cb262a6f26b66d1cf62687f3504095",20,15,37,3.78378378378378,11,9,2,1
"838","05cc4574f74bd84d35e8aa6c2e53a296",68,49,35,13.6,68,0,2,1
"839","05cca674305bb95fe64f4ae77a8239da",34,34,0,34,34,0,1,2
"840","05cd3651cd980e17f83df473d8e82154",14,14,0,14,14,0,1,2
"841","05d02d211b853d08891cf745809b64da",30,30,0,30,30,0,1,2
"842","05d0645c4057e4133ffc12d47a195146",17,17,0,17,17,0,1,2
"843","05d0a6836af2621075c761e4b08c6522",46,35,43,7.48837209302326,46,0,2,1
"844","05d1a32cabba11acc93162bbb2dea4b6",51,37,42,8.5,51,0,2,1
"845","05d2b989bfc0dd2d623675ff0f6230f6",33,31,25,9.24,17,16,2,1
"846","05d4602c4e35117b01d7028f2e1f27f2",12,12,0,12,12,0,1,2
"847","05d521e6ef2d586f162f235a6dd6a5c7",66,37,62,7.45161290322581,66,0,2,1
"848","05d6a8da1228873f976e385c8fe05491",42,42,0,42,42,0,1,2
"849","05d8395ce54cbf64922bcbbaf37725f3",29,20,33,6.15151515151515,29,0,2,1
"850","05dbf70ece340421b70d3dd30cde37ed",89,67,70,8.9,89,0,2,3
"851","05dcb455d8a8fde49bc043b918d251a3",43,31,11,27.3636363636364,43,0,1,2
"852","05de0cd5038afb0b9ae3af4f19f2ab64",72,51,77,6.54545454545455,72,0,2,3
"853","05dfdb5ecd632b9a4a74aadda503937c",51,51,0,51,51,0,1,2
"854","05dfe9d2cc5b1ecfb043f914e8268008",19,19,0,19,19,0,1,2
"855","05e0737bfa92fbd898f630f273205176",6,6,0,6,6,0,1,2
"856","05e256a4abfe2b7894e6cdc9e7713891",100,67,47,14.8936170212766,100,0,2,3
"857","05e34520fd9122dd7e2e87b915c7a0a0",56,53,7,56,56,0,1,2
"858","05e77df052172b5defd226d58e6fd081",53,35,59,6.28813559322034,41,12,2,1
"859","05e88ca9394922c53242c816738be25f",24,14,28,6,24,0,2,1
"860","05e8c8e9d06f6fb34378156646fddcd5",39,39,0,39,39,0,1,2
"861","05ec1823f87e62c2c30ae42a7d46ac17",52,52,0,52,52,0,1,2
"862","05ec68b311334d5a49586130664f1227",37,37,0,37,37,0,1,2
"863","05f222ee6266d9995279b8c82795903b",13,13,0,13,13,0,1,2
"864","05f2bdaa66be2d62dabab519b6593558",61,45,65,6.56923076923077,35,26,2,1
"865","05f79a1d05aac1d010268dff9a7dfb9c",27,26,14,13.5,27,0,1,1
"866","05fc4743c3bbfca36395ab588006145a",42,18,69,4.26086956521739,42,0,2,1
"867","05fd6b404b07daa045f37e8e58e1f051",63,39,68,6.48529411764706,63,0,2,1
"868","0600908a5c75863866325439d301a7ce",32,26,45,4.97777777777778,32,0,2,1
"869","0602e67988cee18e02dc9b1756478271",42,42,0,42,0,42,1,2
"870","06031b2cddf1c41abbbcf5015099af95",74,48,53,9.77358490566038,43,31,2,1
"871","0603359a8757ed17a16126a241495f4e",23,23,0,23,23,0,1,2
"872","0603bbd25a569950c10cdb3b0c527d56",138,86,73,13.2328767123288,116,22,3,3
"873","060407f3ffcd7a56b87bc9dffe45ccf0",33,33,0,33,33,0,1,2
"874","060819df60e280c0bb92c4a852b224b8",6,6,0,6,0,6,1,2
"875","060cd28d06b38837ed7d907e77ece22e",18,18,0,18,18,0,1,2
"876","060da050114b6ceff1370c6b8ddeab9e",87,56,57,10.6842105263158,87,0,2,3
"877","060e64131e225f495c6fa159c1b3cb07",123,107,62,13.8870967741935,123,0,3,3
"878","0610a634e5515882ae2000f37b985025",82,67,12,47.8333333333333,82,0,1,2
"879","06160e704063c55a482cea37b12054b2",88,64,49,12.5714285714286,57,31,2,1
"880","061638be25199a4dd3e107b80ef8efbc",46,41,48,6.70833333333333,22,24,2,1
"881","061653525a759759b7c91664c3a7dd90",60,49,34,12.3529411764706,60,0,2,1
"882","06187d9870156e026bfb70d957e8f23f",188,122,76,17.3157894736842,188,0,3,3
"883","061d7108b357c441cdc90fcaf7877aa1",16,16,0,16,16,0,1,2
"884","061e49563f8b4d9e282a37050c97fbb7",20,20,0,20,20,0,1,2
"885","062095ae2bebe6afb3409a096f515309",28,20,27,7.25925925925926,28,0,2,1
"886","06211943c4a5eeec66bba6be8276f688",27,27,0,27,27,0,1,2
"887","06251cd15265cc0ecfca97aa697bbdf8",17,17,0,17,17,0,1,2
"888","062a2bc12598a35e8c81b73cb518d645",14,14,0,14,14,0,1,2
"889","062afda7c67286babca953793e0bb377",16,16,0,16,16,0,1,2
"890","062bb9082b1504b8cedd9ddc825879af",14,14,0,14,0,14,1,2
"891","062cd8fc5373faef9f1862196ba54146",92,70,48,13.4166666666667,92,0,2,3
"892","062f6f73b25a38308db46d3a6d224e03",6,6,0,6,6,0,1,2
"893","06351fad0c3bd36796a689ac496f3de1",44,44,0,44,44,0,1,2
"894","06373f493495a47f3ceda61e99ac8bd5",16,16,0,16,16,0,1,2
"895","063868cb3a66cca3c8f7a89299b39a99",21,21,0,21,21,0,1,2
"896","063980eec93a8b51214df136870e36fc",47,47,0,47,47,0,1,2
"897","063a25102760ce9d36102e4319c29ec7",175,92,59,20.7627118644068,175,0,3,3
"898","063bfec6695ef0ce08920a4922fa11aa",14,14,0,14,0,14,1,2
"899","063dd4af80818696d11c6e5a0a8c2d7e",10,7,55,1.27272727272727,10,0,2,1
"900","063e8296421e8da1a14c98f46c5d121a",33,33,0,33,33,0,1,2
"901","06413b08a412a4a2d1e55b40d97a210a",82,72,49,11.7142857142857,82,0,2,3
"902","0644e2038c38954ffef0fc8c5baea750",31,31,0,31,31,0,1,2
"903","064696788e3aa122da1d87404780ee75",6,6,0,6,6,0,1,2
"904","0646dc55fed7d6ffc1f7dde9309c765b",21,21,0,21,21,0,1,2
"905","0646f18b21c90060e0d6ce1bf2657270",5,5,0,5,5,0,1,2
"906","064b7fc30c719acd0586792d7f1a65c4",91,69,39,16.3333333333333,91,0,2,3
"907","0650a538020696e08ba33ffc4f9e627a",44,35,65,4.73846153846154,44,0,2,1
"908","0651c4d6c461456e69f0499710390488",94,76,45,14.6222222222222,42,52,2,1
"909","06531b8a8633ddb370a0c12cae19c618",70,54,29,16.8965517241379,70,0,2,1
"910","0654ef4f905d3d5c68d22bd423d009b1",48,37,34,9.88235294117647,48,0,2,1
"911","065725c3c5b1503f3f652fa24b280aa1",25,17,33,5.3030303030303,25,0,2,1
"912","065739b0c8d2aa9db22304d32d692ff9",30,30,0,30,30,0,1,2
"913","0657dce5c9aaaf540416bbbc57ba130c",137,88,67,14.3134328358209,137,0,3,3
"914","06587181c32f150679a980025fa2160f",52,52,0,52,52,0,1,2
"915","0658985d9043fe83746475d3bfbbd720",73,61,33,15.4848484848485,73,0,2,1
"916","0658cbd14054610d2ed2b16b45caf7ba",14,14,0,14,14,0,1,2
"917","065aaaefedd311bdd88ba4671ad61213",11,11,0,11,0,11,1,2
"918","065cce25fc3109608baf1c6a3148f4b5",44,39,54,5.7037037037037,44,0,2,1
"919","065eae30725c7a147eaee954a646b680",64,57,56,8,64,0,2,3
"920","065fad0fac15872fb6769b2342309a2d",37,37,0,37,37,0,1,2
"921","0661774ff49530643c7320967cf7c837",32,32,0,32,32,0,1,2
"922","0664f4184b43be4273c527fccde44d7e",113,82,74,10.6891891891892,113,0,3,3
"923","0665ecf973f28712c9c30bac640422f7",126,90,50,17.64,88,38,3,3
"924","066bc63cf07e2e9ede182a231376a444",90,54,64,9.84375,90,0,2,3
"925","066f3fb760aff5db7714f6cce02eb279",30,30,0,30,30,0,1,2
"926","066fe8270ccadfec92f3e0cb9ae75ce7",157,110,64,17.171875,157,0,3,3
"927","067125be005a7d9885b772a13c019eaa",23,22,21,7.66666666666667,0,23,2,1
"928","067262b58c76bb279eb65e40863dcde6",38,29,26,10.2307692307692,38,0,2,1
"929","0672643a8d6489644130ac17dc134429",38,34,15,17.7333333333333,38,0,1,1
"930","06737b396c61ba81efe36320f527f64e",175,64,84,14.5833333333333,146,29,3,3
"931","067392e481ed0f592afa3406cdf6ccf6",31,31,0,31,31,0,1,2
"932","0673ca121109bf754496cf7bb917cc96",24,24,0,24,24,0,1,2
"933","0674aa765e66e25a9761777fce78c7a8",118,95,76,10.8684210526316,118,0,3,3
"934","0676892f823090855ee36c910d7f281e",23,23,0,23,23,0,1,2
"935","0676c045b5ff20798380ac568a037710",7,3,67,0.73134328358209,5,2,2,1
"936","0677598cdfcce0bd87d3b64b3b2b3ead",23,23,0,23,23,0,1,2
"937","067ab3763a4b5822ad96c179d32f4674",126,71,77,11.4545454545455,126,0,3,3
"938","067abe0ef683b5a531ec7f91a2cd0af8",36,36,0,36,36,0,1,2
"939","067cb2ecad80b3b7ada426f02aec87b0",39,39,0,39,39,0,1,2
"940","067e3fc055c89e519b147589268c1872",51,51,0,51,51,0,1,2
"941","067e487970f9c4b055642fb50fbef107",67,54,77,6.09090909090909,67,0,2,3
"942","068106ea35fd7be7c44328229ed72041",19,19,0,19,19,0,1,2
"943","0681e101eed13150d8a90ccbc141b884",146,88,72,14.1944444444444,146,0,3,3
"944","0684d5d585f99c44e96c686717229065",40,34,14,20,0,40,1,1
"945","0686f0a72e5e609b8d1bdabf9ec17f07",41,33,68,4.22058823529412,41,0,2,1
"946","0688f5803a61463828819d6d22375868",132,77,89,10.3820224719101,103,29,3,3
"947","068c017dfc3ae93ec8559f593896cc6d",22,22,0,22,22,0,1,2
"948","068fb951e763a1cb81dc71caf2d1d8ec",98,58,85,8.07058823529412,43,55,2,3
"949","06902b9720adcc89156d235ac83fc222",29,29,0,29,29,0,1,2
"950","0691d08bb3b58d6c74099065fc13b814",23,23,0,23,23,0,1,2
"951","06936ae4c13d921a2318fe2670523617",130,92,77,11.8181818181818,108,22,3,3
"952","0695d680bc394aa71b00ece0ce982265",156,119,30,36.4,156,0,3,3
"953","06973b27c6810e2f435d45e5d967ee12",137,99,63,15.2222222222222,137,0,3,3
"954","069984726679800dba47cbbb0d60408a",23,23,0,23,23,0,1,2
"955","069befb4a810c07cc5d16252c9a8356d",40,40,0,40,40,0,1,2
"956","069f3e08949af89320fdb4538bc28827",54,34,81,4.66666666666667,54,0,2,1
"957","06a0db990d326c4af6a29c5382433cc5",199,108,70,19.9,165,34,3,3
"958","06a0e62ef9364aa442f4729a6cfed11f",37,37,0,37,37,0,1,2
"959","06a0e890803d4a615db34e9a5b13a9ee",44,30,78,3.94871794871795,36,8,2,1
"960","06a244e9e0064ca747d0000e23cea161",55,35,22,17.5,34,21,2,1
"961","06a3aab723a397d13207faf0a70be51c",49,49,0,49,49,0,1,2
"962","06a9cee6b1a2de69bf546db30e339399",31,31,0,31,31,0,1,2
"963","06aa163ce1bb8fa3f7c75d8ffb3e8b8b",35,35,0,35,35,0,1,2
"964","06ac9ec7e8b46ea597eae3125b634b30",35,35,0,35,35,0,1,2
"965","06ad80e5c7284fe7763eb50602fd80c1",103,70,40,18.025,103,0,3,3
"966","06af9784f7b18c8ddc7ba530f10c4505",13,13,0,13,13,0,1,2
"967","06b0325b9a9efef32cd8fe416dc07c56",136,73,67,14.2089552238806,136,0,3,3
"968","06b3b6d55af5a51a8cdc7160d03c077f",55,55,0,55,55,0,1,2
"969","06b4c6a28a6022760878325a19e413f7",194,77,84,16.1666666666667,194,0,3,3
"970","06b62a126e43ef9ab17314cb8d04377c",25,25,0,25,25,0,1,2
"971","06bf27f407d50705bbfa6c7d173f8600",82,60,25,22.96,45,37,2,1
"972","06c00f2487241dae0697c4cdf397de3f",24,24,0,24,0,24,1,2
"973","06c02fe6f7aead4f830412959151beee",29,21,62,3.2741935483871,29,0,2,1
"974","06c273c3b4bed47f041cd9bb32e9926a",28,28,0,28,28,0,1,2
"975","06c2b458f36109f547472b57f8617330",26,25,4,45.5,26,0,1,2
"976","06c584d5fe0cb3f95d0e7e9937781758",21,21,0,21,21,0,1,2
"977","06c78b3bba74a7465609c6af179f289d",20,15,46,3.04347826086957,20,0,2,1
"978","06c8cf3f1a06929a253e830ad1fb5b0e",2,2,0,2,2,0,1,2
"979","06c9cd0099c4bedf44cd26a7048312d0",155,80,57,19.0350877192982,117,38,3,3
"980","06c9e65b766b08c7d1124ef4a17c328b",28,28,0,28,28,0,1,2
"981","06caeb6688807a086aceace59406707b",179,70,73,17.1643835616438,179,0,3,3
"982","06cf0d006cee683c8f738049844caab1",55,55,0,55,55,0,1,2
"983","06d11527be31d0bca5595e81c77f6aad",32,15,64,3.5,27,5,2,1
"984","06d5b3c4241edb3c4e92fddb5935eb1e",33,33,0,33,0,33,1,2
"985","06d6166da64fe038883fae8370e557ae",23,23,0,23,23,0,1,2
"986","06d7168cccbfa477053b8916a71b99b2",113,91,88,8.98863636363636,113,0,3,3
"987","06d7d0594414a535b5fddf9e2a57598c",142,104,72,13.8055555555556,142,0,3,3
"988","06dcd57830630fc9a7c5a6809bfab63d",7,7,0,7,7,0,1,2
"989","06dd1c1cf10fade22ccabe204faf4ce0",115,69,50,16.1,91,24,3,1
"990","06df81a81f96e04ee608d44b26a55927",47,39,35,9.4,0,47,2,1
"991","06e111394f598d5b80e8621dca8b8b2c",25,25,0,25,25,0,1,2
"992","06e1c710c4d1f0e9799907764d8da9df",159,97,62,17.9516129032258,159,0,3,3
"993","06e31abc38bc191f8e8325d2b6aac4b3",53,48,61,6.08196721311475,35,18,2,1
"994","06e3e9b78fd036ae177e95d36cfa5fde",30,30,0,30,30,0,1,2
"995","06e3f18760a5e8961e648789fa277cce",123,92,49,17.5714285714286,123,0,3,3
"996","06e546eea84eb48917ef981bea8169ee",102,73,38,18.7894736842105,101,1,3,3
"997","06e598dd79812b81df0e808d8b6fb4a6",91,54,62,10.2741935483871,91,0,2,3
"998","06e5fb37c89b22d2edbcddcd2952a663",47,43,58,5.67241379310345,47,0,2,1
"999","06e6fb6aa4b150e785213ed91dc49da6",147,88,60,17.15,147,0,3,3
"1000","06e88413ab0fe6dd9e20fa3674bcc06c",24,24,0,24,24,0,1,2
"1001","06e9cd4d92284c56f197b5b8428a919f",11,10,7,11,11,0,1,2
"1002","06f1238ebf230ffa2ddd8411e307856d",26,26,0,26,26,0,1,2
"1003","06f2711069647c7afc1978f584c0dae9",64,50,73,6.13698630136986,64,0,2,3
"1004","06f4195c3f070949383427d33fa4c0d8",48,47,7,48,48,0,1,2
"1005","06f86cbc1936c5817a43f41d1735c522",51,51,0,51,51,0,1,2
"1006","06f9af012cce85b24cf0cd9f57f2dc77",63,22,87,5.06896551724138,63,0,2,1
"1007","06f9d633d0f6a3760f33fc439399c2ec",191,92,66,20.2575757575758,146,45,3,3
"1008","06fbc310c8634b924a063caa2f4d0224",39,39,0,39,0,39,1,2
"1009","06fe6c1181fe6b0faf31f01f6e409dcf",49,45,65,5.27692307692308,49,0,2,1
"1010","070195caad59c4aaadb445b3fad1f2d9",130,75,84,10.8333333333333,93,37,3,3
"1011","07043485e34d0c20814bcab2c42b3353",23,23,0,23,23,0,1,2
"1012","0704cf4e641470d925212d3e6b8a3e69",110,82,39,19.7435897435897,110,0,3,3
"1013","07075b8eef9b2597c361ed41f83f7e0b",36,32,56,4.5,36,0,2,1
"1014","0707ab9faef26bc529929a9a270f32f6",19,19,0,19,19,0,1,2
"1015","07096d1c712dbac2bcd19e65e7768abd",5,5,0,5,5,0,1,2
"1016","0709d02686f37acd384362e8c3bf87e6",15,15,0,15,0,15,1,2
"1017","070aa6c1b54f1c44fb7c399d605180f0",13,13,0,13,13,0,1,2
"1018","070b3498251e8980bf532a28e2125c15",51,51,0,51,51,0,1,2
"1019","07100ba48d0707a23847da7663e47c86",20,20,0,20,0,20,1,2
"1020","07123cda350b8eee7c81c6f0411fd49b",28,28,0,28,28,0,1,2
"1021","0714001ce1068a0329400e63a02a8312",76,51,73,7.28767123287671,76,0,2,3
"1022","07147fe2b3367553498a6184435a1113",38,38,0,38,38,0,1,2
"1023","07176cbfcbebd36e06fb7af0401c0fe8",11,11,0,11,11,0,1,2
"1024","0719adc6d2028e2072154210b8163cd2",61,40,77,5.54545454545455,61,0,2,1
"1025","0719d8063473543905cacceed00e9a9e",85,63,25,23.8,85,0,2,3
"1026","071c64f49d9c881cfaa94ec3adbc373a",41,37,63,4.55555555555556,41,0,2,1
"1027","071dd08edf1cdd2fea017983341c387e",171,83,71,16.8591549295775,171,0,3,3
"1028","071dd91b156e4e8bff17717d6a35b3b4",104,67,14,52,104,0,1,2
"1029","0721f693e297e72737abee9da7f4eb98",205,87,83,17.289156626506,176,29,3,3
"1030","072323f03974a341281e093e15e6e8b9",185,109,67,19.3283582089552,138,47,3,3
"1031","0723d7cc65418825d5f17f8d31574457",69,52,77,6.27272727272727,69,0,2,3
"1032","07249f02baf7615ffa36c80cb7ee2e8e",10,7,68,1.02941176470588,10,0,2,1
"1033","0724b43f828dd843f3985413b4532fe9",73,63,69,7.40579710144928,73,0,2,3
"1034","0724c110a93e415904ef4a65a4c1b0b3",78,59,28,19.5,78,0,2,1
"1035","072591223dd3d537b3936078f88f4068",52,38,35,10.4,52,0,2,1
"1036","0725c8a5fa0bbb5922992914310505eb",26,26,0,26,26,0,1,2
"1037","0727f80bd888bc10049a4da9ec1b5815",17,17,0,17,0,17,1,2
"1038","072d1a013f70b4ef132eef183bc34cc1",169,73,84,14.0833333333333,169,0,3,3
"1039","072e1fab4a5c3b224a20303715326afe",19,19,0,19,19,0,1,2
"1040","07328e5ed9cbf215a201bee2eb8c83d9",127,66,36,24.6944444444444,103,24,3,3
"1041","0732c7571e003779e84cde2bdbaa1393",121,99,36,23.5277777777778,121,0,3,3
"1042","07337200ac1ea5bb90be85fc6f210424",35,35,0,35,35,0,1,2
"1043","0735973822c5dc888704f8b3b1ae2095",18,18,0,18,18,0,1,2
"1044","07385b11615d01a89f40357d67195342",105,82,17,43.2352941176471,105,0,3,2
"1045","073bc48eb2cdaf47387a9ee7492ecd9d",54,40,22,17.1818181818182,54,0,2,1
"1046","073f0b661aa1466d8a9702ba58ff88ce",50,50,0,50,0,50,1,2
"1047","07400e2ca5bc90eccb911f6dbc3fa87e",15,15,0,15,15,0,1,2
"1048","0740ed6af826253db76782212cd5ad96",54,42,36,10.5,54,0,2,1
"1049","0741a092d7c05f5368f8a4966251b57b",88,66,23,26.7826086956522,88,0,2,3
"1050","07463ad536131ad80cbf8f701e4094a3",16,16,0,16,0,16,1,2
"1051","07475146386e2705bfa7de255991f76a",18,18,0,18,18,0,1,2
"1052","07477223dda2ea4c554526e9c897407a",47,26,70,4.7,47,0,2,1
"1053","0747897bffbcc6497b53d8f69cda36ff",73,62,26,19.6538461538462,73,0,2,1
"1054","0747ce7d06a64f73cb443d4af445236e",24,24,0,24,24,0,1,2
"1055","0748c19fc08168975cb322facad97a74",101,64,55,12.8545454545455,70,31,2,1
"1056","07497308e2d0f9af87cc609da1ec5015",29,29,0,29,29,0,1,2
"1057","074a1807496fb4222d74d2edc52fce39",15,15,0,15,15,0,1,2
"1058","074a979c310749cd1971cf49eab2439c",29,29,0,29,29,0,1,2
"1059","074eccbab9d2e220b6fe0f2d8a00bd63",45,37,74,4.25675675675676,45,0,2,1
"1060","0750caa347c224d9ac499d19fa4d37ce",85,69,61,9.75409836065574,85,0,2,3
"1061","075187e1f3b12ff4ac46893ef5e6be00",152,56,82,12.9756097560976,101,51,3,3
"1062","0754634ca2bca757ad3f16ae81711cf9",43,36,46,6.54347826086957,43,0,2,1
"1063","07565303327b85e4c96315f8a7a5730c",223,99,70,22.3,206,17,3,3
"1064","075924e1d9d25f06e46e5ca9c7a553ce",154,91,83,12.9879518072289,154,0,3,3
"1065","075aec40179cc536692ee75fe8ed6388",21,21,0,21,21,0,1,2
"1066","075e6c723bf43285855f3d43555534b0",83,64,25,23.24,83,0,2,3
"1067","075eb377d35cc564ec303436bd95e329",44,44,0,44,0,44,1,2
"1068","0761675ee63c2f375ff42e9c237a427c",30,30,0,30,0,30,1,2
"1069","0762574f8c8934a51f754846c33843ef",50,42,74,4.72972972972973,50,0,2,1
"1070","07636d1e8b38a99b80a3cb18f64ebf03",35,35,0,35,35,0,1,2
"1071","0763a0af4800907db57982192c9f9fdf",47,38,51,6.45098039215686,47,0,2,1
"1072","076764dde57b556f0a1100120043c9d4",163,86,71,16.0704225352113,163,0,3,3
"1073","07678776235c7bbc7e495915cd440c0c",54,46,83,4.55421686746988,54,0,2,1
"1074","07684c4c0d0e553666eb9f64a0226fea",32,32,0,32,32,0,1,2
"1075","07745ab3ad670b090d3a15374fe1e3e8",88,57,56,11,71,17,2,1
"1076","0775647adfe6e43c1c20d66ef91d661a",120,84,63,13.3333333333333,120,0,3,3
"1077","077576d1bd5e1181f86403031ec42862",52,41,43,8.46511627906977,52,0,2,1
"1078","0775be01fc1d0f849735fe69aeebd05d",227,141,75,21.1866666666667,191,36,3,3
"1079","077658dd9f6d43b4d6e64b99ce7c2893",35,33,48,5.10416666666667,35,0,2,1
"1080","0777e1434f84a5078b4579e16d51bd67",31,25,14,15.5,31,0,1,1
"1081","077887358935a8aaf607f4d0865215cd",45,45,0,45,45,0,1,2
"1082","0779e29d4cc51ae1584661806fde119f",118,73,80,10.325,89,29,3,3
"1083","077c431b47e0e41b29a8e3641f814c26",76,63,45,11.8222222222222,76,0,2,3
"1084","077c5e47c69e4eaeab55e14527eca7f6",47,41,38,8.6578947368421,47,0,2,1
"1085","077e196dccd4e25028b0a1516721d424",27,27,0,27,27,0,1,2
"1086","07801da90d98d751bd9049ecef90235c",72,34,77,6.54545454545455,72,0,2,1
"1087","0782b3bb5d46e04b5977279b9ca11b31",37,28,31,8.35483870967742,16,21,2,1
"1088","07848eeca1a078dc4fe74aeafd5fa70e",11,11,0,11,11,0,1,2
"1089","0784b3936cfb27eaf08ab40efd7c9847",21,21,0,21,21,0,1,2
"1090","07858d3c85804b3ae617975fd0f5956e",117,80,40,20.475,117,0,3,3
"1091","07868c11dde8c6c4957e6f27e38173da",68,62,52,9.15384615384615,68,0,2,3
"1092","078726bbba365ad5d161894e89d54d23",23,23,0,23,23,0,1,2
"1093","0787cdf0766087764fa1f2c5fa64ffcf",23,23,0,23,23,0,1,2
"1094","078d200ac1ea59081e4d8047d1d0c7f6",127,76,65,13.6769230769231,86,41,3,3
"1095","079476a1374108b2f49f028a6d033aea",11,11,0,11,11,0,1,2
"1096","0795c60062b9d799f3554a730c601174",27,27,0,27,27,0,1,2
"1097","07990322f2647a40368fcf5d3824f344",46,41,54,5.96296296296296,46,0,2,1
"1098","079e27e2f031617338f6a63b709749e7",23,23,0,23,0,23,1,2
"1099","079f72fe149bf665fde98ca0c48abdc0",43,27,28,10.75,21,22,2,1
"1100","07a0125d3e2b9b37dd406e18f259dc4e",11,11,0,11,11,0,1,2
"1101","07a06ccd81e040938d01a6282a076f72",28,28,0,28,28,0,1,2
"1102","07a19d6b2feacc35189597da706f6bfd",10,10,0,10,10,0,1,2
"1103","07a3dbe263cf6b20de4584108c1fbf1a",11,11,0,11,11,0,1,2
"1104","07a407eb24b3c8c1e20eb03620947ba0",42,39,71,4.14084507042254,42,0,2,1
"1105","07a40eb2774ec9363fe9dbffd7ca36fa",110,83,33,23.3333333333333,110,0,3,3
"1106","07a6a600a3d85c42c7ebe7f114cec25c",185,92,74,17.5,160,25,3,3
"1107","07a99757e6d14af9860fc0e6397dc7b7",198,100,78,17.7692307692308,168,30,3,3
"1108","07aa869204be03e4b0c9a8184c89f211",39,31,33,8.27272727272727,39,0,2,1
"1109","07ac6b11fba094f4e33bda231102a881",17,17,0,17,17,0,1,2
"1110","07ac6c3b125d8d341d2233976f798831",47,21,70,4.7,47,0,2,1
"1111","07afca4853d6b8d07a15b9c3bf194407",109,89,47,16.2340425531915,80,29,3,3
"1112","07b300f9d5d767ffdc0f8a0a6903715f",7,7,0,7,7,0,1,2
"1113","07b4205bb92e3fa8f2576c49bd8f46c9",153,100,68,15.75,153,0,3,3
"1114","07b584c762c61360c8185b07e56cc53a",138,89,63,15.3333333333333,138,0,3,3
"1115","07b68675de96aba6fb2968bd591322a1",30,30,0,30,30,0,1,2
"1116","07b7f68722e0a6eea96b9da57dc17b9a",43,26,80,3.7625,43,0,2,1
"1117","07b823983f7de6a2b7c3b281c4348e86",47,47,0,47,47,0,1,2
"1118","07b93f0f3294649075ee3d8a5cde4a1a",176,89,86,14.3255813953488,176,0,3,3
"1119","07b94224672df0431f1db3e22e6ba179",71,63,13,38.2307692307692,71,0,1,2
"1120","07bab9916392c02e8b61a501b30616b0",114,84,43,18.5581395348837,114,0,3,3
"1121","07bbbcff2aa1bb367fb57cdd0dbb8324",4,4,0,4,0,4,1,2
"1122","07bd507c69fa8c1dcffa5e4c6f2dfe47",25,25,0,25,25,0,1,2
"1123","07c0bbb7b0f095ad4479c72c463d0de1",151,100,63,16.7777777777778,151,0,3,3
"1124","07c0dc5dadf114fb89286e6b57e41737",34,34,0,34,34,0,1,2
"1125","07c1a66eadfce095a4804ce67ec20a2c",23,23,0,23,23,0,1,2
"1126","07c733dfc2c79ca3a025348f2fa92db3",11,11,0,11,11,0,1,2
"1127","07ccff1646e071c46ea0b85cdc7b0b41",18,18,0,18,18,0,1,2
"1128","07cde06dedacbb8fae1360288333f780",51,34,42,8.5,0,51,2,1
"1129","07cf157c854de2f7df347ce71647b5f4",147,77,73,14.0958904109589,147,0,3,3
"1130","07d0045247765aeaf71d35e368db3303",111,62,79,9.83544303797468,111,0,3,3
"1131","07d0f2e72bf07722ca7aa325aa8aaeb2",137,74,82,11.6951219512195,137,0,3,3
"1132","07d4fac095ef997c7388e2ac84c89591",19,19,0,19,19,0,1,2
"1133","07d663bf4e70414605825434e2256c92",27,27,0,27,27,0,1,2
"1134","07d96c4c21a1254c3e86447c582f6c6d",150,107,70,15,150,0,3,3
"1135","07da089992ab1e002f04a9066f51180e",35,35,0,35,35,0,1,2
"1136","07dec1ae0a4732e4badc9b4262146696",67,52,53,8.84905660377358,67,0,2,1
"1137","07e0e1a44c07aa9ea2152bf525c2fe6c",39,39,0,39,39,0,1,2
"1138","07e3d3aca08c2366e8cf331175a5f286",192,99,70,19.2,192,0,3,3
"1139","07e60d8d2e256a99a3dd6cc3712237f1",44,44,0,44,0,44,1,2
"1140","07eb282b0b940e6c7910bba1b066f600",32,32,0,32,32,0,1,2
"1141","07eb28d76f1b5eda3a4d4bde01104e28",34,34,0,34,0,34,1,2
"1142","07eb659476d128ad518cf8dde4ca465c",57,41,50,7.98,57,0,2,1
"1143","07ecf8f30346a51a28799f121cb03001",5,5,0,5,5,0,1,2
"1144","07ef67d19ecd2383b14670a0962b9c72",31,31,0,31,0,31,1,2
"1145","07f0ec957f9f54e4221f9abcc1ec54f9",37,37,0,37,37,0,1,2
"1146","07f111218e75deca05d09f2dd611bf58",95,79,68,9.77941176470588,95,0,3,3
"1147","07f2c51e85427486239a75456c76129f",132,50,64,14.4375,78,54,3,3
"1148","07f305aa084935423b6a38294839be09",49,49,0,49,49,0,1,2
"1149","07f30b2ddd184e452293b8c3f8481d13",156,124,69,15.8260869565217,156,0,3,3
"1150","07f482e00a4599db8968ccbc704d989e",17,17,0,17,17,0,1,2
"1151","07f64c60106d598a10708db580b8498a",121,71,63,13.4444444444444,121,0,3,3
"1152","07f8b48fa596f3cafc324646bd5b65af",26,26,16,11.375,26,0,1,1
"1153","07fa97638b5ea341910e7e9fa60b4418",10,10,0,10,10,0,1,2
"1154","07fac0a88877aa0133ab2cb540c062c7",165,112,69,16.7391304347826,128,37,3,3
"1155","07fb677c69416004ba5f92068f86741b",18,10,57,2.21052631578947,18,0,2,1
"1156","0800b80043ba986cf910f33b0519bfb1",38,33,85,3.12941176470588,38,0,2,1
"1157","08018712cd912cf85d19f0b22bea13cc",66,48,33,14,66,0,2,1
"1158","08035d9e2a32eb0ca9e81fb8fa307722",17,12,49,2.42857142857143,17,0,2,1
"1159","0804301abad8e654e0206ea6db0d9eff",69,42,56,8.625,24,45,2,1
"1160","0804d92ad5cefa9f8ff2b713967eb83a",135,74,58,16.2931034482759,135,0,3,3
"1161","0805e030862c53d6a7d51e439291839b",99,64,48,14.4375,99,0,2,3
"1162","080bde487af7478aeba5d5910f7123af",9,9,0,9,9,0,1,2
"1163","080ca72b2ee40c0bc27f9fa9fa0ca929",209,74,75,19.5066666666667,209,0,3,3
"1164","080db2faa4e462beb101abac495db502",31,31,0,31,31,0,1,2
"1165","08102505d830cb376ef0e810ddf110bf",5,5,0,5,5,0,1,2
"1166","0811f3fa5f36db89c3a7900942df97a0",25,25,0,25,25,0,1,2
"1167","081221228ea334e046cb50fe2cce8540",139,88,34,28.6176470588235,139,0,3,3
"1168","0814f0e6d7e16f867a2b5094713f3ac2",14,14,0,14,14,0,1,2
"1169","0817147aaad970388e49e0af78f8dad4",81,55,90,6.3,81,0,2,3
"1170","0819be81779e8e01f7102ca7e9abd8e7",4,4,0,4,4,0,1,2
"1171","0819fb743fe2f9efd122f0a98b5fb52b",53,48,61,6.08196721311475,23,30,2,1
"1172","081a042ad70d1322f2e8b625187cdc61",150,92,61,17.2131147540984,150,0,3,3
"1173","081a4cb97d81d2ecc0707e0b514d9b61",62,49,20,21.7,62,0,1,1
"1174","081ae0ab6252bd413b67fec52ce10525",74,67,43,12.046511627907,74,0,2,3
"1175","081c9733abca795367b01081b71439b4",22,22,0,22,22,0,1,2
"1176","081ead9b9d6252c24a80f3598d7e10b3",63,41,50,8.82,31,32,2,1
"1177","0820306a955b67df270537021d7296b0",82,62,84,6.83333333333333,82,0,2,3
"1178","082147455784c732e9366ceb214e96c4",18,18,0,18,18,0,1,2
"1179","0822107f5aa3392485973846f184e530",140,73,77,12.7272727272727,124,16,3,3
"1180","0822cbeda930353ce362a4f0d0bb9515",19,19,20,6.65,7,12,1,1
"1181","08289becbe1f9f1913eeaa706abeef35",135,67,77,12.2727272727273,135,0,3,3
"1182","0829be887f87a26ce60c353545d4b7cb",101,69,63,11.2222222222222,101,0,2,3
"1183","082d6f5927b5cde6594ba93789592816",46,40,77,4.18181818181818,46,0,2,1
"1184","0830067c19aced26403f5353489192e3",24,20,49,3.42857142857143,24,0,2,1
"1185","0834248f1f899fb3268ced51f6ce50c7",229,64,81,19.7901234567901,205,24,3,3
"1186","08375f5431e87a1823d9205f108e5a65",18,18,0,18,18,0,1,2
"1187","0837d17e8a58fb77994d2f4183b4e235",45,31,41,7.68292682926829,45,0,2,1
"1188","08387801853df45e950eb4b8b69a0ddb",16,16,0,16,16,0,1,2
"1189","083932d8db53dd9a7bdd1aedd8b95637",81,56,75,7.56,40,41,2,1
"1190","083ecfddf2388544834b9a96f5eb3218",48,48,0,48,48,0,1,2
"1191","0848332385f8283686f167484ebb3cdd",31,14,70,3.1,31,0,2,1
"1192","084a6550beebe18bb7bdae81b75d916f",21,21,0,21,21,0,1,2
"1193","084d224331bfe73c0410272e5bb9ad08",19,19,0,19,19,0,1,2
"1194","084e4b10a085c2af390dec7cb106024f",134,88,71,13.2112676056338,134,0,3,3
"1195","084f2b75c9e219b76fc89b9bd5033efa",22,22,0,22,22,0,1,2
"1196","085382ac9d41e3c9a5bd643ef0761068",17,17,0,17,0,17,1,2
"1197","0853d14a183916c04d87e04028ca529a",37,37,0,37,37,0,1,2
"1198","0855aa9cee3b947d09474f93f6de795b",15,15,0,15,15,0,1,2
"1199","0855bbf75024c6691fbd5e65f34b7457",97,64,60,11.3166666666667,97,0,2,3
"1200","0857f78594bd1b2412112d60b24b290f",65,58,84,5.41666666666667,65,0,2,3
"1201","085a02f83d02a0ddb4c466048e6cf241",101,82,75,9.42666666666667,58,43,3,3
"1202","085a3b089e5ff1f14a4d965e2d08fc93",34,34,0,34,0,34,1,2
"1203","085adf77a44f960f7ae55783311f941a",119,58,70,11.9,95,24,3,1
"1204","085c43303f713410f2bbd25e5c12b325",233,116,85,19.1882352941176,188,45,3,3
"1205","085caee5be0eb4b820b35d18df88ab35",124,94,20,43.4,124,0,3,3
"1206","085ceb3945c55e09f42a6a37f0e6bc6b",20,20,0,20,0,20,1,2
"1207","085d6a364f2da7d7b5cc5d790e3952b4",31,31,0,31,31,0,1,2
"1208","0861971be6f45ace1ec3c20b91404938",76,59,36,14.7777777777778,76,0,2,1
"1209","0863b156df4cc46d22f24b7d535d13c7",47,47,0,47,47,0,1,2
"1210","08685534a46bbd8ffd387b7a6f2d53b3",76,54,44,12.0909090909091,76,0,2,3
"1211","0869d0146adb7c92bf4d3570119858f2",21,21,0,21,21,0,1,2
"1212","086bde9a531b727a088d71cb32cd61c8",145,99,43,23.6046511627907,145,0,3,3
"1213","086c6a49b1a50feb4e06f5da7d14f7e1",50,42,7,50,0,50,1,2
"1214","086c95ffd64b1740e79252445c0e8ec7",83,52,41,14.1707317073171,83,0,2,3
"1215","086f2cde85bda0efbd36d4bc842c0533",215,114,79,19.0506329113924,175,40,3,3
"1216","0872c0bf1578165376a14cf7a4f3ebe0",39,25,35,7.8,33,6,2,1
"1217","08739f2fad98140d3251f350cb634671",19,19,0,19,19,0,1,2
"1218","087a148cb78aaf2e443fe54c1210a313",30,30,0,30,30,0,1,2
"1219","087a1d94c6429313180e7f06636bd4e4",181,73,64,19.796875,181,0,3,3
"1220","087e24c2f05beb8ac033405f319bdf44",155,68,82,13.2317073170732,122,33,3,3
"1221","087e32790907da98bad2a00cafa9f698",104,57,84,8.66666666666667,104,0,2,3
"1222","08894a09b40563d57835737a5ac48885",148,100,65,15.9384615384615,110,38,3,3
"1223","0890279480ee8a5b5495b674fa74669a",119,56,73,11.4109589041096,119,0,3,3
"1224","0890d9acff256c47f7fa107239cb0068",50,50,0,50,50,0,1,2
"1225","0895d79843211fc6d4cdc231b18c0e74",166,104,82,14.1707317073171,148,18,3,3
"1226","08967486390301991b8d10a8d5801865",17,17,0,17,17,0,1,2
"1227","089773c74471bda55013b6e98073eaf6",17,16,40,2.975,11,6,2,1
"1228","0897d8da7365cda9335242a07fee8e56",52,28,81,4.49382716049383,47,5,2,1
"1229","0897e4b6ffa1621bcd50de75c5dc58c5",69,60,46,10.5,29,40,2,1
"1230","089b4d057ae28dc27a42414d3850f688",19,19,0,19,19,0,1,2
"1231","089e549a5ea7fc1d2fa6035da73556a0",19,19,0,19,19,0,1,2
"1232","08a096174df69bb310e0be2536a0e23a",153,114,43,24.906976744186,105,48,3,3
"1233","08a11d5909fb3fdb1bdb09d2a1030e08",76,54,36,14.7777777777778,76,0,2,1
"1234","08a7ebb6c984188e128cebf4a1f1e84c",165,82,77,15,131,34,3,3
"1235","08a91a744c122f797bbd0b81ac2bfb54",128,104,60,14.9333333333333,95,33,3,3
"1236","08a9f253e3a3c507c0886e0f7d21a8e4",36,36,0,36,36,0,1,2
"1237","08ac7ba4d50c96572a1e0db6ac16f85a",78,56,66,8.27272727272727,78,0,2,3
"1238","08ad9040d18486fc404ce5cba3373713",185,103,89,14.5505617977528,185,0,3,3
"1239","08add61a4af668093ea4087af2335230",69,57,15,32.2,69,0,1,2
"1240","08afa8ec930c96fd38213c5bdbb99e22",23,23,0,23,23,0,1,2
"1241","08b25b5ea2698700bfc64ffd99beb5a2",54,54,0,54,54,0,1,2
"1242","08b3d2bf9f6b0d7281dbf5a678a37918",7,7,0,7,7,0,1,2
"1243","08b559766bbe3cb37a620ba6d010393b",21,21,0,21,21,0,1,2
"1244","08b8c9450a2a336b25e0199d75de4870",22,22,0,22,22,0,1,2
"1245","08b8ffcbcdd7bf8e57b826eac3dc3324",82,60,51,11.2549019607843,51,31,2,1
"1246","08b9588b5fcb0b2ce56a5f47b804c4bb",198,82,83,16.6987951807229,171,27,3,3
"1247","08ba963c61870290d07259d190b61e86",133,84,65,14.3230769230769,102,31,3,3
"1248","08bbacff725f12a32be462277aa72f91",186,119,76,17.1315789473684,163,23,3,3
"1249","08bc1e2bf740ff22374a0451158a2e88",153,110,54,19.8333333333333,153,0,3,3
"1250","08bd8af8607e6b3e59911b8e13544c7e",30,18,50,4.2,30,0,2,1
"1251","08bf7dfe45331663cd535074a5d64e91",32,32,0,32,32,0,1,2
"1252","08bfacf0369a894732d5dc7ecbb4a47f",59,44,63,6.55555555555556,59,0,2,1
"1253","08bfff5cb61df19f7f06d4f362f8149b",20,20,0,20,0,20,1,2
"1254","08c1ff8f551fe7039d2bf354206ecb13",89,77,53,11.7547169811321,89,0,2,3
"1255","08c7f4a3b12bbda956d6d275343654d7",68,46,68,7,68,0,2,3
"1256","08c9c215dc8ab1c0a397b9182e787d53",4,4,0,4,4,0,1,2
"1257","08cada06275a4be90481ce4b9d4bd8d3",46,46,0,46,46,0,1,2
"1258","08cbfe43ebbff254605fe3a4514d69db",90,59,69,9.1304347826087,90,0,2,3
"1259","08cc89ff6b2be3863be056db35c97b46",170,117,70,17,170,0,3,3
"1260","08cd358c6f555efa39e428b88c27f25b",25,25,0,25,25,0,1,2
"1261","08d1fdc62458d7fbcc5ef6829872107b",41,34,60,4.78333333333333,41,0,2,1
"1262","08d27e6d181f3da835a1cda71f3c6e66",52,52,0,52,52,0,1,2
"1263","08d42258f20c58a0c9b06832d3e207db",42,42,0,42,42,0,1,2
"1264","08d52b30ea22b9ec4ef96216964169cb",14,14,0,14,14,0,1,2
"1265","08d6a49c6f6d4715bae4814c31cbe42d",6,6,0,6,0,6,1,2
"1266","08d7327ca0bc44a285d50020d179330e",49,49,0,49,0,49,1,2
"1267","08d8b2b2371cd09c637ed4e50b886af6",50,50,0,50,0,50,1,2
"1268","08dbcdd6929eef4fc27bceb66c546fbf",119,81,42,19.8333333333333,119,0,3,3
"1269","08dc679097872a1594358fdddc60befe",100,75,61,11.4754098360656,62,38,2,3
"1270","08dd98922f23f4e49dfe49fae6663bdd",14,14,0,14,0,14,1,2
"1271","08dda0bc44af5bb295204fab48241cf0",53,53,0,53,53,0,1,2
"1272","08e0c2a2efd5a2beb111555c0536dec9",81,68,26,21.8076923076923,66,15,2,1
"1273","08e1fa133330c2f75787c7a56eaa4f1f",17,17,0,17,17,0,1,2
"1274","08e38bd3866f30b45f867f1e62b55cd9",54,31,42,9,54,0,2,1
"1275","08e43f659e003b30ee870d7f15215638",7,4,3,16.3333333333333,7,0,1,2
"1276","08e4a50fcccbb257e719518431dac5a4",5,5,0,5,0,5,1,2
"1277","08e65b1582184487bf605c15e9351663",196,88,74,18.5405405405405,196,0,3,3
"1278","08e6e81f28566e0691279b73fc057beb",74,38,59,8.77966101694915,33,41,2,1
"1279","08e8035b4cc5049011a6fc9e8411413a",60,44,52,8.07692307692308,60,0,2,1
"1280","08e929d92bc159f6cb09f3c18f26e731",175,102,72,17.0138888888889,175,0,3,3
"1281","08ea26728265394e314a3446d373161f",17,17,0,17,17,0,1,2
"1282","08eafdbc19a6d842a20d67392f335926",18,18,0,18,18,0,1,2
"1283","08eb18d83d09a7f8ca499a9e29807eee",200,112,83,16.8674698795181,200,0,3,3
"1284","08ed55ed06e4a7be6a98b378a93d147d",24,24,0,24,24,0,1,2
"1285","08ffdf649c43c5da05fadf561d80da5c",99,66,51,13.5882352941176,61,38,2,3
"1286","090099bfb9b96f08538d3851f8963f97",43,43,0,43,43,0,1,2
"1287","0902ec64248723bf8a8665102e41ca7e",123,66,81,10.6296296296296,123,0,3,3
"1288","0903a3227dbb715585b64ff3c369a70c",7,2,70,0.7,7,0,2,1
"1289","0908dba9744a6a43aaa25daeb003d1d7",17,17,0,17,17,0,1,2
"1290","09096c6db6c682cd12f87207cbd08ae4",67,53,63,7.44444444444444,67,0,2,3
"1291","090a38fdbbaf7ec20424f736a84daea0",125,101,53,16.5094339622642,83,42,3,3
"1292","090beb5a3e58efc2fa9ad5be8fc43b73",19,19,0,19,19,0,1,2
"1293","0912fe0f2c654d034acf6702c6993b8a",81,50,63,9,81,0,2,3
"1294","09132398b53ff3fb70ddcd59b53a3220",38,38,0,38,38,0,1,2
"1295","09151da56bebd5f1ddc7ee2cab3851a6",56,40,70,5.6,43,13,2,1
"1296","091545c117e11d178a4de0e75be07524",110,66,57,13.5087719298246,110,0,3,3
"1297","09157a62ef5d1b23d905f927e4bf65ae",49,49,0,49,49,0,1,2
"1298","091a98f58f655e00582954d9325cb6a8",222,122,83,18.7228915662651,199,23,3,3
"1299","091d172fee14b092e32755271eaa1db7",43,34,17,17.7058823529412,11,32,1,1
"1300","091d6824377cc2b64e85bbbdcb0c6d33",12,12,0,12,0,12,1,2
"1301","091e65b3da8016323a450e3aaa8790b4",3,3,0,3,3,0,1,2
"1302","0920815ac952980130cda91fe0aae814",30,30,0,30,30,0,1,2
"1303","0920cd40231609cf206fa7ebde1ca644",110,72,49,15.7142857142857,110,0,3,3
"1304","0922a1c7070e04f4c74ba316faf38023",132,78,61,15.1475409836066,132,0,3,3
"1305","092359acb7b75b24c7a0a5f1a9bdccad",140,92,57,17.1929824561404,140,0,3,3
"1306","09235b7bcd016e766a80669335689b3d",34,29,64,3.71875,34,0,2,1
"1307","09240fde9ec227e2c677aab84e888e60",59,41,17,24.2941176470588,59,0,1,1
"1308","0925d2bedd82f21bee2e20ad9a019f4c",60,50,35,12,60,0,2,1
"1309","09285e1b072f3a6b31b54a81378c0fd8",41,41,0,41,41,0,1,2
"1310","092a71d92c84fccb9e6e2d3c2f308ff2",20,20,0,20,0,20,1,2
"1311","092a8fe9962f57c74372b071575aded3",113,89,68,11.6323529411765,85,28,3,1
"1312","092b53d4651c4ea0c5aaf41281a33693",53,36,42,8.83333333333333,53,0,2,1
"1313","09334732c81cccab3c5817a1ec086000",14,14,0,14,14,0,1,2
"1314","0933a98f458760232f0713fbe5256b9a",184,109,77,16.7272727272727,184,0,3,3
"1315","0933adde8adec14c8c2392ed6365ad27",140,93,63,15.5555555555556,140,0,3,3
"1316","0934d79b0c2b07e738a6d5d965c60694",42,42,0,42,42,0,1,2
"1317","09364e36c23c7eab71a6329f2734f6ce",33,33,0,33,33,0,1,2
"1318","093aad5750e46fdaf8126ffdc3b79b82",16,10,37,3.02702702702703,10,6,2,1
"1319","093c0d419e980c8330ff8813a82b46ed",109,54,52,14.6730769230769,109,0,2,3
"1320","093e34168de40fee116ee72772c797aa",54,54,0,54,0,54,1,2
"1321","09407f81c523f2676457c0cd291dbdc0",36,36,0,36,36,0,1,2
"1322","09439a8f90276ab8c88cb97aa5ee9126",14,14,0,14,0,14,1,2
"1323","0944cb362f9b4d0c5e0e4b373a25f515",34,34,0,34,34,0,1,2
"1324","094da48c018e58777dccf6c0a969b023",18,18,0,18,18,0,1,2
"1325","094daf459d3de93dd591e15b6d4c0c98",44,44,0,44,44,0,1,2
"1326","094dff68f0cafff5e1c22413f326dc3c",23,23,0,23,23,0,1,2
"1327","0951308033ca59c9710fd6cd8bdf1491",48,48,0,48,48,0,1,2
"1328","09527098e600eda1c87af7840fa7f2bc",32,32,0,32,32,0,1,2
"1329","0953ca1a5c03e15f9d770bceb695349e",33,33,0,33,33,0,1,2
"1330","0957e689c5da28a1d19b38be40810972",30,30,0,30,30,0,1,2
"1331","0959a67517831558b46bfdf0d66df256",74,43,61,8.49180327868853,74,0,2,3
"1332","095a277120db276c13cf37855a0ffec5",21,21,0,21,21,0,1,2
"1333","095d92f0cbb4f0f6c27599173b7aea41",24,17,61,2.75409836065574,15,9,2,1
"1334","09600975d77e3be8173d18671c3d2b91",202,139,62,22.8064516129032,159,43,3,3
"1335","09622ec1b9c1a6bcd7f75bfcee475dea",137,80,53,18.0943396226415,137,0,3,3
"1336","0962eae2253d8c3cc7d21bc8ef5f3f0a",23,23,0,23,23,0,1,2
"1337","0964eb01077644f34c17daf9b40c12d3",125,70,64,13.671875,125,0,3,3
"1338","0967302dc2ccbb8bf959bc235fc5b4ff",20,20,0,20,20,0,1,2
"1339","096d047d50087bba1e72c218f087a6c5",23,15,38,4.23684210526316,23,0,2,1
"1340","0971ae6df101268c0c30fe5e2deb870c",35,23,54,4.53703703703704,8,27,2,1
"1341","0971dddfb0a943afcc35be816b027b0d",11,11,0,11,11,0,1,2
"1342","0973f5410111cfa9ff8cdff19f079c66",101,64,50,14.14,101,0,2,3
"1343","097400feb71239a5cdd06157fac14b11",26,26,0,26,26,0,1,2
"1344","09747c8ee1bc606738e2179f29838801",9,5,44,1.43181818181818,9,0,2,1
"1345","0976a8c6c7ceead9396514b1a384f19c",10,10,0,10,10,0,1,2
"1346","097804b2b489868dd968aaf437da011c",76,53,33,16.1212121212121,76,0,2,1
"1347","097988da0fe3064e650b24dcbdd048c6",120,85,23,36.5217391304348,120,0,3,3
"1348","097c49d8885fb22b426ab53af9399a21",12,12,0,12,12,0,1,2
"1349","097c4a7e7f08176579adf50c0ae3a817",104,67,41,17.7560975609756,104,0,3,3
"1350","097f11acde31954938aeb17951302d60",22,22,0,22,22,0,1,2
"1351","097f4d6d3dbc97a48a47ae3316c0c9d6",37,37,0,37,37,0,1,2
"1352","09806609edd0ff160d85c8069c9ac575",5,5,0,5,5,0,1,2
"1353","0981503da71925b5e83cb26b96ecb69b",34,34,0,34,34,0,1,2
"1354","0982454e06a265d526f640a1fd4f89a4",15,15,0,15,15,0,1,2
"1355","09838ad181872ec6d4d3ab2b609b78b6",19,19,0,19,19,0,1,2
"1356","0983cda436665188459036bdd59ea71b",5,4,28,1.25,5,0,2,1
"1357","09847d28e9ccc7e5182a07f980242e8e",31,31,0,31,0,31,1,2
"1358","098977117f5ef02444e1a2285ca1b26b",23,23,0,23,23,0,1,2
"1359","098a2712962d44e2a80a134dd52f4eb2",48,44,7,48,0,48,1,2
"1360","098b2fbdc8ea0af4953e91f9d620eb6c",99,69,44,15.75,86,13,2,1
"1361","098b56d3cc85861c5950e42d3ae679d2",33,33,0,33,0,33,1,2
"1362","098d7cff26b5bfaf146b08bb63e8c21e",80,47,58,9.6551724137931,80,0,2,3
"1363","098e2b693c1f0c6adc3ed37a55cac02c",43,29,53,5.67924528301887,33,10,2,1
"1364","098fc45bdbd17938ebdea356a468f592",50,31,51,6.86274509803922,25,25,2,1
"1365","0990ee03116c6393eeacb30c93756940",111,93,41,18.9512195121951,111,0,3,3
"1366","09914302682243b6d83f2d5d9a9c7960",44,43,6,51.3333333333333,19,25,1,2
"1367","0991eb5a3288bcef05f29a3afdf6f66c",24,24,0,24,0,24,1,2
"1368","09939ef86a8f906c35ef9fa05854bbd2",128,77,62,14.4516129032258,128,0,3,3
"1369","09974482e5ab270c5d0b7e7d5ae099f9",29,29,0,29,0,29,1,2
"1370","09984b3c41fdbe260fb42205c843498a",177,78,84,14.75,142,35,3,3
"1371","0999770e217c6f0be8ae99b0b770d2e6",30,30,0,30,30,0,1,2
"1372","099a08a66763c5c367806983df245c41",24,24,0,24,0,24,1,2
"1373","099a8dcaa96bd1e37cb33141499992a7",161,68,79,14.2658227848101,161,0,3,3
"1374","099ae106827a4b412be405957bff2947",129,77,65,13.8923076923077,129,0,3,3
"1375","099b8d941908fcbb5e1c4b104565e737",110,75,37,20.8108108108108,110,0,3,3
"1376","099c2bf1ad2fc455c606634f1aced6d7",30,30,0,30,30,0,1,2
"1377","099c716360fb7aceae5d97d6d8640585",14,14,0,14,14,0,1,2
"1378","099ea92fde03555208ff846725e945e3",115,58,39,20.6410256410256,115,0,3,3
"1379","099f633b765e0a62cb53c4567f429746",102,50,68,10.5,82,20,2,1
"1380","09a0d5633364c7a37a8e65626269ec84",72,64,66,7.63636363636364,72,0,2,3
"1381","09a250c210626d7ef38c6ad090c2cbfb",25,24,6,29.1666666666667,1,24,1,2
"1382","09a5b2457f033a86c8dcb438e1bdf0b1",34,34,0,34,34,0,1,2
"1383","09a9c9e6595dd2ea3766d520baadb478",41,41,0,41,41,0,1,2
"1384","09aa514b2b707af72cdf5cb576fee5e3",25,25,0,25,25,0,1,2
"1385","09addc9db7f7faaceba8f9ecda271e9a",213,144,90,16.5666666666667,213,0,3,3
"1386","09ae1183b25f1c43fb2d2d3fbc4ea008",164,102,70,16.4,164,0,3,3
"1387","09af3a0b5eab2d52c38b0c563d313bb2",139,100,58,16.7758620689655,139,0,3,3
"1388","09b171be530462ac2b7a287bcacf3bb4",26,22,40,4.55,26,0,2,1
"1389","09bbc51726801fff3c6d52dfd0506b23",50,39,22,15.9090909090909,50,0,2,1
"1390","09bd86820ecb5b4ee9fe64108262164f",103,62,45,16.0222222222222,82,21,2,1
"1391","09be76ea383c2b164866434d8751ee37",30,24,14,15,30,0,1,1
"1392","09c0409c7bbeec6cb6c91c4016aaff86",17,17,0,17,17,0,1,2
"1393","09c166ce49631e56e234fb2090048e80",109,85,44,17.3409090909091,68,41,3,3
"1394","09c3c0e84bbea74ea6b9d229ce87d119",30,30,0,30,30,0,1,2
"1395","09c4f9fb998d8b7ff7495b2eeee80c99",31,31,0,31,31,0,1,2
"1396","09c6391a0b45ba7eeb2561f3b420400f",4,4,0,4,4,0,1,2
"1397","09c67f8363d22c46ff8cde21c64b2629",143,72,77,13,143,0,3,3
"1398","09c8d9cab6f7f2de23e0934c66b17153",43,34,63,4.77777777777778,27,16,2,1
"1399","09caa662684843018663f08dc60910b3",109,90,25,30.52,56,53,3,3
"1400","09cbf4c69a66735b99bc893f209ad832",82,35,61,9.40983606557377,82,0,2,3
"1401","09ccaca7656415d5eee41a0a9a6f6be3",80,48,52,10.7692307692308,49,31,2,1
"1402","09ccdf48512724b0ac713fa87bf338b5",44,43,43,7.16279069767442,12,32,2,1
"1403","09ce6f28bfeefffc67c34af3c8f915a6",51,38,71,5.02816901408451,34,17,2,1
"1404","09d33be7bae6427a5dd61d4a51ca2292",51,43,27,13.2222222222222,22,29,2,1
"1405","09d5a75c0e75b79222a1a1d252429696",13,13,0,13,0,13,1,2
"1406","09d635b5ea3f67ea998521462097012d",30,30,0,30,30,0,1,2
"1407","09d73db1243f52d2e3e99e9039afc741",30,30,0,30,30,0,1,2
"1408","09d74c5f9f5cf2a090a192bbe12fee47",14,14,0,14,14,0,1,2
"1409","09d91c6e55d4742849278918dee42ae8",61,43,38,11.2368421052632,27,34,2,1
"1410","09d975e733bf4a9750826cd18f9d195a",128,70,87,10.2988505747126,104,24,3,1
"1411","09d9a6c9dc4f5515294749d4afa1ee1f",38,29,53,5.0188679245283,26,12,2,1
"1412","09da28a2b99e15618101609f520d5297",19,18,29,4.58620689655172,19,0,2,1
"1413","09ddd43d0185e580c3796fd4fb1772ea",26,26,0,26,26,0,1,2
"1414","09df9c9da4eb8efa32a624bbd7e28b59",39,32,6,45.5,19,20,1,2
"1415","09e097c6417c1f7a9838963797322171",81,58,37,15.3243243243243,81,0,2,1
"1416","09e1fa535a3147250b1e046a48e0d67b",20,20,0,20,20,0,1,2
"1417","09e2b56d2c5e6dcb559dba67ed914491",1,1,0,1,1,0,1,2
"1418","09e66e9a508490afa5f3c43db3c5a942",54,54,0,54,54,0,1,2
"1419","09e7ea221426e193d645a240be804119",41,41,0,41,41,0,1,2
"1420","09e98d1d2eee1281efe22ca4263be8e3",95,65,77,8.63636363636364,68,27,2,1
"1421","09e9efe778809be0db161284b0bc7315",43,43,0,43,43,0,1,2
"1422","09ebbd6b98e6d6d80fbb3afb26fca384",26,26,0,26,26,0,1,2
"1423","09ef5538961decf0be2c425fcd1bc0a5",98,74,32,21.4375,98,0,3,3
"1424","09efc67dc1007d26ffc17902f5494fda",39,39,0,39,39,0,1,2
"1425","09f42fcf047b67261149efd04454d566",15,15,0,15,15,0,1,2
"1426","09f6b99e934d571a7bb054339ddc5833",30,27,16,13.125,13,17,1,1
"1427","09fb58942cb4f353c491e227322c8e08",33,33,0,33,33,0,1,2
"1428","09fcdaa72cdfb327023abd80ced876c7",31,31,0,31,31,0,1,2
"1429","09ff8333a9360e7918ce8e283dbf2a24",26,26,0,26,26,0,1,2
"1430","0a00ee47b5ff0ce0b721d5905422cde5",132,68,77,12,132,0,3,3
"1431","0a011e42f913c6f90cac8afcad3b6f95",41,41,0,41,41,0,1,2
"1432","0a02fc78d75f988b840dba73d72ca302",81,67,41,13.8292682926829,81,0,2,3
"1433","0a06991c08c19ca9ba90fe3a06506fdc",61,34,19,22.4736842105263,61,0,1,1
"1434","0a07aa075419af938ec6ee76e0a17881",117,83,47,17.4255319148936,117,0,3,3
"1435","0a0c3adec91c5f1206a5be780a0c76bb",99,69,58,11.948275862069,99,0,2,3
"1436","0a0e2bc5b0e184b62de7bb0614a78269",26,26,0,26,26,0,1,2
"1437","0a10ecf85ffe4a9c8e1b124aa12e9bd0",34,26,27,8.81481481481481,34,0,2,1
"1438","0a1174b03e2bcee5d19f0194c700dcc0",21,20,7,21,21,0,1,2
"1439","0a135aca71fadb0a23535d6fef7c98e5",31,31,0,31,0,31,1,2
"1440","0a157acab7e93ddeac94cb9e35f01130",10,10,0,10,10,0,1,2
"1441","0a1844bee0a321d2a74058f9ee2f9182",125,74,68,12.8676470588235,88,37,3,3
"1442","0a188b844122b82af8ccf0c0f43d16a8",7,5,19,2.57894736842105,7,0,1,1
"1443","0a19d25b64ff91886b5d2e6ca3b0bcf9",106,90,66,11.2424242424242,71,35,3,3
"1444","0a1ca867f6e935284fb2c04d7e7c3b68",33,33,0,33,33,0,1,2
"1445","0a1f6458521ad0d1a1b662f568a696ca",2,2,0,2,2,0,1,2
"1446","0a1f6a2e1c847018ffadf5f059e4c9ce",58,44,31,13.0967741935484,58,0,2,1
"1447","0a1fe48dbb339738d704827f99037b72",20,13,63,2.22222222222222,20,0,2,1
"1448","0a20dc103e735fa493d492c55c685a6b",8,8,0,8,8,0,1,2
"1449","0a239fd6209fe42753491663dea3aadc",33,33,0,33,33,0,1,2
"1450","0a23dc7dda5bf4a2497dd2638663f74e",11,10,7,11,11,0,1,2
"1451","0a252c0a5997e8dfa315306ff9611edb",26,26,0,26,26,0,1,2
"1452","0a2dc17b9034387d0a0a1d3fd74b32f1",4,4,0,4,4,0,1,2
"1453","0a303de15652248236e90d89592a69f6",32,32,0,32,0,32,1,2
"1454","0a306aecb00afa1a3a861232d9d2730d",31,31,0,31,31,0,1,2
"1455","0a3169d8b5ee51e1865eb6be9d858d6c",76,59,54,9.85185185185185,31,45,2,1
"1456","0a3197e5f073d59b37faf0a0aebdbe56",114,90,45,17.7333333333333,70,44,3,3
"1457","0a31c28899e2b6b9b38faab262c4b1b8",95,71,29,22.9310344827586,54,41,2,3
"1458","0a35c5ca286460035c3ef94801a547af",28,28,0,28,28,0,1,2
"1459","0a36ecf702717e38b52982160c42e166",33,33,59,3.91525423728814,4,29,2,1
"1460","0a3a291ba972877da39421323930c0cc",7,4,43,1.13953488372093,5,2,2,1
"1461","0a3bee08f86b2203378956407d54e256",100,57,69,10.1449275362319,100,0,2,3
"1462","0a3d98c75dcd39b1f877e34f50dbe021",97,63,72,9.43055555555556,61,36,2,3
"1463","0a3f9739235ca51818df1d52543b4ee5",197,57,74,18.6351351351351,197,0,3,3
"1464","0a40558648bbfbe5012fbb184e3cb8df",28,28,0,28,28,0,1,2
"1465","0a4194f17b4d779b950a1b5343f72118",2,1,6,2.33333333333333,2,0,1,1
"1466","0a41b8534a99b9c70a871ad1bd827150",91,64,36,17.6944444444444,52,39,2,3
"1467","0a4498700e3520525d5642c20786c8fb",24,24,0,24,24,0,1,2
"1468","0a4612c780206423c8129efea8efd405",39,39,0,39,39,0,1,2
"1469","0a46df5d4d67c275746f39883f2e73d1",75,48,22,23.8636363636364,59,16,2,1
"1470","0a48b8333221a615ff87bee834d084d4",13,13,0,13,0,13,1,2
"1471","0a4940f49b27b199c96cf57304ec766f",20,20,0,20,20,0,1,2
"1472","0a4d56ee3304ad651eee5372b3255d4f",43,42,59,5.10169491525424,25,18,2,1
"1473","0a4d77c192353d24be02aee59671a5bf",44,35,82,3.75609756097561,44,0,2,1
"1474","0a4ee426b04ddffb5656a5d58ba7ba44",31,31,0,31,31,0,1,2
"1475","0a4fd477bd96589b875907ec6c7fb6df",30,30,0,30,30,0,1,2
"1476","0a51fbb9dfd6363ca04e6bd27f61548f",10,10,0,10,10,0,1,2
"1477","0a52d4d07c33c9301f08986e1f1f5345",14,8,49,2,14,0,2,1
"1478","0a598aacad41fc8d888e011f898c493f",33,33,0,33,33,0,1,2
"1479","0a5f5f15a3bad502f2a88621526305ad",32,32,0,32,0,32,1,2
"1480","0a6129e858dbefb384816a1bc3763dd1",143,89,75,13.3466666666667,114,29,3,3
"1481","0a61bee2c58d5c95d1744ebc8c7221e8",56,49,21,18.6666666666667,56,0,2,1
"1482","0a635e48a158ac39d45a4d4d1f3949c1",37,37,0,37,37,0,1,2
"1483","0a63e72d4238833a166f813f5d719f70",33,33,0,33,33,0,1,2
"1484","0a643c990768fc678a1340578944a562",37,31,21,12.3333333333333,37,0,1,1
"1485","0a64b8437b1b0054ad24671fdb8115d4",99,54,69,10.0434782608696,99,0,2,3
"1486","0a6533511aaa519074ad730e6b34b0aa",27,27,0,27,27,0,1,2
"1487","0a65a72461c62b29f142a9d1f2deefd7",25,25,0,25,25,0,1,2
"1488","0a677995535b53558e656640ec5fcec6",58,34,71,5.71830985915493,13,45,2,1
"1489","0a67e2acf04dfc798b63f4c7565db451",32,32,0,32,32,0,1,2
"1490","0a68488891de6700128b457870a392f3",44,44,0,44,44,0,1,2
"1491","0a69957194be7215a01f72bbf3a318e5",225,73,87,18.1034482758621,177,48,3,3
"1492","0a6adfed81e3c6cf54f30a5b023d3720",26,23,16,11.375,26,0,1,1
"1493","0a6bd6113b0379bb5a73cc0faa652db4",28,28,0,28,28,0,1,2
"1494","0a6bf84455f939c0914c3510cd73b35f",44,44,0,44,44,0,1,2
"1495","0a6c2cbc6ae1d32dee30623860689cea",112,74,57,13.7543859649123,112,0,3,3
"1496","0a6d21b90b01deaaeb0f6acb70fcc9bb",97,72,19,35.7368421052632,97,0,3,3
"1497","0a6d753bbbd86dae39649063135abb38",49,33,41,8.36585365853659,49,0,2,1
"1498","0a6e032e3fde84de428bec454eb61316",26,26,0,26,26,0,1,2
"1499","0a6ef6421ef955f9c7b155f4fa500886",43,43,0,43,43,0,1,2
"1500","0a71231be3e6794a1da3201fdf2119d4",47,47,0,47,47,0,1,2
"1501","0a716f1ae007ddbb6ed3030b102bb4bf",19,19,0,19,19,0,1,2
"1502","0a743ae2a2b488555aa1e7324c8681d0",138,95,37,26.1081081081081,125,13,3,3
"1503","0a798062d7d7d57d6ea983782a3d61fa",92,56,59,10.9152542372881,92,0,2,3
"1504","0a7bbcf151d1535335c84ef4418d682f",110,88,63,12.2222222222222,110,0,3,3
"1505","0a7dd16031d8823d7dfb6bd041ea9069",152,99,62,17.1612903225806,152,0,3,3
"1506","0a7e22366508ade3f8ead1193faf1549",9,9,0,9,0,9,1,2
"1507","0a80003ac6a2351152926935df8e5c17",61,32,35,12.2,25,36,2,1
"1508","0a8757ff170c4795509f37cdaa0b51c3",53,53,0,53,53,0,1,2
"1509","0a8a9cb9428a7a3ce846d4201fca4d21",74,58,51,10.156862745098,74,0,2,3
"1510","0a8abf42f317c50f71fb1b71df12dd92",42,42,0,42,42,0,1,2
"1511","0a8e6e679aaac12b565cde3245918113",75,51,61,8.60655737704918,75,0,2,3
"1512","0a8f2c40dabb9bccf6da7027aad4f42d",25,25,0,25,25,0,1,2
"1513","0a9073c660ee5c99d09ea921931209ef",27,25,64,2.953125,27,0,2,1
"1514","0a9834cb67374cc7ccf0916aac3271f9",38,38,0,38,38,0,1,2
"1515","0a9945a3ef751034f1eef69637efa293",34,34,0,34,34,0,1,2
"1516","0a9a05cad9ce05e9c8164d8c231f92e6",17,17,0,17,17,0,1,2
"1517","0a9be7ae7aababf27c6bb829c4234175",12,12,0,12,12,0,1,2
"1518","0a9c561efaa4474aa7a2c8b7a31b2f5e",91,69,42,15.1666666666667,91,0,2,3
"1519","0a9c61e0cce9b0e8e6225d0bbef9883a",122,105,53,16.1132075471698,122,0,3,3
"1520","0a9cb61c20b04e328e441eb049448074",66,53,25,18.48,26,40,2,1
"1521","0a9d52cf1ecf2b9b21150c85bb142cb3",11,10,2,38.5,11,0,1,2
"1522","0a9f7eae876f1d368fc8eee578f49d64",140,89,31,31.6129032258064,140,0,3,3
"1523","0aa1873e9c9646709f6e7e48b3456fe9",67,61,36,13.0277777777778,42,25,2,1
"1524","0aa208c02c06899db6ea90551ce940b8",55,43,43,8.95348837209302,37,18,2,1
"1525","0aa21b1c941a6f55a0a7a5fdf5eb83cf",13,13,0,13,13,0,1,2
"1526","0aa3aedb880b3409240625a7787c4de9",69,65,27,17.8888888888889,69,0,2,1
"1527","0aa5b0c4489142dca963f2355e55dceb",70,60,33,14.8484848484848,70,0,2,3
"1528","0aa77bbc3ddde5d2937d5bdb96dd9bce",28,28,0,28,28,0,1,2
"1529","0aa95a6b855c04dad4249539dc9b85d5",89,49,56,11.125,89,0,2,3
"1530","0aa9bce780934781ee885ea6105ea39d",85,59,43,13.8372093023256,85,0,2,3
"1531","0aaa8e2b9d7928fac94d3fbc350f15ef",24,24,0,24,24,0,1,2
"1532","0aadf6c543d9d5c7e2f82f6c7abd6847",13,13,0,13,13,0,1,2
"1533","0aae68921e061e20e2c4e39c6900799d",91,72,70,9.1,91,0,2,3
"1534","0aafa5b211232e52c44ef9dde8aa4105",8,8,0,8,8,0,1,2
"1535","0ab28cf8a03ec6a11af61c0b05856253",14,14,0,14,14,0,1,2
"1536","0ab2b79b01674ff48f5c17f736bb72c7",134,73,89,10.5393258426966,134,0,3,3
"1537","0ab31770f5fa7aee5e7e565897317b40",83,45,42,13.8333333333333,83,0,2,3
"1538","0ab7ec44c1a56a11e692ab562a139827",14,12,20,4.9,14,0,1,1
"1539","0abbec5ccb155fb198163ca9496fb197",27,27,0,27,27,0,1,2
"1540","0abcfbbc30cba12bdb744bdda902bc15",134,85,70,13.4,134,0,3,3
"1541","0ac02255f7e0131edc8e30576ce4269d",40,27,32,8.75,20,20,2,1
"1542","0ac3205f81dfabb569367526bfdec6c2",47,44,25,13.16,47,0,2,1
"1543","0ac819a23f986d0262f676b6e46cc085",37,30,55,4.70909090909091,37,0,2,1
"1544","0aca8f723df043bc8a09bb1f26d60975",15,15,0,15,15,0,1,2
"1545","0acbfec737b13b9c67404c4a63070e21",24,24,0,24,24,0,1,2
"1546","0ad0d72f09eeb29451760ad0b9111a9d",71,43,48,10.3541666666667,71,0,2,3
"1547","0ad7b158d96e63860255a51fb27ad05f",106,58,49,15.1428571428571,106,0,2,3
"1548","0ad94352096658f06ea0556a2b207a11",46,36,65,4.95384615384615,46,0,2,1
"1549","0ad975b1df101c8099d9fbe15e160813",23,23,0,23,23,0,1,2
"1550","0ad98e372266e28ac262633bb4ded1f2",74,54,50,10.36,33,41,2,1
"1551","0adaf6da0e3df1112b911f48a5d1ddff",65,46,64,7.109375,40,25,2,1
"1552","0adcc6e1084b53324d1c5d68acb4f1eb",10,10,0,10,10,0,1,2
"1553","0addb962f420874d4bcd18e01d90fc8b",9,9,0,9,9,0,1,2
"1554","0addd207eeb315121c2bf4199fcd73b7",156,98,49,22.2857142857143,122,34,3,3
"1555","0addfb709e2b0a5b2c510bc63d2d714e",199,118,84,16.5833333333333,161,38,3,3
"1556","0ae012ea656a4cc22de02dd0f8cd846a",52,42,37,9.83783783783784,32,20,2,1
"1557","0ae025356bd9768e2893b36750dc0c10",5,5,0,5,5,0,1,2
"1558","0ae090d1299c5c4e05ededcc8073dcf7",35,35,0,35,0,35,1,2
"1559","0ae0e87e613c29d9bf5f8f0c3cc63abd",63,50,25,17.64,63,0,2,1
"1560","0ae569c3572bb3b170b5687b6ac41bfd",26,26,0,26,26,0,1,2
"1561","0ae775e2cd42a6682184af68be8cb172",74,65,46,11.2608695652174,74,0,2,3
"1562","0ae843e8d2eb5661e65f86a638831b5d",39,39,0,39,39,0,1,2
"1563","0aed33fb3a0e69b860b7f6ccf1ed5930",137,84,73,13.1369863013699,107,30,3,3
"1564","0aed8f20cc5bdde79adb21e186fe4f64",29,29,0,29,29,0,1,2
"1565","0aef6e118e5a69a8b0ea9fd9d7e2b7de",41,41,0,41,41,0,1,2
"1566","0af3601ee17d924ffba3894823e1893b",29,29,0,29,29,0,1,2
"1567","0af4d0041e3bd2a562bbc924daf23e44",71,53,49,10.1428571428571,71,0,2,3
"1568","0af57f2d8236d6d0d72c74838cd64f25",47,47,0,47,47,0,1,2
"1569","0af6269cee127ed0088da8bda2990de5",49,49,0,49,49,0,1,2
"1570","0af778403c289e9ed59a26dc65a1a026",33,32,42,5.5,33,0,2,1
"1571","0af970805f18e078f1fa709658fb105d",34,25,34,7,34,0,2,1
"1572","0af9fb33a3217fcd0dfdb5fd7b124b9d",109,58,73,10.4520547945205,109,0,2,3
"1573","0afac0925f369de611c3e47d6dbd4648",82,68,56,10.25,82,0,2,3
"1574","0afb8c3e20d5ad692a8d7609cf77580e",40,40,0,40,40,0,1,2
"1575","0afd55d9d8cff45245fb60b1cbc3e534",37,37,0,37,37,0,1,2
"1576","0affaf782b690446f6cac9c9219a9f11",86,62,72,8.36111111111111,39,47,2,3
"1577","0b00a576c76b1a1b32853e089f52db1d",36,36,0,36,36,0,1,2
"1578","0b014bf3580ff84fbc52213ac362bb84",32,24,64,3.5,32,0,2,1
"1579","0b077668a231a53c9e9a21dbf38d627c",21,21,0,21,21,0,1,2
"1580","0b09cd29dda11206ca626cfa172162ef",168,96,62,18.9677419354839,168,0,3,3
"1581","0b0f44b162a96fad23f66e952a7ff9ff",30,22,17,12.3529411764706,13,17,1,1
"1582","0b10c41f3aa4cc35aee1723f5bffd9c4",48,48,0,48,48,0,1,2
"1583","0b10cf5748dcaf5592d73141721eafe7",36,29,69,3.65217391304348,36,0,2,1
"1584","0b1147b828c2b563016af9f118518e53",75,65,57,9.21052631578947,75,0,2,3
"1585","0b122a6871b4f40e6450ad593ba386fb",24,24,0,24,0,24,1,2
"1586","0b13413bab23319313255739e4bbd6c0",41,41,0,41,0,41,1,2
"1587","0b17e3535b6164fcfb038bff4cdd629f",70,45,79,6.20253164556962,70,0,2,3
"1588","0b1d2db8bdd8e16b771f2276c77ae266",73,37,73,7,73,0,2,1
"1589","0b1f7dc1264a1a65c08f55844f1c4eac",51,51,0,51,51,0,1,2
"1590","0b2444d1abb99360317d9ce0decfd829",25,19,46,3.80434782608696,12,13,2,1
"1591","0b25df256647a16049e84f61614eb652",84,63,65,9.04615384615385,56,28,2,1
"1592","0b26db9b891b3a0ae4ff664271a6116d",97,54,62,10.9516129032258,97,0,2,3
"1593","0b276f325bc1adad847313046b271faa",20,20,0,20,20,0,1,2
"1594","0b27edc331f08f70a9834f96c37a38b7",47,41,8,41.125,47,0,1,2
"1595","0b2d7282cbeb273261b895d95fe80224",137,84,78,12.2948717948718,137,0,3,3
"1596","0b2dc173bbec12bd7382557ada05ce97",12,12,0,12,12,0,1,2
"1597","0b2f24f7fcd6ce41cc86c197556c41b6",169,82,84,14.0833333333333,132,37,3,3
"1598","0b3002e29af5cfd371d4e3199331e266",15,15,0,15,0,15,1,2
"1599","0b3297eda50d81a241561c8399733cc9",14,14,0,14,14,0,1,2
"1600","0b32c812a81ef4853f6e37952f659b57",31,31,0,31,31,0,1,2
"1601","0b363f7563d4050e7a348ccfbb6cd591",37,37,0,37,37,0,1,2
"1602","0b380807de01bb020d3d50fbe3ff1d7e",30,30,0,30,0,30,1,2
"1603","0b3ee79c0d57e1d59b3765a0b48d4103",33,16,58,3.98275862068965,20,13,2,1
"1604","0b44568147703e3c6037bc21e393fa4b",11,11,0,11,11,0,1,2
"1605","0b4619f7f3f0b85952ad9cc5164504a6",6,6,0,6,6,0,1,2
"1606","0b47bdcc2a6dbd880aa86a6dbe6bd802",27,27,0,27,0,27,1,2
"1607","0b497843a2104120ea43214adb188346",257,142,85,21.1647058823529,218,39,3,3
"1608","0b4b96e5077831cf11481eb62a36760d",37,37,0,37,37,0,1,2
"1609","0b4ce3fffac9eab2bfe66cc384a58479",61,38,13,32.8461538461538,61,0,1,2
"1610","0b4f73b836b7c7f85686b5afa9038b95",53,53,0,53,53,0,1,2
"1611","0b520ed5820586642fc2d107b913538e",43,43,0,43,43,0,1,2
"1612","0b53bbc3fba58e456df445ed15cc56f9",41,38,12,23.9166666666667,20,21,1,2
"1613","0b570232804c97014b207e5a8745b260",23,23,0,23,23,0,1,2
"1614","0b5cf3ec0ef527a32c77b15ebac3bc6e",50,50,0,50,50,0,1,2
"1615","0b61c081f9098ca74c9cee7746fd38bc",15,15,0,15,15,0,1,2
"1616","0b63d77404eaa0737c12a75b904c6260",3,3,0,3,3,0,1,2
"1617","0b670848d5037f74590a2ea1380cbecf",90,44,70,9,60,30,2,1
"1618","0b678d117ee3d72826bd765d613323d0",16,16,0,16,16,0,1,2
"1619","0b69eadcf6a5fcf060bfb1ba46b8186c",8,8,0,8,0,8,1,2
"1620","0b6a40682724771dbcc7bdbfef6f5518",97,66,83,8.18072289156627,97,0,2,3
"1621","0b6b34d3fbe417382dd4f38740520cae",23,23,0,23,23,0,1,2
"1622","0b6b7e7c52d4f2fa8d0976c5ac1759c8",38,35,48,5.54166666666667,38,0,2,1
"1623","0b750bbbcf46393c2b2aeef433e0187a",237,96,81,20.4814814814815,206,31,3,3
"1624","0b7518cf7c290441ca3ff97d03b0b040",29,29,0,29,29,0,1,2
"1625","0b7603afdbc4c21ab226e68ad8167427",27,27,0,27,27,0,1,2
"1626","0b7922310dda83b1bc9bfb7855d4e553",17,14,3,39.6666666666667,17,0,1,2
"1627","0b79334bde06527d80bf31121316e676",48,48,0,48,48,0,1,2
"1628","0b7a109ff127e30c2ffbeb83dd812558",111,75,54,14.3888888888889,71,40,3,3
"1629","0b7d98a91d7379442d6c21654fd565d7",28,28,0,28,28,0,1,2
"1630","0b7dcdd86dfb1d0c53c2c93083ce5f03",9,9,0,9,9,0,1,2
"1631","0b7fcba9b6ee4e1e28c3d86ba8b32f43",97,76,68,9.98529411764706,97,0,3,3
"1632","0b802065a7006ded9b354593b5838051",82,76,72,7.97222222222222,76,6,2,1
"1633","0b8037c26c268c889aea6b6b76cfd1b9",67,48,23,20.3913043478261,34,33,2,1
"1634","0b82f64e569fe83899cbdcfe574f412c",8,8,0,8,8,0,1,2
"1635","0b85d0f957e29b51a8739cdeeac30dda",136,84,78,12.2051282051282,136,0,3,3
"1636","0b867caf2b21fc1a89cab57f4b566a7d",91,45,65,9.8,91,0,2,3
"1637","0b8999758073ce69fae84b1107309868",19,19,0,19,19,0,1,2
"1638","0b8a42add2c21906775acea115d4da29",77,58,28,19.25,77,0,2,1
"1639","0b8a4e4f714729e97da8fa0f135a442e",28,28,0,28,28,0,1,2
"1640","0b8b6e456b88088870a88969a7934772",134,77,63,14.8888888888889,134,0,3,3
"1641","0b8bc5f3b04516f1698fb7ab4e267e6e",35,22,75,3.26666666666667,35,0,2,1
"1642","0b8ca5423c66c1b66d95eba5da7d17ef",140,89,62,15.8064516129032,140,0,3,3
"1643","0b901c95c5e9e55ec36b825d25fdd995",53,41,25,14.84,53,0,2,1
"1644","0b92e0908155ff5398d744e82ca92165",71,46,67,7.41791044776119,30,41,2,1
"1645","0b92e6a93b8ee42f90f075d3ca9a05d7",134,78,65,14.4307692307692,98,36,3,1
"1646","0b935dee99efc1cba5829c738c79bbc5",18,18,0,18,18,0,1,2
"1647","0b936f84dbc63574a083b6bb98c1c0fd",112,75,70,11.2,112,0,3,3
"1648","0b93fa18a490ab13943eb075af067a02",25,25,0,25,25,0,1,2
"1649","0b9504f679a28b2ea6c839152279a0e1",157,84,76,14.4605263157895,103,54,3,3
"1650","0b975878322a672a1c2d01bca0f3f2c6",108,50,76,9.94736842105263,108,0,2,3
"1651","0b99e4a7aa24241d40ae9f7d55ec06d7",38,31,6,44.3333333333333,11,27,1,2
"1652","0b99e7d563bc17dc9042040bf9126cdb",90,75,23,27.3913043478261,90,0,3,3
"1653","0b9b1e329b7330b19cabbc24721bf64c",39,26,25,10.92,39,0,2,1
"1654","0b9e42d99048e342c7d9024d6c47cc78",53,46,14,26.5,53,0,1,1
"1655","0ba0a575a95e4c66fcac76f96201e1e1",14,14,0,14,14,0,1,2
"1656","0ba22c11c965da23f59551740f36441f",36,36,0,36,0,36,1,2
"1657","0ba3b96a381943ac04efe02f26c712eb",184,87,84,15.3333333333333,135,49,3,3
"1658","0ba4e21a3630da88b3f00cd839b933b1",124,105,20,43.4,124,0,3,3
"1659","0ba529feff8b6dc93d5413335535bd25",50,50,0,50,50,0,1,2
"1660","0ba54c1e498957c2e70e17c07018b230",44,44,0,44,44,0,1,2
"1661","0bab01413a77166fa27b0a9a07bdc623",16,10,81,1.38271604938272,16,0,2,1
"1662","0bad26080f38c67011d24c688d44b408",58,41,64,6.34375,58,0,2,1
"1663","0baebac2ae89d97e9b2d9caae143b640",18,18,0,18,18,0,1,2
"1664","0bafc1c4cd7d8ccc4809ea505416396d",127,104,26,34.1923076923077,121,6,3,3
"1665","0bb0fbe5ecfc94d0efcd01653ad51740",23,19,27,5.96296296296296,16,7,2,1
"1666","0bb19dd30353e03e1845481b88ac9db3",20,20,0,20,20,0,1,2
"1667","0bb5e7e2c702fb60c154c75ef0d1131d",23,23,0,23,23,0,1,2
"1668","0bb6c4d1bda914972f55086796da1c77",7,7,0,7,7,0,1,2
"1669","0bb77394bacf066870931a1c7d338222",149,89,81,12.8765432098765,149,0,3,3
"1670","0bb915a18b5b029956ad9433466a9a10",24,24,0,24,24,0,1,2
"1671","0bbad5e65586200c85214cead1ef9427",34,34,0,34,34,0,1,2
"1672","0bbb4566c62621ecfed12bb111f0ffab",245,114,73,23.4931506849315,192,53,3,3
"1673","0bbdf444cb48ff5347a813527af409d7",5,5,0,5,5,0,1,2
"1674","0bbe62df59fd77f59602c37a68331562",60,48,61,6.88524590163934,49,11,2,1
"1675","0bbeea8329972d0bc9c7497220c4b166",28,28,0,28,0,28,1,2
"1676","0bc15d18797a6111dc63ef03337fdce5",42,42,0,42,42,0,1,2
"1677","0bc19e736e607cdc3dd5b43cdb000376",18,18,0,18,18,0,1,2
"1678","0bc64cc738ae35708f3b7d14e88cf293",29,29,0,29,29,0,1,2
"1679","0bc6754c9f705e2755fd925f75e29257",2,2,0,2,2,0,1,2
"1680","0bc8c33b30b05b1bf6dceac614a96771",6,6,0,6,6,0,1,2
"1681","0bc987c57b4285e03dacdc13437a4620",66,54,18,25.6666666666667,54,12,1,1
"1682","0bcae0a7bc96f891ba5ec62e4a115348",33,33,0,33,33,0,1,2
"1683","0bcdee3976ead6a2fae04dafe08dcb03",30,30,0,30,0,30,1,2
"1684","0bcec100614c730eb1716cbb89f98604",54,36,46,8.21739130434783,54,0,2,1
"1685","0bd106cbd6843ecceb82385fcf037cf9",10,10,0,10,10,0,1,2
"1686","0bd297dae992e7ce082ae8c350abdae8",53,35,44,8.43181818181818,53,0,2,1
"1687","0bd319804b276dd3bf1c692040277314",60,35,63,6.66666666666667,60,0,2,1
"1688","0bd5d1e768eb434e2b1dde0a0787c229",20,20,0,20,20,0,1,2
"1689","0bd7133fb247b1ca076420a8b67b2479",35,35,0,35,0,35,1,2
"1690","0bd7c446bdd10ae43080ebeee2be8ecc",59,48,72,5.73611111111111,38,21,2,1
"1691","0bde04465c2c5eee83d71eecaa0995f7",110,89,29,26.551724137931,110,0,3,3
"1692","0bde475ed4bee54851f7eb17f5086d00",23,23,0,23,23,0,1,2
"1693","0bdf60d4ecbcc7910abbb95054f6bc78",107,57,79,9.48101265822785,56,51,2,3
"1694","0be0bb2f83c35846f959c71c3fdf3458",46,36,33,9.75757575757576,46,0,2,1
"1695","0be1c5407398568554d9c7df2ff574ab",33,33,0,33,0,33,1,2
"1696","0be234d832d261a1ec995684edaddf14",15,14,4,26.25,1,14,1,2
"1697","0be260c08a4c5c3b8b515a151048b0bb",4,4,0,4,4,0,1,2
"1698","0be31d209a8c5f39e5e5d8d712e3634d",29,29,44,4.61363636363636,6,23,2,1
"1699","0be4351a23d093cea12218169914a9ef",1,1,0,1,1,0,1,2
"1700","0be8fb6844901075ab4158424dd91356",48,48,0,48,0,48,1,2
"1701","0bed509bcc7f73b6ff55796ffcac0840",4,4,0,4,4,0,1,2
"1702","0bf06a8ba9ca70b8abde4516808625c2",31,31,0,31,31,0,1,2
"1703","0bf180a1799f97a3cd3cb85ca22c7a98",92,75,71,9.07042253521127,75,17,2,1
"1704","0bf23a8222294a1fad185673cfa60f30",111,61,60,12.95,77,34,2,1
"1705","0bf3c6540dd91943f4570d2880c684fb",218,130,80,19.075,185,33,3,3
"1706","0bf5b2f84e026dc5fc3faa8a4a97606e",1,1,0,1,1,0,1,2
"1707","0bf79a1b26975975b7b6888a8a177dd2",56,56,0,56,56,0,1,2
"1708","0bf96270206f792953ba791d552a6d43",109,62,62,12.3064516129032,109,0,3,3
"1709","0bfb3b79a780838f9cc244f028e39b04",201,90,52,27.0576923076923,201,0,3,3
"1710","0bfe87f5754a69745dbbc577f293eeaf",113,56,69,11.463768115942,113,0,3,3
"1711","0bff3bafcd04f52de3d1888660bf442f",55,50,59,6.52542372881356,26,29,2,1
"1712","0bff7cbe787d1f373ef46a6bce63b264",2,2,0,2,2,0,1,2
"1713","0c01ef948930f7d07e413eca467932b8",111,51,63,12.3333333333333,111,0,2,3
"1714","0c0359b97aad64938db5456a4f4519c8",40,34,61,4.59016393442623,39,1,2,1
"1715","0c085df6fc193a5806a88b82c01cabd0",39,26,59,4.6271186440678,39,0,2,1
"1716","0c091b65ae7385711ea5f411fed6359e",81,74,40,14.175,81,0,2,3
"1717","0c0a9a233e10ecd1297475ce02a24fd8",10,10,0,10,10,0,1,2
"1718","0c0d1f9e222c59a8edad17d73a34c16c",86,48,64,9.40625,41,45,2,1
"1719","0c0d212205d24095362b1c0b47457eed",144,86,59,17.0847457627119,105,39,3,3
"1720","0c0d9433882099773d854d0fdcad255e",50,50,0,50,50,0,1,2
"1721","0c1029da68d6f49a38762a6b48df5e03",103,45,83,8.68674698795181,103,0,2,3
"1722","0c111fc1966bb23b3bf8ca116dfc0b33",123,74,62,13.8870967741935,82,41,3,3
"1723","0c11802f096319270c54a55315aa650d",53,39,27,13.7407407407407,53,0,2,1
"1724","0c125929b467ae02eb18ea219583ffe9",31,31,0,31,31,0,1,2
"1725","0c15df6eebade18f2bd5748d3784dde9",50,33,67,5.22388059701493,25,25,2,1
"1726","0c168949796d0cf11182fd07e3ab3457",164,78,76,15.1052631578947,164,0,3,3
"1727","0c168bad5acb521e3c4465756cc115b1",110,56,71,10.8450704225352,110,0,2,3
"1728","0c177292b00adf6ff60370492f77e3f2",18,18,0,18,18,0,1,2
"1729","0c17a8049e903350d51497d5eca98d08",66,44,36,12.8333333333333,66,0,2,1
"1730","0c1a14d2c643c92e6334296c060e27e1",16,16,0,16,16,0,1,2
"1731","0c1a2e6da9a979a05a4e14f34c7254f3",42,42,0,42,42,0,1,2
"1732","0c1bba8410a8bb5de95172267f31470e",137,86,62,15.4677419354839,114,23,3,3
"1733","0c1f0d61d7a8f0b2a3ae0c7f95906bbe",184,126,74,17.4054054054054,163,21,3,3
"1734","0c1fdc8324024e806f66064c66d747dc",21,19,51,2.88235294117647,16,5,2,1
"1735","0c202250a5f657635dffbf34510e61bb",27,27,0,27,27,0,1,2
"1736","0c2207b2e8caade3f8e95f3d4965f655",39,36,70,3.9,39,0,2,1
"1737","0c227f425ab8862dcb3700e48e613e5f",44,44,0,44,0,44,1,2
"1738","0c23cdfbaba857ab047d258e7e2f1f81",203,84,76,18.6973684210526,203,0,3,3
"1739","0c25a22f3b32a09f860d25d5c4eadeaf",43,34,36,8.36111111111111,23,20,2,1
"1740","0c2c5beb63631def630bc0fabd171c97",101,65,62,11.4032258064516,101,0,2,3
"1741","0c3049b73ef9c493339ffdc020a314fa",10,10,0,10,10,0,1,2
"1742","0c3135406f47f3c9dc422d7f031e13df",77,55,60,8.98333333333333,77,0,2,3
"1743","0c327e5f0f4e79cf2e6deef2ffba9a0f",104,69,69,10.5507246376812,55,49,2,3
"1744","0c330df4e6dd341e5c4455ae3e6a8c34",97,80,61,11.1311475409836,97,0,3,3
"1745","0c3433ee7f3226b836256278a1e88f28",45,37,71,4.43661971830986,45,0,2,1
"1746","0c36b5a6d8f6bb17551a139de913c875",204,96,84,17,188,16,3,3
"1747","0c37537852abe72980f8518a3ea42857",40,40,0,40,40,0,1,2
"1748","0c390854aa9ee6388ebf5f4f8d54940b",40,35,37,7.56756756756757,17,23,2,1
"1749","0c397aad21709a9b9cdb9d754b70e4da",34,34,0,34,34,0,1,2
"1750","0c3d2d9bbc9375a4605ec5fbdbfa8b0e",41,38,48,5.97916666666667,41,0,2,1
"1751","0c3eb3b0c55ebc2eed4e1ca914f7be67",159,104,75,14.84,116,43,3,3
"1752","0c4275b84b21f7b076d0624419fd4e2a",33,29,8,28.875,33,0,1,2
"1753","0c42f9cf3eb43c42cec1215c80c72807",76,53,41,12.9756097560976,76,0,2,3
"1754","0c443beec43347a66ef535327801cdff",64,36,33,13.5757575757576,64,0,2,1
"1755","0c447805ceea3281b331ba538219d8d9",5,5,0,5,5,0,1,2
"1756","0c44f59ce4fc7c857a3dd247efef9be3",43,43,0,43,43,0,1,2
"1757","0c46d2f4c030abdc3035347779b4a830",39,39,0,39,39,0,1,2
"1758","0c475c006325af25fa5fa42adf5f066f",64,38,12,37.3333333333333,64,0,1,2
"1759","0c48a1e8a1faa94f67ad3f6db01dd71c",88,66,65,9.47692307692308,88,0,2,3
"1760","0c490e56741cc938fb6e01f5612a8882",40,40,0,40,40,0,1,2
"1761","0c495f9b77c0fd5445e989cc6c692664",80,51,62,9.03225806451613,80,0,2,3
"1762","0c4983f4a15006ddaf86cdba9be607b4",82,63,35,16.4,82,0,2,3
"1763","0c4baa71ff0084709e67a83178368a2b",17,17,0,17,17,0,1,2
"1764","0c4d6669e1ad681cbfff4f9ab7f4a5bb",12,12,0,12,0,12,1,2
"1765","0c4fea1d3f8401e1f3f4c4e32f09b7ab",52,37,75,4.85333333333333,52,0,2,1
"1766","0c517f02f1dc6975e6ed4772b2aa8fef",20,20,0,20,20,0,1,2
"1767","0c51b330419419fabfe6de8569833c15",102,63,70,10.2,102,0,2,3
"1768","0c51bac388b1530bae309abbdfd7b239",49,49,0,49,49,0,1,2
"1769","0c533a469ec342a918413d0e7d00c41a",66,55,14,33,66,0,1,2
"1770","0c5356b46ad3dfe352af82f0d543f089",30,26,23,9.1304347826087,19,11,2,1
"1771","0c54125a6bec6e79f526e5b8574286a1",25,25,0,25,25,0,1,2
"1772","0c58f3aec293ae520c734972ca54de9d",20,20,0,20,20,0,1,2
"1773","0c59c0272f044de7c9ae4fd306e95f0d",96,45,42,16,83,13,2,1
"1774","0c5ee7b081f8cd55742a96c6efdc053e",57,39,74,5.39189189189189,57,0,2,1
"1775","0c5ee93afa29891552740b161c1b4363",19,19,0,19,19,0,1,2
"1776","0c5eee5b19bed214200251a5e3b235a1",78,40,48,11.375,78,0,2,3
"1777","0c5f80cddbb432fffd12f8207f61691d",6,6,0,6,6,0,1,2
"1778","0c5fae0aeede53d0474f18fa63a99585",15,15,0,15,15,0,1,2
"1779","0c63d4bc934dbfe7fce4c5a8c09f0bc8",21,21,0,21,21,0,1,2
"1780","0c63e57832dd6d59dfaaee86a3fd3746",78,66,21,26,78,0,2,2
"1781","0c6734c6d03068e2c18bd8c4f5a4b10f",20,16,9,15.5555555555556,4,16,1,2
"1782","0c68358bd74a3df82c2870b9b5e43cb0",53,49,9,41.2222222222222,25,28,1,2
"1783","0c68b36ef8481b143bf58941319df9b7",207,92,48,30.1875,168,39,3,3
"1784","0c6a3ab9fa5e52981b2959a7258b2cad",60,47,29,14.4827586206897,60,0,2,1
"1785","0c6a4dd0d5ff0026eb956f54eb9bd0ce",46,46,0,46,46,0,1,2
"1786","0c6b4763c5113e7a18c76c05a742dcb2",19,19,0,19,19,0,1,2
"1787","0c6b5027233878a1cd2c7905d1c5b58e",26,26,0,26,26,0,1,2
"1788","0c6f8aadc0874094e177d97c583c2273",158,70,81,13.6543209876543,117,41,3,3
"1789","0c751be2877ef36849a08d62deb771ab",76,50,28,19,76,0,2,1
"1790","0c7521e6c5f26a9b555bb86ba68ac163",45,39,21,15,45,0,2,1
"1791","0c755cc2cf86174e29396290631e1111",201,141,84,16.75,201,0,3,3
"1792","0c777374b7e01820e965b944f9e28a1b",52,27,67,5.43283582089552,52,0,2,1
"1793","0c778b88cff2baf1ccfef622f5fb1574",24,24,0,24,24,0,1,2
"1794","0c77f91b2edaa36254d4ea4c65e6ef3d",23,23,0,23,23,0,1,2
"1795","0c7c200904393b326369a1a5ada400de",11,11,0,11,0,11,1,2
"1796","0c7c3f294e31ab0edd66d71946e2a11d",64,43,87,5.14942528735632,19,45,2,1
"1797","0c8195f26ea5c3b5516eab48977e0546",21,21,0,21,21,0,1,2
"1798","0c8236b474a70d0b3608ed76e65c8708",30,30,0,30,0,30,1,2
"1799","0c83a0355c0ef6a750eb1cd9e23e201f",104,79,63,11.5555555555556,64,40,3,3
"1800","0c84ce19fafeb7685f6dbcafa4f290ad",26,26,0,26,26,0,1,2
"1801","0c84df8cfb74b205706eb631fc0b7523",64,51,13,34.4615384615385,64,0,1,2
"1802","0c8b0b447138af1b3a328d078b2c667c",108,27,75,10.08,90,18,2,1
"1803","0c8b33ba74721ce884bfa26f1947cb0e",31,31,0,31,31,0,1,2
"1804","0c8fdf99b0251539b6ae07ae429b2aa7",121,87,46,18.4130434782609,121,0,3,3
"1805","0c926782d86a4e4335a78ff75c3e15aa",56,46,50,7.84,56,0,2,1
"1806","0c957b4a894ca57e781c5cef6ad61d89",70,55,18,27.2222222222222,33,37,1,1
"1807","0c9734d96513162d1a571782ea240c0e",98,53,78,8.7948717948718,98,0,2,3
"1808","0c9dfeb49db36bf47371d72adc30ffa1",33,33,0,33,33,0,1,2
"1809","0c9e47d0b1371a0a6ef55c73fd4acc07",54,42,26,14.5384615384615,29,25,2,1
"1810","0caadf65e27afe31a55e8a882ebe5cbd",134,88,49,19.1428571428571,134,0,3,3
"1811","0caccfd7c6792c11ba8f3b951ae5fc1e",29,26,6,33.8333333333333,29,0,1,2
"1812","0cae50d1411d972201618bc486d1296b",67,57,38,12.3421052631579,67,0,2,3
"1813","0cb6fddde02a5d10b17457ea104ffd4e",65,41,26,17.5,24,41,2,1
"1814","0cbc96d0ac6454998653b78ce8d3230d",117,84,46,17.804347826087,117,0,3,3
"1815","0cbd13b30f52ff29e83adb60630645c0",25,25,0,25,25,0,1,2
"1816","0cbe10a841736e76c2db5f308b94849c",7,7,0,7,7,0,1,2
"1817","0cc21fc36cf3878b677a9d2ea58f8f9f",15,13,31,3.38709677419355,10,5,2,1
"1818","0cc363ac466e8eec1c5271e478a04658",105,38,81,9.07407407407407,88,17,2,1
"1819","0cc5495363e69525ffb85c84b4fcba2c",41,34,13,22.0769230769231,41,0,1,1
"1820","0cca472641dd2dab5468f82012699095",14,14,0,14,14,0,1,2
"1821","0ccb2b0c01d712da16b4b695c396bbdc",33,26,71,3.25352112676056,33,0,2,1
"1822","0ccf6852ccd4a1aeaddab7981be1de58",130,88,47,19.3617021276596,130,0,3,3
"1823","0cd33c584492409b8d7eed36d4202481",8,8,0,8,0,8,1,2
"1824","0cd3eda33fbf4fc25994913c1fb7085b",30,30,0,30,30,0,1,2
"1825","0cd4c39052f99bdde9e4171a002a9c7e",157,109,50,21.98,107,50,3,3
"1826","0cd56fe66009ca54667b69d8c62926bc",29,24,46,4.41304347826087,11,18,2,1
"1827","0cda5c0b39cf7840e1689bfeba2eba71",101,72,54,13.0925925925926,101,0,3,3
"1828","0cdcf794dd7da594e3a6205e0b781046",114,86,66,12.0909090909091,62,52,3,3
"1829","0ce491e3a290f29db6b3f598997afbc4",97,58,63,10.7777777777778,97,0,2,3
"1830","0ce524007ce7d8742d6591d372e85c2f",36,33,31,8.12903225806452,36,0,2,1
"1831","0ce7b3fbacc3f1329202bb48770a950f",51,51,0,51,51,0,1,2
"1832","0ce853ea35e55161b49d8c25213eeb9f",33,33,0,33,33,0,1,2
"1833","0ce93cc9a2242b9a8571b4733fc8ed9b",110,71,62,12.4193548387097,110,0,3,3
"1834","0ce959333f8d51c4d873bbcdf5e6a89b",27,27,0,27,0,27,1,2
"1835","0ce9f5c33914160f4376ccfeb9ec7985",65,51,45,10.1111111111111,25,40,2,1
"1836","0cea617743eb34f10db723b98f8b51c5",57,48,49,8.14285714285714,57,0,2,1
"1837","0ceacb0dc66f840afe214763380ed6f6",61,49,26,16.4230769230769,61,0,2,1
"1838","0ceb5bd8c0d16f371dcfbdc0f105c24e",66,58,48,9.625,66,0,2,3
"1839","0ced898a821d90780826a15d14d08c35",50,50,0,50,0,50,1,2
"1840","0cee47455c9b6eef2ab89991b41e89f8",30,30,0,30,30,0,1,2
"1841","0cee4a137db1916e7e8577dd42a159bd",51,36,36,9.91666666666667,0,51,2,1
"1842","0cefa7b41e20c8d1c01503df3c55f652",20,20,0,20,20,0,1,2
"1843","0cf1ff00a976d1833293049e06aa7f05",66,45,61,7.57377049180328,54,12,2,1
"1844","0cf8796dba2f6597160cf2430fe77d33",175,96,84,14.5833333333333,153,22,3,3
"1845","0cf8987f829ec6dbded32e33c2d10735",89,62,80,7.7875,89,0,2,3
"1846","0cfa7e14eb33c7b98c1e42e6b9e537f7",11,11,0,11,0,11,1,2
"1847","0cfad74ecdb1df16c9a8ba5de23fee71",14,14,0,14,14,0,1,2
"1848","0cfc7ff7183375a9b89d05edecb91946",78,69,30,18.2,78,0,2,1
"1849","0cfdb34fda839a4aa9eed4e20bc821d0",183,102,75,17.08,183,0,3,3
"1850","0cfe56421e31014ff53601ca13f7bc8d",195,110,62,22.0161290322581,195,0,3,3
"1851","0d0413b72e77a3fae0febad16d1d0f73",22,22,0,22,22,0,1,2
"1852","0d079f12cd28e952856b939cb5120d89",64,58,26,17.2307692307692,64,0,2,1
"1853","0d08e8beb1fe560cf6f14577a75f47c6",1,1,0,1,1,0,1,2
"1854","0d0bafd56f2694c3503819774040b044",216,111,72,21,176,40,3,3
"1855","0d0e34ecad789c94c500d78d13fa058b",33,33,0,33,33,0,1,2
"1856","0d0e42b5c26806b03ec01ef83719987b",12,12,0,12,12,0,1,2
"1857","0d0f2088df019cf0e30d1fd5dbc4f811",1,1,0,1,0,1,1,2
"1858","0d1046e2d7cebe73fd6460bc68eb3d4c",89,55,56,11.125,89,0,2,3
"1859","0d108d0e2194c7d01f3bff2b0f695293",33,33,0,33,33,0,1,2
"1860","0d1244db8116f59ad7c7d0d8eda30e1c",200,112,70,20,200,0,3,3
"1861","0d1843d128c9d0598046744b8ce196bf",52,47,33,11.030303030303,52,0,2,1
"1862","0d1858918ea9ecb1a22b8639c769f8ca",13,13,0,13,13,0,1,2
"1863","0d18ce0cbadecf107bd7ed7095fbe34c",47,41,43,7.65116279069767,47,0,2,1
"1864","0d1dc2ba0475531f68995e2d5cd64aba",36,36,0,36,0,36,1,2
"1865","0d1e24fe229bbd5692063868026aa225",35,35,0,35,35,0,1,2
"1866","0d1ea06de4e68b41d26fb5f444341032",104,76,32,22.75,104,0,3,3
"1867","0d205cccb830678e8f21558c3c330db5",177,110,76,16.3026315789474,177,0,3,3
"1868","0d23e22cff80d465175ae89d20491ed3",216,122,73,20.7123287671233,216,0,3,3
"1869","0d2531ec1888e9b247140bf97b039c79",75,50,62,8.46774193548387,75,0,2,3
"1870","0d2557dcb18a1740c6b6b1cbf8e606b7",19,19,0,19,19,0,1,2
"1871","0d2aa7cdbe1f9d2775f994a9f2d0a2a5",1,1,0,1,1,0,1,2
"1872","0d2cf30ceacb20baca68a0b0806a3b4c",18,18,0,18,18,0,1,2
"1873","0d3053d412fa190d6a4bf47136fd97d9",30,21,70,3,30,0,2,1
"1874","0d30f367d05b45ffa22bc3cbe7f0279d",107,72,30,24.9666666666667,107,0,3,3
"1875","0d3181c661069069d68d5bd23af341c4",80,64,78,7.17948717948718,80,0,2,3
"1876","0d327953a6f11e8433988dbd16a7d7ef",31,31,0,31,31,0,1,2
"1877","0d3585bc9e36a38d5b93fd75f32897ec",6,6,0,6,6,0,1,2
"1878","0d36eeb3ceac2ba11c4779c435d4fdd3",161,95,68,16.5735294117647,161,0,3,3
"1879","0d399ae7e26d67f4a591638c67220f08",12,12,0,12,12,0,1,2
"1880","0d3a3e690beeb032988fdbe67a6a0ca0",82,73,39,14.7179487179487,82,0,2,3
"1881","0d3a682661ee60599ec44c8106a86777",209,123,56,26.125,209,0,3,3
"1882","0d3b591890941eb6030981aeeb20caca",90,69,26,24.2307692307692,90,0,2,3
"1883","0d3bd1b1808203a6d4eeb35312d7482a",71,62,75,6.62666666666667,71,0,2,3
"1884","0d3d758e4c568009466781b4f458a095",22,22,0,22,22,0,1,2
"1885","0d3e21b614f8d8511b12c6421c5c12c0",41,30,70,4.1,41,0,2,1
"1886","0d3e5c3071f10986cdeb2c3a0b2926d5",109,75,54,14.1296296296296,109,0,3,3
"1887","0d3f3d98707d43f1fbbac8d49ddebb08",48,22,58,5.79310344827586,48,0,2,1
"1888","0d40588d961f79984c37ac44ec49188d",72,62,29,17.3793103448276,72,0,2,1
"1889","0d4074a5ec2c00757ade0cf873750251",8,8,0,8,8,0,1,2
"1890","0d4605e50f2146ec539435ebfa92f0a9",29,28,79,2.56962025316456,10,19,2,1
"1891","0d46e553956481e0c643b748aac0c328",30,30,0,30,30,0,1,2
"1892","0d47deea819a12ccec77c8e0fcb42ed7",20,20,0,20,20,0,1,2
"1893","0d4838d07ddd96b04b73bec97d12226e",23,23,0,23,23,0,1,2
"1894","0d48d1d2a4085626b670db657284ed43",125,93,37,23.6486486486486,125,0,3,3
"1895","0d491ea1453c9623464e21437b9095c0",16,9,2,56,8,8,1,2
"1896","0d4b43e04b728e9aa68a5addfb644cd1",27,27,0,27,27,0,1,2
"1897","0d4d5f5914acd93e31b0c8115752946f",44,44,0,44,44,0,1,2
"1898","0d4d8a9bc468e7e3b88eb4177721f13d",12,12,0,12,12,0,1,2
"1899","0d4fb5a76939d3816a6752c3aa214c40",95,65,65,10.2307692307692,66,29,2,1
"1900","0d52ad5587360e2d0a21135a7e7c6306",28,28,64,3.0625,1,27,2,1
"1901","0d531a8ba8668d9b69d0ddfa7e9cca30",63,40,76,5.80263157894737,63,0,2,1
"1902","0d5788c5f17a538c726d849048576ac6",18,18,0,18,18,0,1,2
"1903","0d58655362ce1be258092e2b32ef60f6",85,72,51,11.6666666666667,85,0,2,3
"1904","0d5874234271acc0c9c9ee4f6c82c3bd",27,18,48,3.9375,27,0,2,1
"1905","0d597e60438a14318458f5946eb683cc",15,15,0,15,15,0,1,2
"1906","0d5c730ba8b052ac0fba1404ace85a4f",75,56,32,16.40625,75,0,2,1
"1907","0d654669ab00564b71c8bced45891540",18,18,0,18,18,0,1,2
"1908","0d67338b748be3704d1bdfcd68229931",77,58,65,8.29230769230769,77,0,2,3
"1909","0d680d3fbbf8ba6cada59e064ee7cb96",34,34,0,34,34,0,1,2
"1910","0d68ee898b8c4264e868e485e229d8c5",43,43,0,43,0,43,1,2
"1911","0d695df3f86649e4aba553cc7ad3369c",104,75,69,10.5507246376812,66,38,3,3
"1912","0d69b4289a2383a769f9aaec0b6550c3",29,29,0,29,29,0,1,2
"1913","0d6a10cdb836313a2906ca0d9e3f7c36",36,32,5,50.4,34,2,1,2
"1914","0d6adee0e738359d8afe7995d65dac77",97,78,69,9.84057971014493,97,0,3,3
"1915","0d6c6c7af8cf912aeff5b0026e070443",25,25,0,25,25,0,1,2
"1916","0d6c824a7248691f3ec9da41f629d881",169,103,88,13.4431818181818,169,0,3,3
"1917","0d70246311cd643127dba090f368a74f",23,23,0,23,23,0,1,2
"1918","0d714b537fef8294cd3d1504459915b6",75,38,76,6.90789473684211,75,0,2,1
"1919","0d725ac3dcb10083dac84e8f01d8238f",113,59,80,9.8875,92,21,3,1
"1920","0d77606fc36c6584fc6453e9a84a9461",36,29,47,5.36170212765957,36,0,2,1
"1921","0d793e271087bc7a5fa687488adeedb5",92,77,41,15.7073170731707,92,0,2,3
"1922","0d7bbdb188844ef4784f2a3ffa139e0f",25,25,0,25,25,0,1,2
"1923","0d7cff9a054e6302e38bd8c6e9d62397",22,22,0,22,22,0,1,2
"1924","0d7d44e9e46ad06a21936581b6688da5",53,43,27,13.7407407407407,53,0,2,1
"1925","0d7f4d517d6fb2cad4def0c6912e789f",42,31,65,4.52307692307692,42,0,2,1
"1926","0d7f7ea5d00b5b0758942e0f2109b064",214,106,85,17.6235294117647,195,19,3,3
"1927","0d81c404bdd7872d9b28b827b9c5d866",105,71,36,20.4166666666667,105,0,3,3
"1928","0d8248ff571e1a689bdf6bf33a86816d",197,109,66,20.8939393939394,197,0,3,3
"1929","0d82a96aed73bda527abeb15cdd9f7d2",126,105,48,18.375,126,0,3,3
"1930","0d85da23b6b8f9034626201756a2de5d",13,13,0,13,13,0,1,2
"1931","0d890fee565f425db4539add82104068",97,63,46,14.7608695652174,70,27,2,1
"1932","0d893a0f1eb8ac99caa726fec1ce5bc3",141,72,53,18.622641509434,109,32,3,3
"1933","0d89d2bd0939d19d83f00c9f15a48954",73,50,13,39.3076923076923,73,0,1,2
"1934","0d8fb6aaa950ac2d59aab187dea61438",88,63,52,11.8461538461538,88,0,2,3
"1935","0d905abdfa396688ae55223c68d602f3",165,127,67,17.2388059701493,137,28,3,3
"1936","0d91e80768d6c074c0b51078ed08db7e",52,52,0,52,52,0,1,2
"1937","0d91f99f86083cb49aa41fe9c7c51c7e",19,19,0,19,19,0,1,2
"1938","0d92b489f069a2030c4be270961ad80c",50,50,0,50,50,0,1,2
"1939","0d937cf02dd68960997d0280306d5e4b",36,24,57,4.42105263157895,32,4,2,1
"1940","0d9436375e58653f818ae90c9ae54c48",32,31,18,12.4444444444444,32,0,1,1
"1941","0d954bb17699f316344e312802c71445",51,39,65,5.49230769230769,51,0,2,1
"1942","0d95d171d6038549e8464cbcd8d551c4",79,55,70,7.9,79,0,2,3
"1943","0d9653a3f3465d8ff5d8c375b8c3890f",23,23,0,23,23,0,1,2
"1944","0d9694a942f1ac591fd6e8e5fec85fcb",69,54,50,9.66,33,36,2,1
"1945","0d97a72a2d90ff44ac3e3e13b7bdf048",30,30,0,30,30,0,1,2
"1946","0d9a8ce6ba2116d6cd324a220a816b8b",28,28,0,28,28,0,1,2
"1947","0d9c8339a071f6723924a8707085a339",34,28,62,3.83870967741935,34,0,2,1
"1948","0d9ddc3f6385db17443454011a43a7ff",46,35,68,4.73529411764706,21,25,2,1
"1949","0d9e67e323c81dc700f7bba2cd1fb1de",59,46,75,5.50666666666667,59,0,2,1
"1950","0da05b531930fe94b031c3ba2bd97c7b",37,37,0,37,0,37,1,2
"1951","0da51eae459c36300a6532a3d84b224f",187,81,68,19.25,141,46,3,3
"1952","0da7ad9d50561d93b66beb93ea1804b1",56,56,0,56,56,0,1,2
"1953","0da7b236adecf1d258850396fe48f1b6",33,33,0,33,33,0,1,2
"1954","0dac1b7b6748f328eb3bccbc2dce6c02",172,86,69,17.4492753623188,133,39,3,3
"1955","0db42f55edd9051544475e910932d6fd",59,43,61,6.77049180327869,34,25,2,1
"1956","0db50a338aaa63eddce065393035ee5b",209,111,64,22.859375,209,0,3,3
"1957","0db7b6d080d98b66fa75383e626418fb",40,33,60,4.66666666666667,40,0,2,1
"1958","0db7cad4bc65b46a26b9e02a33608a62",37,37,0,37,37,0,1,2
"1959","0db8387a223e1e4d2e70cbd5462c3a25",74,63,67,7.73134328358209,41,33,2,1
"1960","0db89bfdcb73b645a1f2fb40af8ab62e",94,61,76,8.6578947368421,59,35,2,3
"1961","0db9b587cc577b442c5a2175f00dea86",14,14,0,14,0,14,1,2
"1962","0dbe30f17403c4d5c695d29b20c615d3",42,42,0,42,0,42,1,2
"1963","0dc2074beedf2324f69667803aa36fe3",163,120,28,40.75,163,0,3,3
"1964","0dc23e356a1446927015494b4b89c097",36,36,0,36,36,0,1,2
"1965","0dc2650b485bc325b8367a27556c3a99",83,64,33,17.6060606060606,41,42,2,3
"1966","0dc3873c4e3bae83ce11514ed9d39be1",42,35,21,14,42,0,1,1
"1967","0dc54bbc1814d4df096f93d6ead4f3e0",96,79,30,22.4,52,44,2,3
"1968","0dc67bf7870fcea680257fd217ab2d42",40,40,0,40,40,0,1,2
"1969","0dc9803510d054051862dae3cf75779a",21,21,0,21,21,0,1,2
"1970","0dca31025438b30839ab1c84aa18e6a0",39,39,0,39,39,0,1,2
"1971","0dceac2e9e315e027a9e23abbac4c692",53,47,43,8.62790697674419,53,0,2,1
"1972","0dd0dfddec25ea39813de28ae2687d57",14,14,0,14,14,0,1,2
"1973","0dd0f4099ed8d0d2207494edd9d69d1e",114,79,70,11.4,114,0,3,3
"1974","0dd1e66433ff6e2152e90c31a392dda4",153,67,76,14.0921052631579,153,0,3,3
"1975","0dd42ab63e4f67461704ae141234ca62",14,14,0,14,14,0,1,2
"1976","0dd4a4a082ef382fb415c0a25e238f14",22,14,89,1.73033707865169,22,0,2,1
"1977","0dd5f6db354337027bf4dae8b9804c43",86,42,70,8.6,86,0,2,3
"1978","0ddaab4b792bb116a3758ceb1b781fde",38,32,40,6.65,38,0,2,1
"1979","0ddba9437a77bd7584c3539f7bc23f0a",219,74,80,19.1625,188,31,3,3
"1980","0ddbb75ec2fed177f034c50c0feab011",59,44,49,8.42857142857143,59,0,2,1
"1981","0ddcb384d8c15ebb9c7a0269c3743ba7",15,12,65,1.61538461538462,15,0,2,1
"1982","0de043a6319c9f20bc0f4b4c3891e68f",47,47,0,47,47,0,1,2
"1983","0de2f180939146422a1dfc4b44c11746",21,21,0,21,21,0,1,2
"1984","0de473fd87a4c4c4d075333cae8fdd96",19,19,0,19,19,0,1,2
"1985","0de4ee2bf7953dc9fbab47ca23019789",6,4,34,1.23529411764706,6,0,2,1
"1986","0de70c3702470510d0b20bc8ee7a6fd9",96,45,61,11.016393442623,63,33,2,1
"1987","0de9f6d9710322dd4f8ebf6cecb37521",13,13,0,13,13,0,1,2
"1988","0deb7fe7bafd6d94707dd9943f45858e",23,13,64,2.515625,18,5,2,1
"1989","0decaec1e74e3769036e966f14f17d59",46,41,12,26.8333333333333,46,0,1,1
"1990","0decd1018f4167ae9f8781846bd3f084",100,62,61,11.4754098360656,76,24,2,1
"1991","0dee158e59de5d52f63f92ded973abee",21,21,0,21,21,0,1,2
"1992","0deea0d089327f55c5fb5ce689cea9a0",6,6,0,6,6,0,1,2
"1993","0def1dd7785130cb69fed1416bc7dc29",84,63,56,10.5,71,13,2,1
"1994","0df0f3f474863b5199822e9188c176d4",42,37,58,5.06896551724138,42,0,2,1
"1995","0df29bf5893f9c1ac5716284e0cfa98d",77,62,36,14.9722222222222,33,44,2,1
"1996","0df2b57612442d509995025b0d2937a2",155,103,53,20.4716981132075,155,0,3,3
"1997","0df42559dfb77db3176d745de81b1b1a",180,97,71,17.7464788732394,158,22,3,3
"1998","0df543193cad1b918bb6817418f84eb0",29,29,0,29,29,0,1,2
"1999","0df5d8caf770c93e656a9ab5e36d34a7",68,51,33,14.4242424242424,68,0,2,1
"2000","0df81368be5792305b3f4b304a507177",36,36,0,36,36,0,1,2
"2001","0df9face69551e11cdff51c118813bdf",22,19,21,7.33333333333333,22,0,1,1
"2002","0dfa6018b38f5e29d60d2a62988b365f",209,105,82,17.8414634146341,160,49,3,3
"2003","0dfb0aafd7aeaaa5fb38b2f318015dc3",133,70,61,15.2622950819672,88,45,3,3
"2004","0dfb6e4ff901d22be9a34a63900056c1",40,27,62,4.51612903225806,40,0,2,1
"2005","0dfd11dd361c4b10f94f3f9f9227ad98",104,63,63,11.5555555555556,104,0,2,3
"2006","0dfdbfbe4891bd91d6b3bc13d80b3837",10,10,0,10,10,0,1,2
"2007","0dfef9f10f3f2096112c615483d94195",7,7,0,7,7,0,1,2
"2008","0dff2029223a4a7f7d11ca471b0ad6a5",81,53,50,11.34,65,16,2,1
"2009","0e018702bf81633400db99fb7ee53f18",72,53,79,6.37974683544304,72,0,2,3
"2010","0e02b8b0738643027723b78e4924ec9d",23,23,0,23,23,0,1,2
"2011","0e03cfdbdb75e62b113e7d748887b75e",14,14,0,14,14,0,1,2
"2012","0e049dc11b80379193e9f5a496db0879",201,101,81,17.3703703703704,201,0,3,3
"2013","0e04ba3ca4b174519ca2e4eb40dd8c06",15,14,5,21,1,14,1,2
"2014","0e0580aa6bea61ddc9f75adaf8d26a96",180,110,66,19.0909090909091,180,0,3,3
"2015","0e0633128dea4e8f9301ce61c40b5273",173,88,56,21.625,173,0,3,3
"2016","0e06a809b721c69326745300e78ce2c8",23,23,0,23,23,0,1,2
"2017","0e0770bd0f685ead30b25faa2fecfb0e",24,24,0,24,24,0,1,2
"2018","0e0966c8b36b267d6e3c91dc83f7f4f5",15,15,0,15,15,0,1,2
"2019","0e0991424aa00edca328f99740af5f95",53,44,36,10.3055555555556,53,0,2,1
"2020","0e0a4ac39904ea66bf7b9f815f67de82",4,3,42,0.666666666666667,4,0,2,1
"2021","0e0ccbdc0226eb452396d4478f421d78",132,103,37,24.972972972973,95,37,3,3
"2022","0e0eac6b0dadf1c5e0b69261044d5693",28,28,0,28,28,0,1,2
"2023","0e108bcb471eb1dfe0640590450d3928",64,45,70,6.4,64,0,2,1
"2024","0e13148abaf09d53075d46a0ad26f837",117,94,25,32.76,117,0,3,3
"2025","0e15bb1264e395f67bd05f354ce1574b",32,32,0,32,32,0,1,2
"2026","0e19218628b139c6ac162a52cd57c519",19,19,0,19,0,19,1,2
"2027","0e1926393035883374aee0bc4281d67a",55,55,0,55,0,55,1,2
"2028","0e1adb05d947bf5ee444ecff4049918e",124,60,78,11.1282051282051,124,0,3,3
"2029","0e1bc66620fb6ff2bac4a7e5fb96c8d2",212,112,51,29.0980392156863,177,35,3,3
"2030","0e1c90abe1a17eeffff53b22ab17af1d",92,56,71,9.07042253521127,92,0,2,3
"2031","0e1d82cccd07d5f044111b3a42784c08",48,48,0,48,48,0,1,2
"2032","0e1dc6a718759b1241bf50e041fe67be",45,37,64,4.921875,45,0,2,1
"2033","0e1dfb5177f3b17ae334ed6957c3f0f2",72,66,69,7.30434782608696,72,0,2,3
"2034","0e24de51341362b84717e8b6fc4847eb",97,72,65,10.4461538461538,97,0,2,3
"2035","0e25efc37f82dc694bacd06fe9f76f7c",19,13,64,2.078125,19,0,2,1
"2036","0e262a2d4f928cb1c76280084b758d12",22,22,0,22,22,0,1,2
"2037","0e277b6f25c9511910613c892e1ab0b7",27,27,0,27,27,0,1,2
"2038","0e2971ab1bb7cd8e8ba2566e82bec625",29,29,0,29,29,0,1,2
"2039","0e2a4f3e021011c459cc660399127513",94,65,32,20.5625,94,0,2,3
"2040","0e2faab4f9a36aa96ddcd7c65a063e6f",19,19,0,19,19,0,1,2
"2041","0e311fcb5a5d4e9408d3e626f101a074",8,8,0,8,0,8,1,2
"2042","0e34962b6abb7c227ec1f00116bce69d",115,77,83,9.69879518072289,115,0,3,3
"2043","0e375b955cba048f33991fe8923bacea",112,86,57,13.7543859649123,75,37,3,3
"2044","0e3909f7d289546cffd28c684434a4a1",53,53,0,53,53,0,1,2
"2045","0e41ba39cee9ca9e1a14432b393226ce",69,61,15,32.2,69,0,1,2
"2046","0e434f0d3629c28a12faf520fca4a18c",137,86,67,14.3134328358209,92,45,3,3
"2047","0e4500e30cd4a561f21745dff9fae4e9",163,87,76,15.0131578947368,147,16,3,3
"2048","0e462523d2b1b25335d2efa2ae0b6dd1",37,37,0,37,37,0,1,2
"2049","0e4a608a37d42869d2de8c81b166cd38",28,17,88,2.22727272727273,22,6,2,1
"2050","0e4d394c1d2cad16c9b93e7514e086da",71,46,55,9.03636363636364,71,0,2,3
"2051","0e4e82fc98258e46673ce85c7d83601e",162,107,73,15.5342465753425,114,48,3,3
"2052","0e501fcaaedec18209073881b12688da",16,9,36,3.11111111111111,16,0,2,1
"2053","0e50e1ceaf96e554cb215cbd7532abde",51,43,39,9.15384615384616,25,26,2,1
"2054","0e52ecc9772dfbb349459d5084011f70",32,32,0,32,32,0,1,2
"2055","0e590e5cfdb4df8b6e73cb10c179501b",11,11,0,11,0,11,1,2
"2056","0e5b1dccad9633fde847a6d1ce985db5",32,32,0,32,32,0,1,2
"2057","0e5ba87d284d3dadb1d54773d594a877",146,66,62,16.4838709677419,146,0,3,3
"2058","0e5d40da8421e48c8ea9e6afe37208bf",23,23,0,23,23,0,1,2
"2059","0e5d60de8a2543bba8f68ea348bfc77e",102,74,13,54.9230769230769,102,0,1,2
"2060","0e5ffce9a347c699ddc4c1028cd9c0ff",67,62,69,6.79710144927536,67,0,2,3
"2061","0e614dd70acc75006bfa33ada66f2f53",29,29,0,29,29,0,1,2
"2062","0e62055c0df417e53f4959afe4861ce9",24,24,0,24,24,0,1,2
"2063","0e6345cdbde0e30bf1531f3ac77c17b1",42,38,64,4.59375,42,0,2,1
"2064","0e64140b6a88cffb8dc83c75a93f532c",27,19,42,4.5,27,0,2,1
"2065","0e6959750e4cef720644ba0541d6d99d",31,31,0,31,0,31,1,2
"2066","0e69f854daebcc1365accc57dd03ea45",55,49,14,27.5,0,55,1,1
"2067","0e69fac646b0e35c075b789ea7e456bb",17,17,0,17,0,17,1,2
"2068","0e6a2b28e1652408cdae3cd6500e9ce6",157,82,76,14.4605263157895,128,29,3,3
"2069","0e6a40353e867e7b34a1d041d65451d2",28,28,0,28,0,28,1,2
"2070","0e6c26ea229f21de53d5a3eb0013fb67",22,22,0,22,22,0,1,2
"2071","0e6d5e9bf55a83854d8bfdf153ab3729",59,53,85,4.85882352941177,59,0,2,3
"2072","0e6e200d63df289ae8d3c42f2e90d758",101,82,34,20.7941176470588,101,0,3,3
"2073","0e6ec85302c20256cdc5a875777c04df",51,36,67,5.32835820895522,29,22,2,1
"2074","0e705d2fa8b3465a70963ffc5ecf33ac",19,19,0,19,19,0,1,2
"2075","0e74f3d5016e4dc716a92ef98241ea0e",29,29,0,29,29,0,1,2
"2076","0e7759546a0f4ecc0b9a3cf339c7cefe",102,82,13,54.9230769230769,102,0,3,2
"2077","0e797e81139896273196019042141c9d",57,49,22,18.1363636363636,57,0,2,1
"2078","0e7e5b5d09f2cb24ca0dab0a77340d31",33,32,10,23.1,27,6,1,2
"2079","0e810db2b80e868ea702d171ed96e0f5",20,17,70,2,20,0,2,1
"2080","0e8149a37a2dacf8aca4a37abc143a8b",40,40,0,40,0,40,1,2
"2081","0e81b572b0a6e4547b412b45d60dceb7",201,88,49,28.7142857142857,201,0,3,3
"2082","0e82060c4939cffce68cd456cff10062",99,59,29,23.8965517241379,99,0,2,3
"2083","0e88ed86e2f1ed62afb6d0948241a160",41,22,66,4.34848484848485,41,0,2,1
"2084","0e8904daaceed26db2f83966786b1892",61,34,80,5.3375,46,15,2,1
"2085","0e89ccf48c1e1930187b9eb6de48ae4b",94,67,58,11.3448275862069,53,41,2,3
"2086","0e8c00b3c4c9711f03caef32d329c071",211,144,84,17.5833333333333,211,0,3,3
"2087","0e8d3d98a311288f0bd23787d725c2ec",59,53,12,34.4166666666667,59,0,1,2
"2088","0e8ebf580f03135bbab6abc093f84829",13,13,0,13,13,0,1,2
"2089","0e8fb0c60b69a26806d1f1c2e978e242",45,28,61,5.16393442622951,11,34,2,1
"2090","0e91851835ae1de6dff61245e7fbe60c",14,14,0,14,14,0,1,2
"2091","0e94817ae2b1b451563d3b9f42e21e37",32,31,4,56,32,0,1,2
"2092","0e989973655ffc697a10cc845a4bd798",64,55,70,6.4,64,0,2,3
"2093","0e99e4f33655341a5541121cff8804f5",28,28,0,28,28,0,1,2
"2094","0e9c94753369137226693a3aa35c78cf",73,53,84,6.08333333333333,55,18,2,1
"2095","0e9fc0fb33703a7390b7e46640d8ba3d",95,79,37,17.972972972973,46,49,2,3
"2096","0ea708d3829661b47336b606b3d6fcab",10,10,0,10,10,0,1,2
"2097","0ea76133990f7541f89e24c2551e1ad6",92,77,45,14.3111111111111,52,40,2,3
"2098","0ea7ea792b9d340ffd67a4268066ebe2",28,28,0,28,28,0,1,2
"2099","0ea89222a42e55976e3577fcbb95a292",100,83,43,16.2790697674419,78,22,3,1
"2100","0ea9b3d9036c6ed6d9df3853eb1f4c9f",27,27,0,27,27,0,1,2
"2101","0eabbe2acb17881c86221abe03c03a62",33,33,0,33,33,0,1,2
"2102","0eae8efe2c95992d4992c60cb17650cd",12,12,0,12,12,0,1,2
"2103","0eaf211d9314f2170db85cf4973594ef",106,60,68,10.9117647058824,84,22,2,1
"2104","0eaf9e29507c6aa9044d246f1411e9d9",27,27,0,27,27,0,1,2
"2105","0eb5c62c3779221240eb15d6b82e6375",167,116,59,19.8135593220339,167,0,3,3
"2106","0eb647250fdb7c566bcac21fb982b6a3",149,75,82,12.719512195122,149,0,3,3
"2107","0eb64a78ae7032380a0200686e1e3f3d",119,85,34,24.5,119,0,3,3
"2108","0ebab71c1030e64d8bd729e2e407573a",32,32,0,32,32,0,1,2
"2109","0ebd353c63a076ed58722db68279fbad",52,15,88,4.13636363636364,52,0,2,1
"2110","0ebe40355dd042aff6ba229ad471ecac",69,51,49,9.85714285714286,69,0,2,3
"2111","0ebeb630073d06b93782ef0d6959db98",141,120,70,14.1,141,0,3,3
"2112","0ec1d606c6d5f6d228cbfae116c760ef",37,37,0,37,37,0,1,2
"2113","0ec27a348200461ee54182cde485df5c",45,45,0,45,45,0,1,2
"2114","0ec3087da96d91051bc84714cb29cd9a",99,87,38,18.2368421052632,74,25,3,1
"2115","0ec3ebeefc828e37ba854e99afbcd430",32,32,0,32,32,0,1,2
"2116","0ec7f3f294d52ba37540a85d05b63940",28,27,6,32.6666666666667,28,0,1,2
"2117","0ec8c2820d096a35b68dcf48379be2cc",47,39,44,7.47727272727273,47,0,2,1
"2118","0ec8ceb5812b9efe8ff096618c501ccd",49,49,0,49,49,0,1,2
"2119","0ec9094103b652c5ba73389ff20bf2db",25,25,0,25,25,0,1,2
"2120","0ec9c1d8fa09dc539d2c56d28e3fb12e",50,42,49,7.14285714285714,50,0,2,1
"2121","0ecc9b4a54dc0ec385e4a32d984e08a0",34,34,0,34,34,0,1,2
"2122","0ece13fe207601ae8fbea90499f41095",39,35,15,18.2,18,21,1,1
"2123","0ecf94029bdc0bc42adba80474ff49f9",62,51,38,11.4210526315789,62,0,2,3
"2124","0ed2609ab0d4536254cc4d8f271fb320",62,50,49,8.85714285714286,62,0,2,3
"2125","0ed3512a54b359f429e4fffc013fb004",45,35,24,13.125,45,0,2,1
"2126","0ed4bf57d86017a1620883a0800a3c38",91,76,49,13,91,0,2,3
"2127","0ed6da5b3eddfa5290ed85e8a2d558ce",41,39,80,3.5875,31,10,2,1
"2128","0edcd103528029f406206c0b8c8a1a79",98,64,39,17.5897435897436,98,0,2,3
"2129","0edf80f75a60dbfac8124642a346bc4f",203,95,77,18.4545454545455,203,0,3,3
"2130","0edfb60a04766e1421414c27a4ebf09f",26,17,45,4.04444444444444,26,0,2,1
"2131","0edfb8b67749fc2c7aa29a37f7811434",132,93,71,13.0140845070423,132,0,3,3
"2132","0edff4c915b7b4f24d7bbaad6e92ba0a",172,135,74,16.2702702702703,172,0,3,3
"2133","0ee0e2ffa1f6871aaa53c9edbcdac60b",19,19,0,19,19,0,1,2
"2134","0ee1ace30c4b0362560c6ed90fbfb082",102,86,61,11.7049180327869,66,36,3,3
"2135","0ee497da8713390969548a314d459e95",109,92,53,14.3962264150943,109,0,3,3
"2136","0ee5424766d7dacf3a0b509345ffbaaf",21,21,0,21,21,0,1,2
"2137","0ee83203934caec1e839b2d9c471f694",23,23,0,23,23,0,1,2
"2138","0ee8ea86a7439ee5666d8848798a90f3",10,10,0,10,10,0,1,2
"2139","0eeae06da39b967c4bd8f9d6587f7b2d",194,108,60,22.6333333333333,194,0,3,3
"2140","0eeba85295b809d09a26ed4cfbe6ba15",22,22,0,22,0,22,1,2
"2141","0eed0c375bb13097d9cc0f9c6b2554c0",21,21,0,21,21,0,1,2
"2142","0eed509eecf6373883883e392793ae85",74,43,47,11.0212765957447,53,21,2,1
"2143","0eeeebda46546272da0b822de0b5dd9d",22,22,0,22,22,0,1,2
"2144","0ef084c80c4800f5f2f093fc4d2b45f4",80,58,13,43.0769230769231,37,43,1,3
"2145","0ef6dc79f2fdba21e3eeedeb4d8537fd",7,7,0,7,7,0,1,2
"2146","0ef999bea5094c46f0a6a2ed7e2ef8e7",29,29,0,29,29,0,1,2
"2147","0efb2ae86cde42cc9159d35e228e4678",109,80,66,11.5606060606061,77,32,3,3
"2148","0efdcdd5228697c622a2c7f8c58ac31d",60,49,37,11.3513513513514,60,0,2,1
"2149","0efe6647d4a9ff2c5b07c683ed73465a",16,16,0,16,0,16,1,2
"2150","0f03419cc99e948002b097e7a2dc7a96",124,76,59,14.7118644067797,124,0,3,3
"2151","0f03fd53014e3431ddfeb8ef223d5f05",79,60,32,17.28125,44,35,2,1
"2152","0f04e6a564d484853ab342e6e92c8b2f",20,20,0,20,20,0,1,2
"2153","0f05d891678237e0289a04e579df54c2",95,63,76,8.75,95,0,2,3
"2154","0f09e838b861772b01880428228dc756",39,39,0,39,39,0,1,2
"2155","0f0a5453c44ccddafdac64b6e9fdb9d5",27,25,25,7.56,10,17,2,1
"2156","0f0b76888f058244e726d0224f01ec8b",5,5,0,5,5,0,1,2
"2157","0f0c6249526db99b0ef1b4cdd1f8002c",50,50,0,50,50,0,1,2
"2158","0f0dc209ef622ebdad97ebb6b9f2f1d5",205,149,77,18.6363636363636,205,0,3,3
"2159","0f0f0cb94584cb8dd1fa9fc8b6d2a2d5",51,51,0,51,51,0,1,2
"2160","0f1017d69bbae9974589513c1c49da72",163,112,67,17.0298507462687,163,0,3,3
"2161","0f116642d437a97592569d86a664d9cf",75,55,30,17.5,30,45,2,1
"2162","0f121f37634fa9451f6d5cf8de1d7e88",38,38,0,38,38,0,1,2
"2163","0f131c28f46c628cf82dd7f8e0a6f411",181,91,28,45.25,181,0,3,3
"2164","0f1a339a49615fd27cc7b7e3b5ae82d0",81,49,30,18.9,44,37,2,1
"2165","0f1a69baff9a5f7dab7470ee61a4c621",6,6,0,6,6,0,1,2
"2166","0f1bcb76422cf5d8a7e98a52d29aed0c",19,19,0,19,0,19,1,2
"2167","0f1c17f7e577fe8b0a100f63caea4d66",39,39,0,39,39,0,1,2
"2168","0f1c367714fc049f75576165fb880990",61,54,14,30.5,61,0,1,2
"2169","0f1d95528ac180e4afcecb7bf7c0a03d",50,50,0,50,50,0,1,2
"2170","0f1f10f88e9a62c7148f5fb5bbdfe7da",165,101,45,25.6666666666667,165,0,3,3
"2171","0f216c6b998a9ac0a8b2dfa8fc8a35b4",47,47,0,47,0,47,1,2
"2172","0f227f689c0de53f6e815c2744ab7079",75,62,28,18.75,75,0,2,1
"2173","0f22b9e62256040c8b1fbee18e9a1ac2",171,92,76,15.75,171,0,3,3
"2174","0f245174f6153da2b33e9989b97932ce",22,22,0,22,22,0,1,2
"2175","0f24c828b7533b8249aec5aa608b7dfa",116,63,68,11.9411764705882,116,0,3,3
"2176","0f251568febb02f9961c62279b53dd1e",71,57,26,19.1153846153846,34,37,2,1
"2177","0f25ff1f452d5601fa939a506a7aed55",13,13,0,13,13,0,1,2
"2178","0f281c614d5da38b069eb613ac6cc2f1",21,21,0,21,21,0,1,2
"2179","0f2caa938dc8322afbed07862bfe043e",54,47,30,12.6,54,0,2,1
"2180","0f2d5100733f7cfeec94c525a13066ae",114,111,45,17.7333333333333,114,0,3,3
"2181","0f2dc044aa0afe4f18277547ce02a35e",55,55,0,55,55,0,1,2
"2182","0f2e02599df6d7ff870f0a78f48ce9ed",88,77,59,10.4406779661017,88,0,2,3
"2183","0f2f8dedbb65d5f57581b657767305fb",27,27,0,27,27,0,1,2
"2184","0f2fc227c044d2ad0d357d26f663a15e",69,52,35,13.8,69,0,2,1
"2185","0f311809c12890f67ded04dd3396b838",121,99,61,13.8852459016393,121,0,3,3
"2186","0f31e4f5cb20264d49b5887b9ebbfcd7",50,50,0,50,50,0,1,2
"2187","0f3355a60e352c9a09c5514835baca40",43,43,0,43,43,0,1,2
"2188","0f35c3135980ee81bdd3b2689b550683",88,73,70,8.8,88,0,2,3
"2189","0f367b7eb8538b0fca46ba20049fd82a",49,49,0,49,49,0,1,2
"2190","0f36c6b6b4616b2a15e7bbb9c1e23679",22,22,0,22,22,0,1,2
"2191","0f371d448625ceee42dcee88e78ff652",19,19,0,19,19,0,1,2
"2192","0f38340b0d889ff8dbc36fc0b5764a2a",174,103,35,34.8,148,26,3,3
"2193","0f389ad98ae4be79ae5da50c809cbfce",54,45,32,11.8125,54,0,2,1
"2194","0f395d90cc4c80ab86dd0be43dbee64f",28,19,39,5.02564102564103,28,0,2,1
"2195","0f3c7fc08c6bde96cd719f16867a7fed",112,55,80,9.8,112,0,3,3
"2196","0f3cec6187a4fe9c5c08fd62f298c078",75,65,75,7,75,0,2,3
"2197","0f3e64db4696df26d722ed960ddbccc2",109,74,70,10.9,109,0,3,3
"2198","0f459aad9ad208920cf33725c5081d16",30,30,0,30,30,0,1,2
"2199","0f4b1cac30ded20bd29db1a450e875ab",14,14,0,14,14,0,1,2
"2200","0f4be644ac64d8f8af1615a2e3dc2aae",14,14,0,14,0,14,1,2
"2201","0f4c54288b7b6e2f43922cc809e9f10e",20,19,38,3.68421052631579,20,0,2,1
"2202","0f4f645c79ab956dd9b415dc4f87cc43",177,94,80,15.4875,160,17,3,3
"2203","0f53e4db4e1d935220ce0e073679da13",97,85,49,13.8571428571429,97,0,3,3
"2204","0f591c75dcab3a80ba374bd6ae2b3383",29,29,0,29,0,29,1,2
"2205","0f5a16c63c7f0e1722371d4e82d36be8",84,63,37,15.8918918918919,57,27,2,1
"2206","0f6050fb886066b80c79d9e548d9ebd9",123,75,62,13.8870967741935,123,0,3,3
"2207","0f61b3be0dc38455defb28b440b92e15",49,49,0,49,0,49,1,2
"2208","0f63d967485a8d363e0b39e4ae7252a0",26,26,0,26,26,0,1,2
"2209","0f6423bf59975f17d45c2c3c879881a3",42,38,28,10.5,42,0,2,1
"2210","0f65717b6f25d387e771e991fb1525e5",141,98,32,30.84375,86,55,3,3
"2211","0f664db9d166b330d789f00fcb44fb45",61,60,49,8.71428571428571,61,0,2,3
"2212","0f68852906f82ee9a4938bf7b562f2ea",22,22,0,22,22,0,1,2
"2213","0f6a967245493fbe4b7c0071b3d05a15",15,15,0,15,15,0,1,2
"2214","0f6b82a71f2192a6db191d0a0914e7ed",104,83,47,15.4893617021277,104,0,3,3
"2215","0f6fb21de310a050e1bc3195f7acd88c",99,71,28,24.75,99,0,3,3
"2216","0f6fd82d657d216f6206f367ecfa4574",171,115,64,18.703125,122,49,3,3
"2217","0f717aa91a53ccebb2f5ed9c43d0d48a",207,121,85,17.0470588235294,157,50,3,3
"2218","0f75cc13e9c0704c985c348079256d91",9,9,0,9,9,0,1,2
"2219","0f79c54d3e96c6a69045f3b65c2df180",15,15,0,15,15,0,1,2
"2220","0f7a0736669953f920e9e87ce6279487",261,130,63,29,217,44,3,3
"2221","0f7a58c133fc7797ccb7bac7c9910397",33,33,0,33,33,0,1,2
"2222","0f7c6382a05d3691c7b9f95992f315a4",12,12,0,12,12,0,1,2
"2223","0f7ca97a17c37dc0df59430ef62c074e",28,20,67,2.92537313432836,17,11,2,1
"2224","0f7e1071af3542deab4393cf1e29de2f",95,72,35,19,72,23,2,1
"2225","0f8306257189ed013725d5ce6d8c1e45",34,31,40,5.95,21,13,2,1
"2226","0f8311d836aef89db6277086660ad66b",45,45,0,45,45,0,1,2
"2227","0f833a66bd9a3385f8d443d94926974c",46,46,0,46,46,0,1,2
"2228","0f8342d6187ed515fc8337041d3e8480",43,43,0,43,43,0,1,2
"2229","0f837f6b5cafb232a20a2dec453e64ac",103,67,68,10.6029411764706,73,30,2,1
"2230","0f84126fc74e0e56e16714def9669395",23,23,0,23,23,0,1,2
"2231","0f86adcd1f0c38381cbf7565809e159f",104,51,54,13.4814814814815,104,0,2,3
"2232","0f89bd0f1cdefb02144cbf4b27a14147",32,32,0,32,0,32,1,2
"2233","0f8a2208006403479c0b6ced8119ae95",49,37,22,15.5909090909091,49,0,2,1
"2234","0f8d1988d339c510fe3a1b299b5d46b4",43,35,57,5.28070175438596,43,0,2,1
"2235","0f907faeb6d53a7f3b25f9deebab8b3f",30,30,0,30,30,0,1,2
"2236","0f91776537143dccebef4f00350216dc",118,83,63,13.1111111111111,118,0,3,3
"2237","0f93fb4442aa6bbb9d34156bf7d3f026",47,29,62,5.30645161290323,47,0,2,1
"2238","0f94b9695e681f5b3bbb8ce1540aff99",18,18,0,18,18,0,1,2
"2239","0f954d24e76b451f952fa31d01c88ea5",40,40,0,40,40,0,1,2
"2240","0f9630280980881a77ab7749304d917b",103,66,64,11.265625,63,40,2,3
"2241","0f96ba034b749b1727322e1b6048b52c",35,30,30,8.16666666666667,13,22,2,1
"2242","0f99d785c237dc806cebf343229c9400",74,55,13,39.8461538461538,74,0,1,2
"2243","0f99d90765c7d675ac1f5ecd81ebb1fd",30,30,0,30,0,30,1,2
"2244","0f9ac57b81646b85c2be2264bf9ae3e9",51,38,25,14.28,51,0,2,1
"2245","0f9b27f5acf1b61bf6e94f5b691f9128",37,28,38,6.81578947368421,37,0,2,1
"2246","0f9bac04261ac3af7f97445b87016e72",74,58,45,11.5111111111111,74,0,2,3
"2247","0f9d1dbdad31da2bdf22fafbfb2dae29",41,41,0,41,41,0,1,2
"2248","0f9e666afc5bf2d87fd7aec50027cdb1",93,62,64,10.171875,93,0,2,3
"2249","0f9f712efbe33a1cb6d347f8d866214a",58,56,14,29,58,0,1,2
"2250","0fa9d51b7364d764777c6ab5af0eaab8",37,28,15,17.2666666666667,37,0,1,1
"2251","0faa76ecccebaa3f282f35a2b169eda2",58,39,48,8.45833333333333,58,0,2,1
"2252","0fab650cc4d2aab1b144970385433ea6",50,43,45,7.77777777777778,50,0,2,1
"2253","0fac3213b899dd6d8846cc3b355da1e9",10,10,0,10,10,0,1,2
"2254","0fac6dde18e1c71330d8214556f0f372",18,18,0,18,18,0,1,2
"2255","0faee95084a4756566408ad6d6ffd13b",15,15,0,15,15,0,1,2
"2256","0fb3bb7246deabfe4fd9f4075a6212af",28,20,37,5.2972972972973,9,19,2,1
"2257","0fb5dfbf376b3a5b936f02380af2ff03",104,70,46,15.8260869565217,68,36,2,3
"2258","0fb6408874e9b7a34ea9f949217bb065",137,105,67,14.3134328358209,137,0,3,3
"2259","0fb70db6c64ea008d16dde193b8c0361",7,7,0,7,7,0,1,2
"2260","0fb9af4d4ab7af4dd0d71d40b6ca0034",24,24,0,24,0,24,1,2
"2261","0fbbfe51edd947669f682c6a374e07cd",26,26,0,26,26,0,1,2
"2262","0fbd89058fd2dced2882d9645458cb9e",198,112,57,24.3157894736842,143,55,3,3
"2263","0fbdbcd34879e672ac05fa6dd38dcb08",213,121,76,19.6184210526316,213,0,3,3
"2264","0fc05acdf64aec14f9fa95584a55466c",54,43,38,9.94736842105263,54,0,2,1
"2265","0fc07116a02b05b7b804bd607d6cea4a",10,10,0,10,0,10,1,2
"2266","0fc0cd645ebbf78a183ae20b5d7b8e34",17,17,0,17,17,0,1,2
"2267","0fcab1a80c565b874e8f5ec41940d429",75,73,49,10.7142857142857,75,0,2,3
"2268","0fcb45bc9c2ad83274fbde8c34c4ac0c",55,55,0,55,55,0,1,2
"2269","0fcb84af0786d3dec29072b19b9b5f8b",93,71,60,10.85,53,40,2,3
"2270","0fcbc727e466bb5d31fcad63d22a46c2",20,20,0,20,20,0,1,2
"2271","0fd0a752d84ed57beeb6f73e8f0eb3fe",36,36,0,36,36,0,1,2
"2272","0fd0b6abbcbc04dac98992d94db4c58d",40,40,0,40,40,0,1,2
"2273","0fd20b469cb87db81fb06dce42575702",13,13,0,13,13,0,1,2
"2274","0fd4b05fb35532b33ad744cb62205867",19,13,59,2.25423728813559,19,0,2,1
"2275","0fd785494fdc764a7a43f1ed4e4a4a29",93,68,70,9.3,93,0,2,3
"2276","0fdb256ddec8b02dac3978d7e3213322",24,24,0,24,0,24,1,2
"2277","0fe49a852c2c1d0945deb0ff0853d98b",83,64,36,16.1388888888889,83,0,2,3
"2278","0fe534371ad16bd9548d889aacf70109",96,62,55,12.2181818181818,59,37,2,3
"2279","0fe5f4404bb0fbae5df9c119cae175a9",50,50,0,50,50,0,1,2
"2280","0feaaffe40934365c23948b4da6ad77d",2,2,0,2,2,0,1,2
"2281","0feacfdcc6bf813424f5606a01d5f7dd",44,44,0,44,44,0,1,2
"2282","0fec9cd1ea2f985259e256d2b14e23ae",21,21,0,21,21,0,1,2
"2283","0feeb1db008b1bb59f661d3c396cc7ca",24,24,0,24,24,0,1,2
"2284","0ff2d38d7b9b18b06e53bf0e2b676d54",224,110,75,20.9066666666667,192,32,3,3
"2285","0ff68827e7cb5209d181f1b0b011f4fa",125,88,76,11.5131578947368,113,12,3,1
"2286","0ff6921e33183bed94ba63041bb6e882",20,20,0,20,20,0,1,2
"2287","0ff8c7ed1ab6f547aefa85147033c17d",14,14,0,14,14,0,1,2
"2288","0ff9131e3fd6bb944d368656c501fefd",176,108,70,17.6,141,35,3,3
"2289","0fffef71fd0b20cefabecf9dc621c869",64,38,56,8,64,0,2,1
"2290","100035456c6678fc8884e11de523c1ff",71,60,44,11.2954545454545,71,0,2,3
"2291","100302936205f7b28ea3fb7a3f4ac431",36,36,0,36,36,0,1,2
"2292","1003368a1c51aa4d95a8e596c449b576",23,23,0,23,23,0,1,2
"2293","1003f82c854e12d62641bf07c14de02e",130,93,44,20.6818181818182,130,0,3,3
"2294","100640c902776a49910978bf566059dc",44,43,58,5.31034482758621,17,27,2,1
"2295","1009eca815628b9a0dd947e2f0d8669a",194,93,73,18.6027397260274,194,0,3,3
"2296","100ae91fe26833feb21965c18822c87b",22,22,0,22,22,0,1,2
"2297","100b6fd9ff74947361661d1fdefcc9a1",48,48,0,48,48,0,1,2
"2298","100cbf752484c78a2e6532d5d5bb2830",50,37,43,8.13953488372093,50,0,2,1
"2299","100e220c3a523ab09de9642462626ee8",34,34,0,34,34,0,1,2
"2300","100ea275c1df614f79de130520d61428",22,18,60,2.56666666666667,22,0,2,1
"2301","10140a3f3f743b6de725739fcb4b10fa",26,26,0,26,0,26,1,2
"2302","10140aff5a9b15a5920b86459df81bce",105,68,27,27.2222222222222,105,0,3,3
"2303","10147d10ed38f556ec2374769e823e5d",160,73,67,16.7164179104478,160,0,3,3
"2304","10162cae1d36f605d2cca903b3fe22ec",49,42,33,10.3939393939394,49,0,2,1
"2305","1016c4eae2164bae75b4f9a4243d70b0",212,139,85,17.4588235294118,196,16,3,3
"2306","1018eedb262e61571317417c85739fe9",17,15,42,2.83333333333333,17,0,2,1
"2307","10199d43b8b166159ec40a9f5f562231",84,76,37,15.8918918918919,35,49,2,1
"2308","101cf4cc9a072db45f1a899417a89155",92,47,67,9.61194029850746,92,0,2,3
"2309","10206b16100b8648432e3ab551924095",60,57,61,6.88524590163934,30,30,2,1
"2310","1021ac1f1f30f6d8e18e123438cacadc",27,27,0,27,27,0,1,2
"2311","1021ac81261f41603d29dc2729fa0ed3",26,20,40,4.55,26,0,2,1
"2312","10222aa95dcc51a5bace3ebcd9270594",39,34,11,24.8181818181818,18,21,1,2
"2313","102259209973d3e46ebe68de15726d02",75,54,34,15.4411764705882,75,0,2,1
"2314","1023e56a626d7f9ab30e7f3cab691e1d",10,10,0,10,10,0,1,2
"2315","102bf42b41225d457c9841ec0bd66e50",30,30,0,30,30,0,1,2
"2316","102ef68c611a9bb9071d41cb7587a912",80,78,34,16.4705882352941,80,0,2,3
"2317","102fecba2dca7884291443a40132d200",55,50,59,6.52542372881356,55,0,2,1
"2318","103110af157d5a47930e0076a80a64f7",35,32,19,12.8947368421053,35,0,1,1
"2319","10329d9397dd7813934c95f34613e9c4",71,63,14,35.5,71,0,1,2
"2320","1034653aac3b4a0c841a8e9b04266747",45,40,8,39.375,45,0,1,2
"2321","1035c7b232c34944caff80b602ef3ef6",118,81,49,16.8571428571429,118,0,3,3
"2322","1036d1041b3f6546a88702f52734dde9",58,44,42,9.66666666666667,58,0,2,1
"2323","1039ff0356f08de4bf7b21fbd9cb70f5",83,53,25,23.24,83,0,2,3
"2324","103aaa93f3268fbc61bf56ad7e6ba8ae",27,27,0,27,27,0,1,2
"2325","103ac04f3e6931c7d65003349f6611d8",31,31,0,31,31,0,1,2
"2326","103b4f74df02682c72b2801d9f12e0c7",21,21,0,21,21,0,1,2
"2327","103c39ed6b54987200af217a7367e5a3",28,28,0,28,0,28,1,2
"2328","103d20d38b948308d7f6ff5cec924e42",33,33,0,33,33,0,1,2
"2329","103f9e034b68db6ba81cefaafd73ff6b",36,25,42,6,36,0,2,1
"2330","1040a4e81c46222e90ac3660fa37c892",15,15,0,15,15,0,1,2
"2331","1044ade52e7741a43152db4b50802458",40,40,0,40,40,0,1,2
"2332","1045024ac84e32b48bde146db42b8480",33,17,72,3.20833333333333,33,0,2,1
"2333","10466b9b6a1b0491ba7ad9e99d61c4bd",12,12,0,12,12,0,1,2
"2334","1046c3b52f681f34129f9351f66838b4",43,37,21,14.3333333333333,43,0,1,1
"2335","1046d8e6d1ff1d80876a07964257a7c3",89,75,61,10.2131147540984,50,39,2,3
"2336","10470b024305bb2a59708c23edff0fb6",33,33,0,33,0,33,1,2
"2337","104938b0c252472022eb2b05ac7e0f4f",30,29,41,5.1219512195122,30,0,2,1
"2338","104a181f6f6e6750cc39a3a6d670c7aa",33,33,0,33,33,0,1,2
"2339","104e53dc9afb7bd4dbb00be26e53a493",182,116,62,20.5483870967742,182,0,3,3
"2340","104f215a125cc8e705dbaad6f8cf3f46",1,1,0,1,1,0,1,2
"2341","1050b0dd884e7638149dedf13e420bc7",64,48,48,9.33333333333333,43,21,2,1
"2342","1052747684afe89dc499591f9896a6a4",41,34,86,3.33720930232558,33,8,2,1
"2343","1052c720881a0502193cc6189c74fa3d",76,65,32,16.625,76,0,2,1
"2344","105333e27eb301d7c4579fa461303702",73,63,28,18.25,73,0,2,1
"2345","1054e5336f05f9a6dcbf332c9a5ee470",29,29,0,29,29,0,1,2
"2346","1058104ad9b7a2796b3b6cc5527fd0bf",79,59,40,13.825,79,0,2,3
"2347","10592e292775c5f1358c724c72de3b60",134,84,33,28.4242424242424,134,0,3,3
"2348","105a065c106643160ecb8a321df1f7ef",7,7,0,7,7,0,1,2
"2349","105a973f8e45fe78b1be12648a174821",34,34,0,34,34,0,1,2
"2350","105be44277fa3e5f26f18db3d2135f4d",19,19,0,19,0,19,1,2
"2351","105bffd1a0577a2a8cfe29ca07d7888f",1,1,0,1,1,0,1,2
"2352","10600c4de1fbc164803bf9af4fad86a1",107,71,76,9.85526315789474,107,0,3,3
"2353","1061b0e9bd1f984e4d0f9057b6a12509",1,1,0,1,1,0,1,2
"2354","10643b3a9cdbc495c01fe9a132749014",37,37,0,37,0,37,1,2
"2355","1064e7181c28717499f872fb33e62e61",94,58,49,13.4285714285714,94,0,2,3
"2356","10698c9e9b35491d0d53337c5ca7f7ad",19,19,0,19,19,0,1,2
"2357","106a131662ec14225d7dc2a27cfa404b",77,29,71,7.59154929577465,77,0,2,1
"2358","106c6d0c17f46d71ebd5f705d81c32a3",3,3,0,3,3,0,1,2
"2359","106f9ac75a9452196137845a353c1253",34,34,0,34,0,34,1,2
"2360","1071906c15c2325cfebf012857e63fab",65,43,58,7.8448275862069,65,0,2,1
"2361","10727ad15be65d615aa9cbce2830fa3c",80,53,70,8,32,48,2,1
"2362","10756fe9a717d3f73292a0b7fe3a1498",18,17,78,1.61538461538462,15,3,2,1
"2363","1077300ff4ac98930ec367a9fef2a1db",53,42,18,20.6111111111111,31,22,1,1
"2364","10789844f0987714996f857e6f2741c9",13,13,0,13,0,13,1,2
"2365","1079003f6fb596554dec93a8c4bb9e73",4,4,0,4,4,0,1,2
"2366","1079cd9f91f510bd20d31f98bfd60791",181,83,68,18.6323529411765,137,44,3,3
"2367","107b623b46fae04284cdbc3e21370f8e",127,82,42,21.1666666666667,127,0,3,3
"2368","107d829b016a940b3580f9b10aa14fb2",16,16,0,16,16,0,1,2
"2369","107ff144d7644e6c9112903606c42506",139,87,54,18.0185185185185,139,0,3,3
"2370","108060db2a4949fa6f6acd9269337cca",17,10,26,4.57692307692308,12,5,2,1
"2371","10878b7fb8d779a79ffbf8cbd4906e56",79,56,54,10.2407407407407,25,54,2,1
"2372","108d1503dd411fda78968d82a95cbdcc",14,14,0,14,14,0,1,2
"2373","10907ef846bb939eac6f470b588c21b4",145,94,61,16.6393442622951,101,44,3,3
"2374","109264bd010ce0d2392a2b6c4f2890e9",31,31,0,31,31,0,1,2
"2375","1093d5b8f6bdab76ac4e1b98ab799677",25,25,0,25,0,25,1,2
"2376","1094bd3efa1f342b2a169158a8924fb6",35,28,37,6.62162162162162,35,0,2,1
"2377","109545bacc5f471194f053bd27a09515",88,48,77,8,78,10,2,1
"2378","1097d4a4788b2d06d6fc835c83a8ec46",67,42,60,7.81666666666667,51,16,2,1
"2379","109822016d83c30d9d3f66079c3e3fa4",136,62,78,12.2051282051282,124,12,3,1
"2380","109920bc3b8336deda1d7435ab5a2060",197,73,82,16.8170731707317,167,30,3,3
"2381","109b16ce9b65707cbd9eacb4353851b9",189,82,83,15.9397590361446,189,0,3,3
"2382","109d27e74f357d8a150366a227c24b71",41,41,0,41,0,41,1,2
"2383","109d9cdab3231f280bb887c72d7fb955",92,61,67,9.61194029850746,66,26,2,1
"2384","109db86ffe28a9b583fefd451b5a1d44",131,89,65,14.1076923076923,94,37,3,3
"2385","109f888c00ae01f37d659c03f095abeb",179,105,73,17.1643835616438,179,0,3,3
"2386","109ff4355b5fcc06ad082037c2ac457d",195,82,66,20.6818181818182,149,46,3,3
"2387","10a00da58a7f0ef4875bb5be17c27ac5",107,38,69,10.8550724637681,107,0,2,3
"2388","10a09a5a13776b0499db80c5bdff2be3",146,91,52,19.6538461538462,116,30,3,3
"2389","10a10c957c447003b27095f86edd3075",107,81,28,26.75,107,0,3,3
"2390","10a52edf6d46524fc235f8fc909920d2",33,33,0,33,33,0,1,2
"2391","10a57fa57d79b37e259cf7ff500870af",192,112,81,16.5925925925926,192,0,3,3
"2392","10a7e613758ecf616f47c9bd088d3bed",1,1,0,1,1,0,1,2
"2393","10ac4871da8e96b9f4345156a587b345",61,46,57,7.49122807017544,31,30,2,1
"2394","10adb64a819d26c180f4bf4eb84e3775",60,53,11,38.1818181818182,33,27,1,2
"2395","10ae8c6becf745b629153bf30d74aa7f",36,35,39,6.46153846153846,36,0,2,1
"2396","10af1d63c94f6b8fc6ea1b83a3a335d8",19,19,0,19,19,0,1,2
"2397","10af9386ad50eb2cba7d15cba7f24c71",28,18,63,3.11111111111111,28,0,2,1
"2398","10b13b1f38e1adde25d4f0c0272fdf07",43,43,0,43,43,0,1,2
"2399","10b40f3a23fe26be5aa97a61fd7d968c",16,16,0,16,16,0,1,2
"2400","10b5238e6ce238f251128e41caee3fd5",71,56,19,26.1578947368421,71,0,1,2
"2401","10b5424c9ae11ed0ccde18b9fa097f00",68,50,12,39.6666666666667,36,32,1,2
"2402","10b645b34e2825e5a7d042c91ef51b7c",38,32,75,3.54666666666667,38,0,2,1
"2403","10ba9815b6ad8dad24bf61f0acf7b3b0",8,8,0,8,8,0,1,2
"2404","10bb37203ee02ba8d6dc8482c3ade5a7",56,56,0,56,56,0,1,2
"2405","10bb477544ef55d1f99c08ee1d52a79f",136,86,52,18.3076923076923,96,40,3,3
"2406","10bba4f88988d82d4759324c95808482",27,27,0,27,27,0,1,2
"2407","10c00b74661b14e5071c2697f82a1e52",23,23,26,6.19230769230769,23,0,2,1
"2408","10c0d23152ed0b50bf7749418ce78d2c",57,48,47,8.48936170212766,57,0,2,1
"2409","10c297abef98ad69fe08ae8c54d35ef4",53,29,61,6.08196721311475,53,0,2,1
"2410","10c3aca5f30347b9df7161052ab11db7",1,1,0,1,1,0,1,2
"2411","10c448537b4278540df9c81891c22b25",128,71,63,14.2222222222222,128,0,3,3
"2412","10c53333af845d4888beb0fd2ca543e0",175,95,90,13.6111111111111,124,51,3,3
"2413","10c5a00da4109da2c30de4fc6d5cd82b",23,22,63,2.55555555555556,23,0,2,1
"2414","10ca1d1595cd5ef3f5f5d033a6175779",21,21,0,21,21,0,1,2
"2415","10cb49814fab2bda121bb54f837eb380",47,43,59,5.57627118644068,47,0,2,1
"2416","10cbd3e21dff7a45b5458bcfd3bd9dd6",48,48,0,48,0,48,1,2
"2417","10cffe163f6f10ced0be485e6d87fa6a",247,107,62,27.8870967741935,196,51,3,3
"2418","10d05338c30e423f0d442d8a475a0897",105,90,34,21.6176470588235,105,0,3,3
"2419","10d09fffb4e5f0ad383f3313a987a932",34,34,0,34,0,34,1,2
"2420","10d1d86629c339bd3c92383a956659fb",17,17,0,17,17,0,1,2
"2421","10d5b9f1356e439551ffa438c2e4b105",196,109,82,16.7317073170732,155,41,3,3
"2422","10d78d8c9a9052d4638e4262069bfd91",207,95,67,21.6268656716418,153,54,3,3
"2423","10dbf3733a6c40eb5a92993a9f982a0b",45,45,0,45,45,0,1,2
"2424","10dc37711610a91212a16406fac68863",64,51,43,10.4186046511628,64,0,2,3
"2425","10ddbc508c8fc17a4cd41389490c7b8a",210,139,63,23.3333333333333,210,0,3,3
"2426","10ddf7e0e5a8a6857a45e20dea54e8f9",186,108,61,21.344262295082,186,0,3,3
"2427","10dfd66003624bd475c16b0c55bdf688",11,11,0,11,11,0,1,2
"2428","10dfe7a9ddfe6f2737cf37cfdae57aca",124,83,64,13.5625,124,0,3,3
"2429","10e54f68760ef1e4b0d5fa5610b9f861",52,52,0,52,52,0,1,2
"2430","10e59cf7a3ac3bf5e51df279e06266e9",88,63,27,22.8148148148148,88,0,2,3
"2431","10e6cf1cd2d55a4b1581af81538c62a0",24,24,0,24,24,0,1,2
"2432","10e847e6dcd05f85ad443f223d1bb15e",71,68,39,12.7435897435897,71,0,2,3
"2433","10e9f692eaa07d2337c8864d082a9710",59,44,52,7.94230769230769,37,22,2,1
"2434","10ebb1044039e2d3ad345bc373917b74",68,51,47,10.1276595744681,68,0,2,3
"2435","10ebb5019a605888679ab82ba0502d53",5,5,0,5,5,0,1,2
"2436","10ec6663bd78590b9a9c7ddf59e84b5a",20,20,0,20,20,0,1,2
"2437","10ecb3317a9f934c0ce742ecdf18f247",37,31,42,6.16666666666667,37,0,2,1
"2438","10eed39ea7fd922006168a713ce26de2",14,14,0,14,14,0,1,2
"2439","10eedf478f7503c33a2cfb3ad663c6ff",27,27,0,27,27,0,1,2
"2440","10efa8a941f01e721e43428889efbe16",26,12,66,2.75757575757576,26,0,2,1
"2441","10f422c34e9e497215f3a9177306e6a9",33,33,0,33,33,0,1,2
"2442","10f5079da9e2bcccdd3c015324a17f6f",33,33,0,33,33,0,1,2
"2443","10f52d0f4815c761fed4605708bc6791",20,20,0,20,20,0,1,2
"2444","10f662dab57d28de894483016e476e06",11,11,0,11,11,0,1,2
"2445","10f93b300bfcabd5eed00e289f3ce1b7",22,22,0,22,22,0,1,2
"2446","10fa03cd3665a5896124acb9ade92abe",78,60,35,15.6,78,0,2,1
"2447","10fb1e3c71af3f732dc144f4b6362e1b",101,72,57,12.4035087719298,65,36,2,3
"2448","10fd5ec1817a71b08447cf2593899649",40,39,5,56,40,0,1,2
"2449","10fdc6555d99563669e2e9b377b2f336",50,50,0,50,0,50,1,2
"2450","10fe0e3c0c458129658589cd2ebcd073",64,45,43,10.4186046511628,48,16,2,1
"2451","1104c7bbbb3b17a46f3cb63509e3c454",108,70,55,13.7454545454545,89,19,3,1
"2452","11073140eb22cce136a44a04d2a6620c",25,25,0,25,25,0,1,2
"2453","11076d704979aef677bbb97e76cce869",32,32,0,32,0,32,1,2
"2454","11084aea566e99c2f750fcd462fe5132",19,19,0,19,19,0,1,2
"2455","110872e1dc5fc5b0460fd801a180305c",20,20,0,20,0,20,1,2
"2456","110d1123091f7847369ee38644aa9900",116,57,48,16.9166666666667,116,0,3,3
"2457","110e60af70022dbf320735a9ea490a9a",26,26,0,26,26,0,1,2
"2458","1110bcdbbfb228d5ce35a25c65f3d1d5",55,55,0,55,55,0,1,2
"2459","11141b38a2191a6d2d1c7cf78c1eb73e",43,28,78,3.85897435897436,43,0,2,1
"2460","111424ab1e9e3ec203cf1ce8ef3c4ae6",10,10,0,10,10,0,1,2
"2461","1115e4427c633086d91b96c7de5a82c3",40,29,63,4.44444444444444,40,0,2,1
"2462","1119b23a96afdcc9646bee12e32db059",36,29,41,6.14634146341463,36,0,2,1
"2463","111bbce1e4390f99f86daf28f52c69f6",16,15,49,2.28571428571429,16,0,2,1
"2464","111f109794996e0fc681916d6be360f4",69,55,43,11.2325581395349,38,31,2,1
"2465","111f91a63dcdeea3c16deeec2976e602",19,19,0,19,19,0,1,2
"2466","1120bfb3cef8c4c3c2b19589c1aff0ec",25,25,0,25,25,0,1,2
"2467","1122b0a9e55c919c10ff5adb9b981677",108,63,75,10.08,108,0,3,3
"2468","1127b5a5c06091b2ca9fc499fc08fbd2",30,29,7,30,30,0,1,2
"2469","112ad545ba06aa73e4819188bd206cf8",183,98,88,14.5568181818182,156,27,3,3
"2470","112b9fdaf4f78d8afb26434eeb93baa8",65,53,35,13,65,0,2,3
"2471","112d82531ceca0a415ea517ce11a387d",33,33,0,33,0,33,1,2
"2472","112e2d0f10074c4e47a0d54b32b8cc59",41,38,58,4.94827586206897,41,0,2,1
"2473","112e5725663f4252553d3fd8a60b6b0d",189,78,73,18.1232876712329,160,29,3,3
"2474","112f8f5c88501290939b627aacf2bada",36,36,0,36,36,0,1,2
"2475","1132984f35e22ff5d4c87649bc124ac1",66,59,27,17.1111111111111,66,0,2,1
"2476","11348091d48ce37329122f61f27b0f63",29,29,0,29,29,0,1,2
"2477","113742310d54dc96e0d0b138790ad8de",192,92,77,17.4545454545455,192,0,3,3
"2478","113bf629f3a7d2d2582ab98f8ee87e40",28,28,0,28,28,0,1,2
"2479","113ccf497a343465b2d5f1261a8398e0",110,76,62,12.4193548387097,110,0,3,3
"2480","113f61a588c538ca27057e9dc7a81a08",117,70,68,12.0441176470588,97,20,3,1
"2481","113f650308befd0a9422a0ea1f77ff64",185,100,66,19.6212121212121,144,41,3,3
"2482","11426f88920a9a1ac294037b4215e377",55,47,31,12.4193548387097,55,0,2,1
"2483","1142b04fbbf956ba869ae36f7edbe53e",26,26,0,26,26,0,1,2
"2484","1147a5bb6607772ec801006623f8fa7b",28,28,0,28,28,0,1,2
"2485","1147ee61faa3711ee40263672eaa2c55",35,35,0,35,35,0,1,2
"2486","11481791a24f42b733495375511b00ae",21,21,0,21,21,0,1,2
"2487","1149d137f56ea9c8b38190b035ecda05",31,31,0,31,31,0,1,2
"2488","114ad2e58e6c0f58d18c3535e751c6ac",170,117,70,17,130,40,3,3
"2489","114b32b6a417cfeb162422ca32dc6e75",33,33,0,33,33,0,1,2
"2490","114c0111f61b15ee64572ea48faaafe9",44,40,10,30.8,44,0,1,1
"2491","114f717d6f4b9b5f7ba4fa9617ef4a78",15,15,0,15,0,15,1,2
"2492","115084fb4d92569ba86dde5caeef4cca",15,8,61,1.72131147540984,10,5,2,1
"2493","1153b8b8b7573056d8930cd8b9d941c0",126,96,59,14.9491525423729,122,4,3,3
"2494","11554d94fa126335d3c819ea3f9f2546",160,90,64,17.5,160,0,3,3
"2495","115756c3f38546a5b2b8a8c179a8a39e",17,17,0,17,17,0,1,2
"2496","11580d4eba3fc4ec5141755f70e561ad",29,29,0,29,0,29,1,2
"2497","115b5296bfeecef27fc8d62d3a3077d2",25,20,51,3.43137254901961,25,0,2,1
"2498","115cd03dac45475ebbeecbbbf86084a6",11,11,0,11,0,11,1,2
"2499","115f4e843b8695c1396aebcd0d8fe2ea",36,35,15,16.8,36,0,1,1
"2500","115ffc749975147b5800e8cc6e861874",61,49,62,6.88709677419355,61,0,2,3
"2501","11687f1d5105394b359db9715f23b43c",9,9,0,9,9,0,1,2
"2502","1168f2631f0f604d452e9aaa7b2453d5",247,99,77,22.4545454545455,201,46,3,3
"2503","116d1cd07d87c6aece803410d2616a4c",109,60,69,11.0579710144928,109,0,3,3
"2504","116decbba9d072d3ef3e9749f911885e",47,45,55,5.98181818181818,47,0,2,1
"2505","116e66d88cab53cbd535e6e8346cfd0b",31,28,63,3.44444444444444,0,31,2,1
"2506","1170419dd58dd6cd2e8e0c301525d137",19,18,49,2.71428571428571,19,0,2,1
"2507","11704dead77f072e58af1379a9a3af78",24,24,0,24,24,0,1,2
"2508","11711003eefdd53e8c6937dd3181486d",24,24,0,24,24,0,1,2
"2509","117322e3a49af5505540adb3cda6a376",12,12,0,12,12,0,1,2
"2510","117606eeffcfce53d00f64745a9b751d",19,19,0,19,19,0,1,2
"2511","1176ae9c27b7fca61788c1a13bbe5f02",11,11,0,11,11,0,1,2
"2512","11776aee24acc361f533e2dc3f11bf80",82,63,37,15.5135135135135,58,24,2,1
"2513","117d815a10a49e8c55744fcb1b579d0d",18,18,0,18,18,0,1,2
"2514","117edb63b589f7ab6f8b092224c7a4b1",31,31,0,31,31,0,1,2
"2515","11808529f6b27541795109c1d4e65b5c",35,35,0,35,35,0,1,2
"2516","1183dea5a5f75e665abea0218c4e8e9e",48,39,84,4,48,0,2,1
"2517","1185c95b30a35cb75a4e294810638662",86,45,63,9.55555555555556,86,0,2,3
"2518","11861e72c514a87e82b8e3265e536b44",68,48,66,7.21212121212121,68,0,2,3
"2519","1189400c209f43af067f6988d93b9a93",96,70,66,10.1818181818182,89,7,2,1
"2520","118af3380a96770e9cadb951d19d32a9",57,53,54,7.38888888888889,57,0,2,1
"2521","118cad63db72357e2e955676f813a2cf",112,71,66,11.8787878787879,112,0,3,3
"2522","118d41e5e9ead304c6f356e67748934f",18,18,0,18,18,0,1,2
"2523","118e70cc06e647336a4e39ea02f8a1aa",35,32,41,5.97560975609756,35,0,2,1
"2524","1191015346a62d017e753bf2d5cb414b",65,54,31,14.6774193548387,46,19,2,1
"2525","119233643892f9845238ac18a1639e32",24,24,0,24,24,0,1,2
"2526","11953af10dae3659921de3569b4a0f15",70,60,21,23.3333333333333,70,0,2,2
"2527","11964d0796cd6b6bf2f66698bfe6c5d2",36,35,7,36,36,0,1,2
"2528","119a717b225037d2149089fe52646591",22,19,34,4.52941176470588,22,0,2,1
"2529","119ca1a9bb28ac6a1cf159ae692da8b2",119,53,83,10.0361445783133,101,18,3,1
"2530","119ccbe6670d43b18a7722b35fd32e68",26,26,0,26,26,0,1,2
"2531","119f1600e4a3e65556237ec5f919b8c7",16,14,10,11.2,6,10,1,1
"2532","11a036942e8b109847b5433d647e105d",49,45,29,11.8275862068965,49,0,2,1
"2533","11a184b72f500a3220f2be0de2fae5a2",156,85,63,17.3333333333333,129,27,3,3
"2534","11a2c6d94a73d483db22fef35a8df2fe",44,34,49,6.28571428571429,0,44,2,1
"2535","11a4bae57ed192e919e082c2ed542baa",43,43,0,43,43,0,1,2
"2536","11a4c8f3388f5338dc5b213c86ed7632",29,29,0,29,29,0,1,2
"2537","11a4da7274838ac3286e10249ee64444",227,80,84,18.9166666666667,201,26,3,3
"2538","11a977cd505c21df08e70cd3efafeccf",63,51,84,5.25,63,0,2,3
"2539","11ab5d338ab0efaf241a03f4c8f2ccc0",56,44,38,10.3157894736842,21,35,2,1
"2540","11aba1d36e8a6281a094dc54577cacf9",14,14,0,14,0,14,1,2
"2541","11add00bfec5eaed79b9879219fce399",67,55,35,13.4,37,30,2,1
"2542","11afd1c9697f7990abd2f5ac572c056b",84,60,61,9.63934426229508,61,23,2,1
"2543","11b166abedbf4c2dbc051d6cdd758f30",46,35,58,5.55172413793103,25,21,2,1
"2544","11b6030574f5a8ba38250b30da44d4c7",102,73,63,11.3333333333333,102,0,3,3
"2545","11b62ddba1f0da16790140a43522b51e",28,28,0,28,0,28,1,2
"2546","11b68417b5c7bca1268f50f33a1bbda8",54,54,0,54,54,0,1,2
"2547","11b91d8d100849bbefc6a71f2413516b",215,120,82,18.3536585365854,215,0,3,3
"2548","11b97ce38ee8e6c8866da0d1130c5355",126,93,58,15.2068965517241,126,0,3,3
"2549","11bc5388ee8e80ba9db7c0f6530b4704",195,113,62,22.0161290322581,195,0,3,3
"2550","11bfe367c4eadd9b549ba7116f38fb2f",14,14,0,14,14,0,1,2
"2551","11c2d782b1b2a7242b26711d72f0b3b5",1,1,0,1,1,0,1,2
"2552","11c5cea67c9c43214dd9d8f939550e19",42,29,62,4.74193548387097,42,0,2,1
"2553","11c86ac82830cc2a8cfdc4d153134f4c",188,81,84,15.6666666666667,142,46,3,3
"2554","11c8de9c62140d93232b5bca676bdc99",95,73,49,13.5714285714286,50,45,2,3
"2555","11ca95ff8a5403efc08dd347fe509696",49,28,82,4.18292682926829,49,0,2,1
"2556","11cb7989d6bb56ac23dedb446e0fc04b",9,9,0,9,9,0,1,2
"2557","11cd9eb34667a0280f8c21dc09444b2c",25,25,0,25,25,0,1,2
"2558","11cdf0cc70e24663d91f7f76c5c02776",110,78,84,9.16666666666667,110,0,3,3
"2559","11d0758dd69a93f533c8e5e0a95be3ba",46,29,46,7,33,13,2,1
"2560","11d0d77522f776db88ddb885cba3e3bc",61,58,19,22.4736842105263,61,0,1,1
"2561","11d59e2f1641254050127a0738cf731c",40,40,0,40,40,0,1,2
"2562","11d6298fd577d5e47378e85c64e2847c",68,47,33,14.4242424242424,68,0,2,1
"2563","11d6fa685ae13737f76ec493d7b8f521",92,57,47,13.7021276595745,56,36,2,3
"2564","11d72aaf1578cdee1a0683b4b7abd108",202,96,67,21.1044776119403,202,0,3,3
"2565","11d7aa37debcede0f9dd7a64af9b0c31",92,55,77,8.36363636363636,92,0,2,3
"2566","11d8ce62ea91ed1de30186fa3d9ed65e",9,9,0,9,0,9,1,2
"2567","11e2becc36fe47b34f22d202867bd3b9",13,13,0,13,13,0,1,2
"2568","11e2db9aff7d113bc1cea550f0b96b4e",219,97,70,21.9,219,0,3,3
"2569","11e3a3fdf1ae42bc5cdc02998fac3294",121,85,76,11.1447368421053,98,23,3,3
"2570","11e3b035d701d450b6f1c9f946345232",20,10,67,2.08955223880597,20,0,2,1
"2571","11e3e7fbf9beeda4695fadc456baae82",127,87,34,26.1470588235294,85,42,3,3
"2572","11e74d4a5188544f8daaf326d2b9bac5",119,83,49,17,80,39,3,3
"2573","11e93838fd13bf269e4aee4a90ae1dd3",79,40,58,9.53448275862069,79,0,2,3
"2574","11e9a5264c930b781d2ba6eafda71fe1",51,46,24,14.875,26,25,2,1
"2575","11eb074bde38090f6bca7ef981fb6747",31,30,5,43.4,31,0,1,2
"2576","11ec9fa92e1ed11bd8ed8ef9f38adb53",18,18,0,18,18,0,1,2
"2577","11ece1777ce2d2031f10fb8d832d9538",28,28,0,28,28,0,1,2
"2578","11f1d7b01a2f7f5fa3cac23010f49f84",232,138,58,28,212,20,3,3
"2579","11f371beb3be20eec0dd101d61b71255",48,48,0,48,0,48,1,2
"2580","11f64cfc2ce9a4eb80efc8b862e7d0ee",16,14,71,1.57746478873239,16,0,2,1
"2581","11f6a4a499cca95f98bd2ca05293be7b",137,66,65,14.7538461538462,137,0,3,3
"2582","11f8c7e2f00e2a65eb7129e3ae92d768",18,18,0,18,18,0,1,2
"2583","11f9c5e5efecca73a191c85880fbfc15",98,48,65,10.5538461538462,71,27,2,1
"2584","11facc08450d97e100499707d694de63",168,96,84,14,168,0,3,3
"2585","11fc1f55df03092bbcb0f3f92ceddb1e",64,53,47,9.53191489361702,26,38,2,1
"2586","11fc67ed7b97a98629641788c61c64d3",2,2,0,2,2,0,1,2
"2587","11fc72f8bb780061794cf2fcafec33c4",139,87,58,16.7758620689655,139,0,3,3
"2588","11fdf63047bb0fb07250d9b0fd99bbfd",44,33,76,4.05263157894737,44,0,2,1
"2589","11feb5f3b35ca9442dabd1f1f083b11e",33,33,0,33,33,0,1,2
"2590","11fec6d7b4c589cfe795022762b39b56",17,17,0,17,17,0,1,2
"2591","12019ad08fa45cca14652b998e36a42c",82,41,75,7.65333333333333,68,14,2,1
"2592","1204aae2136ef6ecb1ee345e9c34b640",110,61,51,15.0980392156863,110,0,3,3
"2593","120718bbc8952b8c2852ae642f0ee538",52,39,26,14,52,0,2,1
"2594","1209f44dffc4b447ad61e473d7a63f14",69,57,35,13.8,69,0,2,3
"2595","120b31986fde3f6e98535b5a9d1caa37",26,26,0,26,26,0,1,2
"2596","120c6495f9ed6aa80f15789c92cc0952",31,31,0,31,31,0,1,2
"2597","120d80b0e3abdb73a00361ede4359ae0",18,18,0,18,0,18,1,2
"2598","12110a58d934eba0e08071ae7f25159b",99,75,57,12.1578947368421,99,0,3,3
"2599","12130208da30c2fff8cfd271193c5d00",43,26,47,6.40425531914894,31,12,2,1
"2600","1213b0d851d958556cf4930165308d94",142,99,42,23.6666666666667,89,53,3,3
"2601","12176819e1f46648913481f3e05bc87c",23,19,31,5.19354838709677,11,12,2,1
"2602","121949f575a39a751d008bcb5dc1d1dc",41,32,62,4.62903225806452,41,0,2,1
"2603","12196f03aced13c5f0e45755a0be0040",36,36,0,36,36,0,1,2
"2604","121a2b26958e6c898f95aa88ca5d9577",93,41,61,10.672131147541,93,0,2,3
"2605","121bdc3fd77ad6b096a1650319b3aed2",32,32,0,32,32,0,1,2
"2606","121d0330b5dddb86feace0839db9c3b8",165,83,56,20.625,142,23,3,3
"2607","121d11604d9996ed7bf8598e368198a3",23,23,0,23,23,0,1,2
"2608","122a6b6cc0e9818120193f83f38804f9",35,35,0,35,35,0,1,2
"2609","122b95440fc60e6252232d38e5a63afa",28,23,28,7,0,28,2,1
"2610","122d09ec3799d28b4e20813fec02aa7f",28,22,20,9.8,28,0,1,1
"2611","122d29af8a0367e9903232bedd8600e2",196,115,77,17.8181818181818,196,0,3,3
"2612","1230404dba64e1f4b53e9447fa44d848",55,45,22,17.5,55,0,2,1
"2613","123144bdfe00677e66477c2cf9f319dd",172,107,62,19.4193548387097,122,50,3,3
"2614","123562547bb35c8ccb81a5a037bf838b",34,34,0,34,0,34,1,2
"2615","123778dfcb163d790a02217e4bca7d91",189,113,40,33.075,189,0,3,3
"2616","12388f94ac9ecf3674a15360364aae83",76,65,80,6.65,76,0,2,3
"2617","123b02ff6f992672d44beacaadfe74da",3,3,0,3,3,0,1,2
"2618","123c18d78fa1ad8dedd675b57ffd320d",229,93,67,23.9253731343284,205,24,3,3
"2619","123e14ad9ad4204a39653a291c866f5a",16,16,0,16,16,0,1,2
"2620","123ee8630f08d33332f883deb68382cb",204,102,49,29.1428571428571,170,34,3,3
"2621","123f391ecad5a12b85da480fa0f4f58b",38,38,0,38,38,0,1,2
"2622","123f53b0db59f898739d06283d16e3c8",70,53,33,14.8484848484848,70,0,2,1
"2623","12411eb58d4568801acb27f67ef3222d",63,60,73,6.04109589041096,53,10,2,1
"2624","124193dca5c8f70af6e8674bb8f26dac",25,25,0,25,25,0,1,2
"2625","1241bbb51f9454ebefd073b57dd1b40b",103,81,58,12.4310344827586,59,44,3,3
"2626","12457dbfe145ad010c67f7ae84fce149",52,26,66,5.51515151515151,36,16,2,1
"2627","1245b4ea0577e9c878d82d131138e208",36,29,52,4.84615384615385,36,0,2,1
"2628","124752e617e46865ab16eb99b3f4ecda",70,49,27,18.1481481481481,70,0,2,1
"2629","124a5d0dbebf7e4ce279ba1418bda2a6",86,52,64,9.40625,86,0,2,3
"2630","124abadbf15dca8db42972ebd1052590",33,14,25,9.24,24,9,2,1
"2631","124e2f1690aac301283afafdfbcd874b",41,38,21,13.6666666666667,41,0,2,1
"2632","124e4b878c399ad82e31a0eee922c57c",33,33,0,33,33,0,1,2
"2633","124e92d515bc9a66e9a8c1425aa63038",107,62,61,12.2786885245902,78,29,2,1
"2634","124ed36274552c3b0c83d09d6de50004",15,15,0,15,0,15,1,2
"2635","124ef397824724aca7345ed59337a8f8",60,36,62,6.7741935483871,60,0,2,1
"2636","124f7ea9156e28412e63832d62f8c485",31,31,0,31,31,0,1,2
"2637","12508ca41ff843755ef820d9a21ce726",80,60,17,32.9411764705882,40,40,1,1
"2638","1258b09a08466d9f9414dd59d5616e7f",22,22,0,22,22,0,1,2
"2639","12594ed3e5326661bcc4c13a931e0636",120,91,70,12,120,0,3,3
"2640","125a1ce1457ff1afb2b19536e349ea5b",144,70,70,14.4,131,13,3,3
"2641","125cabff238d825c815fb43b23f075d1",130,50,77,11.8181818181818,130,0,3,3
"2642","125d818be22959ec9b26127617b14745",101,64,43,16.4418604651163,101,0,2,3
"2643","125de604b5a28280c0c0c40a0c83f63e",45,40,71,4.43661971830986,45,0,2,1
"2644","125e8d567d03c33dbe9328cd714803e5",198,103,37,37.4594594594595,198,0,3,3
"2645","125ea42568223b4b74ddbf81682a15ae",93,55,83,7.8433734939759,93,0,2,3
"2646","12601e23c4b307e007119f62ef7b6efe",6,6,0,6,6,0,1,2
"2647","1260dcce68089fd193a32f767289d052",98,38,71,9.66197183098592,98,0,2,3
"2648","1261490fb99d407a2604e00025e98deb",48,48,0,48,48,0,1,2
"2649","1262da621317df74ca88531766beea35",37,37,0,37,37,0,1,2
"2650","1264b29e33a51d110424fa7b7fa26250",34,34,0,34,34,0,1,2
"2651","12668f0df8352e8226063531c165c095",131,84,67,13.6865671641791,131,0,3,3
"2652","1266d7fbb60001e1655a705fe90d9e00",206,98,84,17.1666666666667,206,0,3,3
"2653","12680da5b0fe19858e5907125498702d",79,43,61,9.0655737704918,79,0,2,3
"2654","1268bcdb6bd448f984766020a43f9dcd",29,20,54,3.75925925925926,16,13,2,1
"2655","1269042aef664d6e96b90df750703d24",21,18,5,29.4,14,7,1,2
"2656","126b54fd3752388acffc7434d7af4d93",36,36,0,36,36,0,1,2
"2657","1271d08b881ce80d94d056f46f73281b",110,83,85,9.05882352941176,57,53,3,3
"2658","12728eea1570128e4cd4ba80a2f9a558",42,42,0,42,42,0,1,2
"2659","1272981442459aa013b0ea80d7013556",74,67,33,15.6969696969697,28,46,2,1
"2660","1274063ec7b7ab19edaf70d8f05c886b",57,40,28,14.25,57,0,2,1
"2661","1276e58ae96158798877f98b4c152cf0",115,64,70,11.5,115,0,3,3
"2662","12799ab66370eca24ac6effa553bdccc",71,47,48,10.3541666666667,52,19,2,1
"2663","127c9edf25ad1421c23512d2fe295c51",13,9,56,1.625,13,0,2,1
"2664","127e43898f0fe3e43c79017acab47054",25,25,0,25,25,0,1,2
"2665","127e68746d8eeba5bfe5e946527ee6eb",62,58,11,39.4545454545455,28,34,1,2
"2666","127e992af2e66ff5994ff5ad91a96814",4,3,38,0.736842105263158,4,0,2,1
"2667","1281f4c2f911568ace114784844c1989",17,17,0,17,17,0,1,2
"2668","1282c021f5410040f2d930cb77c3423d",48,48,0,48,48,0,1,2
"2669","128359bc9abb8758dd6a8e52299d239a",21,21,0,21,0,21,1,2
"2670","1284f047300556373c7b0a17731a132c",102,68,20,35.7,102,0,3,3
"2671","1286defd37ee2485297f6047c65dc998",17,17,0,17,17,0,1,2
"2672","1288bfc7e96054e15b4b56cfe44ebad7",30,30,0,30,0,30,1,2
"2673","128a5956cbbe028bcb5309cc1fb4e3d5",135,92,71,13.3098591549296,135,0,3,3
"2674","128af18485f8b894975badd319fe70b1",99,73,43,16.1162790697674,84,15,2,1
"2675","128e0d6ea2be3fad16bdef9fa0e699a2",88,58,57,10.8070175438596,88,0,2,3
"2676","1290c9ecf5f65b0d2adf3fd783d46ead",140,105,64,15.3125,98,42,3,3
"2677","1291549605d55824ff9854c6eb12eb56",117,83,54,15.1666666666667,87,30,3,3
"2678","129177188692dbf94af3a4a338a907b0",20,20,0,20,20,0,1,2
"2679","1291af623953815005a21804bd4fc55a",51,51,0,51,51,0,1,2
"2680","1294ff57cb23052f4d9a88e19d6a8b79",125,60,79,11.0759493670886,101,24,3,1
"2681","1297a5e3aee8c0a357cf152d72e2a1d7",4,4,0,4,4,0,1,2
"2682","1297e5074a989204aa44bd61a3a08ddd",70,48,35,14,70,0,2,1
"2683","1298610e7ab63e1fdcdeacd9cf02adf8",150,73,70,15,150,0,3,3
"2684","129a6d0e32222fc6797f9bb0668fcd07",13,13,0,13,13,0,1,2
"2685","129b259dc3beff9ac59c82470127a1d0",9,9,0,9,9,0,1,2
"2686","129ddf481c5d54ef7902487677507670",116,51,58,14,116,0,3,3
"2687","12a405d0e35474cb12d2831ff45d0ac0",138,95,45,21.4666666666667,138,0,3,3
"2688","12a513e56dddcc1011d8811431440f96",75,48,68,7.72058823529412,56,19,2,1
"2689","12a60ee53fe16d79357bebefca77305f",13,11,45,2.02222222222222,7,6,2,1
"2690","12a6d5c00873f8a6c3aa9e9c6f0ecc81",82,62,65,8.83076923076923,82,0,2,3
"2691","12a8d8e4b2c36b023c9b889254153f6d",69,45,72,6.70833333333333,69,0,2,1
"2692","12aa1fb0e6433a55f6bf20baaabee7fe",90,54,71,8.87323943661972,90,0,2,3
"2693","12aac64a79bf0815c4c0454c6c9da451",26,26,0,26,26,0,1,2
"2694","12aaca1a7df2c988a72336751573a20d",19,8,66,2.01515151515152,19,0,2,1
"2695","12afdfe2f8441154321fba6b9d58801d",216,107,74,20.4324324324324,216,0,3,3
"2696","12b028af74dafa17d5ad36133e983a44",79,42,64,8.640625,79,0,2,3
"2697","12b102e90ed20bfe144cca4f32c2b7ac",63,56,54,8.16666666666667,29,34,2,1
"2698","12b15dc1e63e896ec963052e2194504f",24,24,0,24,24,0,1,2
"2699","12b20671d1915012a1bdf4d1c31ebef9",105,87,39,18.8461538461538,105,0,3,3
"2700","12b3c2f26957bfc299f8feb4ceaa6158",41,34,62,4.62903225806452,41,0,2,1
"2701","12b5027e6b583d558edfb9eec7075cfb",19,19,0,19,19,0,1,2
"2702","12b50908d8081d09ed8db2f798ea4d7d",35,35,0,35,35,0,1,2
"2703","12b856d27f8e08c88b75626831ab84c6",23,23,0,23,0,23,1,2
"2704","12bd518300ca914649912429f26e55c4",18,18,0,18,18,0,1,2
"2705","12c56ea0796907ed97365156be29ba4f",71,43,70,7.1,62,9,2,1
"2706","12c78359e98ea2623e4ae87b4c87af86",89,79,64,9.734375,64,25,2,1
"2707","12c886d0d26664c23e67ab08430a6ed2",125,62,90,9.72222222222222,125,0,3,3
"2708","12c9084a62e4eafa09b6d80c4e544af6",25,25,0,25,0,25,1,2
"2709","12c9b6a206eea15d050451fa33904c81",41,41,0,41,41,0,1,2
"2710","12ca1bb72a9731d48c57266f30273d13",7,7,0,7,7,0,1,2
"2711","12ca747d0c74d32b68f6d4620d4956f2",89,65,75,8.30666666666667,76,13,2,1
"2712","12cd1e05d0890a23f30d1bd70a1e5751",212,96,76,19.5263157894737,212,0,3,3
"2713","12cd6f9dcb60cdd6d5cc9c54e2b67a8f",26,26,0,26,26,0,1,2
"2714","12ce0f73c500e19b7d9baf2ab06fa21d",52,45,17,21.4117647058824,52,0,1,1
"2715","12d1a04c78fc2dee8184e9831f7eb798",51,51,0,51,51,0,1,2
"2716","12d1e3bf988568bb15bfdab912759830",130,103,26,35,130,0,3,3
"2717","12d20a7ddd8be7c9c83dba253e9f58de",40,40,0,40,40,0,1,2
"2718","12d6e3c127a3a047c1ec192fd8933c0f",37,35,63,4.11111111111111,37,0,2,1
"2719","12d845306c3eb775ec9bc77c56d1db0f",37,37,0,37,37,0,1,2
"2720","12da238e3b97d0d52cdc550f92f2302f",169,92,64,18.484375,169,0,3,3
"2721","12db456f533c24db32bacabe0918e8c7",126,68,56,15.75,126,0,3,3
"2722","12db9d8f640299620990d63a4c625afa",30,30,0,30,0,30,1,2
"2723","12dbeba46865017bbef4f4e9076aa2ad",134,66,42,22.3333333333333,134,0,3,3
"2724","12dcf6d5a66d600f54829b656fccacea",44,44,0,44,0,44,1,2
"2725","12e510ebf19590079b5fee3e2f6754d3",78,66,35,15.6,78,0,2,3
"2726","12e6be90e79f8a010a024cd2970dff50",77,61,42,12.8333333333333,77,0,2,3
"2727","12e95b0f75cd9d719d81f6596df06610",43,38,51,5.90196078431373,43,0,2,1
"2728","12ea6e6e86633181d705fb0a8b9ec8d6",129,91,48,18.8125,129,0,3,3
"2729","12eb8f29cb26ded36cb78bff93c90db9",25,25,0,25,25,0,1,2
"2730","12ec14a61ca9d2a518435812f42db332",211,105,52,28.4038461538462,170,41,3,3
"2731","12eccf69f79289247b735efb4cfecf24",27,19,30,6.3,12,15,2,1
"2732","12ed0aa67c8ba37be477363b28429107",112,56,59,13.2881355932203,76,36,2,1
"2733","12ee34f3c4bdfbf6e7a467eefa07a694",12,12,0,12,12,0,1,2
"2734","12ef520a3f078f5d770cd1cbe2145a91",16,16,0,16,16,0,1,2
"2735","12f0c7eff671679ecb7db569ba0d0eb5",9,9,0,9,9,0,1,2
"2736","12f64869c21673efe5da8738ef108253",19,19,0,19,19,0,1,2
"2737","12f7575b74c9709fb327520b13006aad",45,45,0,45,0,45,1,2
"2738","12f85598aaff9f3c9a5925ec56577d29",5,5,0,5,5,0,1,2
"2739","12fabdbefb317132947bfc243860256d",40,32,57,4.91228070175439,24,16,2,1
"2740","12fb6a1d6a15e83ea168e661992ff674",19,19,0,19,19,0,1,2
"2741","12fbff085a7744825e50da118d3ab614",29,29,0,29,29,0,1,2
"2742","12fdf705e53abe1d4a6e6e1b72a2479c",21,21,0,21,21,0,1,2
"2743","12fdfc2733194d91bccb7070de3792f6",22,22,0,22,22,0,1,2
"2744","130175c5e24d5a98c49fd38c6c330789",155,75,61,17.7868852459016,155,0,3,3
"2745","13024a63f5dae4a17a88b7b1383d21d0",31,20,83,2.6144578313253,31,0,2,1
"2746","1307313e8ce5c7884ea91f212600dd55",56,56,0,56,56,0,1,2
"2747","130b7761b4e6bbec08bb8109e9fded94",39,39,0,39,39,0,1,2
"2748","130bbe5ca1c49e556c4b7c5d890bab8a",99,60,71,9.76056338028169,69,30,2,1
"2749","130bf45a0d940af0a12068a64b33de09",25,25,0,25,25,0,1,2
"2750","130c2390a323ba9c8ecdd116ec884926",65,54,40,11.375,31,34,2,1
"2751","130d78e4d68e8e6522940893140df30f",59,53,47,8.78723404255319,59,0,2,3
"2752","130dd2361eaa47472579476bf2dbfa94",33,33,0,33,33,0,1,2
"2753","130e33423b839a35b360384277cec984",22,22,0,22,22,0,1,2
"2754","1312f593cac0e1fcdc0357fa98978b6e",35,35,0,35,35,0,1,2
"2755","13133f0bbf23a680d442e25aab402902",115,91,84,9.58333333333333,115,0,3,3
"2756","1313dbd2d007dd46536ecdfad9646c9a",31,31,0,31,31,0,1,2
"2757","13146153bf3a13dd53e3975ca327f886",37,28,26,9.96153846153846,37,0,2,1
"2758","1315d6641e9bf898540ef131c31f8c5f",10,10,0,10,10,0,1,2
"2759","13175bf51658b57a49797cb240682c49",25,25,0,25,25,0,1,2
"2760","131943fcffb7470c11df091ffe0eed34",180,76,67,18.8059701492537,146,34,3,3
"2761","131a6734d322e653278a5c183382eb24",24,24,0,24,24,0,1,2
"2762","131b12b347a73a35440087666ddc27af",2,2,0,2,2,0,1,2
"2763","131bb10d44019d77293efae86035c5b9",41,41,0,41,41,0,1,2
"2764","131c5d68946d86e8dcb136394bcd6b6c",106,82,63,11.7777777777778,106,0,3,3
"2765","131d0999a63ed67bf8f0e84d872edf7e",9,9,0,9,9,0,1,2
"2766","131dac459b3ba9e6eaaf8f406f5e5333",35,33,18,13.6111111111111,35,0,1,1
"2767","131eea520f581334a1b1011dd18117c8",18,9,62,2.03225806451613,18,0,2,1
"2768","13203b177b9c78c5ea199341db7a8205",29,29,0,29,29,0,1,2
"2769","1321e55eb73c603887a08c516c8eaea7",4,4,0,4,4,0,1,2
"2770","13220e0f8c5b51efd2a122cd57f5ad5f",127,56,70,12.7,109,18,3,1
"2771","13256a76795814d8d5b02501270b2607",132,81,72,12.8333333333333,132,0,3,3
"2772","13287c082f0766d8b26aff47168048c3",3,1,6,3.5,3,0,1,1
"2773","132945ad1892d471b969a391ccb21285",81,58,15,37.8,40,41,1,3
"2774","1329daa6398c625158c9b3f1658ce102",92,51,21,30.6666666666667,92,0,1,2
"2775","132b368ee30ea016f0f52c733a503343",32,32,0,32,32,0,1,2
"2776","132b9badd92dd41ca80f86167998dc82",10,10,0,10,10,0,1,2
"2777","132c3237397ae790c50ececc9d851428",28,28,0,28,28,0,1,2
"2778","132dddfdcaa127efcedcd0c6dbcb8bf8",164,82,76,15.1052631578947,164,0,3,3
"2779","133269422ecb03946f8324996b306af1",25,25,0,25,25,0,1,2
"2780","13331ffd3ede2f76ec3acf1ff3861dca",41,41,0,41,41,0,1,2
"2781","133726c180f272d57d08529bc28e801f",183,126,48,26.6875,183,0,3,3
"2782","1337409299499f1a68210cd297562738",20,20,0,20,20,0,1,2
"2783","1338ced9b8be082b45dcac173d6733c5",18,18,0,18,18,0,1,2
"2784","133b3f51c3a44017e830e05cb1a95b52",40,40,0,40,40,0,1,2
"2785","133bc6bd7dad835d9fba69de49d26e25",91,62,88,7.23863636363636,91,0,2,3
"2786","133ff389e1c52c937e958da477c2bbe7",35,35,0,35,35,0,1,2
"2787","13402dd8176533e7fc9bf9cda15af9ab",162,91,75,15.12,137,25,3,3
"2788","1341806c0c3a022082ed117867f44ade",32,32,0,32,32,0,1,2
"2789","13426f7ade0403787178d054c0312e02",32,27,69,3.2463768115942,32,0,2,1
"2790","1343ef9770d4de8e4b0ed110293a6466",98,81,72,9.52777777777778,98,0,3,3
"2791","13445ab53978a9913aa5e13fcd691294",89,50,59,10.5593220338983,89,0,2,3
"2792","1344ef99e8fc50c727ad2e1d44dfdb2f",178,59,84,14.8333333333333,160,18,3,3
"2793","13494eb9ef992595cd742b62c782a2b0",44,44,0,44,44,0,1,2
"2794","1349ebff2ebb15f5051be02e5e063c2a",53,36,18,20.6111111111111,53,0,1,1
"2795","134b4ae493da4a15cb88655638d001a3",53,39,67,5.53731343283582,53,0,2,1
"2796","134bd68f3aaa98e66c8091afb197ec39",83,69,33,17.6060606060606,83,0,2,3
"2797","134c63db67aa5b3caca0888fc069d7ff",14,14,0,14,14,0,1,2
"2798","134dff2c7d717f11c60e5ef40a38be77",19,19,0,19,19,0,1,2
"2799","135195237852c9c64f63148dd2e53c3f",81,66,38,14.9210526315789,81,0,2,3
"2800","1351f31dc2d661d34452c9628293553c",21,21,0,21,0,21,1,2
"2801","135218190d6218ee1e7bd080c48ccbc4",35,35,0,35,35,0,1,2
"2802","13536908d53a67d597b6238247ffca5d",33,33,0,33,0,33,1,2
"2803","13544f5bb5260d0c56edc96d10f74b68",44,44,0,44,44,0,1,2
"2804","13598d9ce35e5628ebc16dd1e52240f6",108,50,76,9.94736842105263,84,24,2,1
"2805","1359c3bd693d4da6c573bb2460f08b95",27,27,0,27,27,0,1,2
"2806","135b56c1ee7c2a4e01d28739be5e57e0",78,54,51,10.7058823529412,78,0,2,3
"2807","135d3fb7e0c1b512b54470ef81292884",82,64,49,11.7142857142857,82,0,2,3
"2808","135e3cb2699f947556ffa2d9b416d691",32,20,51,4.3921568627451,32,0,2,1
"2809","1362fd3da9cee5c29b81fdf8ee0f08bf",131,85,46,19.9347826086957,102,29,3,3
"2810","1363ac9bda925ef75b3425ae9d5223cf",40,40,0,40,40,0,1,2
"2811","1363cad07a6c00fb31057d3643cb04ac",10,10,0,10,10,0,1,2
"2812","13658e12902d30f337247286e49f86aa",3,1,47,0.446808510638298,2,1,2,1
"2813","13676654e97d40374f7be542d2fbcae7",196,103,84,16.3333333333333,147,49,3,3
"2814","1368c2c99d1769c9d1c9183f45ec74e6",172,78,65,18.5230769230769,135,37,3,3
"2815","136c0149c4a9e7997e24c1881d581309",22,22,0,22,0,22,1,2
"2816","136d9bcea37808dee2cf31416364ed94",66,52,42,11,66,0,2,3
"2817","136dbc2df758cd9a385f98949931abd2",58,41,76,5.34210526315789,35,23,2,1
"2818","136def00dcb8e511a47d265341232ce9",120,75,44,19.0909090909091,120,0,3,3
"2819","13720f9880857013fb8159f8de97695d",217,104,72,21.0972222222222,217,0,3,3
"2820","1376240d38ed891276c95846e51971f0",3,3,0,3,3,0,1,2
"2821","1377acb4af13856c9f85abaefab30532",37,37,0,37,37,0,1,2
"2822","137918098b0567a14691607ec8107861",120,70,75,11.2,94,26,3,1
"2823","137cb6ad57a604e8b3eed858aae3dfc0",34,34,0,34,34,0,1,2
"2824","137f16d10f0e0808c7d281e47ff62ccf",61,42,70,6.1,61,0,2,1
"2825","137ffaeee2f4dfa3fa4f156e98fb0fd4",202,127,59,23.9661016949153,158,44,3,3
"2826","1381b377d157b8f404e256340fcc99ba",104,54,80,9.1,104,0,2,3
"2827","13827e8fbbb6619a7eea74d56e2a04eb",45,36,59,5.33898305084746,45,0,2,1
"2828","138423daf3e94b93c0090aacc1baaa1c",45,40,24,13.125,45,0,2,1
"2829","1385d56f76a4a7e947763b95c29d9fff",52,41,20,18.2,52,0,1,1
"2830","138608789ace1c8a8ad3bf7e5fab6057",28,28,0,28,0,28,1,2
"2831","1388b57aead1f883f680a3008a5f0fa6",143,94,56,17.875,143,0,3,3
"2832","138a6e2b5f5d8da37fec3d151c6f87a2",224,108,83,18.8915662650602,176,48,3,3
"2833","138b2aa04e460faed00e5eb5c5e7b64d",60,49,42,10,60,0,2,1
"2834","138d3711d308f0dbb1002f13fa7ded4f",15,15,0,15,15,0,1,2
"2835","138ff74c0dcacc6caee960cfce8812c0",24,24,0,24,24,0,1,2
"2836","13905817536025f71768407fb2473768",33,33,0,33,33,0,1,2
"2837","13908d78ad18290167f24f38680023c0",8,8,0,8,8,0,1,2
"2838","1393a5a5192e377574bff00754c6d851",83,67,40,14.525,83,0,2,3
"2839","1393af05acdeeb850c785a1511933377",30,30,0,30,30,0,1,2
"2840","1396f551aec0e2338273d3700debdeb2",158,100,60,18.4333333333333,106,52,3,3
"2841","1397387fa5a8737f21e3031aea616996",52,39,73,4.98630136986301,52,0,2,1
"2842","13975ba552aad88575383f2b13087f25",23,23,0,23,23,0,1,2
"2843","13977a94e8b0818bc497193efe717699",16,14,42,2.66666666666667,16,0,2,1
"2844","13990b29991aaa972e44ebb61db6c6cb",60,33,48,8.75,60,0,2,1
"2845","139c84e9b214b2f8e1ebb6b6cebcfef3",45,45,0,45,0,45,1,2
"2846","139cdb7fbd9aa0e2e29bc2862e4cce0d",18,18,0,18,18,0,1,2
"2847","139dc31bdaccc911c8467a90d21def53",47,33,68,4.83823529411765,34,13,2,1
"2848","139ec01deda8f6bb5a5f047a3ef6c65c",19,19,0,19,0,19,1,2
"2849","139fec0b60a4631f7a666037578b9e43",76,46,34,15.6470588235294,76,0,2,1
"2850","13a1c33469f307e78ca190b19dffb317",11,8,40,1.925,6,5,2,1
"2851","13a20b0a9152bb0add6d4c7b6acae6ae",80,49,64,8.75,80,0,2,3
"2852","13a63bcb7aab639878b06ca4ddd89d5c",107,58,78,9.6025641025641,107,0,2,3
"2853","13a75f0cad6b84eb17bc8d82a6bee04b",115,67,71,11.3380281690141,89,26,3,1
"2854","13a8bc08f4063dd92d3518b5b26dea34",38,26,74,3.59459459459459,38,0,2,1
"2855","13a99454de92ed26f712f8a9cc901abd",74,60,48,10.7916666666667,74,0,2,3
"2856","13aacd7c6242df8b698e5b94446b70fb",27,27,0,27,27,0,1,2
"2857","13ac592673e3bc1e6b68bfc4a6a1f809",44,32,26,11.8461538461538,44,0,2,1
"2858","13b12f5ac069962f9a7b8a08b509e4f9",40,40,0,40,40,0,1,2
"2859","13b3689ce11c88c8f5d36bc46533176a",9,9,0,9,0,9,1,2
"2860","13b553626d8d8636a6323b9c3cf36dc6",6,6,0,6,0,6,1,2
"2861","13b84a066c35150d882e9061d669a32d",52,52,0,52,0,52,1,2
"2862","13b88846a35a6d5704771ee9d6afee19",27,27,0,27,27,0,1,2
"2863","13bc0fc451713114c09993ccd0a34141",94,54,73,9.01369863013699,94,0,2,3
"2864","13be1a2891281b726882bb871a6cf662",40,40,0,40,40,0,1,2
"2865","13bf0f2fe6fd2c7cfd66e28161c0615e",10,10,0,10,10,0,1,2
"2866","13c1371c01ec15a7230bbc6ea6092682",54,27,56,6.75,54,0,2,1
"2867","13c20bf003b8250feb93c6164f4e40a5",107,71,43,17.4186046511628,107,0,3,3
"2868","13c676c3af3020293f5084a86af79dfb",157,95,75,14.6533333333333,157,0,3,3
"2869","13c8d763fc9eb03e37d6ba70e9a97000",135,85,74,12.7702702702703,135,0,3,3
"2870","13ca2ca3813c4b1590280743118db561",21,21,0,21,21,0,1,2
"2871","13ca35d770dfe03eb2dd7a4e42d6266a",95,59,50,13.3,95,0,2,3
"2872","13ca55a048e01132b93b1b5bb0dcce3f",46,38,26,12.3846153846154,25,21,2,1
"2873","13cec7da9d395fbffc0fcde395fd0bf8",78,62,82,6.65853658536585,78,0,2,3
"2874","13d1a94295820e9e752cb1dbfb214905",16,16,0,16,16,0,1,2
"2875","13d253ccc1db792fa99dde32dfab67f9",122,75,62,13.7741935483871,122,0,3,3
"2876","13d2f847cfe84fefc7fe177e277bb2ab",36,36,0,36,36,0,1,2
"2877","13d443e803d3e79385223ca669962e76",214,121,84,17.8333333333333,213,1,3,3
"2878","13d75a1537fcc18fbfee38bfa0802e99",30,30,0,30,30,0,1,2
"2879","13d7e42ca639fb8e307f963baae5db79",26,26,0,26,26,0,1,2
"2880","13da6236ec1bf633c98997357e177567",24,17,30,5.6,24,0,2,1
"2881","13dc2b9530ecad6620f4b2f442d8fc58",18,18,0,18,0,18,1,2
"2882","13de83ff4a59359c8976fed2d30d48bb",163,97,81,14.0864197530864,163,0,3,3
"2883","13e03aa805989584f4b873b10184cba3",132,78,70,13.2,132,0,3,3
"2884","13e2959d402663f1dc247e0f29cad069",47,44,42,7.83333333333333,47,0,2,1
"2885","13e3a34171113d841e766728e13a83c6",53,30,50,7.42,53,0,2,1
"2886","13e5e8f92ef4148e45d361c7a9261df3",8,8,0,8,8,0,1,2
"2887","13e6647cf8be32500ab3e27eb6e1a23b",4,4,0,4,0,4,1,2
"2888","13e9d3d729f0e0f1e5b602b766fad1a1",56,56,0,56,56,0,1,2
"2889","13ebd0465a77d02a49cf0071381136ac",36,35,5,50.4,1,35,1,2
"2890","13ecb7e3c4438db05952fd44c997aae6",124,65,76,11.4210526315789,124,0,3,3
"2891","13ed6d8f5349d4db1933b293c4288551",35,35,0,35,35,0,1,2
"2892","13ee9680d5014b90f0868e68d02e1d75",50,41,25,14,17,33,2,1
"2893","13eea3eb7396b589305f195ad8affaf2",169,91,56,21.125,169,0,3,3
"2894","13efb19c7ace21feadd868d6d917de80",5,5,0,5,5,0,1,2
"2895","13eff522682f637731b753d2e7202881",26,26,0,26,26,0,1,2
"2896","13efff1b3c795c3cac00ed779a0b6c9e",67,58,28,16.75,67,0,2,1
"2897","13f14d7aae0152bd3e103a7665d66136",133,91,27,34.4814814814815,133,0,3,3
"2898","13f1701e8f73e09b4a34993b40e356a9",35,35,0,35,35,0,1,2
"2899","13f3fbc79e057523ca48376fccf30b6a",92,69,65,9.90769230769231,62,30,2,1
"2900","13f685f1f6254348e93d239649b8567c",13,13,0,13,13,0,1,2
"2901","1401f3fd3e4f8f40902b175590da771b",142,79,31,32.0645161290323,142,0,3,3
"2902","14020d8b7c7bf3f5f0790926b6033fba",128,90,83,10.7951807228916,128,0,3,3
"2903","140406d7c683d2e5146a6a58cfae97e5",38,38,0,38,38,0,1,2
"2904","1404743889355fd458aed0bd8b62bb2f",21,21,0,21,21,0,1,2
"2905","14055f006f8b61ea0658a78d3f2f2111",29,29,0,29,0,29,1,2
"2906","140662ce3f9cd9f17bd3ca5fc794e80d",20,20,0,20,0,20,1,2
"2907","140687541a8653dfdc073ae40ecd6638",30,30,0,30,30,0,1,2
"2908","1411ed0ba560a9ae27899acc84eaf840",129,100,62,14.5645161290323,94,35,3,3
"2909","1412f7c9457947dc6e361809d3f3a4b1",119,63,83,10.0361445783133,102,17,3,1
"2910","14153055d5d46c992d0c6bc91ff9911c",81,58,47,12.063829787234,60,21,2,1
"2911","1416758510ac60230dbed23ee62f0dac",50,50,0,50,0,50,1,2
"2912","14169f329d7ddb3338622abbfb355a45",211,105,55,26.8545454545455,211,0,3,3
"2913","1416b6f8aa7974c01bdd3479b81bba22",83,42,60,9.68333333333333,83,0,2,3
"2914","14190f1550bd31aacf5e06efda41a8cd",128,86,72,12.4444444444444,128,0,3,3
"2915","141a1e2524ca6851f2db29265eef6904",73,47,35,14.6,73,0,2,1
"2916","141b54430bd31c1d2df685a45062398d",92,76,51,12.6274509803922,92,0,2,3
"2917","141c303201150e656adf42682cfe3ece",71,56,16,31.0625,33,38,1,1
"2918","141ed57287a5190faa0a60df5c8bfd6e",6,6,0,6,6,0,1,2
"2919","141fc55a6394fd748066f096612b4044",95,59,80,8.3125,95,0,2,3
"2920","1420da60a18cb540b6decffb898c2b40",36,36,0,36,36,0,1,2
"2921","14229122833932e15d8fee97df5fdb79",70,43,53,9.24528301886792,70,0,2,3
"2922","1422aaf16ecce54d8442e07fa6c1aceb",56,46,26,15.0769230769231,56,0,2,1
"2923","1426e4747c1b4fe55d8edf0a7b88b534",132,96,51,18.1176470588235,132,0,3,3
"2924","14275af74f27a79b675ab00a071b5042",66,42,76,6.07894736842105,66,0,2,1
"2925","142903a9307779cd15f2987edd7b4e00",68,44,61,7.80327868852459,68,0,2,3
"2926","14297408ea8e8390493aa52d57b11003",67,50,31,15.1290322580645,67,0,2,1
"2927","142a514f68b7178d2f953c0d33233c58",113,40,46,17.195652173913,113,0,2,3
"2928","142acb1ac5fa1bee1f187f9f49a4aed1",128,93,58,15.448275862069,107,21,3,1
"2929","1435f548f274ede393091311d3044e5f",75,61,42,12.5,75,0,2,3
"2930","143b47093e7fa5385c215910f7c11392",121,103,55,15.4,66,55,3,3
"2931","1442b3bb8a58fee52b5d4bf44aaa6658",166,102,70,16.6,166,0,3,3
"2932","1444da783b0bc64ee5e9987c9e515bc0",51,45,49,7.28571428571429,0,51,2,1
"2933","1444f01a087d813793e9a70186332f2b",1,1,0,1,1,0,1,2
"2934","14467912fa2210c35aeb909982d97cdf",85,51,54,11.0185185185185,55,30,2,1
"2935","144808b0731dde53f6f6efffcfdfc8fc",72,58,50,10.08,72,0,2,3
"2936","14490d8e22b674f068d075bc8e3893a9",223,77,84,18.5833333333333,206,17,3,3
"2937","144d83f5506414709941740bf170c2ac",70,41,77,6.36363636363636,33,37,2,1
"2938","144db7a91f0ea5db4b3e310bf6370516",43,36,54,5.57407407407407,43,0,2,1
"2939","144de19837dd69b0f31ddcea8a3933aa",156,95,83,13.1566265060241,132,24,3,3
"2940","144e5cf8eb9a55ceed602f717f1559e6",47,33,58,5.67241379310345,47,0,2,1
"2941","1453d19d64e2c725eea083e2aae0cb8a",28,13,69,2.84057971014493,28,0,2,1
"2942","1454bdcd5b4772168a9c99d0c5575b23",52,45,66,5.51515151515151,52,0,2,1
"2943","14580e9dc206c505612aff5575021b0d",37,32,28,9.25,37,0,2,1
"2944","145844a7547e5d032ccd6c20f3b1681a",179,91,59,21.2372881355932,144,35,3,3
"2945","145846a7739f83eb72df8333c2f2be14",22,22,0,22,22,0,1,2
"2946","145b18170da0068aef7a12f120bea103",241,123,64,26.359375,192,49,3,3
"2947","145b605b63afb5f76ac88a9a830db864",52,52,0,52,52,0,1,2
"2948","145b7971ed3c7acaa0e91095d5e23c5f",21,21,0,21,0,21,1,2
"2949","145ce186c5a36bd5eb00686e006a65f8",21,21,0,21,21,0,1,2
"2950","145cf65da275e4a4066370d7565ac745",136,81,51,18.6666666666667,103,33,3,3
"2951","145e37b9dd9e3af85db0400b7f3b1e5c",90,56,76,8.28947368421053,62,28,2,1
"2952","1462d0d60589e5e5ad61750a96e1146e",13,13,0,13,13,0,1,2
"2953","146410e277e32891475dcd8b3581ab34",142,102,79,12.5822784810127,91,51,3,3
"2954","1465ceeaaba9d4bad12e83b490fb83aa",42,42,0,42,42,0,1,2
"2955","1465f2dccb2ac36e69d709db7c2206ab",32,32,0,32,32,0,1,2
"2956","14665c517da2e4374fb48ee274f8377e",27,27,0,27,27,0,1,2
"2957","146668d67bdcac20aeaf33af39148770",26,26,0,26,26,0,1,2
"2958","1466875fc34812f050558b459dc53539",76,62,71,7.49295774647887,76,0,2,3
"2959","1466c860247494cd214733dad2a9e56e",35,34,5,49,35,0,1,2
"2960","146c0cbd0952bd6761b8a7a945e55a8c",14,14,0,14,14,0,1,2
"2961","146df446af8fcdbc2ece358da9889413",34,34,0,34,34,0,1,2
"2962","147016851f4d557d0bed92f4eafe19e8",30,23,69,3.04347826086956,29,1,2,1
"2963","1471c31a46145aae2b0df2e27f19ee9b",83,63,35,16.6,83,0,2,3
"2964","1475617bf997f75550591b672d35036b",15,15,0,15,15,0,1,2
"2965","1476e9379d6ccd9aa9d7cdd3b805d698",66,51,64,7.21875,66,0,2,3
"2966","147a7e986ae0fe5b66d6e0b358f98658",202,123,59,23.9661016949153,202,0,3,3
"2967","147d4cc7f9c14051fd1a00e0cfc4c6bd",65,58,48,9.47916666666667,65,0,2,3
"2968","147dd9a2837957ce0b84d8ef8b2711d3",36,24,65,3.87692307692308,36,0,2,1
"2969","147e51057e7a83121bacbb16550e840c",42,42,0,42,42,0,1,2
"2970","147eaf741d64a42c97abf82693efa5f2",30,30,0,30,30,0,1,2
"2971","1480adaf2961096de9b21e3b0946395e",170,82,64,18.59375,129,41,3,3
"2972","14818924bd283e79d9244d3e1300a84e",24,23,7,24,24,0,1,2
"2973","14826fc31dd29c2ca8c30c51660619a4",57,50,18,22.1666666666667,31,26,1,1
"2974","14828351d412ce9cc1df8a1568d3ea2b",20,20,0,20,20,0,1,2
"2975","1484590674b4f1a6e7abc8110cf045fb",38,38,0,38,38,0,1,2
"2976","1485149a74373631ce276341075af53d",40,40,0,40,40,0,1,2
"2977","148795f51600711ab118833645f5fc9a",59,44,75,5.50666666666667,33,26,2,1
"2978","1488f4a4cedfdc646e1026b69cb39331",6,6,0,6,6,0,1,2
"2979","148a80b789a67574e478ec8ce5cfe7d9",28,28,0,28,0,28,1,2
"2980","148d050a6752a530cac1809b66ff06b0",36,36,0,36,36,0,1,2
"2981","148f26b258ed3d5f0500ececcecfc5ff",42,32,60,4.9,42,0,2,1
"2982","1492f8fcc3337d22603ea35c4c9dfd4d",2,1,46,0.304347826086957,2,0,2,1
"2983","1493608ef6ec5cef90d35828ac648d02",20,20,0,20,20,0,1,2
"2984","149477bc28d200b4b80254ef8af634e4",54,45,34,11.1176470588235,54,0,2,1
"2985","1495bf5de8717a9876c84488ce166281",174,97,54,22.5555555555556,174,0,3,3
"2986","1496f55cafddb058298955e0a8863a0a",17,17,0,17,0,17,1,2
"2987","1499ae800ee292085128dd36844f46d8",140,81,29,33.7931034482759,140,0,3,3
"2988","1499f9b12b93bbec748a5178bb8c4377",24,24,0,24,24,0,1,2
"2989","149cf555edc6888f01e1d5e54d30eea7",175,105,71,17.2535211267606,130,45,3,3
"2990","149f932cf99aebe0262cd3df6e4f34be",81,65,53,10.6981132075472,61,20,2,1
"2991","14a3b6de2ed35b85273d4c7eb909b7e7",208,42,71,20.5070422535211,208,0,3,3
"2992","14a44397ee1e8c5f8bd138b11fe27e37",206,92,83,17.3734939759036,186,20,3,3
"2993","14a9284c0b092e20b1ce1cb36b2c0ac9",43,43,0,43,43,0,1,2
"2994","14a94c044c6b683435793c2a02699968",102,84,39,18.3076923076923,102,0,3,3
"2995","14aabffc50bda9a3fef378314d2d8445",95,56,56,11.875,95,0,2,3
"2996","14b01d533a9414942e0cc4855a7cb3b9",65,48,45,10.1111111111111,28,37,2,1
"2997","14b4fb855fc325f29b4d3cce3b5c26bd",243,114,61,27.8852459016393,208,35,3,3
"2998","14b544dd210ae8ab83e80c8f1ac6e3fc",15,15,0,15,15,0,1,2
"2999","14b65241b5340f0d3db2e32dd24bd625",43,43,0,43,43,0,1,2
"3000","14bb4a7ab6b45a6229d7f311f0b36a5e",42,37,41,7.17073170731707,42,0,2,1
"3001","14c02bfdd62729d8ab4dbb42a823964e",52,45,40,9.1,52,0,2,1
"3002","14c1b307c2d8ebb10e993da44bd9b80e",66,55,68,6.79411764705882,66,0,2,3
"3003","14c49f92ab18ab224c618bc7925e5861",170,92,50,23.8,170,0,3,3
"3004","14c685839ee9a386f9987afc152e7f52",8,8,0,8,0,8,1,2
"3005","14c876415417ec58e664f9533afb8228",96,50,63,10.6666666666667,96,0,2,3
"3006","14ca50afd821344f06500d0a67730654",202,131,62,22.8064516129032,202,0,3,3
"3007","14cbe197b9d9aa9d80df17845e2d73b3",29,29,0,29,29,0,1,2
"3008","14d298ae62801cfc51e2a5efb1374d64",42,30,12,24.5,42,0,1,2
"3009","14d3197ef162b3e27801e4721c278f47",6,6,0,6,6,0,1,2
"3010","14d4eec7bd7414979fa37355fd29a977",28,28,0,28,28,0,1,2
"3011","14d51e53e4841bd3cd41568de8dd686f",32,32,0,32,32,0,1,2
"3012","14d84dfe1a23868e56faf32f11338e34",38,21,57,4.66666666666667,24,14,2,1
"3013","14da13a4c6f88bbdfa8a58a6dce3ac95",35,33,17,14.4117647058824,18,17,1,1
"3014","14da22aaf945dd3a8faf3b3052e40273",24,24,0,24,24,0,1,2
"3015","14dc95435f5b701c72e031a3ba15eec8",26,26,0,26,0,26,1,2
"3016","14dd0873f48a633005dbf533a2ff9544",37,20,47,5.51063829787234,37,0,2,1
"3017","14ddb2cb011e8002ea78128586a9ed8c",54,49,25,15.12,54,0,2,1
"3018","14de785b2973e5cd9aeeac4d06e827dc",43,43,0,43,43,0,1,2
"3019","14e021794fbf683c680d5641ac56dd23",108,85,70,10.8,108,0,3,3
"3020","14e10db2d727ad16f8f1a4730036561f",180,85,48,26.25,127,53,3,3
"3021","14e234d28ba7f5cecc05506c5918c02f",1,1,0,1,1,0,1,2
"3022","14e320ba21e8829ea69ed5da58b214ba",9,9,0,9,9,0,1,2
"3023","14e7463440d45d6294b546fdcc03a885",22,22,0,22,0,22,1,2
"3024","14e7a1f3cb45283755a7b92853af9956",43,43,0,43,43,0,1,2
"3025","14e7c3ed489c1dd86f11ed34d934a897",38,31,19,14,19,19,1,1
"3026","14ee618b2c83036217bc15ae7afc96f6",109,68,68,11.2205882352941,109,0,3,3
"3027","14ef677f98968696b3d546f6099335f0",23,23,0,23,23,0,1,2
"3028","14f0700e40ec1b5c1f4b61ed320eb000",26,26,0,26,0,26,1,2
"3029","14f22c9cc7d5110ff540cbe5ae29f68b",134,82,74,12.6756756756757,99,35,3,3
"3030","14f4a073e39788d07acf4da03f7ffc6c",37,37,0,37,37,0,1,2
"3031","14fc46d8abc86a257fcd280a32cf0a84",27,26,43,4.3953488372093,27,0,2,1
"3032","14fc8632945081524a1934064057edf5",49,49,0,49,49,0,1,2
"3033","14fd3786dbc7b462ea93f208fc9e1632",131,103,41,22.3658536585366,131,0,3,3
"3034","14fd963514488708c7f22abe4e1910c1",117,58,77,10.6363636363636,117,0,3,3
"3035","14febd14ff3e2c368da0f84fcfea618e",102,80,36,19.8333333333333,102,0,3,3
"3036","14ff02b409cd9a269a2f60985032a9d3",118,94,59,14,97,21,3,1
"3037","14ff67292de9a515b43eadb1e5f1ec2d",23,23,0,23,23,0,1,2
"3038","14ffa92416241d95187e1264cf17ac7a",107,44,71,10.5492957746479,107,0,2,3
"3039","1500412b1a5152ff4986f954f3385529",179,74,74,16.9324324324324,179,0,3,3
"3040","15025b818f8fe407228544c8e0e9f56a",159,90,37,30.0810810810811,116,43,3,3
"3041","1504f0a99d5088bffe8233d81a38d7c6",53,53,0,53,53,0,1,2
"3042","15066bd52ba25829b370ecc06ffad070",21,20,4,36.75,21,0,1,2
"3043","150710ac7b6059a6f561b249fa1c9487",130,74,59,15.4237288135593,80,50,3,3
"3044","1507b20e7b88a90878243645e34610ac",43,33,30,10.0333333333333,17,26,2,1
"3045","150a272cdfcdd48d695170df635233a2",100,47,21,33.3333333333333,100,0,1,2
"3046","150ccd3c0d462f5f0cfd3cbef46bad0a",62,59,8,54.25,62,0,1,2
"3047","150de33377767498409ac0c451bd59e1",26,26,0,26,26,0,1,2
"3048","150e0af35fdab80d5e229382313fe829",103,68,83,8.68674698795181,89,14,2,1
"3049","150e3ae0574f6dd011fd2c056ce17531",56,46,31,12.6451612903226,56,0,2,1
"3050","1510cd7ad20791361f858de366f8678f",30,30,0,30,30,0,1,2
"3051","15121e0b5511aad68e870d733f1e2633",24,18,41,4.09756097560976,24,0,2,1
"3052","151243ad0a8ceaa21971a4e995b746d8",156,83,83,13.1566265060241,128,28,3,3
"3053","151e6cb00dbf81f622b6f7b76eb0ac3f",29,25,28,7.25,29,0,2,1
"3054","152088984bd7c4af1c1ef30698bbd104",51,38,26,13.7307692307692,51,0,2,1
"3055","1521a15c66bc481099136157457dc14c",79,45,58,9.53448275862069,53,26,2,1
"3056","1524832696b5661c98c32897739c260b",185,70,50,25.9,185,0,3,3
"3057","152b0952267bd6df144fda45a8e5c7bf",45,45,0,45,0,45,1,2
"3058","152b7beb2d786ad45d21753cb8a32a2a",87,64,47,12.9574468085106,87,0,2,3
"3059","1534671d91eff9bf3665d7e48cbea1e8",24,17,72,2.33333333333333,12,12,2,1
"3060","1538d33b0505a6d16995fb86be237c1a",103,57,59,12.2203389830508,74,29,2,1
"3061","153bade2f9944e23f7348a90d09f6846",30,30,0,30,30,0,1,2
"3062","153de16ab7223ce1db40fd7a5ce4a73d",18,13,48,2.625,18,0,2,1
"3063","153ec1bffcb9e5ea7ae3b86d15c60ca1",22,22,0,22,22,0,1,2
"3064","153f46c4f24433622f22314ba0efe171",154,88,38,28.3684210526316,154,0,3,3
"3065","15401c0e3f5551c9b0c7f7b5bf05a5fb",5,5,0,5,5,0,1,2
"3066","1546471d70644c1a1cbcb03d2c8a9827",48,39,51,6.58823529411765,48,0,2,1
"3067","15485bd490f4653e0a177ae260ebb90f",33,27,56,4.125,33,0,2,1
"3068","154e719256e5e4f52695c2e1c879d38f",21,12,62,2.37096774193548,14,7,2,1
"3069","154f8a63f69657c59c86bf43dcc7a59e",142,90,69,14.4057971014493,142,0,3,3
"3070","1551786ccd254458ee3f2109e6ff1ec9",43,43,0,43,43,0,1,2
"3071","1553238677099cc75373a97d78e8c7a4",57,51,18,22.1666666666667,57,0,1,1
"3072","155361f3084dba34004168f204175f1f",67,56,20,23.45,67,0,1,1
"3073","155400ccd3d44d1c5aa5b5c58fd4652b",104,86,14,52,104,0,3,2
"3074","1554e291bfd2bd14c51b2d8154412251",52,44,7,52,52,0,1,2
"3075","1556f2262838baa6e44013f30ce14b46",107,55,66,11.3484848484848,81,26,2,1
"3076","15589edf382a9162765cea773d4d20f0",160,80,81,13.8271604938272,129,31,3,3
"3077","156280d76cfdd9038516fe983ef59e83",8,7,37,1.51351351351351,8,0,2,1
"3078","15642218d548545b7fc3674d0ffe7771",84,44,60,9.8,84,0,2,3
"3079","15642f006dc8594577778484d0490d43",21,9,65,2.26153846153846,15,6,2,1
"3080","1564c2a556d50c3934e92455c5bd5a4f",37,37,0,37,37,0,1,2
"3081","1565386e3879c3d661555c7cdc37cda2",19,19,0,19,19,0,1,2
"3082","156636cb3d382cff126081476c026e4b",69,52,78,6.19230769230769,56,13,2,1
"3083","1566abadb5a27a238fdd6fe3a3943f37",12,10,17,4.94117647058824,12,0,1,1
"3084","15698b8ec459a7baaf99faff0ff22823",19,19,0,19,0,19,1,2
"3085","156d620cc9e0db11a5c56fc7ab0bc35a",54,26,70,5.4,54,0,2,1
"3086","15713b06e87d656a23f063a140435d05",59,50,63,6.55555555555556,59,0,2,3
"3087","15738a2b7f57ef455fd6378010e93829",180,95,77,16.3636363636364,180,0,3,3
"3088","157467c2729f263daf3fa3e70d6392e6",30,30,0,30,30,0,1,2
"3089","15780c556c2069cb60ad729d69df9340",40,40,0,40,40,0,1,2
"3090","1578a8566e8b10f76a16a27d2ea673db",135,76,77,12.2727272727273,135,0,3,3
"3091","1578fc4f03346fa3eabb93f2fa78bd77",75,45,56,9.375,75,0,2,3
"3092","157a0684385a43a0a4ff91dbc4ed8918",122,69,69,12.3768115942029,79,43,3,3
"3093","157ec8e09bd2b2bc73482948a091e352",216,88,84,18,216,0,3,3
"3094","157edfa9d369127620e192ef1e1b7959",31,31,0,31,31,0,1,2
"3095","1581b684d5600e1f1dabec4dd98a12b1",246,111,73,23.5890410958904,214,32,3,3
"3096","15890d67472ea284f0a75bc897cf64c2",186,87,85,15.3176470588235,186,0,3,3
"3097","158a5858fa762a43b25d55ddd9282123",49,44,12,28.5833333333333,49,0,1,1
"3098","158f37807dd5a932a91489b3134a2c2b",27,27,0,27,27,0,1,2
"3099","158f39b80f0f0a505fa0ae046d5d7e51",60,50,50,8.4,60,0,2,1
"3100","15906f317aa83c35d51772a1868c75ac",25,25,0,25,25,0,1,2
"3101","15956b476dc8707e97ef4b28c5a8f81b",68,45,67,7.1044776119403,68,0,2,3
"3102","15976d25a0467520627e30d795f1e67d",39,34,74,3.68918918918919,39,0,2,1
"3103","159b7a798603bf07b5e6b3fdb8ef7116",107,74,85,8.81176470588235,73,34,3,3
"3104","159c7800f769e94a4d34a4d20c0518dc",70,57,83,5.90361445783132,52,18,2,1
"3105","159cfa1c7f60fb4cb3fce932366935c0",85,66,39,15.2564102564103,85,0,2,3
"3106","159f80107f3536d8dec6a99a3676df8a",31,31,0,31,31,0,1,2
"3107","15a54619a3cd3933483152f71c7191bb",108,89,21,36,108,0,3,3
"3108","15a66c4fd6a7280d6bcaecdc7b666d52",152,111,54,19.7037037037037,152,0,3,3
"3109","15a79f966a3ac3fc161a3f0ce47d0140",19,19,0,19,19,0,1,2
"3110","15a7dd2b5211d50146bf1dc18fc5d8ed",28,28,0,28,28,0,1,2
"3111","15a91b670cb645e4f8aad91abb047a54",50,39,40,8.75,29,21,2,1
"3112","15ab82fae0ab20d956de4aaa30afc806",1,1,0,1,1,0,1,2
"3113","15ae74d5b7ea3228481bb724c9281866",146,86,67,15.2537313432836,146,0,3,3
"3114","15aff63c4e7ad3f50e5cb322a5386e4a",29,29,0,29,29,0,1,2
"3115","15b09d6d14ff69dce170b773344e299f",120,59,83,10.1204819277108,89,31,3,1
"3116","15b1c742928cf1778dc40c1ac6ab7b09",30,30,0,30,30,0,1,2
"3117","15b293e7bee223fa035552a9e77a7cb1",35,30,15,16.3333333333333,35,0,1,1
"3118","15b3ddefe83d3a5aac2bdc676d6f98ad",9,9,0,9,9,0,1,2
"3119","15b3e469d0d47e930ea8bc7bbfcfbd6b",28,20,69,2.84057971014493,28,0,2,1
"3120","15b436bf199802e7eeab41b72a1a4cfe",3,3,0,3,3,0,1,2
"3121","15b5548f2279d8af481e9678ce92afe0",36,36,0,36,36,0,1,2
"3122","15b5db2352d9a08bf9b4a5c987ef65bf",135,81,85,11.1176470588235,135,0,3,3
"3123","15b8fa8d5990b4fe097fe4f16992a658",40,40,0,40,40,0,1,2
"3124","15bd6e17ee7356663daeb8959cbea054",92,63,46,14,64,28,2,1
"3125","15bf0ebfc5b0a306a9505bc5eb07dc87",16,16,0,16,16,0,1,2
"3126","15bf8a5377dbcccf2bc187559c4cadd1",106,72,69,10.7536231884058,106,0,3,3
"3127","15bfef7c3b0c338fdb2d8b86618de3f0",24,23,42,4,15,9,2,1
"3128","15c0f3f90cf8a309c9cd4e8b61cdbc7f",52,52,0,52,0,52,1,2
"3129","15c41f18c0a6674c8f48d817e1f4f4f0",103,61,79,9.12658227848101,103,0,2,3
"3130","15c53b17ede8a57004f1af32e60ee14e",59,38,57,7.24561403508772,43,16,2,1
"3131","15c62aac0e64eab4a73b975f5a6481d9",38,38,0,38,38,0,1,2
"3132","15c632ed5f0d3ce9078fd95b12447a7a",44,24,66,4.66666666666667,8,36,2,1
"3133","15c9db09e45a405096cd9746ce4f9006",9,9,0,9,9,0,1,2
"3134","15cb7aa49f8b032613afe88f4b018fb5",21,21,0,21,21,0,1,2
"3135","15cc23970cf93af55a6bc25ad3f0acfc",22,18,35,4.4,22,0,2,1
"3136","15ce38b359c1425baf8a4554bb541927",8,8,0,8,8,0,1,2
"3137","15cf6599cbd104d040ea01e7ed7d955b",12,12,0,12,12,0,1,2
"3138","15cfecd76bf42acc0eecb13811296dc9",29,22,56,3.625,29,0,2,1
"3139","15d56b54cbf329973bd95bdcf8ef67fe",3,3,0,3,3,0,1,2
"3140","15d90d539cb3b3d86efadc82cde131d8",28,28,0,28,28,0,1,2
"3141","15d9861c490e5bb2c8d8a38dfb02a914",40,40,0,40,40,0,1,2
"3142","15d9fbcdc61680dbcf246a22cc742e8f",31,31,0,31,31,0,1,2
"3143","15da9f40e14fa6194035629da2100ebb",97,77,15,45.2666666666667,97,0,1,2
"3144","15dd4972e4cb0f1454198bff134b573d",43,30,30,10.0333333333333,21,22,2,1
"3145","15df750643d9e3c89e982c1a0d776005",146,60,84,12.1666666666667,146,0,3,3
"3146","15df8b266eb5c116410a1f5748487648",27,27,0,27,27,0,1,2
"3147","15e0a9b7b0c2b5c0b758f693667116d5",22,22,0,22,22,0,1,2
"3148","15e0d27e9a2dc9f850c19a1dc73285f8",87,55,63,9.66666666666667,87,0,2,3
"3149","15e22c91415989cc3fdec9aef46965f2",79,67,35,15.8,79,0,2,3
"3150","15e332e7b63d52bb6bab7ced03e1da66",88,60,60,10.2666666666667,88,0,2,3
"3151","15eaba10e6eb7c00737f94e935ed9fc3",102,77,36,19.8333333333333,102,0,3,3
"3152","15eb15f27be1ef5b18f3951c694cdef8",51,51,0,51,51,0,1,2
"3153","15eb246e56851ef63a07dbf6fb68c7bc",110,75,71,10.8450704225352,110,0,3,3
"3154","15eb8ea26c8d002dafeb96b07bdf1411",96,78,55,12.2181818181818,96,0,3,3
"3155","15ee2cfa84042e329985ce95d1b15a49",144,91,77,13.0909090909091,98,46,3,3
"3156","15f49a2e3b9009e85eba73ed8f9cd90b",31,31,0,31,31,0,1,2
"3157","15f5dcf73e2bc7e7e98060eaee23f27d",45,45,0,45,45,0,1,2
"3158","15fd37e365beace87b4ac31a022bff21",37,27,58,4.46551724137931,28,9,2,1
"3159","15fd81d36d9653f681c34369a68edb7e",22,22,0,22,22,0,1,2
"3160","15fe7ab855a49d9e1a0979829e8f03da",50,50,0,50,50,0,1,2
"3161","15ffa02bdb768e676b5c8c1502bdb853",119,44,76,10.9605263157895,119,0,2,3
"3162","16040b28ce58dd285017250847b94380",20,20,0,20,20,0,1,2
"3163","16074f7f0d4b9df197c61963155984f6",20,20,0,20,20,0,1,2
"3164","1608e892f6d440575fbe97a98a93bdf4",43,43,0,43,43,0,1,2
"3165","1609b2ecf60e3f0ffb623bdb09159302",93,52,82,7.9390243902439,93,0,2,3
"3166","160a16a0709641f041150358182e7e93",40,33,35,8,40,0,2,1
"3167","160bb0619b28d2af8f232e6f59f44dec",65,47,55,8.27272727272727,65,0,2,1
"3168","160c64eec7a5232d0b22cf42586b42ad",167,124,76,15.3815789473684,167,0,3,3
"3169","160c8e8803cf32cae79858fb141dda3e",60,46,32,13.125,60,0,2,1
"3170","160db47aa2735b562a5b2db24735048b",143,94,71,14.0985915492958,143,0,3,3
"3171","161075831906a59d08e0b3b62c523783",160,73,79,14.1772151898734,126,34,3,3
"3172","1611d345c39dea010cda94a444d8b8cb",18,18,0,18,18,0,1,2
"3173","1612fd21ca3a037c2413281f71428dc2",18,18,0,18,18,0,1,2
"3174","16150770291a12f78ba4e5507d358d48",41,38,20,14.35,41,0,1,1
"3175","16175e6827d06e23fc55f9decf99de4b",29,29,0,29,29,0,1,2
"3176","16192c6224eae768be66f3cae3a3ef72",51,42,19,18.7894736842105,21,30,1,1
"3177","161b3434266f563e563ea11a47a196ab",146,82,76,13.4473684210526,146,0,3,3
"3178","161ca874f261bedd7f17b2375893c21b",203,121,77,18.4545454545455,203,0,3,3
"3179","161d5f7d8454638a8b66d1e335be58e3",48,48,0,48,48,0,1,2
"3180","161dc1379006a0c2bf2e2d0906003148",80,43,77,7.27272727272727,67,13,2,1
"3181","1621fcc7c280f4ca49a340b871366cbb",56,46,49,8,56,0,2,1
"3182","16224cf16d728320dc7bc522586c68e9",207,81,78,18.5769230769231,207,0,3,3
"3183","1626048b3bd2cac2042c11041188fafd",86,45,62,9.70967741935484,86,0,2,3
"3184","1628851acca5b21988e1d1c28ffc5cce",9,9,0,9,9,0,1,2
"3185","16293c3b4486ccb6d9a386fbfdf81968",17,17,0,17,17,0,1,2
"3186","162a075e896522cb9c61e4e14e66fef0",9,8,4,15.75,9,0,1,2
"3187","162a69beb1a57bc66c06f2ee7bcd0a53",65,46,33,13.7878787878788,45,20,2,1
"3188","162b1dc3534c3a342822f0c126117f47",9,8,3,21,9,0,1,2
"3189","162d855a04f811bd9a659d9d52cb470f",10,9,2,35,10,0,1,2
"3190","162fd53231da89518e8692ad85519508",33,33,0,33,0,33,1,2
"3191","162feaffabae88c631e6bb8719ab5052",44,28,49,6.28571428571429,44,0,2,1
"3192","16308de56c37c334ae19e2f80cf42979",163,115,56,20.375,163,0,3,3
"3193","1630c91f3661ca831849f09ec8388264",97,71,44,15.4318181818182,63,34,2,3
"3194","1636b9fe3996927dec2912e814334467",61,48,30,14.2333333333333,61,0,2,1
"3195","1638260e70afc1d8165fb5a9a7cfcda2",43,35,68,4.42647058823529,15,28,2,1
"3196","163b4785cde15167594c541bf0b936ca",211,103,83,17.7951807228916,211,0,3,3
"3197","163d35e123f4a0ff41b113ce2e64e480",40,40,0,40,0,40,1,2
"3198","1640681378d05a9fcbec7ca3c5da56ab",63,38,85,5.18823529411765,63,0,2,1
"3199","16418c88ef92fa6cc0a5f0eb19c6c474",80,62,56,10,52,28,2,1
"3200","164211cce3efcc76c26cf6280d4ed02f",185,114,63,20.5555555555556,185,0,3,3
"3201","1642f32941ef98ae212575d207630734",122,90,55,15.5272727272727,122,0,3,3
"3202","1642fa16461fad25c98335b90bec6358",61,52,38,11.2368421052632,35,26,2,1
"3203","16432536fd90784dafe5c059aa7bd45e",145,81,77,13.1818181818182,145,0,3,3
"3204","16470c97233fcabdc4901b150d72fac2",64,34,76,5.89473684210526,41,23,2,1
"3205","16473e8971f109f1ef7fe51400248e9a",32,32,0,32,32,0,1,2
"3206","1647f7dddf0b173eded8fdb30c7f1b55",142,102,47,21.1489361702128,89,53,3,3
"3207","164b07bfc56bffcda86eb07c5fc4b74f",31,31,0,31,31,0,1,2
"3208","164ba0a61bde27fa8221ae364419b52a",119,93,65,12.8153846153846,119,0,3,3
"3209","164d93b42c69bce9acc0dc351d04829a",24,22,36,4.66666666666667,24,0,2,1
"3210","164e5a1deb2aace9f2ebd773ee4278af",124,89,61,14.2295081967213,85,39,3,3
"3211","16507073e2f9ac090ece108dddd36f49",182,61,82,15.5365853658537,177,5,3,3
"3212","165119b21be92074e15837e4ce131583",76,63,39,13.6410256410256,76,0,2,3
"3213","1651e4e3b7eae9fad0bbb2c9f6c27efb",172,69,83,14.5060240963855,120,52,3,3
"3214","16528d56bd2ce2a80b873cd5c6e1a318",21,21,0,21,21,0,1,2
"3215","16532c6df369557a748bbde95f45cbe0",41,37,45,6.37777777777778,41,0,2,1
"3216","1654d0328b2fe2dc4482d71ff9717f39",35,33,6,40.8333333333333,13,22,1,2
"3217","16563fe6aa5323f500e32b4e08ad2361",60,47,49,8.57142857142857,60,0,2,1
"3218","165722f0a7a863c2afef0f8b11485771",27,27,0,27,27,0,1,2
"3219","1657bc1333136689653bf8c3a1f4dd6b",45,26,73,4.31506849315068,45,0,2,1
"3220","1657d48a55bd7dab607f22fd1d80b100",31,25,74,2.93243243243243,31,0,2,1
"3221","1657e826b2c68fd89c6693b8f760ee6a",4,4,0,4,4,0,1,2
"3222","165b455bae8a2d8b63d60e78320babc2",109,61,70,10.9,109,0,3,3
"3223","165c366e88f712e07a21a75dd5ac7ba5",34,34,0,34,34,0,1,2
"3224","165d3d7d60d88876b5debc301a106a9f",101,80,25,28.28,101,0,3,3
"3225","165d9c726016e657abc8ea801d0e8d4d",120,78,76,11.0526315789474,120,0,3,3
"3226","16608113272d715756a914bafa53ba1f",25,25,0,25,25,0,1,2
"3227","166352748ac1109950a34d4c46c7acf4",24,24,0,24,24,0,1,2
"3228","1663644cc0468245aebebf076aaa8237",166,68,76,15.2894736842105,166,0,3,3
"3229","1664039a7644fcffb29a287b2549dbad",45,45,0,45,45,0,1,2
"3230","16644fa9f3c7287eccb449f3b01584fe",6,6,0,6,6,0,1,2
"3231","1665677573f15ee26c5d9fb5b26198f4",91,61,77,8.27272727272727,91,0,2,3
"3232","1665aedf373c38dc56b9cfd75af98071",25,18,52,3.36538461538462,25,0,2,1
"3233","166609698d4a669f3e32324756a61a1e",25,25,0,25,25,0,1,2
"3234","16675ebbb6670921925a19e11f0569ef",108,72,83,9.10843373493976,108,0,3,3
"3235","16694098efa2ccb70ff7725cbd07153f",29,29,0,29,0,29,1,2
"3236","166b23e405ed093b0392c0ab80f4e505",153,83,71,15.0845070422535,153,0,3,3
"3237","166d5616e0c849b72b3677913d6ccccc",85,42,67,8.88059701492537,85,0,2,3
"3238","166df004a3983e7b3922a61896d99810",24,15,64,2.625,24,0,2,1
"3239","166df854206c983b197ec08ff375b2d5",24,24,0,24,24,0,1,2
"3240","167260c156675a9d3fb0b0de7d0e11ee",22,22,0,22,22,0,1,2
"3241","1672b7a46ac1c8354e1e8dd0361ec7e6",41,35,21,13.6666666666667,41,0,1,1
"3242","167334c9498c6ad03ffc054d3f2862fe",30,30,0,30,30,0,1,2
"3243","167419b09ff04233828760ecfb8dd866",81,63,51,11.1176470588235,41,40,2,1
"3244","16747dae97be389bddd35be69d11106f",12,12,0,12,0,12,1,2
"3245","167816c2acd7cf225912c320a07b576d",72,57,25,20.16,72,0,2,1
"3246","167c569d22c704ea528239c6e5200cd0",106,73,50,14.84,106,0,3,3
"3247","167cc02e7bf795dcb06793dff896f12a",16,16,0,16,16,0,1,2
"3248","167d7a89837b37cc70dce037a5edec2f",10,10,0,10,10,0,1,2
"3249","16802e3b98c6301756305e6da0c2da99",22,22,0,22,22,0,1,2
"3250","168184a6707c16399654c75e2af3304a",16,16,0,16,16,0,1,2
"3251","168217e1d15d5d288d87551829b3260c",61,39,36,11.8611111111111,42,19,2,1
"3252","16835eeca0906ac7aa53f751fb013332",63,45,64,6.890625,30,33,2,1
"3253","168368116d901e7171712538a56a4c53",120,71,58,14.4827586206897,72,48,3,3
"3254","1685684189fda22d173964a85c399803",18,18,0,18,0,18,1,2
"3255","16863f3ba44eb4d842f584d98d16f01c",12,12,0,12,12,0,1,2
"3256","1687fcbceeef790e439aff9f6835cd23",25,25,0,25,25,0,1,2
"3257","16882de9d1d2b5e8b73753a1b8b62ae0",85,70,20,29.75,85,0,1,3
"3258","168837508042e28d4f4728a17a1ae4e4",98,76,56,12.25,98,0,3,3
"3259","1688b75c17b76d0770f07f216e50de5e",46,41,60,5.36666666666667,30,16,2,1
"3260","168b404780afb821132d5a99957a5e29",28,28,0,28,28,0,1,2
"3261","168ce3aa860cb845c281f4acf9fa53f7",116,70,60,13.5333333333333,78,38,3,3
"3262","168e179cb6ff7dccc2ebd013872b7ff6",92,73,81,7.95061728395062,92,0,2,3
"3263","168e5165572a87499619565441f1643f",120,84,40,21,72,48,3,3
"3264","168e52c4d4ddd96d1a23c886a83e6495",80,64,63,8.88888888888889,80,0,2,3
"3265","16909795874d4b3f4cbef300b5a16316",30,30,0,30,0,30,1,2
"3266","16910cd9a4517018434844240f86e4b6",82,42,49,11.7142857142857,82,0,2,3
"3267","1693b355d2e809ef5401525982ad2325",91,74,63,10.1111111111111,91,0,2,3
"3268","16954128c559b63ba62a617f25a584ea",136,92,63,15.1111111111111,136,0,3,3
"3269","1697ecf4928745e14561fdd97d35effe",18,18,0,18,18,0,1,2
"3270","169b818f525dbf5bf69a99976386890e",134,99,33,28.4242424242424,134,0,3,3
"3271","169d05044cb14923b185166ae0117d1e",52,52,0,52,52,0,1,2
"3272","169d2b702bd201240e4ba4e81e9f368c",180,120,63,20,180,0,3,3
"3273","169d3bfb377d39ac9faec2f3a474311f",54,49,69,5.47826086956522,54,0,2,1
"3274","169dd81a352e53655ce41643a233a664",74,62,80,6.475,74,0,2,3
"3275","169e56f1debc9c865bd2b65fac673c05",18,18,0,18,18,0,1,2
"3276","169f3894f2ae41fc373dfbe7cd539767",42,37,52,5.65384615384615,42,0,2,1
"3277","169fae644f0647eb6de28ab64654d1b0",84,59,72,8.16666666666667,84,0,2,3
"3278","169fe79ac2945f916a9df332668b94fa",19,19,0,19,19,0,1,2
"3279","16a3b4d25f7683bcc5dcc63814b5816b",85,62,72,8.26388888888889,75,10,2,1
"3280","16a7c5a49c8e1116b10699edf2b6051d",38,37,6,44.3333333333333,1,37,1,2
"3281","16a8aa82abbd347170e737f27cb53c0b",15,15,0,15,15,0,1,2
"3282","16aa878575d46570150425ceafc4b7fa",28,28,0,28,28,0,1,2
"3283","16aab73cfaca0193c769808f91ca68ae",52,48,48,7.58333333333333,52,0,2,1
"3284","16aadcc4369e4a64c619ab5bf24589cd",35,35,0,35,35,0,1,2
"3285","16af027917d3bebc69c4cb025bb53224",36,36,0,36,36,0,1,2
"3286","16afe2a71418ad140f27f5b44fea7f00",204,140,83,17.2048192771084,186,18,3,3
"3287","16b3a9573bb29a7f7c18035782715c38",37,37,0,37,0,37,1,2
"3288","16b6888846b7bceda53eb0bd98e1d025",12,11,15,5.6,12,0,1,1
"3289","16b6a55888fe0bcddd97ec543681fd92",55,46,44,8.75,55,0,2,1
"3290","16bd168f4900f30fbf2055113b28b2e4",27,27,0,27,27,0,1,2
"3291","16be95dcd9d3c4a9d5963b7aaf772320",26,26,0,26,0,26,1,2
"3292","16bef9c7b875061eff6db93c5548e346",56,44,36,10.8888888888889,33,23,2,1
"3293","16c3733c653bf2f0225f325783653ee1",172,84,68,17.7058823529412,172,0,3,3
"3294","16c4065ec8a678695df67d658e182643",81,66,25,22.68,81,0,2,3
"3295","16c6e172bb43bf2b35fa54df06b65392",22,22,0,22,22,0,1,2
"3296","16c6faba880628aecd6c1bcfd6c40c07",35,27,66,3.71212121212121,35,0,2,1
"3297","16c7739309541910ffe09172618c5976",56,38,87,4.50574712643678,56,0,2,1
"3298","16ca0f304502dceb1ecc26e036e35562",22,22,0,22,0,22,1,2
"3299","16ce34f0b2805498c8236eafdb370639",41,41,0,41,41,0,1,2
"3300","16d154e6c174badc5b28a20e4fad156e",161,84,67,16.8208955223881,161,0,3,3
"3301","16d5654f4ad2fb1b6241c1138d3fec8c",85,65,41,14.5121951219512,85,0,2,3
"3302","16d7a2b8b21617d6d8ee034e5ffb64ae",53,48,39,9.51282051282051,53,0,2,1
"3303","16d9c03c87d4b4671d91d19e8e16bdce",30,20,36,5.83333333333333,30,0,2,1
"3304","16dd80b45941f2b46d02e34a3bcb1708",11,11,0,11,11,0,1,2
"3305","16e11be0be17e5df21aa5ac67d0c19f0",45,45,0,45,45,0,1,2
"3306","16e14fa424dc41439a3202aa9ed9f63e",28,23,48,4.08333333333333,28,0,2,1
"3307","16e21ca05f18777beb8e643f415844c1",81,67,51,11.1176470588235,43,38,2,1
"3308","16e62584c9ef4f3acd46d89295b1ac9d",165,62,84,13.75,149,16,3,3
"3309","16e6567544587b8e09b5b706bce597b7",33,27,51,4.52941176470588,13,20,2,1
"3310","16e6ed4d42796cee8eec78a89d7763f5",60,51,57,7.36842105263158,60,0,2,1
"3311","16e9adc725fbc0565a7142674c7b5941",76,70,15,35.4666666666667,76,0,1,2
"3312","16ebb843acf304475eec69d456523a8f",66,58,22,21,66,0,2,1
"3313","16ee8c643e2bbebdef080726a28321fc",62,46,57,7.6140350877193,39,23,2,1
"3314","16f064dc906f5e29d19a158ee6a8aca2",156,88,73,14.958904109589,156,0,3,3
"3315","16f120b51e02b6842197ec7c5669880c",23,23,0,23,23,0,1,2
"3316","16f1b5db9e1521f345d37074bb722abc",38,38,0,38,38,0,1,2
"3317","16f32b75b6a3f10edc59ddaf3c1e9222",121,93,27,31.3703703703704,121,0,3,3
"3318","16f45f4c7f1a45ab68628dabf4143a7a",118,57,85,9.71764705882353,118,0,3,3
"3319","16f4d6c78886eee7a43ba75d49358a89",70,56,68,7.20588235294118,70,0,2,3
"3320","16f4f5ce5a3fe83c7cf64045030738fd",35,30,22,11.1363636363636,35,0,2,1
"3321","16f536520cf501cbb40848e7e4545ad2",90,61,60,10.5,66,24,2,1
"3322","16f74e9590b10ab73b6b8a0ee2c96fc7",34,34,0,34,34,0,1,2
"3323","16f77bf864cf7c2fdba73dfb7e301f42",42,29,58,5.06896551724138,42,0,2,1
"3324","16f85f38b2a57f0023cca007b7133d50",9,9,0,9,0,9,1,2
"3325","16fb959f9267a4b7d14a5c75d2390056",40,40,0,40,40,0,1,2
"3326","16fb9aab533ee13cd9db305bcc14a223",30,29,78,2.69230769230769,30,0,2,1
"3327","16fd2674878372e214c83b3048710431",55,55,0,55,55,0,1,2
"3328","16fe35a92008706cd7432ccbff0fa508",163,60,83,13.7469879518072,163,0,3,3
"3329","16fe9ca292727e54e6292a859b71099b",57,41,15,26.6,57,0,1,1
"3330","1701a15181dbde3a87683045e54b8cb0",38,38,0,38,38,0,1,2
"3331","1702c20271a4ca1e0414d70b1d254f5c",26,26,0,26,26,0,1,2
"3332","1708874713036106b879595c7ad5b22e",34,29,48,4.95833333333333,34,0,2,1
"3333","170a52c88a7f2d8d3bb2190e931b2ce3",27,27,0,27,27,0,1,2
"3334","170d57bad65b1096acff5f76f22e0140",46,46,0,46,0,46,1,2
"3335","171568e2547a5617b7092b47a7d5a97b",53,45,28,13.25,53,0,2,1
"3336","1715d03482cd9118b96b9bc013f2c351",51,43,70,5.1,0,51,2,1
"3337","17182f8060a50da785c35e6598ade05c",64,50,30,14.9333333333333,25,39,2,1
"3338","17187db0daa5d1379ac752ad6235d067",50,42,43,8.13953488372093,50,0,2,1
"3339","171d4c7d1c7bee0b0cef2599974d03e5",85,45,55,10.8181818181818,85,0,2,3
"3340","171d54be0a19b7dd0a54bd7d32294477",33,33,0,33,33,0,1,2
"3341","171db12f90ccf130ad964a81a6bd526f",53,42,14,26.5,53,0,1,1
"3342","1721e4bc9a1e906786a02e168681c3b8",72,49,53,9.50943396226415,72,0,2,3
"3343","172217c9403669b01007cd45493da6ad",36,36,0,36,0,36,1,2
"3344","17237fcf0a5313f35042953436cc9aca",150,92,58,18.1034482758621,106,44,3,3
"3345","17238cb4bbebb230ea68dcfc00f7a82a",77,69,70,7.7,77,0,2,3
"3346","1725e418fe275b0578279b76b84bc93e",41,41,0,41,41,0,1,2
"3347","1726b59fe1d47b7338a9c1706d469211",104,73,84,8.66666666666667,82,22,3,1
"3348","17293d81a7d9d2f2708777ce41594ba0",10,10,0,10,10,0,1,2
"3349","172aaf29b6cd73bc64f5e5ba6ed47da9",39,39,0,39,0,39,1,2
"3350","172d0939698e3b8a61073a3e51f6f57b",69,40,70,6.9,69,0,2,1
"3351","172d789dbba996bb0e3bc69fc57b1da2",44,42,65,4.73846153846154,22,22,2,1
"3352","172ec051ff407ed8b0dda7210ff06209",28,28,0,28,28,0,1,2
"3353","1732f8eb065a41668dbc7218d4bde41a",65,45,45,10.1111111111111,65,0,2,1
"3354","17349b215fb9be1c0701da1c5829c5f7",107,89,64,11.703125,107,0,3,3
"3355","173589a8f149419cbf16ee4008d0f7c0",43,41,14,21.5,43,0,1,1
"3356","1735bcafdd81090ae2e5d1206e87c9f8",43,43,0,43,43,0,1,2
"3357","173754d599a221dd14d831e3b8d84454",36,36,0,36,36,0,1,2
"3358","173791ed86b96d3e9f90ac80fe98211f",28,28,0,28,28,0,1,2
"3359","17379ec66901cfe14b904563ec5e9e69",13,13,0,13,13,0,1,2
"3360","173899b8dd80ad06f76eb0bec332b711",107,48,82,9.13414634146342,107,0,2,3
"3361","1739c79d2b644e016ba3224784b30dde",24,24,0,24,0,24,1,2
"3362","173b2b240049227612260f0f9fa4dd8b",17,17,0,17,17,0,1,2
"3363","173b8dd2afdf53309de65d5673376ccb",145,124,30,33.8333333333333,101,44,3,3
"3364","173c2d712740b238d2130cc1960c3236",34,34,0,34,34,0,1,2
"3365","173cb43fb93785374a1c7a731d9a0c98",29,29,0,29,29,0,1,2
"3366","173d1cae01815e1b595bf9c03210443b",256,125,62,28.9032258064516,212,44,3,3
"3367","173ed37b2673f8afaf349ff958439906",27,27,0,27,27,0,1,2
"3368","173f44e28f2a2fc6b9853f9994155ad9",160,102,68,16.4705882352941,160,0,3,3
"3369","174343a6b34bdef3bc8ee9a13251c608",39,39,0,39,39,0,1,2
"3370","1748f117c44cd2b362085bfd554d72cb",34,34,0,34,34,0,1,2
"3371","1749da2a536c65e1ab91a3c9fc4beda8",119,69,81,10.283950617284,119,0,3,3
"3372","174a077fd0c436b0bbc4e083d9215a63",23,23,0,23,23,0,1,2
"3373","174a50499c6866dac82a90175eb290e9",37,37,0,37,37,0,1,2
"3374","174dabaeb09d77b27b788ea42a3330e9",54,49,25,15.12,31,23,2,1
"3375","174f89385bebdaaa50448a53cfb7fac3",2,2,0,2,2,0,1,2
"3376","1750047d7ab00adae80da21a4bbcdd57",146,114,42,24.3333333333333,146,0,3,3
"3377","17500c561a228c34179711c2c2a723e8",217,129,60,25.3166666666667,217,0,3,3
"3378","1755116e8f581308e86d298b173457e9",26,26,0,26,26,0,1,2
"3379","17562393f0778a81936c65a40a646e07",21,21,0,21,21,0,1,2
"3380","175665ce5ec2efbf7ede05f05c346bcf",15,15,0,15,15,0,1,2
"3381","17566cc9e1b6df2a931f98fd12846252",7,7,0,7,7,0,1,2
"3382","1759410e075597df03e0e9515eafe114",23,23,0,23,23,0,1,2
"3383","175ccbc8d583e30efa9f9b8adff800e6",103,65,56,12.875,82,21,2,1
"3384","175dc1e218367c0d6ee60eebbeee73e4",143,87,61,16.4098360655738,110,33,3,3
"3385","175ea3a75875266646e8cb43af282e82",60,47,20,21,60,0,1,1
"3386","1760e46cea0a554e148cc0e481edad68",121,82,64,13.234375,102,19,3,3
"3387","1761434b9189c8bbbadc2613ee60b14d",21,21,0,21,21,0,1,2
"3388","1761ca1283252c1cd327f3a48c663990",2,2,0,2,2,0,1,2
"3389","1765aff8ad300191db72ae6b90c4579d",17,17,0,17,17,0,1,2
"3390","17665b1948c39b15c22d6793a28a7bbd",130,100,31,29.3548387096774,130,0,3,3
"3391","1768d7619357ff043db4e2314ae86150",66,44,65,7.10769230769231,45,21,2,1
"3392","176c73097227c3ecfc87d246fc91321e",45,45,0,45,0,45,1,2
"3393","176d28b521472add1d3c199972658870",18,18,0,18,18,0,1,2
"3394","176ee94a530e5bc303dca4062c12dee4",34,25,73,3.26027397260274,34,0,2,1
"3395","176f5717f18f3b12fa9c5f7743ffe9db",5,5,0,5,5,0,1,2
"3396","176fc28182230ff43818351d296e8f42",89,62,15,41.5333333333333,89,0,1,2
"3397","1771a67d55fe9ee46c700c455d6dfdec",16,14,33,3.39393939393939,16,0,2,1
"3398","1775a6baff537a5cc41ea0e735c62913",219,102,85,18.0352941176471,173,46,3,3
"3399","17770962ff148447c09eea115036ac78",77,68,79,6.82278481012658,65,12,2,1
"3400","177909b49e08bbc8885dfd776b4b121e",13,13,0,13,13,0,1,2
"3401","177b06cc4c748995d3112f1951c308b8",19,19,0,19,19,0,1,2
"3402","177b0915a84121683427c19fb52a14cc",18,13,59,2.13559322033898,10,8,2,1
"3403","177b3d8c42e818fba0ab134bcefa57e3",120,65,63,13.3333333333333,120,0,3,3
"3404","177f09d766cf733eb1478023f37138a3",179,77,70,17.9,179,0,3,3
"3405","177f6a2114e10afd9b91f4023ede32f8",30,26,32,6.5625,30,0,2,1
"3406","17831942b9c3b662d6b9a754daf1eade",24,24,0,24,24,0,1,2
"3407","178539d14ddc1fc0129f6b077e43e2fc",95,85,33,20.1515151515152,95,0,3,3
"3408","178927e7205f516a8c748b3f994a314d",97,70,88,7.71590909090909,97,0,2,3
"3409","178aceae16e5d1f7c6c04053dc1e388f",101,62,70,10.1,101,0,2,3
"3410","178bf45c2041610c528af3bc33437c0e",125,83,46,19.0217391304348,125,0,3,3
"3411","178da0d12c2c0da60f7bcef863bf6fb7",12,12,0,12,12,0,1,2
"3412","178e54b11319911b46aab31cbb08b18a",63,47,44,10.0227272727273,39,24,2,1
"3413","17913207f3a8dd2faf63027fdb3d3b8b",65,55,61,7.45901639344262,65,0,2,3
"3414","179296e0f7752cd356e4083c37de9824",68,63,68,7,68,0,2,3
"3415","1793832ff43df0f6bebe5a15a22013e5",194,135,73,18.6027397260274,194,0,3,3
"3416","17969f26d6af802e54de6cb47aeecb46",16,16,0,16,0,16,1,2
"3417","1798a29a6c7e5ceb364d79dd1f7d5ebe",29,24,31,6.54838709677419,29,0,2,1
"3418","1799157c8992872be9f7ae66905a03da",19,19,0,19,19,0,1,2
"3419","17995f2d09e6e7ce9b67f53067368f83",54,45,31,12.1935483870968,54,0,2,1
"3420","179a8e1b5a4c21ccf68021e8aa88cab2",110,73,46,16.7391304347826,110,0,3,3
"3421","179ba4aa3930cb747df30e143fc34885",49,49,0,49,49,0,1,2
"3422","179c4847d61c4dd51477d4ae35a8c8bf",54,49,36,10.5,54,0,2,1
"3423","179da3fb0b7e92a7babc77f44cd12bb6",27,27,0,27,27,0,1,2
"3424","179f0a4d780e9a8b639042eb27c7c256",104,84,14,52,104,0,3,2
"3425","17a06ab9e6aa37d2e11e7adafcfc2870",8,7,2,28,8,0,1,2
"3426","17a0dfb7f6da37a8e0b397a01468c56e",189,123,75,17.64,156,33,3,3
"3427","17a391a1280ee02eff889b1bc61598e2",117,82,58,14.1206896551724,78,39,3,3
"3428","17a3d172ddc307a0c110b32b07e2b042",10,10,56,1.25,10,0,2,1
"3429","17a4e38090534afbb2d72218d2e4e7b0",46,40,25,12.88,46,0,2,1
"3430","17a62bf901caf0e00ea7d76aec90012b",103,53,34,21.2058823529412,103,0,2,3
"3431","17a82bddd17fffc029450432db46aaa3",82,61,28,20.5,82,0,2,3
"3432","17a91b98e10a2a69505b9b2166d04b73",56,43,35,11.2,56,0,2,1
"3433","17ab4ebe6fbe562f539903da47685d17",191,100,45,29.7111111111111,191,0,3,3
"3434","17ab5afe749980671b565714682d4869",122,92,41,20.8292682926829,122,0,3,3
"3435","17ab8ef72bbe57e09be658152d5ef3f3",18,15,11,11.4545454545455,18,0,1,2
"3436","17acfb3064b7c0db927af5ed4de5fb55",29,29,0,29,29,0,1,2
"3437","17b092cd64609c4c73304c946d385907",37,37,0,37,37,0,1,2
"3438","17b0f303b9725635ca352f678d91cd69",24,24,0,24,24,0,1,2
"3439","17b22dde8acea0a4327aa4b61e36416c",24,24,0,24,24,0,1,2
"3440","17b2bd23a6e61733d8a48b8e25656cef",100,77,53,13.2075471698113,100,0,3,3
"3441","17b461293ca87de51ea4629cb41b1c2a",89,58,31,20.0967741935484,89,0,2,3
"3442","17b4c3859262abfa8c668ab9ba5e3c3f",92,60,56,11.5,92,0,2,3
"3443","17b564e8035b5237333d6d3381ce1d00",50,50,0,50,50,0,1,2
"3444","17b9950273899201e2a90328b67ef0dd",25,25,0,25,25,0,1,2
"3445","17bccec87b6d79a02e36bd26224f537d",44,44,0,44,0,44,1,2
"3446","17be5acc12b0192cc71eff6351a1ae3a",111,66,43,18.0697674418605,79,32,3,3
"3447","17bfc73b083d485904e10b696dd7ee68",15,15,0,15,15,0,1,2
"3448","17c8cbf0cb7b751b0a5a64a42bb9d0d7",31,31,0,31,31,0,1,2
"3449","17c9298740e650e67d766953dfaa175f",124,77,67,12.955223880597,71,53,3,3
"3450","17c95f961ef56180cdf4fe6aa85985ee",77,61,28,19.25,77,0,2,1
"3451","17cac251539d1dd3047431c3c0a5a893",46,46,0,46,46,0,1,2
"3452","17cc2331d1b595f3602d6182f7a239f2",23,23,0,23,23,0,1,2
"3453","17cec0dbc026f097b8fa3ad412d81857",36,33,19,13.2631578947368,36,0,1,1
"3454","17cf5fee30d9dfd037491c63204586cc",24,24,0,24,0,24,1,2
"3455","17d2609a0f184532cd292d97c8cbcc34",139,100,36,27.0277777777778,139,0,3,3
"3456","17d41f5d3822beb28416d7485a408956",31,28,6,36.1666666666667,31,0,1,2
"3457","17d71aedfd80eea960d051b7bb004f4a",45,38,25,12.6,45,0,2,1
"3458","17d78f3aece99a91adeca1ce70653b8c",23,23,0,23,0,23,1,2
"3459","17d85e1712921e91179e7ec5d7b69f1e",39,31,55,4.96363636363636,39,0,2,1
"3460","17db04f08e37780190ac51fcf0c22f55",47,39,28,11.75,47,0,2,1
"3461","17db46c38afd663d90a73cf45ebd2300",31,31,0,31,0,31,1,2
"3462","17db7981c5ca3ff6211e9eaa0d997b6f",19,19,0,19,19,0,1,2
"3463","17df16d024dd9b54a615e418a9a783da",83,69,46,12.6304347826087,61,22,2,1
"3464","17e175edaf26cb500aedeab88e2bca67",61,31,64,6.671875,61,0,2,1
"3465","17e390b78f0da9e0d4834f1b08ba8921",46,36,39,8.25641025641026,46,0,2,1
"3466","17e7133e70ef881cce7fdcfbe529c1af",157,76,58,18.948275862069,104,53,3,3
"3467","17ea8dc2d4be45be4b79a02f112bd141",159,71,86,12.9418604651163,159,0,3,3
"3468","17ec5f5992e3e0d7ec795b2eae3b1a48",156,87,49,22.2857142857143,156,0,3,3
"3469","17ed3669f5a1cf232a7042020e08f8d9",98,67,25,27.44,98,0,3,3
"3470","17edb0b577c5ba01007893f000e895fe",97,54,69,9.84057971014493,97,0,2,3
"3471","17f0a9a0ef746f86c112f3155cae18b3",32,32,0,32,32,0,1,2
"3472","17f3066dde36ba992c3684107d9dcff7",26,26,0,26,26,0,1,2
"3473","17f4020b0002182e361361ba4bb865f7",78,69,28,19.5,78,0,2,3
"3474","17f4fda922f74e294c1e533d34708337",12,12,0,12,12,0,1,2
"3475","17f770326b7b3037838089bf9a6c5ee2",28,28,0,28,28,0,1,2
"3476","17f79f19231e8ac9d3d1c441e43124dc",40,40,0,40,40,0,1,2
"3477","17f8510b0953a648c66a89e59714de10",23,23,0,23,0,23,1,2
"3478","17f9a643376df9769170cf973fbc5a43",26,22,33,5.51515151515151,26,0,2,1
"3479","17fa82389c8264cf0ca216392cc99694",31,26,76,2.85526315789474,31,0,2,1
"3480","17fbe427ad50555260b6ed76d67b0d1b",44,44,0,44,44,0,1,2
"3481","17ff6ef2dce720224c5c6d386e097d77",29,29,0,29,29,0,1,2
"3482","18003ec0de98e228e25ca2ba82cd83c8",48,48,0,48,48,0,1,2
"3483","1800cc98c67657b46fcfdeba1c23e169",18,18,0,18,18,0,1,2
"3484","1801cebd2ca57d151b366d35a43ae000",79,45,81,6.82716049382716,79,0,2,3
"3485","180420ab3182059d5680b9c90796e4fd",52,51,12,30.3333333333333,52,0,1,2
"3486","1806b407e027006a3dced72902d79b6b",146,94,77,13.2727272727273,127,19,3,3
"3487","1807e66be2db29bf6a12d1a0ca3c8d3a",66,38,61,7.57377049180328,66,0,2,1
"3488","180995b58d8983e0a4f7249882634360",185,72,73,17.7397260273973,185,0,3,3
"3489","180be756126f6cf4f574f6716ddda318",75,53,55,9.54545454545455,36,39,2,1
"3490","180c16f53ed1611290280fd68030b08d",24,24,0,24,24,0,1,2
"3491","180cb1fea35d7d4ad1667df276bb3b35",32,21,41,5.46341463414634,32,0,2,1
"3492","180ce8379a59d81b7371c8c72b438ab4",117,68,62,13.2096774193548,117,0,3,3
"3493","180d688a39d80a4980c95b438a5fa921",18,18,0,18,0,18,1,2
"3494","180f26a10efa2c3eff17f0edc1169a21",30,30,0,30,0,30,1,2
"3495","1812553363694c99995df04d3e2ee6ba",19,19,0,19,19,0,1,2
"3496","18125c1b8aa4ab92e8263740e02af15b",16,16,0,16,16,0,1,2
"3497","1816d95013305cabdc6b125bf573e446",15,15,0,15,15,0,1,2
"3498","181803595cc7804fdb3b9c69001706ca",13,13,0,13,13,0,1,2
"3499","18186daaa2faf4a2aed9110a9a9923ef",32,32,0,32,32,0,1,2
"3500","1818d6104ef930e0fb11bdaf73b01ccd",21,21,0,21,0,21,1,2
"3501","181ac506d3f53fbe78070b7022fd15d6",26,24,28,6.5,0,26,2,1
"3502","181d503b3f4398a0518ca7f957a5d1b7",150,82,77,13.6363636363636,150,0,3,3
"3503","181d8152529a9c2d00c74edd15feb869",38,29,38,7,22,16,2,1
"3504","18220cb5da6c7578fd939ac58d9a44b3",24,24,0,24,24,0,1,2
"3505","1824cd55d719fee57155806269dfecf0",91,35,77,8.27272727272727,81,10,2,1
"3506","1829b7fecb9046c8c69c262d80e2078e",149,95,75,13.9066666666667,130,19,3,3
"3507","182a915ce42974956a696e560014768d",70,58,76,6.44736842105263,49,21,2,1
"3508","182c5c71dda468a1b506f271c61870d7",3,3,0,3,3,0,1,2
"3509","182e61a0ce177983e0d3156bd27d24ba",78,54,80,6.825,78,0,2,3
"3510","182eedab8ede0c397e4ab940ae9a2bd8",50,50,0,50,50,0,1,2
"3511","18333faf3c9114fa9a803fe8c077fe7b",1,1,0,1,0,1,1,2
"3512","1837a858690a30133436108ffdf89a76",43,40,20,15.05,43,0,1,1
"3513","1837c28327da149ce54184a960d6082f",137,98,56,17.125,137,0,3,3
"3514","18380314ff91371bc19ff2708ac1cb44",151,91,62,17.0483870967742,151,0,3,3
"3515","183ba6e96a285cbe3a72556bbc31e76d",166,86,60,19.3666666666667,166,0,3,3
"3516","18413b5bd852f71341312426d512a997",19,19,0,19,19,0,1,2
"3517","1844dcbe6627fb230b437bd456af98b0",58,41,75,5.41333333333333,58,0,2,1
"3518","184602a83a6c6d901983b4b27db420dc",33,33,0,33,33,0,1,2
"3519","18485ca414e9c5e777e4baeb30c39172",68,52,36,13.2222222222222,68,0,2,1
"3520","1848b9b97e76ce5a4b97ccb51da8e931",179,107,88,14.2386363636364,163,16,3,3
"3521","18492add4f61451686ac461b7ced0774",66,54,43,10.7441860465116,35,31,2,1
"3522","184936e18e0bee7288b8b191582bade9",149,109,71,14.6901408450704,149,0,3,3
"3523","184b32eadbef6935280303e6f1252754",53,53,0,53,53,0,1,2
"3524","184e9daa407d9ebb20b5b0522ef74a6b",49,37,26,13.1923076923077,49,0,2,1
"3525","184f1beee9f237ecd2ce3ff78cf2ec5a",28,23,24,8.16666666666667,28,0,2,1
"3526","1852ee0d14944f8296b91191ac23ca15",21,21,0,21,21,0,1,2
"3527","1853b8a2661dfe279a0bf1bc5a09ccfb",1,1,0,1,1,0,1,2
"3528","1854fac75c8002e93b2f4534e85c8f93",10,10,0,10,0,10,1,2
"3529","185636c36a149d0d2b95cbecc4e9f153",33,33,0,33,0,33,1,2
"3530","185809da110d38d4708a4df9782240aa",51,35,65,5.49230769230769,36,15,2,1
"3531","185a9ed5bad636a0112e9c51fe421a43",21,21,0,21,21,0,1,2
"3532","185d45cea17deed3db7d834ff3c451dc",85,49,70,8.5,85,0,2,3
"3533","185d6727d9e5746c273d9224fa03c929",97,76,48,14.1458333333333,64,33,2,3
"3534","185e028c989e84e1088ff8b04427934b",66,50,30,15.4,66,0,2,1
"3535","185e0a14cff9ecdbfc4d3ab736de94cb",36,36,0,36,36,0,1,2
"3536","185f4192de98dcf347bf91b76663785c",19,19,0,19,19,0,1,2
"3537","185fb39eaf3a8acb921dae3743e6d0c3",32,32,0,32,32,0,1,2
"3538","18604e64c441b7045fe0e90e0707a943",21,21,0,21,0,21,1,2
"3539","18605b317502012f1471061deb812f44",51,51,0,51,51,0,1,2
"3540","186760719ad11b8159483761d9207433",31,25,35,6.2,31,0,2,1
"3541","18687017a79befe061bc567a24054ed9",151,72,82,12.890243902439,151,0,3,3
"3542","1868d4d4c9f288325688cae5c35c345a",129,78,73,12.3698630136986,82,47,3,3
"3543","186aa09d2ae4c19760c27683f7695a0b",15,15,0,15,15,0,1,2
"3544","186c7410f444056db21d5f5c9d206ed9",155,81,73,14.8630136986301,155,0,3,3
"3545","186d998b089b361cc26d6b3c452f59d6",32,31,4,56,13,19,1,2
"3546","186e481fd40177aa6b1e6aa5c1c29916",38,32,75,3.54666666666667,38,0,2,1
"3547","186e921cce6781f285b21ea92f565428",21,21,0,21,21,0,1,2
"3548","18705a9d8e66a7583c984d2257e16f28",8,4,36,1.55555555555556,8,0,2,1
"3549","1870e98f306fbd7250c786b2603de1dc",80,61,75,7.46666666666667,43,37,2,3
"3550","1871207253cfe24e53a91d13c465828e",19,14,68,1.95588235294118,19,0,2,1
"3551","187293693260ac5fc62def4152d1461a",25,25,0,25,0,25,1,2
"3552","1872d3259faaf25ed266c4d637728bc4",106,50,63,11.7777777777778,106,0,2,3
"3553","1872df50016cc8eccddec1c1fca80ae2",82,62,37,15.5135135135135,82,0,2,1
"3554","1874961011e063b907fbe108705426c9",142,69,84,11.8333333333333,105,37,3,3
"3555","1877334a1741f0fbef6a27401b2e6018",22,22,0,22,22,0,1,2
"3556","187733c69d85d775818837dd6006417f",56,48,43,9.11627906976744,56,0,2,1
"3557","18778932a74c1115024c2ab8dedf0d87",33,33,0,33,33,0,1,2
"3558","1877cae87617123ee527e099bef65ec8",20,20,0,20,20,0,1,2
"3559","187aee3c32944c9b1efe75e9900d1c20",44,35,35,8.8,44,0,2,1
"3560","187d9be54b81b1add5f774cb99f2fef0",13,13,0,13,13,0,1,2
"3561","187e0f69610d2584b57ecfebe3d6a98a",174,102,76,16.0263157894737,131,43,3,3
"3562","187ef4bc6f2bc3db989e8acd8a17a856",90,58,52,12.1153846153846,64,26,2,1
"3563","18810c0f6fe5caed28970ae2a3d296fb",31,31,0,31,0,31,1,2
"3564","18813bf8a3694f517cbd5f133a86b0e8",153,61,66,16.2272727272727,153,0,3,3
"3565","1884d233c01e99766f7a0c252d9341fd",29,29,0,29,0,29,1,2
"3566","18878c938fd40a2da1b8931e0e9c610f",52,52,0,52,52,0,1,2
"3567","1887dc6ba71f6650403bcfa426ba6602",111,75,58,13.3965517241379,69,42,3,3
"3568","188809c050ddc1d2ff1f06d7096fb196",82,61,61,9.40983606557377,82,0,2,3
"3569","1888c3767c706140db8efd78c094e948",37,28,46,5.6304347826087,37,0,2,1
"3570","1889c854f6f8d2f2662962de88416ca0",38,30,7,38,0,38,1,2
"3571","188b29ed12222c20609423ebff2830fc",131,67,71,12.9154929577465,131,0,3,3
"3572","188db362ee7ec426f92fb5855b461eed",168,97,58,20.2758620689655,142,26,3,3
"3573","188dcb277f48318c7a6a5797604c52ca",37,31,17,15.2352941176471,37,0,1,1
"3574","188ec909319d5d57286db9be932bc1b0",17,17,0,17,17,0,1,2
"3575","188f10a6c9e3069b845b4ac3eb00b053",21,18,13,11.3076923076923,21,0,1,1
"3576","189320fe506d296e5cd6edb5fc854b38",132,92,53,17.4339622641509,132,0,3,3
"3577","18967628583915fef7341e4aad966783",76,63,63,8.44444444444444,76,0,2,3
"3578","189abeb3812feb0dbec529cab5597d1a",28,28,0,28,28,0,1,2
"3579","189b0bdd10dd3f5cac16f6d6cddc7118",131,65,63,14.5555555555556,131,0,3,3
"3580","189b319f89a327522433fbd67b28667b",169,87,56,21.125,117,52,3,3
"3581","189d9dcc1f268265afdf44a544f363b6",33,33,0,33,0,33,1,2
"3582","189e0da417bdf75b2a3a222a163c3684",218,93,81,18.8395061728395,196,22,3,3
"3583","189fbbb610936d780f5c166c51fa95c1",20,20,0,20,0,20,1,2
"3584","18a09f6310e9dd490d5f9edfcd7486fd",26,26,0,26,26,0,1,2
"3585","18a0a18f5e05faa0947b9f832c8e6877",62,38,81,5.35802469135802,62,0,2,1
"3586","18a0b83af6f581b69664e555b11799a1",85,71,30,19.8333333333333,46,39,2,3
"3587","18a0bd61d90885815554aed89afbb079",34,34,0,34,0,34,1,2
"3588","18a279b7627eb2c7cc7b1fe1a9f69bf7",67,54,46,10.195652173913,67,0,2,3
"3589","18a33f55c6a3c764384b634234049eaf",6,6,0,6,6,0,1,2
"3590","18a7093171f2b1fce5f4c6901a286f2d",216,137,44,34.3636363636364,216,0,3,3
"3591","18a8785d153a14150f00f8b026558806",36,22,64,3.9375,14,22,2,1
"3592","18a97393d6fb9cc8b03271ab361ffc27",178,103,56,22.25,178,0,3,3
"3593","18ab242c0dfee068d0aa7a645d1dc183",111,49,86,9.03488372093023,111,0,2,3
"3594","18aba9eaf103a2c4323f7ea928a29f0c",114,92,27,29.5555555555556,114,0,3,3
"3595","18abc1066ec68ad22b12439ef501408c",43,26,27,11.1481481481481,43,0,2,1
"3596","18ac567032b07fdaa35b9c727f6b0eb8",55,55,0,55,55,0,1,2
"3597","18ad50b09f69f0283e760fd5c83b8313",48,40,39,8.61538461538461,48,0,2,1
"3598","18aee6624dd6a1d9792a6da54bfbf7a3",78,41,55,9.92727272727273,62,16,2,1
"3599","18b13bd2c6304f5141896b09eec9c1c1",44,35,38,8.10526315789474,44,0,2,1
"3600","18b1a0540a7e96c6180538cfcf6ec6cf",46,46,0,46,0,46,1,2
"3601","18b260d59022d96f766fb1aa0ed14f1d",1,1,0,1,1,0,1,2
"3602","18b327a26881e9789b00361239c66e15",52,40,48,7.58333333333333,52,0,2,1
"3603","18b367e93200dce0e5d871ca0d06f01a",41,41,0,41,41,0,1,2
"3604","18b5ed5f9bf5e8230e275d06bd6cbaae",25,25,0,25,25,0,1,2
"3605","18b93b778e63898c4c209151198f1a84",32,32,0,32,32,0,1,2
"3606","18bbd0d99425579777b6508eebfcdca0",83,53,86,6.75581395348837,83,0,2,3
"3607","18bc3a5361185ebdfa7541f0b7242d7b",21,21,0,21,21,0,1,2
"3608","18bc5c21e75d204a447c754b39b3e965",14,14,0,14,14,0,1,2
"3609","18bd22e86db4af40a6c409b9865cdb44",10,9,56,1.25,10,0,2,1
"3610","18bd33f40ec19bfbc3f69e56cf70b533",115,87,42,19.1666666666667,115,0,3,3
"3611","18bd695886dcd471c3947e0d3598db5e",14,14,46,2.1304347826087,14,0,2,1
"3612","18bec63cd4c6d33286888d9ef4853089",99,67,61,11.3606557377049,68,31,2,1
"3613","18c160e40df3d40da7f9475305355d7e",53,53,0,53,0,53,1,2
"3614","18c2d18026e8359f6e3ae61218f59503",115,75,54,14.9074074074074,115,0,3,3
"3615","18c354bc83b2c722a8b1c7bd5d1922c6",91,55,66,9.65151515151515,63,28,2,1
"3616","18c7821dd0691dbfc2a4bbf26b28aebc",120,79,49,17.1428571428571,120,0,3,3
"3617","18c8e8ac26837db5c1e576a0bd386b8a",258,150,82,22.0243902439024,208,50,3,3
"3618","18c951e2a5b4d107e78d61f3e0a4ebd3",52,40,22,16.5454545454545,22,30,2,1
"3619","18cb1eee3fb2911cffc0be4685cf4007",20,20,0,20,20,0,1,2
"3620","18cba92311a482e6acbd41aac054446c",12,12,0,12,12,0,1,2
"3621","18cbb45fe92df174044100f44f1e1042",21,21,0,21,21,0,1,2
"3622","18cc3cd7d1c2c87ef9d98b25ffd37394",13,13,0,13,13,0,1,2
"3623","18cdcd193525a1b26bd2ad0cf78b6c83",15,6,68,1.54411764705882,15,0,2,1
"3624","18d1deca0a4c5f1b29a49e73c243ac2c",15,15,0,15,15,0,1,2
"3625","18d3b546302d1a6d5274a2ba952bcc35",211,121,65,22.7230769230769,211,0,3,3
"3626","18d572e8eb64b8c10ed7ea234c67559b",30,30,0,30,30,0,1,2
"3627","18d6e795cbc2fe6521c235090b0300c7",16,16,0,16,16,0,1,2
"3628","18d7313c08c1a94b94f74af4cd8ed04f",12,12,0,12,12,0,1,2
"3629","18d745ce99a522c269417d58ec53a485",23,23,0,23,23,0,1,2
"3630","18d81219d59742248c7a09ec50ed931d",63,34,28,15.75,33,30,2,1
"3631","18dc3a0d3fc9aad36944801bdfe682be",23,23,0,23,23,0,1,2
"3632","18dcc5ffbe3267056e8d040b5f95fd6f",6,3,69,0.608695652173913,3,3,2,1
"3633","18dde44c6fe97bd372dd0a05a7ef9ac6",175,113,71,17.2535211267606,130,45,3,3
"3634","18e25bfd64d902bf50ab71d94caee565",120,73,46,18.2608695652174,120,0,3,3
"3635","18e2753572c7beb754803974b2870abd",52,48,28,13,52,0,2,1
"3636","18e3f4001591ecf58db23ef1f9bf5e63",225,130,77,20.4545454545455,185,40,3,3
"3637","18e4f3bf88965d5139a12ba6bb59b040",14,14,0,14,14,0,1,2
"3638","18e6836008b34853936559ad3a7dde9a",32,32,0,32,32,0,1,2
"3639","18e76eebd1d51dc8b4db63fb59554b2b",54,44,27,14,54,0,2,1
"3640","18e83e221f6a06ff3d8161c1f3f25b61",44,40,55,5.6,44,0,2,1
"3641","18e9f7952986d262f976382bfe2ad13e",24,24,0,24,0,24,1,2
"3642","18ea748bbdcf41d57cf45c6777dc8436",69,57,33,14.6363636363636,39,30,2,1
"3643","18eb169374330bf5d83be6a1423e3ce2",35,35,0,35,35,0,1,2
"3644","18ee8f397b6804ec1ddb3c9ccffe95d4",73,56,35,14.6,73,0,2,1
"3645","18f0d3bc785eb1f6c3cdaf19fb7a63e8",43,43,0,43,0,43,1,2
"3646","18f6cad5ce412343b9e422fb352895ed",78,46,69,7.91304347826087,78,0,2,3
"3647","18fba00556cd582b25d2fa8c29e4ce60",12,12,0,12,12,0,1,2
"3648","18fcde9a03dfd7f3aca254539451e26b",17,17,0,17,17,0,1,2
"3649","18ff26b822f79bf7a632d570a0050646",19,19,0,19,19,0,1,2
"3650","1904f4194f24cd7eb807db4b0b51e3e8",38,38,0,38,38,0,1,2
"3651","1908d1176c37175fc42c606940b3afd9",13,13,0,13,13,0,1,2
"3652","190caa95ac8e66ae8bea1c184f575e38",18,18,0,18,18,0,1,2
"3653","191277e8770e528369de9b3aed2c79e9",2,2,0,2,2,0,1,2
"3654","1912d28da3d368e0bd6b1f0a36ac22c6",7,7,0,7,7,0,1,2
"3655","1913073ee726a99543b3f09e32deafda",95,66,75,8.86666666666667,95,0,2,3
"3656","19144532e1733ec2938cae854f7c3e28",2,2,0,2,2,0,1,2
"3657","19148e217640312f7b8c5919ceda501f",10,10,0,10,10,0,1,2
"3658","191659894f18aa67ec77d0e6d0960f0a",77,66,12,44.9166666666667,77,0,1,2
"3659","1917224ca0be92ede3a58d826f99b23f",40,40,0,40,40,0,1,2
"3660","1918115cd0bfa3f71cab8873d8a627c3",38,27,49,5.42857142857143,38,0,2,1
"3661","1918152b53195ba11b7a61714549094d",33,31,18,12.8333333333333,33,0,1,1
"3662","191a65bd31a61db55d9675cad5fee7f6",31,31,0,31,31,0,1,2
"3663","191afa6c5d41c557653f7781fd7a8712",84,67,63,9.33333333333333,50,34,2,1
"3664","191b87a45a98f1d190deccdd2a74ca4b",50,29,41,8.53658536585366,17,33,2,1
"3665","191e9630f2f04a5211033dd8abe2cc37",37,37,0,37,37,0,1,2
"3666","191fe572bffa7041a5480b769bf3f5a6",41,35,82,3.5,41,0,2,1
"3667","1920d52bebe16c458565f51d0a1b698e",139,113,50,19.46,139,0,3,3
"3668","19226f312b01cbcd557d53ce96533339",2,2,0,2,2,0,1,2
"3669","1922fae52da0b8b5437d559b6843a137",10,9,7,10,10,0,1,2
"3670","1924eec2e37586aa6827a42a0202ef36",45,31,14,22.5,45,0,1,1
"3671","1924fb8e7a9666bcbab0ac7e5e773bc1",32,32,0,32,32,0,1,2
"3672","19267eb1a62e710571ba1ce43435fe6b",21,21,0,21,21,0,1,2
"3673","192807aefae125c748e253989e7375b2",32,18,68,3.29411764705882,21,11,2,1
"3674","192ae2d8055e5f31dc643a200aff3926",45,45,0,45,45,0,1,2
"3675","192b95373bcc81d1b619f7c596523c94",1,1,0,1,1,0,1,2
"3676","192faaadd659091b17d430967605da67",40,35,33,8.48484848484848,40,0,2,1
"3677","1932cbf237d156d58c38a0117802ff5c",22,22,0,22,22,0,1,2
"3678","1932fe826bc6ac15f1b1f7128b69f09b",124,96,38,22.8421052631579,124,0,3,3
"3679","19330e31aa0004770767de514b9844b8",43,43,0,43,43,0,1,2
"3680","19342e8c3b04092a345ea604125fbf67",45,30,62,5.08064516129032,45,0,2,1
"3681","19355f86e3406651fbfc886ac58173f6",26,26,0,26,26,0,1,2
"3682","19396537cda44c86d83206f1c2d8a776",33,33,0,33,33,0,1,2
"3683","193f3fab17e1fc32667157d907c6203b",12,12,0,12,12,0,1,2
"3684","193f6c4eb2f0c101d7563277139f2ec6",32,32,0,32,32,0,1,2
"3685","194128201546a3cc4cf5901d7de77b05",55,30,76,5.06578947368421,55,0,2,1
"3686","19419b81adfd99b8906189384e631862",19,19,0,19,19,0,1,2
"3687","1945473cacc0b9d3b0fc23b18a6f27a7",195,151,58,23.5344827586207,195,0,3,3
"3688","1945a823d0e9e5bea371a24fecbb5eb1",38,38,0,38,38,0,1,2
"3689","19462b757328b6af6621aade1441b51d",40,40,0,40,40,0,1,2
"3690","19466cbfcf4e0d5b7dc45f1eb7f9b26a",73,66,26,19.6538461538462,73,0,2,1
"3691","1946788c2cc54086eaf82c8716951aa2",143,110,83,12.0602409638554,116,27,3,3
"3692","1948a9366b61181364473ce6a7efc893",30,19,28,7.5,30,0,2,1
"3693","1949ed146589c0ae5757a3d15d77a335",20,20,0,20,20,0,1,2
"3694","194f523a6e541804e19fb31d959d89d2",148,83,79,13.1139240506329,148,0,3,3
"3695","1950270a7ac43a21162be4aed41c2989",20,20,0,20,20,0,1,2
"3696","1951ab810520dfefeabf505a4d8cc648",140,98,75,13.0666666666667,88,52,3,3
"3697","1952d856dd5ff612f562d6947addc8c5",85,71,60,9.91666666666667,85,0,2,3
"3698","1955cefd6a7f7888392fe1340caf95aa",60,48,42,10,60,0,2,1
"3699","1956e6540281bf3089cfd3f85eacb324",21,18,7,21,21,0,1,2
"3700","19596e8321abee78dced89d39d5bece0",43,40,12,25.0833333333333,20,23,1,2
"3701","196016b23a20c9acca91afee0b01076e",145,70,58,17.5,145,0,3,3
"3702","196283f825289eadae83cae4e1e3da1f",74,57,54,9.59259259259259,74,0,2,3
"3703","1963ec6d3697919995b727d06eb3a58c",36,21,58,4.3448275862069,22,14,2,1
"3704","1964f955b7910ad639eeef7f80f638f0",14,14,0,14,14,0,1,2
"3705","19653062e75765088820524ac413c02a",24,24,0,24,24,0,1,2
"3706","196613ae2b2f2f1a9c053428683ef03f",32,32,0,32,32,0,1,2
"3707","1967768fbb0c11f20bf63e4b06fdb6ff",22,22,0,22,22,0,1,2
"3708","1968d191191b7fbf332c2646a32965c2",35,35,0,35,35,0,1,2
"3709","196fc2882ae485f9406fd8a68bb0a366",36,32,43,5.86046511627907,36,0,2,1
"3710","1970c7f23c8038a46d9c69fc86f8ae47",66,52,65,7.10769230769231,35,31,2,1
"3711","1973cbeb7e3364f2b7f991c933a70ff2",58,29,89,4.56179775280899,39,19,2,1
"3712","19767a9273d599497d6f4d02fd16ef61",96,74,37,18.1621621621622,43,53,2,3
"3713","19767c27164e97f0896221b0dcac52f0",39,39,0,39,39,0,1,2
"3714","19772d6e735f145e164679bdca4dd515",13,13,0,13,0,13,1,2
"3715","1977b40669845e01cdbc23ef11020fff",32,32,0,32,32,0,1,2
"3716","1977f46060a866183f39b1e17b044eb6",39,34,8,34.125,39,0,1,2
"3717","197b29e6ca2fc1ae174f4fe46be47972",2,2,0,2,0,2,1,2
"3718","197e53b77536726a4f203847f7e0e6a9",32,32,0,32,32,0,1,2
"3719","197e8f76fb83f1e6f7f9ebb7f04a8b6e",24,17,14,12,24,0,1,1
"3720","197ed9afad4dd8377a47e7e5f97ee385",39,39,0,39,39,0,1,2
"3721","197ee5b51ea9a18abb17f84e28c50b0b",137,85,78,12.2948717948718,137,0,3,3
"3722","197f32244cf8e1e21b50165d57707f48",67,50,68,6.89705882352941,27,40,2,1
"3723","197f38a3da4bd1e5ca42a4560856f34d",8,8,0,8,0,8,1,2
"3724","197fb2ac0de2dfb961eae37d3c349f5b",26,26,0,26,26,0,1,2
"3725","19808f2ef209d02b7a5ee4ce406eecfa",32,32,0,32,32,0,1,2
"3726","1980ab67b15f036c98d2e63bd79987c3",16,16,0,16,16,0,1,2
"3727","1980acbafd412a9f35ba2da43588391a",25,25,0,25,25,0,1,2
"3728","1980cd3a7c7c86a2564e96bf3cb3c30f",153,69,69,15.5217391304348,153,0,3,3
"3729","19823629b573caa2787e10889ceb5a6a",28,28,0,28,28,0,1,2
"3730","19825b5e74e82bafe170d2b5f37e17c3",176,76,77,16,176,0,3,3
"3731","1983a7badc8e9e7cfa2c5858b29a3e30",28,12,51,3.84313725490196,20,8,2,1
"3732","19856d7f1e93137062e8d3750e595c17",35,28,25,9.8,10,25,2,1
"3733","1985d517b064c88b02e29cff93a453da",161,67,77,14.6363636363636,161,0,3,3
"3734","1986bcec6324ee475bed3e33c036598b",84,58,69,8.52173913043478,84,0,2,3
"3735","19870c894884e720b1941768182af046",26,25,25,7.28,13,13,2,1
"3736","1989287178fff66ad3122d8d5a2c19bb",22,22,0,22,22,0,1,2
"3737","19892d22d1cda4c24314b529b7570dfb",174,83,64,19.03125,124,50,3,3
"3738","19899a6c661e2b6a3c7e2db5d7631b72",42,42,0,42,42,0,1,2
"3739","198ddd11f4f6be5bd417bb4615fe0d95",23,16,82,1.96341463414634,23,0,2,1
"3740","198f9f7df39cc4c9016517c786714587",37,31,46,5.6304347826087,37,0,2,1
"3741","1990a27cdb6fbbba06ce92756fb10aff",54,42,40,9.45,54,0,2,1
"3742","1991bbc8053b64d346dba6b0ee581605",172,66,70,17.2,172,0,3,3
"3743","199410d64063a0f5e1335c7b7a49695c",45,45,0,45,45,0,1,2
"3744","19951132b69ad4338f47fbb663b5acf3",31,30,64,3.390625,1,30,2,1
"3745","199578868350816d23564524febbf251",149,87,77,13.5454545454545,149,0,3,3
"3746","1997bba70cc682aeed5be453a535f667",21,14,49,3,18,3,2,1
"3747","199f4931067f091fb3cf50cdc87187a1",145,55,68,14.9264705882353,131,14,3,3
"3748","19a1e86825294e03952c38d26d802269",45,38,42,7.5,45,0,2,1
"3749","19a2a059c240532ac271193f518e8024",13,13,0,13,13,0,1,2
"3750","19a30cf1ff43c68545ad9bae1c5aabfb",25,25,0,25,25,0,1,2
"3751","19a6d4954366c172e6f4507c9cbd9c56",92,76,73,8.82191780821918,92,0,2,3
"3752","19a7013f9240bd5dedc8730c61c004bf",41,29,49,5.85714285714286,0,41,2,1
"3753","19a760de7623ee3864cc4fa76509d2c7",7,7,0,7,7,0,1,2
"3754","19a76ac8fd161f09799561875e3feefc",179,85,71,17.6478873239437,179,0,3,3
"3755","19a7ece54fb28aeb94c3a9661f62a2d3",249,117,77,22.6363636363636,200,49,3,3
"3756","19a8a604ca691b0f7a164aa88b197573",14,14,0,14,14,0,1,2
"3757","19a9a520c6c9415f3050abaf00fc1d44",116,68,60,13.5333333333333,116,0,3,3
"3758","19aa23d5ea9a514432d9f710896eaea7",95,52,55,12.0909090909091,95,0,2,3
"3759","19ab431b3fd3a9e2c915e20be579d673",45,45,0,45,45,0,1,2
"3760","19ac058230ebd4926b01bf911f52da0e",84,49,49,12,84,0,2,3
"3761","19ac7739d18c2bd971d673976cb87e40",45,45,0,45,45,0,1,2
"3762","19af1555e4036a15b813dd3beadf6e83",86,55,24,25.0833333333333,60,26,2,1
"3763","19b0e98b1d77001e84bf5133986a9bf5",37,27,51,5.07843137254902,37,0,2,1
"3764","19b1c01e28a3f9fb28c17fc342bbd780",91,69,63,10.1111111111111,91,0,2,3
"3765","19b3f4aa272884ff91966f8a63254784",5,5,0,5,0,5,1,2
"3766","19b68d1d773c60c9f17a74e8201afa3f",21,19,7,21,21,0,1,2
"3767","19b9778c4cb501398328181d18408a5f",113,78,48,16.4791666666667,72,41,3,3
"3768","19b9987ead0b660cf25f7be6a37b20bc",150,94,31,33.8709677419355,150,0,3,3
"3769","19bccbf52a59eb629459d6ff2c007ddd",106,58,84,8.83333333333333,106,0,2,3
"3770","19bfe2804158c03d71f528b5fa232160",28,28,0,28,28,0,1,2
"3771","19c4f0c3c02dfa4ecdf606ad964354b3",40,28,7,40,0,40,1,2
"3772","19c4f1480d373c530e58b10357d335b1",15,15,0,15,15,0,1,2
"3773","19c7d8ac98aa8ea5e1e4b0ea63751485",17,17,0,17,17,0,1,2
"3774","19c8bcf0c01b4d5676e794e26921c92a",158,92,82,13.4878048780488,131,27,3,3
"3775","19c993653ee2e3ba6df063a1420fa9c7",42,38,12,24.5,42,0,1,1
"3776","19ca3f33d6cec703da5776ac36014012",63,50,57,7.73684210526316,63,0,2,1
"3777","19ccbd5279689128be89979247466c39",10,10,0,10,10,0,1,2
"3778","19cd287e4698877432db8ec6309359f3",24,24,0,24,0,24,1,2
"3779","19cd44d93841ac012a55789eb708225b",28,28,0,28,28,0,1,2
"3780","19cdb2613998fa969c14fc4289872260",46,42,14,23,46,0,1,1
"3781","19d3a680adacf9180a12d7c9b1538b7f",29,29,0,29,29,0,1,2
"3782","19d41d7acc0d4342f83eedf6b371a3af",54,50,51,7.41176470588235,54,0,2,1
"3783","19d7ffe63f09f56fcd24fbc470f41f63",33,32,7,33,33,0,1,2
"3784","19d923cc37fcd3682fc00a87a4b8a317",26,26,0,26,26,0,1,2
"3785","19da16ed6d7b080353c0357937f6597f",21,21,0,21,21,0,1,2
"3786","19de6b1745d01cf5f59f0842a43cf1b4",17,16,4,29.75,17,0,1,2
"3787","19df9fc4b8cf79eeb45dbf7cd59877b9",99,48,69,10.0434782608696,99,0,2,3
"3788","19e2d81ee3b4db4ac489f4554074fc9d",48,38,42,8,48,0,2,1
"3789","19e37279f3653c972ba4e8e23b02b1bb",20,20,0,20,20,0,1,2
"3790","19e399e6780e991c2742fa3b065821fc",34,34,0,34,34,0,1,2
"3791","19e618544baea2a7f75959c82ea8e277",36,31,43,5.86046511627907,17,19,2,1
"3792","19e707d6e207a7008c1a051297cfb554",19,19,0,19,0,19,1,2
"3793","19e864a5bc86ad6dca7e2a87b5d48bd0",37,35,33,7.84848484848485,37,0,2,1
"3794","19e8f7b5296eaf5be4c4f3c4aed1559e",106,79,72,10.3055555555556,106,0,3,3
"3795","19e9766a1ed0476df420bb0fc34e4111",72,46,57,8.8421052631579,72,0,2,3
"3796","19ea4ee9e0344fc26d9c5557f2c92dfd",29,29,0,29,29,0,1,2
"3797","19ea733dbe8c760efec0fd3332ad6c0c",4,4,0,4,0,4,1,2
"3798","19edf384e408d2457dc785f9d1263680",209,66,80,18.2875,209,0,3,3
"3799","19ef23fff948db578fb1c0b5d6110ec1",72,59,63,8,72,0,2,3
"3800","19f217b35426592cabea4782ed220084",21,21,0,21,21,0,1,2
"3801","19f28719d899cf84d7129c24d837c053",5,5,0,5,5,0,1,2
"3802","19f2feeef2689cb9436338fe0c3cf3c4",4,4,0,4,0,4,1,2
"3803","19f508d8012e5fe7bead3a2dffa11b7c",14,14,0,14,14,0,1,2
"3804","19f7ec1b510df924d54462b3e44ba769",36,36,0,36,36,0,1,2
"3805","19f9bd018a4f683db69faab812bdc15b",153,125,32,33.46875,153,0,3,3
"3806","19fbae46cb152084f4a1c6c4bf0fc7cc",141,73,78,12.6538461538462,141,0,3,3
"3807","1a0526f849cd193da5ea3dea784708e5",24,24,0,24,24,0,1,2
"3808","1a05ffcb35e157308c577aef7203061c",14,12,20,4.9,8,6,1,1
"3809","1a065a8c1f2dcc09ee728f12e92001c2",21,21,0,21,21,0,1,2
"3810","1a0673b5f0a365e4d29f4b21bbf2ba28",19,19,0,19,19,0,1,2
"3811","1a06df7f217605857dd66c59cbc10559",26,26,0,26,26,0,1,2
"3812","1a07f2f2fd09574998c01cc1537e8128",25,25,0,25,25,0,1,2
"3813","1a0acd21d3b93504d9ab3f7a2ee312e9",30,22,69,3.04347826086956,30,0,2,1
"3814","1a10cb9f0743be4e32a1dcf8ae12da88",93,76,56,11.625,93,0,2,3
"3815","1a11173f173eaf8b16d704428b92d465",15,15,0,15,15,0,1,2
"3816","1a1244f1907b2c507974e50dc21be241",6,6,0,6,0,6,1,2
"3817","1a12d160a1966f348753c99b94511823",27,27,0,27,27,0,1,2
"3818","1a15079f7bb3e713227211bb406b4ae3",23,23,0,23,23,0,1,2
"3819","1a157d62f3bc4a509446827091f0c356",5,5,0,5,5,0,1,2
"3820","1a15dc9ef570b1bc4dfa639725ab4094",96,81,32,21,96,0,3,3
"3821","1a165c815601669171ac7ec85d52cf6d",33,30,6,38.5,33,0,1,2
"3822","1a1746fce8aad096eecd237facb69b76",67,61,47,9.97872340425532,67,0,2,3
"3823","1a18e2eace97f03dc722083b202f198a",39,36,34,8.02941176470588,39,0,2,1
"3824","1a19b2301dabc57d7d47019838b18497",40,40,0,40,40,0,1,2
"3825","1a19c7b3c447b27a25a5530c2af1928f",86,69,24,25.0833333333333,86,0,2,3
"3826","1a1ab763abcf5f26455833a70a7435f2",158,89,76,14.5526315789474,158,0,3,3
"3827","1a1b338fee2a82c2a42dd816c3c266d3",139,66,85,11.4470588235294,116,23,3,3
"3828","1a1ea7a1de63d1ef3b1bb7d0c02851ce",103,80,26,27.7307692307692,65,38,3,3
"3829","1a1ff5830a72b7f8ff54def77b9f1561",110,61,62,12.4193548387097,110,0,3,3
"3830","1a20270e4dc53e147256f3221648bfa4",121,64,77,11,110,11,3,1
"3831","1a20a64fd17b77b0b4d59e37c7883d4f",24,24,0,24,24,0,1,2
"3832","1a22ef85a9e0d6001ecffedc6a3de77c",31,31,0,31,31,0,1,2
"3833","1a2322d34b708174f4e6ce48a9fb1579",21,16,13,11.3076923076923,12,9,1,1
"3834","1a236e4a02f0f5609c3aeb043e94dd37",30,30,0,30,30,0,1,2
"3835","1a28f141acc77e14db297b0a63d511e7",120,88,28,30,90,30,3,3
"3836","1a29515b1503d394c71a99ef77491e67",87,53,69,8.82608695652174,87,0,2,3
"3837","1a296d7dbb21f3fd51cb0aaf588dca4b",109,61,74,10.3108108108108,109,0,3,3
"3838","1a2c90d032bb47983f5394f39f360085",16,13,43,2.6046511627907,16,0,2,1
"3839","1a2df2117e9422f754ad8c72e440868d",35,35,0,35,35,0,1,2
"3840","1a2ec30787194ac926773c00fd409b07",30,25,10,21,12,18,1,1
"3841","1a305c80dc1b3d16896728ddd85025aa",27,27,0,27,0,27,1,2
"3842","1a31dc875d63e560713f252ff3a9b89a",37,28,61,4.24590163934426,16,21,2,1
"3843","1a3764f2b6accf0d5c7b4d90fedd7421",95,62,54,12.3148148148148,95,0,2,3
"3844","1a3967f1be58ac6c94ccc3b2402775d7",18,18,0,18,0,18,1,2
"3845","1a3c7d5689d1fbf6f32eabb7585c9369",51,34,52,6.86538461538461,51,0,2,1
"3846","1a3d9d67678159f3827503a060c8b131",60,42,43,9.76744186046512,60,0,2,1
"3847","1a3f26e0aee0d2863d88ba3b9a230ddf",70,57,35,14,70,0,2,3
"3848","1a42110d5e505ada88730f3189febd4d",51,34,84,4.25,37,14,2,1
"3849","1a45921935fa5344bba18550fdeae6f2",41,32,20,14.35,41,0,1,1
"3850","1a461e499c3c514264097d4bda87a7b0",8,8,0,8,8,0,1,2
"3851","1a46a0fad6ada21f74cd7a2e7824eedb",24,24,0,24,24,0,1,2
"3852","1a486e60a35f2e04e993b4cf789b7e68",25,20,79,2.21518987341772,12,13,2,1
"3853","1a48ee095150888190532dda0617d164",36,32,32,7.875,36,0,2,1
"3854","1a4acef7ecf7096a768cdffed7913ce9",69,45,71,6.80281690140845,39,30,2,1
"3855","1a4f95ada98cce7859f4d332dfbc78a8",22,22,0,22,22,0,1,2
"3856","1a514bffa3686e6616b064123f9c85ff",35,35,0,35,35,0,1,2
"3857","1a516f4875eabdf0ed73457241dc5269",262,132,83,22.0963855421687,219,43,3,3
"3858","1a526cd1ba7344e29602b32832dba068",12,8,65,1.29230769230769,12,0,2,1
"3859","1a545fc7c865cd571377915794e6ca47",42,42,0,42,42,0,1,2
"3860","1a54b318129b9c5a1246cba1f39193cf",171,102,60,19.95,171,0,3,3
"3861","1a557cdb4fc193588681087811a4be49",16,16,0,16,0,16,1,2
"3862","1a56df50493434237b99d31d5896e857",19,19,0,19,19,0,1,2
"3863","1a5c710b9e721b8efa0f04794fd27e61",146,94,67,15.2537313432836,146,0,3,3
"3864","1a5cb4806a6d06e8f4a01561f2dee703",28,28,0,28,28,0,1,2
"3865","1a5e7f6a5c72072e0f1c4c5e2c049d7c",75,59,14,37.5,75,0,1,2
"3866","1a5f44fffe944f2465a57268e65ead90",16,8,4,28,8,8,1,2
"3867","1a6072570c21b31dcf9c4c3d6c6689a0",21,21,0,21,21,0,1,2
"3868","1a62888a87b45f998d9c86d7ebd0ccba",96,76,53,12.6792452830189,96,0,2,3
"3869","1a645af4cb2980606b52cdfd252c5743",8,6,35,1.6,8,0,2,1
"3870","1a6569961e7dcb90bf8cc6a89a0c9089",130,56,59,15.4237288135593,90,40,3,3
"3871","1a686b4c8d10d0f8bdf61981a531733f",119,64,63,13.2222222222222,119,0,3,3
"3872","1a688a1e751b3d0a4f4dc97b6f080676",214,122,63,23.7777777777778,214,0,3,3
"3873","1a6953a0afb980c565fd181354c54d8f",121,80,53,15.9811320754717,121,0,3,3
"3874","1a69cc8ce17cf52b6383a28f81c25318",26,26,0,26,26,0,1,2
"3875","1a6dad55389974cd3eb45c65729c801a",24,18,35,4.8,24,0,2,1
"3876","1a6e8043c3b91ab8df856ad33cf1292b",70,54,53,9.24528301886792,44,26,2,1
"3877","1a7024618fd002848728374c432ba82e",142,78,65,15.2923076923077,104,38,3,3
"3878","1a715095d1cdb072702a343407c606fa",85,37,49,12.1428571428571,63,22,2,1
"3879","1a72e933f5be49b1c39d4481743dfd6d",34,34,0,34,0,34,1,2
"3880","1a7445d2526c9ad9ea6cf875bb27e2d2",36,36,0,36,36,0,1,2
"3881","1a74d2439b3f949b0e39d9ef8037a448",177,75,55,22.5272727272727,177,0,3,3
"3882","1a7861e7b47f9b79a71ea550929b32a5",67,49,75,6.25333333333333,67,0,2,3
"3883","1a79ca07303d874e30f4505426be166c",81,59,49,11.5714285714286,81,0,2,3
"3884","1a7c120e3cc83449b3016161c767686a",128,103,40,22.4,128,0,3,3
"3885","1a80dc685ac40a3aea303baded189dfb",137,93,77,12.4545454545455,101,36,3,3
"3886","1a80fe419e018fc957b2b8ab39b81f1e",124,69,62,14,124,0,3,3
"3887","1a85d5b699c944f4803ec401a1aa7fab",15,15,0,15,15,0,1,2
"3888","1a89d2cf12d05f85587d8aa141d773b1",23,23,0,23,23,0,1,2
"3889","1a8b6c55e7b5b1b1008df29fd465c5c0",9,9,0,9,9,0,1,2
"3890","1a8baad2f13b984eaf33497456695bc2",151,87,67,15.7761194029851,151,0,3,3
"3891","1a8e4635c7148e5d1fa573bcb689cb05",18,18,0,18,18,0,1,2
"3892","1a91637d139fa55ebbcd7e25b38602b3",31,27,68,3.19117647058824,12,19,2,1
"3893","1a9207fb63097d61f2e6817508c81fce",6,5,49,0.857142857142857,0,6,2,1
"3894","1a92ee301e94752257897472035e33b1",23,23,0,23,23,0,1,2
"3895","1a945cd11804b95e17afcce6b7894bc2",29,29,0,29,0,29,1,2
"3896","1a95bdadafffb7b7b88d865e63ea5835",23,23,0,23,23,0,1,2
"3897","1a9858760c779157dc55918eb1ce97a3",89,64,38,16.3947368421053,40,49,2,1
"3898","1a9bd745795c221311a858de3de0697a",33,33,0,33,33,0,1,2
"3899","1a9c3db4ed03741ae997032681983679",37,37,0,37,37,0,1,2
"3900","1a9c678ba68f897385b52db1efe9b027",19,19,0,19,19,0,1,2
"3901","1aa14137a3c6923c0c826a292c4b95de",213,109,74,20.1486486486486,213,0,3,3
"3902","1aa1f668070b091e60e09b42e3faf413",159,75,74,15.0405405405405,159,0,3,3
"3903","1aa3d1adc57f5738d1c0fe4c2b4d3132",147,76,65,15.8307692307692,116,31,3,3
"3904","1aa51eeedf2ee790e521ed13d1deec2c",28,27,24,8.16666666666667,28,0,2,1
"3905","1aa69b58cdb6b40bca4348303f60b8cc",52,52,0,52,52,0,1,2
"3906","1aa6cf4d0f5dc5fee6bef6b295b28f6d",37,37,0,37,37,0,1,2
"3907","1aa821d1d091d9beadb997ce13ec6f50",89,68,45,13.8444444444444,89,0,2,3
"3908","1aa8dcefdb9b118edbe7044bb68343fc",33,23,52,4.44230769230769,26,7,2,1
"3909","1aae270eddd7d1ef418875b70e6d47c2",92,77,35,18.4,92,0,2,3
"3910","1aae2a2968ec847f5d1ffd4e0e2149f2",43,43,0,43,43,0,1,2
"3911","1aaf4dde80801a0a8b03aa653d622736",6,6,0,6,6,0,1,2
"3912","1ab0e77f4d3d0920e662cca1190d494a",95,62,56,11.875,61,34,2,3
"3913","1ab82dd1f209603d51a66dd645cfd690",40,36,50,5.6,40,0,2,1
"3914","1ab83ba930aa5896d2dd321187151fdd",16,16,0,16,16,0,1,2
"3915","1ab8802cb2bc1fb4ef3d2622cdf11caa",25,25,0,25,25,0,1,2
"3916","1ab8c789a4d3a2fb1f4037b83afea01e",42,42,0,42,42,0,1,2
"3917","1aba1231c1786660b6e77686a8fdec7d",35,35,0,35,35,0,1,2
"3918","1abcb95e47bc8ca11298df581e99346c",148,97,42,24.6666666666667,148,0,3,3
"3919","1abf70efede2dd459ba9f60ceff7e1b2",69,59,10,48.3,33,36,1,2
"3920","1abf772197ea4c101b8e3fd5d6df9b44",16,16,0,16,0,16,1,2
"3921","1ac30fd261b84d369fb037ac64516924",53,53,0,53,53,0,1,2
"3922","1ac3ca828229099a3299c70186aab733",124,81,73,11.8904109589041,124,0,3,3
"3923","1ac830a11d675f3f0007a594eadfa871",85,62,65,9.15384615384615,85,0,2,3
"3924","1ac9cc2afaf73f413aa6684f0284e9d2",182,85,75,16.9866666666667,156,26,3,3
"3925","1acab679b7687289d23f4da20b6a4d1d",21,21,0,21,21,0,1,2
"3926","1accc4b2175bb82049a6bc60196cbbc4",5,5,0,5,5,0,1,2
"3927","1acebfd7c063771f5d9d048ba39e4d29",7,7,0,7,7,0,1,2
"3928","1acf8aa8c6831883a9a2556a5e85608b",75,57,22,23.8636363636364,39,36,2,1
"3929","1ad0a6a16b54c6582e5f6ae213066c30",90,68,80,7.875,80,10,2,1
"3930","1ad1418a3308d3ac8286a15b45071b30",26,26,0,26,26,0,1,2
"3931","1ad235311540cb9ee1d8b93f46bd9fb2",139,90,64,15.203125,97,42,3,3
"3932","1ad2359ea51d072a084f4b1c11c0684b",35,28,5,49,35,0,1,2
"3933","1ad438abfdc2128340cd8e83051259f7",19,19,0,19,19,0,1,2
"3934","1ad5e522739ddf7bdad50f0d80f9aa42",62,48,75,5.78666666666667,62,0,2,3
"3935","1ad91334c7fa0f5036ea27274e0c2cb5",12,12,0,12,12,0,1,2
"3936","1adcb030febced0b133dfb6b968f0ade",92,64,53,12.1509433962264,92,0,2,3
"3937","1ade26ef97c8fed419840495b2e6d61d",9,4,57,1.10526315789474,9,0,2,1
"3938","1adf677baa80faa92665891c6882761e",147,92,70,14.7,97,50,3,3
"3939","1ae1bbbc9f31ae9e3ad6f4d675e05b41",17,12,49,2.42857142857143,17,0,2,1
"3940","1ae22fd0fbc6415ae2cd9cd6e078f163",29,29,0,29,29,0,1,2
"3941","1ae2aac57cb974d648ba28cf461ce47a",13,13,0,13,13,0,1,2
"3942","1ae33b47156c00a9c7c9ceec8ccbebc6",6,3,42,1,6,0,2,1
"3943","1ae3a9d3cd6babf12ca0c2672fa4bcf6",131,88,58,15.8103448275862,84,47,3,3
"3944","1ae3df0d1ff3680b314e095460c60663",102,89,38,18.7894736842105,102,0,3,3
"3945","1ae6159b69913326ac88eeed72c3e763",52,52,0,52,52,0,1,2
"3946","1ae654de8cf3195ee6a4a50c495fe094",56,56,0,56,56,0,1,2
"3947","1ae7238cb1a1567a43608270fa5e7cde",205,114,63,22.7777777777778,205,0,3,3
"3948","1ae8dab7e738484ace599531a196e286",218,85,67,22.7761194029851,189,29,3,3
"3949","1ae9042358c31be7e7252933efc3cc32",19,19,0,19,19,0,1,2
"3950","1aed7093bd357e17b2c56664a2471893",18,18,0,18,18,0,1,2
"3951","1aeedff5543fe07473403db01214dd8e",37,37,0,37,37,0,1,2
"3952","1aef58e34e2e622903c035bdcccf3f66",78,63,42,13,78,0,2,3
"3953","1af0440545bedcd8bc457c0cb7907d3a",30,30,0,30,30,0,1,2
"3954","1af0f057392ed2c92c3ddeed0f11d4bc",12,12,0,12,12,0,1,2
"3955","1af481f6952b4d33968015cdc940fa48",100,40,71,9.85915492957747,80,20,2,1
"3956","1af48eba94d1e05ad857a5c0186579c2",21,21,0,21,21,0,1,2
"3957","1af49670b02df1b80b799dcc6c4f0954",63,62,18,24.5,63,0,1,1
"3958","1af876d2cec0df136bfe7a96ab5c3207",29,29,0,29,29,0,1,2
"3959","1af8b983d2a2d21935bb9561aecaa6d1",169,98,51,23.1960784313725,169,0,3,3
"3960","1afb8fbb6bd8666705f83bcdebe677c0",25,15,66,2.65151515151515,18,7,2,1
"3961","1afc78a7de9e14cea040b7d6d8229c98",191,76,82,16.3048780487805,191,0,3,3
"3962","1b003726a3ada5b1d1e5f3b2c244fde9",32,28,17,13.1764705882353,17,15,1,1
"3963","1b0429b31683e0d999f1260ddaec123c",22,22,0,22,22,0,1,2
"3964","1b05b15da8faf45dd280117df04dabbd",32,32,0,32,32,0,1,2
"3965","1b061e33d2daa300131684922eadf799",48,48,0,48,48,0,1,2
"3966","1b0936b2bc8600247e3b990c72edab63",73,60,21,24.3333333333333,73,0,2,2
"3967","1b0ac51122e65e1a0b289825ab8555e2",53,37,31,11.9677419354839,53,0,2,1
"3968","1b0e6c686ee96c211ed9b111f2bd2894",7,7,0,7,7,0,1,2
"3969","1b0e7a93d920aca37e1daf66dc9c3e12",8,8,0,8,8,0,1,2
"3970","1b109568da1519574458d42ff9526118",19,19,0,19,19,0,1,2
"3971","1b11c9c17ba9c64652d4f4946e0c1598",184,92,64,20.125,184,0,3,3
"3972","1b1337d26ecf9585587f7f6db4090c4a",64,53,32,14,64,0,2,1
"3973","1b13e666254e6f7ca47809fcc539e06d",152,81,63,16.8888888888889,152,0,3,3
"3974","1b14284227f13b14531165cf32c1c2fc",63,49,60,7.35,32,31,2,1
"3975","1b15d83306a6b23122c561f3712fc0a0",13,11,83,1.09638554216867,13,0,2,1
"3976","1b16d844d87eaf7247af4bc16409c674",90,70,83,7.59036144578313,90,0,2,3
"3977","1b16f9084764148efbbb617806bb89b4",2,2,0,2,2,0,1,2
"3978","1b17da10d2f75496546888a34db19cbe",15,15,0,15,0,15,1,2
"3979","1b22f8a7e02dd0e926862e8898451310",185,96,76,17.0394736842105,185,0,3,3
"3980","1b247888a3c8524bb847004ea1d7dbba",21,21,0,21,21,0,1,2
"3981","1b26eefd58e08ef98965ad95a08ec335",83,70,20,29.05,83,0,1,3
"3982","1b2d49895dbe0092d496e5544420ca86",192,110,70,19.2,192,0,3,3
"3983","1b2d62c1ff0c29851f95e25e17aaf141",29,29,0,29,29,0,1,2
"3984","1b2feab597c5575dbc965249ac2d7a8d",30,30,0,30,30,0,1,2
"3985","1b30547034215787bd27733424e142dd",67,57,56,8.375,48,19,2,1
"3986","1b3118996bed5d8fea706149dac85c68",5,5,0,5,5,0,1,2
"3987","1b32ac10ae609ce32a92c57fe7897736",46,46,0,46,46,0,1,2
"3988","1b32ffa81ea1b22837485f74daa17fcc",200,106,71,19.7183098591549,200,0,3,3
"3989","1b39c7dd97b83349d6c4277476491c05",59,43,35,11.8,59,0,2,1
"3990","1b3bbc845508432758215c6a0e08a514",41,31,60,4.78333333333333,41,0,2,1
"3991","1b3e07bb0eeec78630e99d66ba8cc924",70,59,34,14.4117647058824,70,0,2,3
"3992","1b412491803d85cfbf5c3e67f1b4a451",45,45,0,45,45,0,1,2
"3993","1b423c83adc48940cdfef8fe731b6c0d",47,47,0,47,0,47,1,2
"3994","1b423f09f704ec30c5a1a05e89c9024f",31,31,0,31,31,0,1,2
"3995","1b43d03e6abcf93a0d9f7ae4a956c09b",40,28,69,4.05797101449275,40,0,2,1
"3996","1b474ce260b414368a62fe21705d4c46",87,49,77,7.90909090909091,69,18,2,1
"3997","1b4827b973af67142b8c16dece260b3f",62,38,38,11.4210526315789,62,0,2,1
"3998","1b499b44224a8c2783e51b1854029c68",23,23,0,23,23,0,1,2
"3999","1b4a0c5bfc0a97bd851c14d1b5b9581e",55,42,70,5.5,55,0,2,1
"4000","1b4a23770ebe9024ae2d1b62548838a0",51,51,0,51,51,0,1,2
"4001","1b4a58af9b23569927ef36e2462c9001",24,24,0,24,24,0,1,2
"4002","1b4b896dd87090f4afeb6a9490bdd4ce",245,102,77,22.2727272727273,216,29,3,3
"4003","1b4f57ef49e883517072b1cf619c5636",23,23,0,23,23,0,1,2
"4004","1b5112de3c96d96bb60cb44c1ff1009b",115,82,30,26.8333333333333,77,38,3,3
"4005","1b538d3578387f7535cbc88713a0358d",86,59,63,9.55555555555556,86,0,2,3
"4006","1b55fe6cbea3ab0c431b2f192ee5c285",134,103,80,11.725,134,0,3,3
"4007","1b5682a637da85ee4bf91f1c7a861bdf",39,33,28,9.75,0,39,2,1
"4008","1b5714c0365fe5f5da56c5ba17a1ca14",48,48,0,48,0,48,1,2
"4009","1b58e79376c777d2cce15ede990c09dd",52,52,0,52,52,0,1,2
"4010","1b5d6398ff7c389d40d609d4feabf809",26,24,32,5.6875,26,0,2,1
"4011","1b5db01a1590633e25c25aec8805413f",33,33,0,33,33,0,1,2
"4012","1b6157017d3e881679977acc225cbebb",9,9,0,9,0,9,1,2
"4013","1b6384b71f4e36345fc96b409ed09e25",16,16,0,16,0,16,1,2
"4014","1b63913598a5c988397785c08cc60678",185,99,62,20.8870967741935,185,0,3,3
"4015","1b63d2a458f4577ec4aea8656274abd2",91,73,54,11.7962962962963,91,0,2,3
"4016","1b64385656f738443c7ab85c9a2a6895",53,42,23,16.1304347826087,53,0,2,1
"4017","1b6499b8a51d88049e417ab384a88383",29,29,0,29,0,29,1,2
"4018","1b65733899777ea21358ebab3a573725",36,20,77,3.27272727272727,36,0,2,1
"4019","1b682ae25bd9fc1cce6b572c18382798",3,1,63,0.333333333333333,1,2,2,1
"4020","1b68b1db07a958704b49b0b325b99b4a",28,28,0,28,0,28,1,2
"4021","1b68ff9dafd3960396dce5094a24047c",21,20,59,2.49152542372881,21,0,2,1
"4022","1b6ea3b1424c9aa712039da639ff88dd",30,30,0,30,30,0,1,2
"4023","1b6ebf5c361e5282501c35e65f1ff0c9",30,30,0,30,30,0,1,2
"4024","1b6fb5c733451b8115a5c1cef6b06f97",47,47,0,47,47,0,1,2
"4025","1b7100294920602d617113d19ad835c4",34,34,0,34,0,34,1,2
"4026","1b7402d84d6eece3fe335b39ee597d69",29,28,42,4.83333333333333,29,0,2,1
"4027","1b743dcf3e29e7c44d571d919f6c0b6f",83,63,28,20.75,83,0,2,3
"4028","1b7445d71400ed1a793e235c528b65bb",95,65,82,8.10975609756098,88,7,2,1
"4029","1b761a2e0278d4455b2bda46f755a239",2,2,0,2,2,0,1,2
"4030","1b76688813d89006a947d75759097d6b",176,82,65,18.9538461538462,148,28,3,3
"4031","1b7753ffd58cc87390d6bb2826ef1bab",14,14,0,14,14,0,1,2
"4032","1b78ebf143ac440d18435c15dd2e53f7",161,107,66,17.0757575757576,108,53,3,3
"4033","1b7afb0eae435214ec03d3744c2eb482",30,30,0,30,30,0,1,2
"4034","1b7b91e8ad7eebd8dd44a06c228b5836",1,1,0,1,1,0,1,2
"4035","1b7e8d9e0b10ebd6051bd45a454936d7",43,43,0,43,43,0,1,2
"4036","1b8303eabdfbdb31a3829b7605e362dc",75,50,53,9.90566037735849,75,0,2,3
"4037","1b83947043ccde5aebe9ef48363ad434",43,43,0,43,43,0,1,2
"4038","1b852a69f60f2a209dca6cc138b131aa",16,16,0,16,16,0,1,2
"4039","1b864b583364b92019dd9fb0e5635fe6",43,43,0,43,43,0,1,2
"4040","1b8990e44c4d48dae8994676c89b5f72",24,24,0,24,0,24,1,2
"4041","1b8c750b6d09342085afee77506b97be",81,59,58,9.77586206896552,81,0,2,3
"4042","1b8d582279fa373a9e6682e1371b724f",129,94,34,26.5588235294118,129,0,3,3
"4043","1b924e4629ba269c28d96f6b972bc495",65,58,29,15.6896551724138,65,0,2,1
"4044","1b93abf2e08330015d390e54a61a0e5a",199,56,82,16.9878048780488,188,11,3,3
"4045","1b9449a76c0a99f5345d7af580013320",3,3,0,3,3,0,1,2
"4046","1b97b2661e82c820bc4702adf94d0883",31,31,0,31,31,0,1,2
"4047","1b97ef169bab4f528773024a6b9570b4",24,24,0,24,24,0,1,2
"4048","1b985052a2d4bd20e5487e52621abe38",39,33,28,9.75,0,39,2,1
"4049","1b9968a487ceb3a7259cb7c005ad3546",17,17,0,17,0,17,1,2
"4050","1b9993946e454d0212e620a4e45e2ea3",89,51,54,11.537037037037,57,32,2,1
"4051","1b9c38732932ad05274c7f9faabf860b",43,43,0,43,43,0,1,2
"4052","1b9d9ae60365fd08dbae8a1048221b0e",53,53,0,53,53,0,1,2
"4053","1b9ee52f12a68d62052ec6b5b13b7437",9,9,0,9,9,0,1,2
"4054","1b9f98950f8eaaa085c25039410d5d7d",77,66,19,28.3684210526316,54,23,1,1
"4055","1ba033ecfd85606dfad762d33b6e6adf",44,36,21,14.6666666666667,44,0,1,1
"4056","1ba0690a23c42b122ebcb1f429ee4c43",33,33,0,33,33,0,1,2
"4057","1ba2b594303ccc815cb90d8e39ea77be",52,46,63,5.77777777777778,36,16,2,1
"4058","1ba33a19d187ef4e53d8c21c28fa6fc1",17,17,0,17,17,0,1,2
"4059","1ba97fe9b0ef27e9287dec932f43fcf4",53,45,12,30.9166666666667,53,0,1,1
"4060","1bae12647c4f7dd4ed90e4526c88ba20",16,16,0,16,0,16,1,2
"4061","1bb090b43d293d41bd7da1b1725ec0c5",50,50,0,50,50,0,1,2
"4062","1bb45870c5e228e562c84fbfdcf0b483",32,32,0,32,32,0,1,2
"4063","1bb57e754a2b2136bf0aaffa5cdf0645",69,57,51,9.47058823529412,47,22,2,1
"4064","1bbdde38032e7068ad0c3834ea0d29f5",71,39,52,9.55769230769231,49,22,2,1
"4065","1bbe5d975bec3e2488760ecd7ab77c96",85,57,41,14.5121951219512,85,0,2,3
"4066","1bc48352b4c6407f03f6c20bdf08237b",55,41,40,9.625,55,0,2,1
"4067","1bc64918fcf718ec8478bf1a60b3f14a",29,29,0,29,0,29,1,2
"4068","1bc73cf80857566123740322cea943f0",102,77,35,20.4,102,0,3,3
"4069","1bc8e3161f828249c9c4a8541a67a48d",90,55,71,8.87323943661972,90,0,2,3
"4070","1bc919988b4fd1c13cfdeeff68ff70b9",45,45,0,45,45,0,1,2
"4071","1bcb0f3b2acb37678c5af2f17c5d2dd0",35,35,0,35,35,0,1,2
"4072","1bcc4786703128e3603ca7d8f1177129",178,136,42,29.6666666666667,178,0,3,3
"4073","1bcd836ed0486384345195709dc41702",91,69,49,13,91,0,2,3
"4074","1bcdd37bb4cb3b998ab8825b5856a23f",143,92,50,20.02,143,0,3,3
"4075","1bce8c05e0b013f455e0033f43267fae",43,36,33,9.12121212121212,43,0,2,1
"4076","1bcf683214bf52c814355424618fe382",45,45,0,45,45,0,1,2
"4077","1bcfa8e835bc5ae3d0243a5d608a32c0",11,11,0,11,11,0,1,2
"4078","1bcfc7f30b624708aac98e9462190fc5",29,29,0,29,29,0,1,2
"4079","1bd5f37d58a29b0328dcb5509c597c1e",102,61,77,9.27272727272727,73,29,2,1
"4080","1bd821e8a1212cf315cea1903c7621a7",11,11,0,11,0,11,1,2
"4081","1bdad7e77c5399a3a5cecd9c2435c83f",59,47,31,13.3225806451613,59,0,2,1
"4082","1bdaea60e29c5384a80df3aeb2dde03c",51,37,21,17,0,51,2,1
"4083","1bdb3af4cfa35c172c3a94469db28028",182,106,62,20.5483870967742,182,0,3,3
"4084","1bdbcabf17c28adaa7d44e3633779c10",44,44,0,44,44,0,1,2
"4085","1bde248ee2f1833080b49bb319bcff12",37,28,27,9.59259259259259,37,0,2,1
"4086","1be17e622e2b6031bfaef940daf03afe",80,70,28,20,80,0,2,3
"4087","1be201c02753b869180e267875989321",46,31,42,7.66666666666667,46,0,2,1
"4088","1be32bfbc91371a80dd8295de3606f20",22,22,0,22,22,0,1,2
"4089","1be4a326f10a7f778fb75a3670e9a3ca",121,96,42,20.1666666666667,121,0,3,3
"4090","1bee970bf7c5eb9f28277929af334102",233,140,74,22.0405405405405,193,40,3,3
"4091","1bef1b784525fc3271214c91de953062",21,21,0,21,21,0,1,2
"4092","1bf100c7715e7a7ce4a43bdc1ac1f3b0",29,29,0,29,0,29,1,2
"4093","1bf31e593e19a28f5db6698ed577bb8b",23,23,0,23,23,0,1,2
"4094","1bf4d57a8d5af3fce8cb999c9fc4a2f5",43,30,62,4.85483870967742,43,0,2,1
"4095","1bf684b746388b9f0cd85643d8880e5e",14,9,40,2.45,14,0,2,1
"4096","1bf713b62f3c5d7d0bddcdf521401a35",29,29,0,29,29,0,1,2
"4097","1bf91994b9ac0830bff2eeee5da8a066",52,41,18,20.2222222222222,52,0,1,1
"4098","1bf960e60f097521d06def73b568bf47",17,17,0,17,17,0,1,2
"4099","1bfb0d66de60625225bd98166ce65cbf",18,18,0,18,18,0,1,2
"4100","1bff036a438b57167457b481d4e16d20",69,58,41,11.780487804878,69,0,2,3
"4101","1c00449cb6615ed1df4f15376bd35370",80,59,38,14.7368421052632,80,0,2,1
"4102","1c037f796f68e24233eba4f4d40ba918",13,11,26,3.5,13,0,2,1
"4103","1c084a3d8615fabfbe2686fa6470a48f",238,122,86,19.3720930232558,186,52,3,3
"4104","1c0973bcddf6caccdee74f5d37da4b24",10,5,45,1.55555555555556,5,5,2,1
"4105","1c099afecb9c550b413b440c1e928ba5",35,35,0,35,35,0,1,2
"4106","1c0b0ea8d7deb2e01c0da4434b6be1a1",59,53,27,15.2962962962963,59,0,2,1
"4107","1c0bed2858225b2f8653e496dc2696d6",40,30,48,5.83333333333333,40,0,2,1
"4108","1c0e42173e6e993d005614e8c8d67676",79,46,53,10.4339622641509,79,0,2,3
"4109","1c113082a6a4f8fdfed474a698452c0a",32,32,0,32,32,0,1,2
"4110","1c121fe86eb97cf662509816c3e91176",41,41,0,41,41,0,1,2
"4111","1c12dc580330869ed6e8be56e3989f07",9,7,28,2.25,9,0,2,1
"4112","1c13671170df46150f8142c1c2da3118",7,7,0,7,7,0,1,2
"4113","1c1c22d9540b1c1c58b4b9147b3863ca",35,35,0,35,35,0,1,2
"4114","1c1e33207091c82fa3654487de01ba83",33,33,0,33,33,0,1,2
"4115","1c21e6ae63bbd92e8224a748a33515a2",26,26,0,26,26,0,1,2
"4116","1c296bf0ae7878eed41f5cd33069ca92",27,22,51,3.70588235294118,27,0,2,1
"4117","1c349a0ded2e37762552f8d36ee842f8",16,16,0,16,16,0,1,2
"4118","1c3bbde2bf65e36a5939c4045f26f95f",44,36,75,4.10666666666667,44,0,2,1
"4119","1c3dd7609ae5aa9c28225d29d7193a96",40,37,83,3.37349397590361,40,0,2,1
"4120","1c3ef8962fdcc461dc9924043d476833",132,72,70,13.2,132,0,3,3
"4121","1c3fb7b07ed81dcedb23fd242de4ce4a",119,85,68,12.25,69,50,3,3
"4122","1c41e2cfe2447b5efec77c458741b30d",27,27,0,27,27,0,1,2
"4123","1c43558e69dc91c1f456162eaa844b96",15,15,0,15,15,0,1,2
"4124","1c43c4ed5e5073b1518629f57c99554f",160,122,70,16,160,0,3,3
"4125","1c4504637988856f80edd5926f06345a",22,22,0,22,22,0,1,2
"4126","1c45e7d6c7bef303bb611ad2e9816f2c",34,34,0,34,34,0,1,2
"4127","1c4700ce09dd1094bf75132eaaafdf5d",81,67,39,14.5384615384615,81,0,2,3
"4128","1c477dd830ca38d5985adba900026ce7",130,82,48,18.9583333333333,130,0,3,3
"4129","1c4a4819cf1b260709dc444248661c1f",33,30,24,9.625,33,0,2,1
"4130","1c5096fa46c29f90701f1c19300b23df",98,75,24,28.5833333333333,98,0,3,3
"4131","1c5177143021b4d51c19402081a92cff",14,9,73,1.34246575342466,14,0,2,1
"4132","1c5518f6176e4f40b1c90f1ec867e998",43,43,0,43,43,0,1,2
"4133","1c56012c228379b3fe27001e9bd201b8",50,42,9,38.8888888888889,23,27,1,2
"4134","1c566edaa5d6955b801267082988c496",15,15,0,15,0,15,1,2
"4135","1c5701444905c0a5de2f4819a571701d",81,69,24,23.625,55,26,2,1
"4136","1c5785d594c04a77f241deee3c200971",69,46,44,10.9772727272727,49,20,2,1
"4137","1c57cdb37b8a59bcf65f45f7e5184f4b",21,21,0,21,21,0,1,2
"4138","1c59501c6249df9a4fa1bdca4a0d34eb",82,50,55,10.4363636363636,82,0,2,3
"4139","1c5ad323db2775f2ecb83b78fcd83cbe",95,49,82,8.10975609756098,78,17,2,1
"4140","1c5d274f1b09d07a204bdd3b9546de28",37,37,0,37,37,0,1,2
"4141","1c5df01e0fe9caa3a96c5caf8896db85",12,12,0,12,12,0,1,2
"4142","1c5ea3774b29c9b602c065a34dfd06de",11,11,0,11,11,0,1,2
"4143","1c5ecdac496ffd772f98d0b1c6876c02",80,64,68,8.23529411764706,80,0,2,3
"4144","1c64da7cabd6324b9a69ecf036dfcae1",139,64,60,16.2166666666667,139,0,3,3
"4145","1c66475fa450dde6366466868e0d413c",92,56,68,9.47058823529412,79,13,2,1
"4146","1c6671d05620b991a7ad56da2f2d35a2",23,23,0,23,23,0,1,2
"4147","1c6bc42ed645afe1200d435cc4c1a453",23,23,0,23,23,0,1,2
"4148","1c6efcb33ae2e1c0cf2231dcd89ff6bb",24,24,0,24,0,24,1,2
"4149","1c7093fe6f0ffd45bc4b7f653b94507b",52,23,52,7,36,16,2,1
"4150","1c70bd51017ce20781e32b022e754520",80,52,65,8.61538461538461,54,26,2,1
"4151","1c7577e7fe494aee0a7d4f8e65ad6a40",103,70,35,20.6,103,0,3,3
"4152","1c75ce8e9b8d94ecc0db2cd2089db76d",2,2,0,2,2,0,1,2
"4153","1c76c85e323399e0f401f2e7d6decac1",43,41,12,25.0833333333333,19,24,1,2
"4154","1c79446981c70ba3900f194b094d51fd",102,43,77,9.27272727272727,84,18,2,1
"4155","1c7a89ccc3924d6d9d483d89f25291a9",87,52,63,9.66666666666667,87,0,2,3
"4156","1c7bfdf8d02044b399065ca4278dbcd9",142,68,76,13.0789473684211,142,0,3,3
"4157","1c7e9d85edba58fef3568249f9b3c577",243,139,76,22.3815789473684,210,33,3,3
"4158","1c7eacf133eab006515c0c1420260a0a",58,48,10,40.6,58,0,1,2
"4159","1c7f2aa3c3f584b2bf499d99adb82b29",23,23,0,23,23,0,1,2
"4160","1c83f10488e2ee8161ce233adf0d7624",46,46,0,46,46,0,1,2
"4161","1c84cd7702888f0f3c56cf07e9d97e3a",75,56,52,10.0961538461538,75,0,2,3
"4162","1c84f96b6e33f45488e877d8f35dc5c4",16,16,0,16,16,0,1,2
"4163","1c84ff1c9f3715fe25a7e4ff1f1d9ab1",30,18,74,2.83783783783784,30,0,2,1
"4164","1c87f534dfad64c7fa937b5db3554533",24,24,0,24,0,24,1,2
"4165","1c8a1321f09f28ab731def886f47cc63",21,20,7,21,21,0,1,2
"4166","1c8b70539b3d0b5bde3b700ea771d762",168,91,44,26.7272727272727,168,0,3,3
"4167","1c8bd98a91834d65110757fb0418a3dd",61,45,61,7,36,25,2,1
"4168","1c8bed2de7e1758447279c8695885670",16,16,0,16,16,0,1,2
"4169","1c8dea04e02df7c5c480f0c094d64a86",19,19,0,19,19,0,1,2
"4170","1c93c0306a5e046a4ab5c0bde63f6862",136,66,69,13.7971014492754,136,0,3,3
"4171","1c944ae32e1c54a2a31e810f6296bbe0",72,51,62,8.12903225806452,72,0,2,3
"4172","1c94c4b2abff34dcb31a565822c9c4d6",40,40,0,40,40,0,1,2
"4173","1c94d5bfa64bee4fae383fc7507d7247",65,57,76,5.98684210526316,65,0,2,3
"4174","1c986c561048a2a870696c36ce1a97bf",12,12,0,12,12,0,1,2
"4175","1c9f97c8d973c259e0c2a1468ea906a2",48,48,0,48,48,0,1,2
"4176","1ca037e8b1adf8dad66097583d1e5be6",117,91,41,19.9756097560976,116,1,3,3
"4177","1ca0475b81c20982ce798eb0aa3f1fd6",121,96,77,11,103,18,3,3
"4178","1ca43de5bda1858a868aa89f8cf05332",49,49,0,49,49,0,1,2
"4179","1ca509aa151c28dfcca2e83033fda1dc",25,25,0,25,25,0,1,2
"4180","1ca52e4b18e15a7306b2db3d397469f3",104,34,70,10.4,88,16,2,1
"4181","1ca91033ef7f17d12784afa39d2fd87a",27,24,4,47.25,27,0,1,2
"4182","1cabed384a69ed199fa2c74b42b24b04",143,89,79,12.6708860759494,143,0,3,3
"4183","1cb15ce8c518a308c55c251e2a509753",17,17,0,17,17,0,1,2
"4184","1cb5bc83b6afed7698215672abbd5cd1",45,45,0,45,45,0,1,2
"4185","1cb9367f12b167a9d790078beae97efc",3,3,0,3,3,0,1,2
"4186","1cb94b82462e7c0086e0809023ed93d9",133,102,76,12.25,133,0,3,3
"4187","1cb9e14b4b032d8e367a238087ea43ce",6,6,18,2.33333333333333,6,0,1,1
"4188","1cbb468a43cb339e3daf0336aee378ee",31,31,0,31,31,0,1,2
"4189","1cbbfaa5333f92280b57f5452cdc8b1f",187,120,45,29.0888888888889,187,0,3,3
"4190","1cbcf7def966fe44b7035e5e78f27764",41,41,0,41,41,0,1,2
"4191","1cbf06ed0179350083446ad0f120e358",41,34,36,7.97222222222222,41,0,2,1
"4192","1cc056333c9b1492dd56f8255bc872c1",11,3,74,1.04054054054054,11,0,2,1
"4193","1cc09e19518466037320edc6eef38603",61,39,41,10.4146341463415,61,0,2,1
"4194","1cc0a635bbd2ddabd8b5313601bb56f7",31,31,0,31,31,0,1,2
"4195","1cc12d26120d8b46514bb6b23bc0ff3d",52,44,55,6.61818181818182,27,25,2,1
"4196","1cc3af2c9d39d0d9527610bfc61cfd36",149,80,77,13.5454545454545,149,0,3,3
"4197","1cc3c5210819a8abb3627e2a21d3a5b5",108,57,61,12.3934426229508,108,0,2,3
"4198","1cc4a6019c3c1dce803eebc6d11bd3b0",5,5,1,35,5,0,1,2
"4199","1ccd30848b4bdbc93a13e6276f6a513d",132,88,69,13.3913043478261,132,0,3,3
"4200","1ccd58235be23ab12fd408d31dd6bfde",128,92,69,12.9855072463768,128,0,3,3
"4201","1ccd70f324b56b87963aedced93e1f31",14,14,0,14,14,0,1,2
"4202","1cd0568f0a6a2fa1902bfdd6fbfcc2f5",121,85,57,14.859649122807,121,0,3,3
"4203","1cd8c93a95eeeb55eb51b4c2b1f623fd",177,88,89,13.9213483146067,177,0,3,3
"4204","1cd9e9dd32aff09e7f475316e555fee7",52,36,34,10.7058823529412,52,0,2,1
"4205","1cdc8c6329759ae9b208d45772c92fe3",15,10,48,2.1875,15,0,2,1
"4206","1cdd9586ed5f91c5f7c41376ab09078b",67,44,9,52.1111111111111,67,0,1,2
"4207","1ce30de9f48c3b1684ffa797719adb47",161,74,65,17.3384615384615,116,45,3,3
"4208","1ce3eca5682b392c6d77552d0223972e",25,25,0,25,25,0,1,2
"4209","1ce633a4e7d20be4764aa229178b6c58",46,46,0,46,46,0,1,2
"4210","1ce7adc730ed95787ebd5c8e22b968c1",56,51,37,10.5945945945946,56,0,2,1
"4211","1ce7b2f29f6dce61d941795a30a420c4",24,24,0,24,24,0,1,2
"4212","1ce9967365e2c1110805408da147770f",48,48,0,48,48,0,1,2
"4213","1cedfa1fd8ac2a69c9b96e5f1b058282",182,136,62,20.5483870967742,182,0,3,3
"4214","1cee05a6733917b816c539605868134f",75,63,46,11.4130434782609,75,0,2,3
"4215","1ceed6c063c6fce5ed08c8c92987fd37",23,20,21,7.66666666666667,23,0,1,1
"4216","1cf1abf45d102a22ec448cb372a4d9a0",75,58,69,7.60869565217391,75,0,2,3
"4217","1cf50cf5d82084ee415dea7ebff3f687",118,81,43,19.2093023255814,118,0,3,3
"4218","1cf60cf53c91c822b00568152958f61a",148,89,63,16.4444444444444,148,0,3,3
"4219","1cf6487900906b9c7241c6d48a59e014",7,7,0,7,7,0,1,2
"4220","1cf7b9afdfd5171ba735fc8e633ad5d7",21,21,0,21,21,0,1,2
"4221","1cf8b4640637c8c474015e3a83aa7e80",30,30,0,30,30,0,1,2
"4222","1cf8b5e0ca324dc3d375f21466603997",92,58,28,23,92,0,2,3
"4223","1cfc8b6eccbae758f7de533c34987e2f",13,13,0,13,13,0,1,2
"4224","1cfe3d33a6b83c0904b505e1d0c528eb",149,72,52,20.0576923076923,149,0,3,3
"4225","1cff4b3510a14317981f5a06e872ebd2",43,37,16,18.8125,43,0,1,1
"4226","1d0009a603ab56ae5dca6d943160f9b0",20,20,0,20,20,0,1,2
"4227","1d01d431b3dc7924b50c8c9f70eada66",10,10,0,10,10,0,1,2
"4228","1d0309661435bbaa468c93ae8410522a",18,18,0,18,18,0,1,2
"4229","1d05257d7c63b0733a7515622f3d2712",31,31,0,31,31,0,1,2
"4230","1d05d422b5654102e8ca1b665a9c72ca",48,40,38,8.84210526315789,48,0,2,1
"4231","1d067b3205ab4c9ef88ee23ad03cf1b6",33,33,0,33,33,0,1,2
"4232","1d08d3e2220c969fde7a5d383079b331",37,37,0,37,37,0,1,2
"4233","1d0eb9a4406d3aa8b68e1c4b49be2d4c",101,82,74,9.55405405405405,48,53,3,3
"4234","1d1075897cc39f74caa33a3cb3eff994",212,78,72,20.6111111111111,212,0,3,3
"4235","1d14156d4a9bb592dec91bd34d3f474c",107,91,21,35.6666666666667,107,0,3,3
"4236","1d1737709d9c7cf39ec1be2c6d5da9d9",86,71,42,14.3333333333333,86,0,2,3
"4237","1d1913c2aa041e8be666c2e2465c146e",30,30,0,30,30,0,1,2
"4238","1d1958334996c6dcbe5c120a041f893c",9,9,0,9,9,0,1,2
"4239","1d1a4782ee08d3e217aa508491f05e3d",14,14,0,14,14,0,1,2
"4240","1d1cf31d79bf6c07c8910c64bc83858d",28,26,11,17.8181818181818,17,11,1,1
"4241","1d1dd3dd9918075b37434eb934061033",14,14,0,14,14,0,1,2
"4242","1d1df2e2378f498da79126b5f9c70910",62,45,59,7.35593220338983,45,17,2,1
"4243","1d200103dd5b7b63775d0017ac2bd695",4,1,35,0.8,3,1,2,1
"4244","1d2025433df7cabe27a3f7faafe9b89b",200,79,75,18.6666666666667,200,0,3,3
"4245","1d20ad5bed93cc7b59e87cf89b4f2746",78,43,54,10.1111111111111,38,40,2,1
"4246","1d2250b8763ad5a58401aaf0666c7a7e",37,37,11,23.5454545454545,37,0,1,1
"4247","1d22693e5b76c92e06cf587add150f45",40,25,70,4,40,0,2,1
"4248","1d26b8d52ae01109029040d9531db99c",78,70,22,24.8181818181818,78,0,2,2
"4249","1d2752db2edec443a9ad72fc27ea5ec2",29,29,0,29,29,0,1,2
"4250","1d2803ba80f911e3285b247d812047ee",174,85,79,15.4177215189873,136,38,3,3
"4251","1d2830c05c204b54578c474250cc6fb9",144,111,69,14.6086956521739,124,20,3,3
"4252","1d294d4cef50de05830f5d15c1ad82de",62,49,28,15.5,62,0,2,1
"4253","1d2f8246b5e63557d42026d13eab82d5",43,29,33,9.12121212121212,43,0,2,1
"4254","1d2fc110a7398349de2c8e991d36bfca",112,85,17,46.1176470588235,112,0,3,2
"4255","1d31a26da5f148ab7fe5caaad8f77234",11,11,0,11,11,0,1,2
"4256","1d33d7fa3c29edcde8620f5062875dde",19,19,0,19,19,0,1,2
"4257","1d33ef844b958dca4f96d33b7b574451",57,50,41,9.73170731707317,57,0,2,1
"4258","1d389d9b24c82347d2d830d48f71fcf3",45,45,0,45,45,0,1,2
"4259","1d3b2db3cd430de0b6923e0b1c731d52",16,16,0,16,16,0,1,2
"4260","1d3cbc9ada74b67eb930fe8eeb73b76f",2,2,0,2,2,0,1,2
"4261","1d3e11fe856b7ea1b3457b5a35e9a70e",29,29,0,29,29,0,1,2
"4262","1d3e58bc44b42c1e864efc675ce53239",99,72,48,14.4375,99,0,2,3
"4263","1d4245f1979d5b61fbc20c19bd71cd8a",111,77,27,28.7777777777778,111,0,3,3
"4264","1d48f0e4cbda9f77f85f1d3b04893134",150,77,62,16.9354838709677,150,0,3,3
"4265","1d49479352139341555944d2b12fad57",46,43,10,32.2,46,0,1,2
"4266","1d4d427bea99c16483662fdc2cbd9743",87,60,69,8.82608695652174,66,21,2,1
"4267","1d4e7cac9c7d6618ac724b27247bf71f",28,28,0,28,28,0,1,2
"4268","1d54242528d41e523d04b54dd1dcf035",194,92,75,18.1066666666667,194,0,3,3
"4269","1d54da62e970fae067bf1a10ad317868",35,35,0,35,35,0,1,2
"4270","1d5c55e5e08e6146162f5ebba11c64df",1,1,0,1,1,0,1,2
"4271","1d5e50d5c19e0d9391da206234b84ee0",43,33,44,6.84090909090909,22,21,2,1
"4272","1d5f4b2e27f5ad1f4f47fa709d2ae714",86,68,71,8.47887323943662,47,39,2,3
"4273","1d5f828302cb64cdbc341f7cdf26eab1",28,28,0,28,28,0,1,2
"4274","1d64f848ea23cb750f2e1e52d1cafa3d",50,50,0,50,50,0,1,2
"4275","1d651e392d993f97876fb0f15de3c558",25,25,0,25,25,0,1,2
"4276","1d66143b596413c8ecbf9e1fb783d5a3",17,17,0,17,17,0,1,2
"4277","1d6749f87d4abfefa6ef836fc8b5439e",18,18,0,18,18,0,1,2
"4278","1d6855a6bfea822277a5d37c7b302e55",30,30,0,30,0,30,1,2
"4279","1d68cb5ed633918a4b74b46cb135c4cc",30,30,0,30,0,30,1,2
"4280","1d69fb1726c6aa34be299490ef2caee9",31,31,0,31,0,31,1,2
"4281","1d6b63f54c2f41563a598057642a5c1f",13,7,17,5.35294117647059,13,0,1,1
"4282","1d6e289801c50a8c17b170b6c8b05626",21,16,30,4.9,8,13,2,1
"4283","1d6ff8579b78e8da615169e651dc2235",184,92,77,16.7272727272727,184,0,3,3
"4284","1d71836d1ad56080700f4b08f577e6c2",51,44,56,6.375,51,0,2,1
"4285","1d72f195142b7a6b9f74a10f2efe17c3",74,54,37,14,42,32,2,1
"4286","1d742e45d6216aeef8f667eb13927977",199,112,87,16.0114942528736,199,0,3,3
"4287","1d757397696155f1dab50c4c9314c4a8",7,7,0,7,7,0,1,2
"4288","1d75f5204d20af9eead4d1d1967a9b29",27,27,0,27,27,0,1,2
"4289","1d75f602693e8481dcf30007bba714c9",26,26,0,26,26,0,1,2
"4290","1d77e9bf0b8b050250a222fd682fd14d",86,68,89,6.76404494382022,86,0,2,3
"4291","1d794bd2f31fe274c6e10cee73ba560e",50,30,81,4.32098765432099,50,0,2,1
"4292","1d79d7f3c0dde96301f758ac675c1a81",187,95,53,24.6981132075472,154,33,3,3
"4293","1d7ac1585eb244399fd228142db65ae8",27,27,0,27,27,0,1,2
"4294","1d7d4b09c48017896cd79d73852328b4",101,75,82,8.6219512195122,86,15,3,1
"4295","1d7de325150d6adf351ac3d303e223ac",8,8,0,8,8,0,1,2
"4296","1d833f302b08d6e8af7df650b0885254",80,33,61,9.18032786885246,80,0,2,3
"4297","1d8415a627c0c2dbda90410f4851a84f",6,3,57,0.736842105263158,6,0,2,1
"4298","1d862e2392138f5249eaa32331fbaf95",82,68,66,8.6969696969697,82,0,2,3
"4299","1d881ea13d13adae928ede923496f7e4",37,37,0,37,37,0,1,2
"4300","1d8a3fe32242670f6850d49bf6f81ce6",76,67,63,8.44444444444444,76,0,2,3
"4301","1d8ba9e160d461c801f9814ef241d37e",78,61,74,7.37837837837838,78,0,2,3
"4302","1d943c237baeee7c8165e15af1afcf47",230,130,63,25.5555555555556,188,42,3,3
"4303","1d970ab546e50833c7c26dd13424f779",93,59,76,8.56578947368421,43,50,2,3
"4304","1d98f84a5f074ed9c7a47515d4f5f329",124,77,53,16.377358490566,90,34,3,1
"4305","1d98fbe741e9921128c936c2ca115a88",1,1,0,1,0,1,1,2
"4306","1d9973bfb8b44ad4af854f716de7a31e",3,3,0,3,3,0,1,2
"4307","1d9978bf4733d8f0e5f4d0d6427191f7",164,76,81,14.1728395061728,133,31,3,3
"4308","1d9c8993010163f178fa83fdb5ad4b8d",48,48,0,48,48,0,1,2
"4309","1d9dd2a10a43d48b59136b27788c3ec2",18,12,7,18,18,0,1,2
"4310","1d9f26a9215ef3da42198d2371d0de98",194,85,73,18.6027397260274,194,0,3,3
"4311","1da075437f7cb61371f393d1045e8f10",136,102,42,22.6666666666667,136,0,3,3
"4312","1da111723056e7ecad8b5cf3bb16c64d",23,23,0,23,23,0,1,2
"4313","1da173923aad2245b82b66d8467a987f",20,20,0,20,20,0,1,2
"4314","1da1b59d957811e94b12b114f022ced9",130,65,61,14.9180327868852,115,15,3,1
"4315","1da33b038dd721b3547dbbc347db63dd",24,22,64,2.625,24,0,2,1
"4316","1da379d5e09bf384516b85c3c5e117be",128,70,75,11.9466666666667,128,0,3,3
"4317","1da903f134d2a5545de8726e6fb424da",54,54,0,54,0,54,1,2
"4318","1da9583017b0f68ca9560ff2b1a5bf8f",50,50,0,50,50,0,1,2
"4319","1da9d2af8fd5c2ee38a21d1039dccfac",102,82,16,44.625,102,0,3,2
"4320","1da9fc1c952918255c0163ff48c74038",62,41,52,8.34615384615385,29,33,2,1
"4321","1db534a69f91a501edd2c15544d9f742",96,80,40,16.8,73,23,2,1
"4322","1db7234d29bf698b80304b80152a153f",46,46,0,46,46,0,1,2
"4323","1db9850699ff733a5902aa8efd3f9b7b",58,47,30,13.5333333333333,58,0,2,1
"4324","1dbad7ae3b0ad600cffdf3608a6f691e",46,40,42,7.66666666666667,46,0,2,1
"4325","1dbefa763afdef9c768cdcf9566ed41f",260,144,84,21.6666666666667,218,42,3,3
"4326","1dbf4e79b89c259534dcf6edac71e7c5",73,49,77,6.63636363636364,73,0,2,3
"4327","1dc003420aba14db2584eb18b1c48057",14,13,15,6.53333333333333,14,0,1,1
"4328","1dc2fd490c323424aa52814244b98f93",139,50,86,11.3139534883721,117,22,3,1
"4329","1dc30db2cc090b6f0bb52e444fd3b33f",199,105,61,22.8360655737705,164,35,3,3
"4330","1dcce250e545d9750f06c7472279fd6a",96,85,20,33.6,96,0,3,3
"4331","1dcd05f644c1f611ba2976537a5f79f2",135,96,49,19.2857142857143,135,0,3,3
"4332","1dce0dc45253a33f76d83976050614fc",9,6,31,2.03225806451613,9,0,2,1
"4333","1dd27ad283f3ff711a998022f7d61326",118,71,49,16.8571428571429,118,0,3,3
"4334","1dd3ff036d368a7a8fcb9fb56e430acf",25,25,0,25,25,0,1,2
"4335","1dd55332d383463fa60567117ab00176",114,72,67,11.910447761194,73,41,3,3
"4336","1dd9fa341f91d008b39b05b6c1913711",33,33,0,33,0,33,1,2
"4337","1ddb52a61e8690b34eda0af390763eaf",38,36,7,38,1,37,1,2
"4338","1de080168ad1678e2083d06755940dcc",140,67,56,17.5,140,0,3,3
"4339","1de1439cdb78332e5ed32f838bb8e882",38,38,0,38,38,0,1,2
"4340","1de2e634833722fd73eb8d04ebe66cf9",25,25,0,25,25,0,1,2
"4341","1de50f372af4a98594c6f7c238577978",45,45,0,45,45,0,1,2
"4342","1de5f2eb0a619d58674a36a6fe5cc690",100,55,65,10.7692307692308,62,38,2,1
"4343","1de621f843a55245d82374e7e0a91d91",22,22,0,22,0,22,1,2
"4344","1de7fac90edf248463b6ac064911a84d",184,140,61,21.1147540983607,184,0,3,3
"4345","1de8f33b0a87874aaeb4de134a8ac7dc",16,16,0,16,16,0,1,2
"4346","1decbc24636025fbeb965cc73a15739b",39,39,0,39,0,39,1,2
"4347","1deebaa499f03f343e958a25610a0689",109,93,65,11.7384615384615,109,0,3,3
"4348","1df0df48f8ebc90c26920804c566a00f",16,16,0,16,0,16,1,2
"4349","1df17b5770e3c2fd0c33ac27cb787cfa",125,80,43,20.3488372093023,125,0,3,3
"4350","1df3a77c68dcaae305dd9201fd7cf71c",90,55,20,31.5,90,0,1,2
"4351","1df3ac9e77aed72aece7423635a1aca5",49,39,39,8.7948717948718,49,0,2,1
"4352","1df8e8aca5ed41a9fdb85f0b00274893",43,33,61,4.9344262295082,23,20,2,1
"4353","1df93e0b07f53aeb76340520157d5625",6,6,0,6,6,0,1,2
"4354","1df9d61f0f0b0325da4ed4f3432ece6c",4,4,0,4,4,0,1,2
"4355","1dfd0ee1c1442031e94459786c49951f",29,20,29,7,25,4,2,1
"4356","1dfdf463fdc4f2cd8d71870be3854bbb",24,20,30,5.6,6,18,2,1
"4357","1dfede1555637432952055643d8b1b6f",28,28,0,28,28,0,1,2
"4358","1e035cfcd33b4a5ba4947cfda59d6b7d",28,28,0,28,0,28,1,2
"4359","1e03b443fb3897dd408365d53387c33e",106,84,21,35.3333333333333,106,0,3,3
"4360","1e0411f42e6bbd2315a289c000eeaec8",31,31,0,31,31,0,1,2
"4361","1e0451331081fba2cab9f8afddf07d02",191,131,84,15.9166666666667,191,0,3,3
"4362","1e05945f03a64cd5fd09608c7144826e",99,73,62,11.1774193548387,99,0,3,3
"4363","1e07532d40235c13fe856a561812110a",15,15,0,15,15,0,1,2
"4364","1e089a22d7c3687c0af886c57191874f",72,65,49,10.2857142857143,72,0,2,3
"4365","1e0eef8c3bf451615fafcd7acb3690b2",21,21,0,21,21,0,1,2
"4366","1e0f65e50d3057ea147f182b58ae5e3e",100,50,56,12.5,100,0,2,3
"4367","1e10888b6a68173ee8b12a97128df5ea",49,27,59,5.8135593220339,49,0,2,1
"4368","1e12bc67864f694703e5231848ccb8c1",44,37,61,5.04918032786885,44,0,2,1
"4369","1e1560024e57cdef9c1952fa3a5f0e59",56,56,0,56,56,0,1,2
"4370","1e15bc72f589ef4eec019f35641f82c7",7,7,0,7,7,0,1,2
"4371","1e1625c9ff39d51abf8dc3ef1f8d3a53",15,15,0,15,15,0,1,2
"4372","1e1708cb118db17123e90ced754e7bea",35,23,48,5.10416666666667,35,0,2,1
"4373","1e181e4d5712f92e8c92768e2305e01a",68,54,20,23.8,68,0,1,1
"4374","1e188e12fac1824c7a75d78a5858ea71",160,90,71,15.7746478873239,160,0,3,3
"4375","1e1b0e73d08fe40f215e36933bc76e77",40,40,0,40,40,0,1,2
"4376","1e1d51dd51af03295d3ae7d65f68b1ba",16,11,35,3.2,0,16,2,1
"4377","1e1e79891ef34b2efda73d1a99aac96f",19,19,0,19,19,0,1,2
"4378","1e1f1833680c23656c9c294201ba597b",111,85,64,12.140625,111,0,3,3
"4379","1e224c8752e93295e33b2272cebc4bf4",55,34,53,7.26415094339623,55,0,2,1
"4380","1e24a68678eef02fc34c6ead6c548e7d",49,39,34,10.0882352941176,35,14,2,1
"4381","1e2632650da155e00f92399e1728ccdb",89,41,73,8.53424657534246,76,13,2,1
"4382","1e27f042a754f1c225feebe545197e70",152,86,77,13.8181818181818,152,0,3,3
"4383","1e28a2fa8fd84c94a84b6f16a4cb4e36",42,32,42,7,26,16,2,1
"4384","1e2a71dc449448d9fa33ed4ae354c330",35,35,0,35,35,0,1,2
"4385","1e2dd72cec4e5972cc85971b666451dc",8,8,0,8,8,0,1,2
"4386","1e2f5b1957986a3be048599a17770bd7",28,28,0,28,0,28,1,2
"4387","1e329343538377085566c9ff8ec078dd",3,3,0,3,0,3,1,2
"4388","1e33002f5c1568eede95f061486dc19a",117,80,75,10.92,117,0,3,3
"4389","1e343a551bdb8ceaa2f6108e48b6a315",48,48,0,48,48,0,1,2
"4390","1e37340da0b58eec13d8173dc5622e92",145,74,84,12.0833333333333,145,0,3,3
"4391","1e3776b2e93b27f50b327856388247cd",1,1,0,1,1,0,1,2
"4392","1e3a2419491ad4367a932e9f53c7c4f4",62,46,70,6.2,62,0,2,1
"4393","1e3a7c8ffc485cf04451520ce29770e7",81,51,62,9.14516129032258,62,19,2,1
"4394","1e3ad9e4e5f719645e7ce2e16546a88d",52,52,0,52,0,52,1,2
"4395","1e3dde05dc3e9e0cae4c98e5a6b1c5c3",39,39,0,39,39,0,1,2
"4396","1e3f845b39f6344c89be867e33b5096c",124,94,82,10.5853658536585,124,0,3,3
"4397","1e3ff685a3ed4553f882223fe234571b",50,36,42,8.33333333333333,50,0,2,1
"4398","1e401af5c5639899d7f791bfd0143a3d",19,19,0,19,19,0,1,2
"4399","1e41ce84b1b9ed42099d2cf20b20deae",22,22,0,22,22,0,1,2
"4400","1e43e456fd2df213c56e1010202068b4",161,105,89,12.6629213483146,153,8,3,3
"4401","1e47cc9e56559a201c30fa5ad465dcd2",44,36,55,5.6,44,0,2,1
"4402","1e4832ff1b742ef6f009746af4e3b07a",46,36,23,14,46,0,2,1
"4403","1e48482d26fe308db73ce752d48cb870",27,27,0,27,27,0,1,2
"4404","1e4a38d4aaf8cf544f95e6b83bc14618",161,61,90,12.5222222222222,161,0,3,3
"4405","1e4b23e82710d3ec33c0c4954f16b15e",56,50,42,9.33333333333333,56,0,2,1
"4406","1e4fe03211ccae2986401adc1d77319b",15,15,0,15,15,0,1,2
"4407","1e55233f9370ece2e40bfaba47f36de8",218,98,30,50.8666666666667,180,38,3,3
"4408","1e555d1f25dbaf1380cf8201962d404d",14,13,2,49,14,0,1,2
"4409","1e56470a78da825b7a85bebd69c8ce98",146,93,60,17.0333333333333,95,51,3,3
"4410","1e58eaa617e815e5bf20492cff698537",22,22,0,22,22,0,1,2
"4411","1e5aeeb0465391927a94d42dab6f4b98",27,27,0,27,27,0,1,2
"4412","1e5b3a593b3996d6c18ae1fb2f2240e7",104,34,84,8.66666666666667,104,0,2,3
"4413","1e5f6176e8ab70d43ce95ac79544a429",198,123,81,17.1111111111111,198,0,3,3
"4414","1e60379013f4d9308db2067aca5f095e",140,105,56,17.5,140,0,3,3
"4415","1e6083788dd2c146d2eaf225c0a74846",138,72,59,16.3728813559322,138,0,3,3
"4416","1e61ab77a65d199763022b6817e33949",9,9,0,9,9,0,1,2
"4417","1e61f7322ee7e4c4b36911e506fcdefd",32,32,0,32,0,32,1,2
"4418","1e624a5fe4bbeb817cbf1c6e624b5c8b",211,111,78,18.9358974358974,211,0,3,3
"4419","1e6502108e225a77ce065612841357c9",60,53,20,21,60,0,1,1
"4420","1e6556c9f657fa4a3061825a563d1b69",159,74,72,15.4583333333333,159,0,3,3
"4421","1e666f708c2cca58670f9a884649bbfc",49,40,81,4.23456790123457,49,0,2,1
"4422","1e6752f3e8992d53095fd87156ee6290",34,34,0,34,34,0,1,2
"4423","1e697135a7e5571a4fdc234f275709e8",45,45,0,45,45,0,1,2
"4424","1e6ba845a9b07d2a09fb3000cfb10383",25,25,0,25,25,0,1,2
"4425","1e6bb7ff3fe2cdd88279c177b887de36",142,108,61,16.2950819672131,121,21,3,3
"4426","1e6f9b4ff76cd0e88249b53e3a191789",213,111,69,21.6086956521739,213,0,3,3
"4427","1e760c374aa94d37ffee7e0f3d34f08a",29,29,0,29,29,0,1,2
"4428","1e7b8baa35ad9b2a12cdfcf89ada6bc9",50,50,0,50,50,0,1,2
"4429","1e7d7ad4468e5efb4789c0487b96963e",53,53,0,53,53,0,1,2
"4430","1e7e7c1ef3b8cd1bbd6b65bcafe1afe5",12,12,0,12,12,0,1,2
"4431","1e7fc0cfa43be319e2b0fe05292b7f0b",60,42,66,6.36363636363636,60,0,2,1
"4432","1e8051dfb18ca49e400351d3905179dd",99,89,58,11.948275862069,67,32,3,3
"4433","1e82558fedb033d6f3412bce4c835a44",48,48,0,48,48,0,1,2
"4434","1e83315ac779fc89216fe414ada2888c",30,30,0,30,30,0,1,2
"4435","1e834320a746215e149e7d7bb17dd2aa",65,43,69,6.59420289855072,65,0,2,1
"4436","1e8451f1c3c5c988f4d84073a7de107a",45,35,22,14.3181818181818,45,0,2,1
"4437","1e85c25cdf754aeef6d0ab80acbed5dc",8,8,0,8,8,0,1,2
"4438","1e867e178f36d9bf80d21b15fea2f95c",49,49,0,49,49,0,1,2
"4439","1e8777ddb8bd933a5d25aba4354e395b",140,87,62,15.8064516129032,102,38,3,3
"4440","1e87f2fb2204a9588ad031c65aa16f7e",63,45,66,6.68181818181818,63,0,2,1
"4441","1e8888db23389b3da73eb04f53e9e578",16,12,43,2.6046511627907,12,4,2,1
"4442","1e898fa8cb39a05f5af99b0ed24096e7",44,29,44,7,44,0,2,1
"4443","1e8ecac45fe560ac855a48e28b627da2",41,41,0,41,41,0,1,2
"4444","1e91aa3ea886e6c0d68c1aad6322a98d",13,13,0,13,13,0,1,2
"4445","1e920afbe363e63a970ede60a6d8c4e8",66,50,32,14.4375,66,0,2,1
"4446","1e92ad2b024f259e40a4119f7327bd24",21,21,0,21,21,0,1,2
"4447","1e94709a8c6a0fe3fe4111c62579939e",19,19,0,19,19,0,1,2
"4448","1e957500859fef9ae5ec9c88e8c28d3b",37,37,0,37,37,0,1,2
"4449","1e962259b9a91c5cdad076569906874d",133,101,77,12.0909090909091,112,21,3,3
"4450","1e965bac3d6090bc17321b75b6cf82d1",26,26,0,26,26,0,1,2
"4451","1e9acaf95a618b29983041f07f3873e8",56,41,56,7,56,0,2,1
"4452","1e9b5e9e4c4d04723e16c5309f3dd754",13,13,0,13,13,0,1,2
"4453","1e9c80c15de4046de7ee65ac1e9488ab",168,107,59,19.9322033898305,168,0,3,3
"4454","1e9ca427f4e5ff6034b17bc4e2874ca5",28,28,0,28,28,0,1,2
"4455","1e9ca940b47a4a8474322af861c3d7fc",61,45,37,11.5405405405405,26,35,2,1
"4456","1e9e71327bd1b0e04dbc85c5332eb081",53,46,8,46.375,22,31,1,2
"4457","1e9e77acac7fc7fc3b950587e6f37d2a",37,37,0,37,37,0,1,2
"4458","1e9f17ca766e7d03dd24a47422a57da4",38,38,0,38,38,0,1,2
"4459","1ea226ff26b23502fe77888abf86208d",81,68,44,12.8863636363636,37,44,2,1
"4460","1ea3e6f4c27c4eb7cd25926e66185bae",37,25,35,7.4,37,0,2,1
"4461","1ea4184b69a2b1930a6959d3c811a8ed",12,12,0,12,12,0,1,2
"4462","1ea550ec409b6f201503cd22a9c23e85",29,29,0,29,29,0,1,2
"4463","1ea793f0790904c10294ea5a146652e7",20,20,0,20,0,20,1,2
"4464","1ea7ba03f378968fc2ba06b699b7fe1f",13,13,0,13,13,0,1,2
"4465","1ea7d38dc946491f2e859f56ec685373",40,24,36,7.77777777777778,40,0,2,1
"4466","1eaaee3c3845ded49a80ab1e9542b93f",144,74,65,15.5076923076923,144,0,3,3
"4467","1eac2c8cc2e60d5250ab0d6c75a7b188",59,49,46,8.97826086956522,59,0,2,1
"4468","1eadce7fd37d5920fcf15542d104454e",16,16,0,16,16,0,1,2
"4469","1eb15bc5f0065cc0a52a1e6fb6647885",60,49,9,46.6666666666667,60,0,1,2
"4470","1eb22f250b05620007022c9f7c99a1b3",118,70,48,17.2083333333333,118,0,3,3
"4471","1eb3c83be41faa398e7d5b52d7d8ade7",48,48,0,48,48,0,1,2
"4472","1eb44517fc8bad96968fa1b385cbe484",10,10,0,10,10,0,1,2
"4473","1eb4c834e3edf926f86722eb3df12054",49,35,49,7,49,0,2,1
"4474","1eb5d176c77581e9a0cc923cb6b08ae0",20,20,0,20,20,0,1,2
"4475","1eb669fad980e90c8ecc3ba1ae42b253",30,29,25,8.4,26,4,2,1
"4476","1eb7218d8a1fdfd67929ad4276921221",38,27,31,8.58064516129032,38,0,2,1
"4477","1eba7067515236c17c610c27c8d18d26",91,76,12,53.0833333333333,91,0,1,2
"4478","1ebaa3170738142e103a4a1f6386240f",33,33,0,33,33,0,1,2
"4479","1ec16c4b42e658dc4c1f3cd9b6f5dea9",38,33,56,4.75,38,0,2,1
"4480","1ec972924beb02b6900782807deb2fae",147,78,63,16.3333333333333,147,0,3,3
"4481","1ec9af7734edb958bc6f25abda4fd424",29,14,70,2.9,29,0,2,1
"4482","1eca688b1f14db9469b755a28f97e8cb",7,7,0,7,7,0,1,2
"4483","1ed64d64892741711783e7b23adfb224",52,35,33,11.030303030303,52,0,2,1
"4484","1ed92177f564f33c1348e49dfde0513b",24,18,39,4.30769230769231,24,0,2,1
"4485","1edb139e27fd247459bb4b9857e5b48f",16,16,0,16,16,0,1,2
"4486","1edb27c4aa1bfbafb699e742af22b320",48,48,0,48,48,0,1,2
"4487","1edba63e33e9075e927f719749083a8b",50,50,0,50,50,0,1,2
"4488","1ededa9ec4b4e0e0a14678c4ef62daea",13,10,81,1.12345679012346,13,0,2,1
"4489","1ee3922c80b958ce2825cf236ee5b5fe",32,32,0,32,32,0,1,2
"4490","1ee58f0c869b52200c86238ce6cfccf4",55,37,81,4.75308641975309,22,33,2,1
"4491","1ee73767dc2a5fcd4632927c0e73bdd3",24,24,0,24,24,0,1,2
"4492","1ee9f630e5a75c820ae033fca39dd29a",20,20,0,20,0,20,1,2
"4493","1eea0c1ad3afd08a4903ddc439ae31d6",20,20,0,20,20,0,1,2
"4494","1eea3664edb1d4e22b23081e0dcd4563",33,29,13,17.7692307692308,15,18,1,1
"4495","1eec8bbf04deebbf17c824764e3970b4",45,45,0,45,45,0,1,2
"4496","1eec960abebf03d9712036d174fdfbab",19,19,0,19,19,0,1,2
"4497","1ef36eed655808c35ca54d590d273d79",254,59,84,21.1666666666667,217,37,3,3
"4498","1ef738d620bdf51f363ce8fc6f0b4458",23,23,0,23,23,0,1,2
"4499","1efce2a72cb0c1f6b918f3beba140263",43,39,70,4.3,43,0,2,1
"4500","1efd1a50df594b5db4b0331e11304aa2",62,50,62,7,18,44,2,1
"4501","1eff7861bfc56b50a04d151ca9aca939",97,80,42,16.1666666666667,97,0,3,3
"4502","1f04aa5d8fe5ce6bc71b554715504ef8",27,22,81,2.33333333333333,27,0,2,1
"4503","1f051cbf7e8cd23c625c90b523b3d4df",24,24,0,24,24,0,1,2
"4504","1f064456dec20223a8b0edfb5e17d5b1",62,41,78,5.56410256410256,62,0,2,1
"4505","1f0f01a638b0df0ce1b367c5ba2de109",39,35,52,5.25,39,0,2,1
"4506","1f0f16c7867255c78628918204b09b29",15,15,0,15,15,0,1,2
"4507","1f1552a2b5f6dce803747c9febd2269f",13,13,0,13,13,0,1,2
"4508","1f16edbeaaaac1084facbf3248db1bd0",29,29,0,29,0,29,1,2
"4509","1f17df711beff859251c1a87a9c3d591",59,49,61,6.77049180327869,26,33,2,1
"4510","1f1b11bdb02e2387321afe692359a02e",107,81,74,10.1216216216216,107,0,3,3
"4511","1f1b19a7493390e5a6f642b29a5ac05d",1,1,0,1,1,0,1,2
"4512","1f1b2103b20aea4c2849edc27bdf5661",37,28,51,5.07843137254902,24,13,2,1
"4513","1f1c27f154b97211aafcb74062bb9704",39,28,36,7.58333333333333,39,0,2,1
"4514","1f1dad5c884a6e8ad12e967f936393f0",22,22,0,22,22,0,1,2
"4515","1f1dc8f43981bd687262320c082327c6",21,21,0,21,21,0,1,2
"4516","1f20b0c4d74b10b8dec9e1a1862cdc39",122,91,45,18.9777777777778,78,44,3,3
"4517","1f2484b24f2477f33d96fd1ae8b7e7f6",29,29,0,29,29,0,1,2
"4518","1f26c851fd72026b4302818b9e8d34cd",165,124,76,15.1973684210526,134,31,3,3
"4519","1f2749704e94a1400bac18eedb6ae86a",104,62,87,8.36781609195402,51,53,2,3
"4520","1f2a27e219bae7833b2f2dcf2cdf251f",79,58,74,7.47297297297297,79,0,2,3
"4521","1f2b90e5a922201c07d44259992fe268",13,13,0,13,13,0,1,2
"4522","1f2dcd5e8c12ab749281cb2881272952",28,19,19,10.3157894736842,28,0,1,1
"4523","1f2e4d42df93b8219e0836b5dd0d91cc",35,22,64,3.828125,35,0,2,1
"4524","1f30a8822639054476ca439149ead28e",75,39,59,8.89830508474576,75,0,2,3
"4525","1f347624c4e5fd8c890b5ff94dc98480",40,40,0,40,0,40,1,2
"4526","1f39a69f6c5e37124330f25b08b493c4",15,15,0,15,15,0,1,2
"4527","1f3ae64cc77c00fafb966936801d2006",1,1,0,1,0,1,1,2
"4528","1f3c3efca78c2d873d5a0034ab66df8c",19,19,0,19,19,0,1,2
"4529","1f3da3ecf97d8ec1830db0712275ced8",35,35,0,35,35,0,1,2
"4530","1f409dc4cd0295bc28145fb69347fb38",28,28,0,28,28,0,1,2
"4531","1f414d39b12ff64627956ca2fb46b912",121,61,64,13.234375,121,0,3,3
"4532","1f41a27773dd97df3b5306be98f59edd",54,48,70,5.4,54,0,2,1
"4533","1f46f280036db85c4209070d77759934",95,85,42,15.8333333333333,95,0,3,3
"4534","1f46f6690b3beb80868761921910ae8d",83,70,60,9.68333333333333,83,0,2,3
"4535","1f491c2ba7a29ac773404a97219cadbc",60,49,12,35,60,0,1,2
"4536","1f4acae63d79d98de9a69a4d3615a78b",58,43,84,4.83333333333333,58,0,2,1
"4537","1f4b021b00b378284d6660f4295345d2",63,46,30,14.7,63,0,2,1
"4538","1f530161b21ee431aa53fdd7e6b7b208",49,41,13,26.3846153846154,23,26,1,2
"4539","1f53c3983c15955a79a283645a941b82",92,55,61,10.5573770491803,92,0,2,3
"4540","1f543ac4bbc25923cbbfb88e0cb630eb",24,24,0,24,0,24,1,2
"4541","1f553c90c91ac226cae79e861d23087d",9,9,0,9,9,0,1,2
"4542","1f55481831c828028ada929360f6abaa",59,46,30,13.7666666666667,59,0,2,1
"4543","1f59148ebb34cbbd6aa7bd80a3fa8c33",48,28,59,5.69491525423729,48,0,2,1
"4544","1f59ac77b28031184bcb2a7aa477caf1",72,54,43,11.7209302325581,72,0,2,3
"4545","1f59f759bef2935c5a7c46a242d5a957",44,31,7,44,44,0,1,2
"4546","1f5ad1112490f5b001e033ae39281bb6",114,86,29,27.5172413793103,114,0,3,3
"4547","1f606dc150d6a03e7239448b01453d7a",16,16,0,16,16,0,1,2
"4548","1f608bc54de604f3d9ce6271baf443d9",40,40,0,40,40,0,1,2
"4549","1f618c3f262fde497967075a6fcd3ff6",18,17,4,31.5,18,0,1,2
"4550","1f632c7566a81c2c387cc9503da63521",24,24,0,24,24,0,1,2
"4551","1f6b4fac985b15701aff7ee3b24227ca",44,36,17,18.1176470588235,20,24,1,1
"4552","1f6c3df3bd95a13f646c9bce09b971ff",74,52,42,12.3333333333333,74,0,2,3
"4553","1f70bd8996dcc0adbc2b17c40af58840",22,22,0,22,0,22,1,2
"4554","1f7292fa537f6685ad59e8a485baf0ac",138,74,62,15.5806451612903,138,0,3,3
"4555","1f72e3172c53e8c1e7d26daabb4e6afb",149,107,63,16.5555555555556,149,0,3,3
"4556","1f73ec4d27e7214ea395893572db54dd",38,38,0,38,38,0,1,2
"4557","1f74be3ba788fde150e064bb33075405",82,72,17,33.7647058823529,82,0,1,2
"4558","1f761211ff3e89731415136972efa901",88,65,39,15.7948717948718,42,46,2,1
"4559","1f785bb570969c6e591c01fd6c996bfa",28,28,0,28,28,0,1,2
"4560","1f79c2a4808bb58abc1bfdefae6e80ce",24,24,0,24,24,0,1,2
"4561","1f7a8ac32707ae6164191ce539e77aa7",146,74,68,15.0294117647059,146,0,3,3
"4562","1f7cc196f91ef586dbaad57b7022d53b",25,25,0,25,25,0,1,2
"4563","1f7e55fba5f6f36a8d38a9fe76243741",239,123,69,24.2463768115942,190,49,3,3
"4564","1f7e93d63bfaeb179d18c4beae3f232b",8,8,0,8,0,8,1,2
"4565","1f80bb1f3aeca2e4babe961dcc99df95",25,25,0,25,25,0,1,2
"4566","1f81879d6ddc1ae1fecd108521d31f4d",35,35,0,35,35,0,1,2
"4567","1f853aebba03833b36a6d5253f8f5a0a",65,41,47,9.68085106382979,65,0,2,1
"4568","1f856343039604c6b4aaaf62b28b0bbc",32,32,0,32,32,0,1,2
"4569","1f88d1f286ebb163fcfbe9ecca27e96d",31,16,71,3.05633802816901,28,3,2,1
"4570","1f895ee8fa607e0c4234e5a7358ceab1",79,58,42,13.1666666666667,79,0,2,3
"4571","1f8cb11e12459232c74e5bd0a963d554",55,49,34,11.3235294117647,55,0,2,1
"4572","1f8d9a2ebee9e0194edacb87394e0dc8",24,24,0,24,24,0,1,2
"4573","1f8e7217aa343f146ae530cd60029c55",141,98,70,14.1,105,36,3,3
"4574","1f908f5de22cdf7b82fd7fa49f56e9fb",158,129,34,32.5294117647059,107,51,3,3
"4575","1f90c28548b1376b86b741e86ac2f6d3",188,96,70,18.8,188,0,3,3
"4576","1f949662db49eb7ee0598a7d00a32e1b",49,49,0,49,49,0,1,2
"4577","1f94a234752a96c586b7aa9b2afdf66e",117,79,65,12.6,117,0,3,3
"4578","1f94a6a25088a2cd36ed4fd8e9396275",64,56,11,40.7272727272727,64,0,1,2
"4579","1f95bc879b6b341b18cb445bb462e5f3",150,83,62,16.9354838709677,98,52,3,3
"4580","1fa11d19d5989ccbf41120f9b02ac20c",55,42,29,13.2758620689655,55,0,2,1
"4581","1fa1b0590e5a344f76f1edab2d9937e5",60,54,21,20,60,0,2,1
"4582","1fa2d7e485df78874d12464b8703c0ff",111,77,63,12.3333333333333,111,0,3,3
"4583","1fa3110af1aeeca5714a51ad587a8d23",43,36,58,5.18965517241379,43,0,2,1
"4584","1fa34f85551ce37dc74fbb6a31ece321",59,48,36,11.4722222222222,59,0,2,1
"4585","1fa678f65b26e91707640a3f484c1337",64,51,15,29.8666666666667,64,0,1,2
"4586","1fa9c154a58ba7eab3faf8ffd5d06a0a",37,37,0,37,37,0,1,2
"4587","1faa80dee70e68cb4dc07ccf12bfa9dd",28,27,10,19.6,28,0,1,1
"4588","1fab89d489822ad1ee7533991ab58795",185,81,76,17.0394736842105,145,40,3,3
"4589","1fad99d6e609b9806715b653509de754",63,51,25,17.64,63,0,2,1
"4590","1fadaccb6bd5445e7cd4e62e347e23a4",93,50,88,7.39772727272727,83,10,2,1
"4591","1faff1f3183629ec0923f7a4f2663ca5",34,20,61,3.9016393442623,25,9,2,1
"4592","1fb2a0684507d0d0f757d23fa349e2b3",95,55,28,23.75,67,28,2,1
"4593","1fb42b4df7eb232a64397dc20cdb3f29",17,17,0,17,17,0,1,2
"4594","1fb55dd81f5c16ed0d8eb5af92d215ab",117,77,28,29.25,117,0,3,3
"4595","1fb925ae5496dc74942276bcaa6bf6f6",15,15,0,15,15,0,1,2
"4596","1fb9dc81b55484d35b42027bef47dedf",39,35,38,7.18421052631579,39,0,2,1
"4597","1fbdbfe2a1ad7a864059c1de982659a3",117,76,81,10.1111111111111,117,0,3,3
"4598","1fbee379f1a1aa258a844cd7149dcf40",28,28,0,28,28,0,1,2
"4599","1fbf2adf49bc35f3f91caa4412e99786",166,81,69,16.8405797101449,166,0,3,3
"4600","1fc294bba84ac2dc76d848d8ddc7e618",116,90,58,14,77,39,3,3
"4601","1fc30c71f29f3c3a9665196123fa7b6d",29,29,0,29,29,0,1,2
"4602","1fc63b6c76a15530f47d8b8e2a39b971",58,40,47,8.63829787234043,30,28,2,1
"4603","1fc687ac8935e5a93e56f1e90be79003",41,31,7,41,41,0,1,2
"4604","1fc76264ce7c68b03c55bfbae46aa3c5",82,63,50,11.48,82,0,2,3
"4605","1fc908761f249609b860f340ec3b44e6",46,39,73,4.41095890410959,46,0,2,1
"4606","1fc9c870ed571f2c36c0a60bf9288dc3",22,22,0,22,22,0,1,2
"4607","1fcc0895130461c08593fa0f4bce8aba",36,9,70,3.6,36,0,2,1
"4608","1fcc0ec5cc125cafdbec0a5c8d691f7c",14,12,57,1.71929824561404,14,0,2,1
"4609","1fcd80fa1c08cf160a0a02dcff5eb8ce",14,14,0,14,14,0,1,2
"4610","1fcefce6a1a81168ecfe36f37accbcc2",30,30,0,30,30,0,1,2
"4611","1fcf158e754a87e2c6532ab6cad728c3",242,140,77,22,203,39,3,3
"4612","1fcfa9c0b1d5d13f54166b550a3e0cee",18,18,0,18,0,18,1,2
"4613","1fd221c55c042830cbbe2073da3dc420",142,112,66,15.0606060606061,142,0,3,3
"4614","1fd27222de4e3fa4cd7a12eff7deccfb",180,96,81,15.5555555555556,149,31,3,3
"4615","1fd4176b0748903569bb018a1a8a99a9",17,17,0,17,17,0,1,2
"4616","1fd5f6e9f3bf069889681c0b2e831778",34,34,0,34,34,0,1,2
"4617","1fdeef2382d5817ee678010721617c21",41,41,0,41,41,0,1,2
"4618","1fdf46b9002f7dae974000bedff59dcd",7,7,0,7,7,0,1,2
"4619","1fdf8fa75c3b37b2d39ca6ffb32122a1",107,66,76,9.85526315789474,107,0,3,3
"4620","1fdfe916eb4fed12aa8398c76b7fef8b",25,25,0,25,25,0,1,2
"4621","1fe16dada92f61a2d4560ef0f53ba4f4",11,11,0,11,11,0,1,2
"4622","1fe17ea97664d07cadacd8cb70e8dc23",52,52,0,52,52,0,1,2
"4623","1fe1eaf93430631cc8e2b676e1893bf1",64,54,37,12.1081081081081,37,27,2,1
"4624","1fe3a9b049c81905ffd5901291b1a759",15,15,0,15,15,0,1,2
"4625","1fe5b391829de7e5334be433515189cd",162,111,46,24.6521739130435,162,0,3,3
"4626","1fe636035662650dde62fc819ff08c08",159,75,67,16.6119402985075,159,0,3,3
"4627","1fe6de7deb0d5295e32f6b814ca6f79f",171,89,74,16.1756756756757,153,18,3,3
"4628","1fe88942597859ae163e71cd7e6de5a8",37,37,0,37,37,0,1,2
"4629","1fec041112766ca00ba25d1d5eec4794",13,13,0,13,13,0,1,2
"4630","1ff1c89fffdc3f8a88083ca4cf81ed3c",45,45,0,45,45,0,1,2
"4631","1ff2d9551b806c89c8fe3ac459e68d6b",97,82,24,28.2916666666667,97,0,3,3
"4632","1ff60b8197f4d777a001fd7182409963",9,9,0,9,9,0,1,2
"4633","1ff67bbfca73b30f454af2a789d72b47",4,4,0,4,4,0,1,2
"4634","1ff7368c83e5d384f1ae3ce46781182e",98,86,46,14.9130434782609,71,27,3,1
"4635","1ffa226f7dda5fe15a363d765b2c3d5f",32,32,0,32,32,0,1,2
"4636","1ffae72404854641c90f61683aa45baa",27,27,0,27,27,0,1,2
"4637","1ffaef44a242612b518523d466fb5a92",52,44,14,26,52,0,1,1
"4638","1ffd0f4a3dbdacbe3ffc598ebc915b41",40,38,30,9.33333333333333,40,0,2,1
"4639","1ffd69dae77014803f7ea7d54a9084b7",37,30,7,37,37,0,1,2
"4640","1fff4eaa1d3cd48f78a945c81c44e131",34,34,0,34,34,0,1,2
"4641","1fff7272c590505ad1caf46a6e85891d",64,52,20,22.4,64,0,1,1
"4642","200294024bfc9b3d887ddf3cbd1def15",74,54,30,17.2666666666667,34,40,2,1
"4643","2002a53de249996c34023be8be6ceb2a",199,113,65,21.4307692307692,199,0,3,3
"4644","2002fc1a761dade4c65644af64aa507e",61,46,33,12.9393939393939,61,0,2,1
"4645","200349f557c7f3fcdadcdb9ac15ce672",41,41,0,41,0,41,1,2
"4646","20055154f5abd5a5671bcecdb9beafad",30,30,0,30,0,30,1,2
"4647","2006f4a60734620fd2a31e625b693e93",39,39,0,39,39,0,1,2
"4648","2007a852db5b0c39db176cdd7d71fe3a",31,31,0,31,31,0,1,2
"4649","200b52a445318b315c0a75c0de3c37b2",70,60,34,14.4117647058824,34,36,2,1
"4650","200da1b52340b64b0a51ce70194e657b",53,32,59,6.28813559322034,38,15,2,1
"4651","200e1adca4ff7bde0d08085aff336ebe",30,30,0,30,0,30,1,2
"4652","200e8b049f0393e2648315b5b7fb95b8",21,21,0,21,21,0,1,2
"4653","200f62d75dfed0f726983b194cac8246",56,36,63,6.22222222222222,56,0,2,1
"4654","201006e2d2d6a6d4d745c0db71d7ac75",113,74,65,12.1692307692308,113,0,3,3
"4655","2012568892549e6782fb6bcf5a7497c7",92,81,64,10.0625,56,36,2,3
"4656","201283dfcb54b15e3de91b9e310939d1",31,31,0,31,31,0,1,2
"4657","2013e61a4ecffebde05b347cc1a3a042",88,64,47,13.1063829787234,88,0,2,3
"4658","2013febe9c7e33a1bf59e6339ac13c38",5,5,0,5,5,0,1,2
"4659","2014d6a4ad377e4c30e528e5c88c1ae2",48,31,63,5.33333333333333,48,0,2,1
"4660","20171205360c125b7e812e4e52280ee9",111,69,61,12.7377049180328,111,0,3,3
"4661","20188050a0533138ecbacc96f6f78bf2",24,16,33,5.09090909090909,24,0,2,1
"4662","201901eb7812393c1ccd7e80668667cf",196,95,78,17.5897435897436,196,0,3,3
"4663","201dbd5f13ca56757e36b7bcebdaa663",64,42,38,11.7894736842105,35,29,2,1
"4664","20270989ce329aa5edb8d969b5a38b94",42,42,0,42,42,0,1,2
"4665","2029577e140195697d99bc3a0d5e7fc3",38,38,0,38,0,38,1,2
"4666","202a06469359213199af2cfd7ccb2ef9",161,91,82,13.7439024390244,161,0,3,3
"4667","202ab043832a206babf88a5f652cd8c1",46,46,0,46,46,0,1,2
"4668","202ec6e9a6fd477ad14c350d354c8c50",26,26,0,26,0,26,1,2
"4669","2030a5f37bf05322724f18b2ef389152",120,54,64,13.125,120,0,3,3
"4670","2030fb65f2d915cc64268dd290d0618d",36,36,0,36,36,0,1,2
"4671","2032b6cd93bbcff4f2596bad761eb3ca",7,7,0,7,7,0,1,2
"4672","2034a5f07b06b43096bf35a3b324bb0c",47,47,0,47,47,0,1,2
"4673","2034eeca78c2084ab14bcfd74dd5982d",9,9,0,9,9,0,1,2
"4674","2036572353b775b5c0eb6a7f6db1eb6b",14,14,0,14,14,0,1,2
"4675","2038e8599f73b0122acee51bf81fc0ae",19,19,0,19,0,19,1,2
"4676","20391c2e3af8b22949baeea006a6c020",27,27,0,27,27,0,1,2
"4677","203a4dd5174b7e90ad7cd956eb8a0f0a",159,101,62,17.9516129032258,159,0,3,3
"4678","203be13e6bb406fb48a7af9a5b1864c6",36,36,0,36,36,0,1,2
"4679","203d526346b836a32548510efc4e818e",24,24,0,24,24,0,1,2
"4680","203e74d5e7e0bce83c75201357217616",118,94,57,14.4912280701754,118,0,3,3
"4681","2040874fd0937e3bf08ae6b9ac0367a3",104,83,41,17.7560975609756,104,0,3,3
"4682","2041195a17f2857f754e2791c5508860",60,43,40,10.5,60,0,2,1
"4683","2041566bfe850e3ac9cd2a6bfa1c0f15",102,59,73,9.78082191780822,79,23,2,1
"4684","2041fefba55aadbf315d9fec9d23c3d6",19,19,0,19,19,0,1,2
"4685","20422163724d75387bd156707d04e1cf",1,1,0,1,1,0,1,2
"4686","20428dcc8bc01c02747f3726f0f9fb73",83,67,65,8.93846153846154,53,30,2,1
"4687","204867221519fab0c3bda95126ce4374",159,91,81,13.7407407407407,123,36,3,3
"4688","2049f53d5540055111dbe7b7d371ea54",106,68,64,11.59375,96,10,3,1
"4689","204c5cabb686fceb1807f788cc576aed",41,41,0,41,41,0,1,2
"4690","204c70d47f35e9900d9474c0f26e32d6",38,32,31,8.58064516129032,38,0,2,1
"4691","204cbdcfb16c4d8938b4bb73b684202c",13,10,78,1.16666666666667,13,0,2,1
"4692","204d5893293495ed5d424573e8c97cf7",46,41,69,4.66666666666667,46,0,2,1
"4693","204f0869d8f2399ef208debd3b7f5585",78,49,28,19.5,78,0,2,1
"4694","20524df5625117deb20af244006df362",112,64,78,10.0512820512821,88,24,3,1
"4695","2052f981b33e3f679d8ff7986e10dc0f",36,36,0,36,0,36,1,2
"4696","205338021502568f045d36c105f7d4e2",29,29,0,29,29,0,1,2
"4697","2053b269b2624dcb639b4394ae4fe17a",81,67,62,9.14516129032258,81,0,2,3
"4698","2055c1e3fbe3ee44c20e70bf09f0352f",144,81,70,14.4,103,41,3,3
"4699","205d82d6f220dd99d54783e266faccf8",212,87,70,21.2,212,0,3,3
"4700","205e13c17ebfae319c397cbcd708edc2",65,57,14,32.5,65,0,1,2
"4701","205f9f0f97b41834ac6487d0f499de11",173,103,84,14.4166666666667,173,0,3,3
"4702","206063da3be5ed8c74ea950dd7e1a8dd",18,18,0,18,18,0,1,2
"4703","2065166abb65b1763b310b8e4e0be395",14,14,0,14,14,0,1,2
"4704","20658df31b9b728b8309c0e4c3eb4116",100,81,62,11.2903225806452,100,0,3,3
"4705","2065e7fa602f4870414a2aa04f8dff47",18,15,88,1.43181818181818,18,0,2,1
"4706","206a263f364e74d14ba823c83e041b36",42,42,0,42,42,0,1,2
"4707","206b0568f7d7fa1c7fcce4ca0383bbe8",17,17,0,17,17,0,1,2
"4708","206e810b2ea4cfb264cef47d5d61895a",106,60,73,10.1643835616438,106,0,2,3
"4709","2070b7691fce9cbfa7eabdd35f692d9d",1,1,0,1,1,0,1,2
"4710","2070c4f94bf27791ad42b75a8c2d44c4",4,4,0,4,4,0,1,2
"4711","2070ff49fb7b3a067e299b2639a5af85",29,29,0,29,29,0,1,2
"4712","2071ac14033d698730c7107f814f123c",231,126,59,27.4067796610169,177,54,3,3
"4713","2072bbd1431476ef87445c724043cda1",6,6,0,6,6,0,1,2
"4714","2074c41c92678f3c2993c2df7201cfcf",28,28,0,28,28,0,1,2
"4715","207913c74de23d3dbe1e7f41f2d76327",45,41,73,4.31506849315068,45,0,2,1
"4716","207b07c8ef1d65da278cf58cf2ad0aa8",76,59,22,24.1818181818182,76,0,2,2
"4717","207b4762d35fc246d0f2e63642dbacd4",19,19,0,19,0,19,1,2
"4718","207cb531dc2638f7cda293bb1badb3fb",150,65,66,15.9090909090909,150,0,3,3
"4719","2081c6b6afa3523a8b44c29011c94dfc",35,35,0,35,35,0,1,2
"4720","2086d4467d70a089ac47e9825e8ed52e",19,19,0,19,0,19,1,2
"4721","2086f194b2646234a66be932c846aab2",46,39,34,9.47058823529412,46,0,2,1
"4722","208a1631fa20f8220fe9bb23c4aaef23",45,45,0,45,45,0,1,2
"4723","208b2a4db243350a9cdad76b58b24cd1",27,27,0,27,27,0,1,2
"4724","208e3051b37ffdf7dc399b331bdc9c29",25,25,0,25,25,0,1,2
"4725","208e7790f09fcb9bf2521cd78690d373",13,13,0,13,0,13,1,2
"4726","20958ac6f22f1434cd92a88cf647cb06",30,17,35,6,30,0,2,1
"4727","209859a23e4cdc54c0cb5d980d51eadf",151,102,36,29.3611111111111,151,0,3,3
"4728","2098f46fb58ccf0c9c715bfdd367de95",43,40,75,4.01333333333333,43,0,2,1
"4729","209bd493571ad9577ba3b03de7d18194",25,25,0,25,25,0,1,2
"4730","209d0ff1720507c687a04e1ecb866778",44,44,0,44,44,0,1,2
"4731","20a15a084b4a8849879f9999669b1613",51,51,0,51,51,0,1,2
"4732","20a33a00b1632c8a9da5ca0516293eae",98,48,28,24.5,98,0,2,3
"4733","20a76e910fa84e60038835403d510298",34,34,0,34,0,34,1,2
"4734","20ac5f7540ca40fb1fdafb59eb5f02c9",21,21,0,21,21,0,1,2
"4735","20ac69a79961bdabda19d80753657da6",38,38,0,38,0,38,1,2
"4736","20ae6033acc8a4c5c88f543f13fc2cec",67,58,57,8.2280701754386,67,0,2,3
"4737","20b0bcf1399b7574cce364ca65427839",168,76,60,19.6,168,0,3,3
"4738","20b0fac432610e208ea66ec0975b5495",18,18,0,18,18,0,1,2
"4739","20b12d0e47f26389856da125e408eaf2",128,74,77,11.6363636363636,128,0,3,3
"4740","20b1e12802762b1858b9e2863e479a84",86,72,70,8.6,86,0,2,3
"4741","20b385c8c89dc178b9bd9a87b8f65d80",12,8,3,28,6,6,1,2
"4742","20b5c0a308e9a3813e8026d552fae29d",42,42,0,42,0,42,1,2
"4743","20ba5a4f55cca1b4d37c1d6baf4e4726",64,48,50,8.96,64,0,2,1
"4744","20bd5d00ebe7b93c2741ae7320ebc2f4",30,30,0,30,30,0,1,2
"4745","20c393c6f076e1726214e35c5f451648",26,26,0,26,26,0,1,2
"4746","20c48aab46432fe328d5e9c19983f1e6",41,28,46,6.23913043478261,41,0,2,1
"4747","20c7d7317d8df5527807e831a3807361",19,19,0,19,19,0,1,2
"4748","20c7e0334f930a462130cd9d2258bce0",251,109,74,23.7432432432432,210,41,3,3
"4749","20c8e334d74f76bdf21616bcb5e2bc80",33,30,58,3.98275862068965,33,0,2,1
"4750","20cb110c44896b84a852234239956737",20,20,0,20,20,0,1,2
"4751","20cd1610630f8cc2c8989e2eebd80149",105,81,65,11.3076923076923,52,53,3,3
"4752","20cf38a57a3ef00428b9088a4716ffce",26,26,0,26,26,0,1,2
"4753","20d56d2b2d2268cbf39e817989c7b4b6",39,37,35,7.8,39,0,2,1
"4754","20d8baa5bd436734795c57cf4a154f0f",81,56,53,10.6981132075472,81,0,2,3
"4755","20d91341877df7955863d3c516d78821",15,15,4,26.25,9,6,1,2
"4756","20dd89a850348c317bca23ff25f9b10b",41,41,0,41,41,0,1,2
"4757","20de421af81821ed23985ce827f019fb",21,17,15,9.8,21,0,1,1
"4758","20df7256ba2f354163dc9ae92fb186b9",111,84,58,13.3965517241379,111,0,3,3
"4759","20dfe202643e6456957a1c143ab25984",90,56,38,16.5789473684211,41,49,2,1
"4760","20e15cbb6b30b4ba0e50407e96852053",42,42,0,42,42,0,1,2
"4761","20e4426d028a7e036b3bc92fcbd8d735",174,88,77,15.8181818181818,151,23,3,3
"4762","20e4b0c110b17a186961a3afef9600ef",23,23,0,23,23,0,1,2
"4763","20e4fb078cf6c9260795e4521c7c969d",34,34,0,34,0,34,1,2
"4764","20e67b2e255dbba7974c675e2e0178c0",39,39,0,39,39,0,1,2
"4765","20e6fe318b430afd3985cd3ccc213146",66,55,9,51.3333333333333,36,30,1,2
"4766","20ee0d521d626af84ae0cd342c337742",36,36,0,36,36,0,1,2
"4767","20ef9498a9192c0668677e81475faaac",33,33,0,33,33,0,1,2
"4768","20f3f7b8c90da819f988bee0fe262760",11,11,0,11,11,0,1,2
"4769","20f48ed2de8dbe90b8f110b0f0ce1710",19,19,0,19,19,0,1,2
"4770","20f57f03b3bf38ec88f399df5d3aef6f",106,73,69,10.7536231884058,106,0,3,3
"4771","20f62d6ad98ca9cfb2493de5bc673d95",70,57,68,7.20588235294118,70,0,2,3
"4772","20f714b19195327e69ac05eab329b79a",6,6,0,6,6,0,1,2
"4773","20f82470da1cc9c12ea04c6e70e47082",81,63,37,15.3243243243243,53,28,2,1
"4774","20fadc8d1c97659daecb705ec45cb0ff",48,48,0,48,48,0,1,2
"4775","20faec8ccf2a596cb0fca6eedc3cc108",36,36,0,36,36,0,1,2
"4776","20fcb8ee45dd83e157fe9f0e2ba843d7",67,42,48,9.77083333333333,67,0,2,3
"4777","20feeaf6c0a7be1f0944f00ac702fbeb",8,8,0,8,8,0,1,2
"4778","210288e0fca9c99e8fbac9377033e7c5",37,32,28,9.25,0,37,2,1
"4779","21084d65a961fa947332332d1089b124",51,51,0,51,51,0,1,2
"4780","210ab2e69b833eea3f608a1740e0d6d3",3,3,0,3,3,0,1,2
"4781","210de4b00cabfe1f85d07a47acadf8c2",39,39,0,39,39,0,1,2
"4782","211090c63c68682f360e56be5a420ff0",65,53,36,12.6388888888889,65,0,2,3
"4783","21122a17127e7f2689d4f29e4dd6b597",19,19,0,19,19,0,1,2
"4784","21129d68c1e47c03086558c262442c72",36,16,77,3.27272727272727,36,0,2,1
"4785","2112dfc48be8affcc74241fe06cb7400",49,38,57,6.01754385964912,49,0,2,1
"4786","21135d3fd7ced69efa764f1098768199",69,57,29,16.6551724137931,69,0,2,1
"4787","211513a03c59b325b53364952bea4547",47,47,0,47,47,0,1,2
"4788","21179ac552029ff2573d40f09af8f783",120,63,77,10.9090909090909,120,0,3,3
"4789","211ab9d086562b67a2da3ade08e2ff3f",40,40,0,40,40,0,1,2
"4790","211ae3e932a7841cc9be02ef94884e7b",62,42,33,13.1515151515152,33,29,2,1
"4791","211ce96cbc90d917382b789d633111cf",61,45,40,10.675,61,0,2,1
"4792","212231c2fb52c37e781a7f333919bcf4",38,38,0,38,38,0,1,2
"4793","2123ce9b1078c85a90788885b5e6993d",163,75,63,18.1111111111111,163,0,3,3
"4794","2123dce28dd39ad05781e981876d1c73",110,65,23,33.4782608695652,89,21,3,3
"4795","212585b4c7cdfc77af1a0b59df333e2d",14,14,0,14,14,0,1,2
"4796","2125b360d98629096596f67211c695c3",1,1,0,1,1,0,1,2
"4797","21266bad207e02cf44f90f80e114a2fa",160,81,80,14,138,22,3,3
"4798","2127b9eb61e0cabd89e021c2391e1891",191,141,84,15.9166666666667,191,0,3,3
"4799","21298d37c3a0de148258c6fce02a88f3",48,46,15,22.4,48,0,1,1
"4800","212c0942f7f8a991a8caf628a57f261a",63,54,48,9.1875,63,0,2,3
"4801","212c1c95a24c687e0092456a41141cc2",17,17,0,17,17,0,1,2
"4802","212ca7c827e226ef1561f60910f386d4",36,33,13,19.3846153846154,36,0,1,1
"4803","21307013a0ab2dbe1ba0ca92a4e9c161",26,26,0,26,26,0,1,2
"4804","2130877a6afe5e030e556659f64829cd",57,52,16,24.9375,18,39,1,1
"4805","2131992c2c35629b9b414aa9bdd8bc69",7,7,0,7,7,0,1,2
"4806","213206045478325d3942eed9d4a83c41",45,45,0,45,45,0,1,2
"4807","21343cdb46e70cb6a88be08781ed17e5",67,52,37,12.6756756756757,40,27,2,1
"4808","21388829c373444202c17097e5aab25b",52,44,21,17.3333333333333,0,52,2,1
"4809","21397088c188f826e56b08721e0281e2",20,20,0,20,20,0,1,2
"4810","2139aae5739638fe76a82dcd6d36cae1",59,46,27,15.2962962962963,59,0,2,1
"4811","213aca9e0d53da6add2d3587ab4f510d",92,63,63,10.2222222222222,92,0,2,3
"4812","213d227cd32b520dbe7f4e8d53590c8a",32,24,84,2.66666666666667,32,0,2,1
"4813","213ff80c66eb83613c8ba97530104b67",47,47,0,47,47,0,1,2
"4814","2141f7c12290d66faaa291413b030442",52,52,0,52,52,0,1,2
"4815","2142aa55ae48a05a51a5b3682cf1a153",172,109,76,15.8421052631579,133,39,3,3
"4816","21451570105c6baad4658a1f6113a0cb",38,23,38,7,38,0,2,1
"4817","21452e149a753507169ee4b8ff026ef6",197,110,43,32.0697674418605,197,0,3,3
"4818","214a1b052c05c7673609821e03cbfc65",83,71,14,41.5,83,0,1,2
"4819","214a60dd499275b26e9a638deca6a33d",18,18,0,18,18,0,1,2
"4820","214aab3a2986c0cef7f476de2a58d404",33,31,7,33,33,0,1,2
"4821","214cc7bb29e2fd3e5f66e7d758fee771",20,20,0,20,20,0,1,2
"4822","21544ed539dcc4ba51e1343ac4a6bd78",177,84,63,19.6666666666667,177,0,3,3
"4823","21554ae6ef3675ddbfe5f520fd41239c",26,25,4,45.5,26,0,1,2
"4824","21555a3d475bcfcdc2b303c0ec6030a2",46,41,24,13.4166666666667,46,0,2,1
"4825","2155912c8f2f51aabfc4b73fba9b7e40",143,103,62,16.1451612903226,143,0,3,3
"4826","215637aefbed5a348464e39483eb70ed",93,62,56,11.625,93,0,2,3
"4827","21563f5896d1eb159673729d3e6da53f",17,10,71,1.67605633802817,17,0,2,1
"4828","215699d22f12170b2417003984c75f98",10,10,0,10,10,0,1,2
"4829","2156a24c814857e555a7d08d263fe588",176,106,71,17.3521126760563,176,0,3,3
"4830","2158d07d29b6d0eadca8a09266b5e14f",178,79,88,14.1590909090909,178,0,3,3
"4831","215c04971ea471b0c991cb7a410ed3e8",159,98,69,16.1304347826087,123,36,3,3
"4832","21602ef500a1a074014d61e01fe58585",102,68,60,11.9,78,24,2,1
"4833","2164a290395fdcf535506d98c372d3fb",35,31,12,20.4166666666667,35,0,1,1
"4834","21650e7c4cc626f4b4dc1ad7ff89bc86",27,27,0,27,27,0,1,2
"4835","21679c725715458d5d848adbb49b7cf6",33,33,0,33,33,0,1,2
"4836","21685c548589da89cf5ff50921f2375e",111,78,36,21.5833333333333,111,0,3,3
"4837","216b2aaaf3127a7890cdb0901cf27a64",32,32,0,32,32,0,1,2
"4838","216d671bcbb380863793eae957c2f4c5",79,38,42,13.1666666666667,79,0,2,3
"4839","216ecac83f24c4b4da9578e5d882bdfb",25,25,0,25,25,0,1,2
"4840","217048013066946a3fd15f2a1c47ae1c",40,29,57,4.91228070175439,25,15,2,1
"4841","217520b960b45d63fafdec14345c8451",2,2,0,2,0,2,1,2
"4842","217693b7c77f335c521e9afc8dd99b8c",54,47,26,14.5384615384615,54,0,2,1
"4843","217c2cf44fe841dbdcea4e6c4a6d02ea",184,82,84,15.3333333333333,151,33,3,3
"4844","217c4e84e85b91f5802674d2217ba149",48,37,14,24,48,0,1,1
"4845","217ce453fadca64ec7d0808b7be9b383",50,40,30,11.6666666666667,34,16,2,1
"4846","217d59da45834d7f0454c4a2ce19ca17",15,15,0,15,0,15,1,2
"4847","217db14eab0233c8fc6377371d05ae0c",22,22,0,22,22,0,1,2
"4848","2181708c00c5592e9e5f90c5844c24fc",24,24,0,24,24,0,1,2
"4849","21842d0357c127ffa862e931d5a5bde3",26,26,0,26,26,0,1,2
"4850","218590ceb61cb8b8f6cf1c1660084248",19,19,0,19,19,0,1,2
"4851","2188bddeb86c0e659fab8be8b78323c3",128,71,79,11.3417721518987,128,0,3,3
"4852","218d1744f00818ff758a72aabc147678",30,23,71,2.95774647887324,30,0,2,1
"4853","218fa5fc55d3af160bb748f35d6789e7",141,69,62,15.9193548387097,141,0,3,3
"4854","218fafefda3857cf371985117c744537",114,50,60,13.3,84,30,2,1
"4855","2193aab46f88b53ee8207b6d516464ec",10,10,0,10,10,0,1,2
"4856","21984cfe37cd5cca769537a59c41f577",46,43,67,4.80597014925373,14,32,2,1
"4857","219a835d7183aeb94153b6a339f751f2",104,68,58,12.551724137931,71,33,2,3
"4858","219fc9b21da13f24e41d51a3e07f46f1",12,12,0,12,12,0,1,2
"4859","21a14b8abf8da207baef54d2e0c51b4c",50,50,0,50,50,0,1,2
"4860","21a34785fffdd945116b511e03580e14",24,24,0,24,24,0,1,2
"4861","21a3e985c5f3ace4710bbba3b8f3032d",72,56,55,9.16363636363636,39,33,2,1
"4862","21a565ca47ca8696b5487ec177c9d90b",190,133,82,16.219512195122,190,0,3,3
"4863","21aae7f486d9407ee76961565ad4ff2c",95,59,48,13.8541666666667,95,0,2,3
"4864","21ab27f65ab5b2266cf8d40c54755cfd",20,15,61,2.29508196721312,20,0,2,1
"4865","21abc844d66826fdaaf0e715f8e62c5c",19,19,0,19,19,0,1,2
"4866","21b044344a49780e53125ee4d13e87e3",17,17,0,17,17,0,1,2
"4867","21b3a13c35311a267b77467f4d0049ce",84,61,81,7.25925925925926,46,38,2,3
"4868","21b4b43a80a88175a76473f072a441db",75,57,61,8.60655737704918,75,0,2,3
"4869","21b502d3f60faba798d1aa9c7c66afb1",101,78,42,16.8333333333333,101,0,3,3
"4870","21b54a561c7764d3fa0852e182c58984",31,31,0,31,31,0,1,2
"4871","21b5f3ceced18ae8d3554ed968aba8a6",139,72,63,15.4444444444444,114,25,3,3
"4872","21b8984a16d6a8adc858c937a0ae839e",129,108,38,23.7631578947368,92,37,3,3
"4873","21b9c360dc87ea460ae23aff3183b522",93,60,69,9.43478260869565,93,0,2,3
"4874","21bbfc54c111cffcd440b2e91680a1d5",26,26,0,26,26,0,1,2
"4875","21bc98352cdee6726f2f05b1ad7f2bf4",63,50,48,9.1875,63,0,2,3
"4876","21bd90d9719850a646d849c5b3507136",6,6,0,6,6,0,1,2
"4877","21c352d1bf83bd1389af3e16652de3a8",3,3,0,3,3,0,1,2
"4878","21c41ab5eb1a190338946c523cba5edc",40,25,28,10,40,0,2,1
"4879","21c758def7bacdc5eee48618edab9c8b",54,45,33,11.4545454545455,22,32,2,1
"4880","21c79081ffedaa018efe36e798836eef",146,104,74,13.8108108108108,109,37,3,3
"4881","21c92f58c85fe04bba5e53f2f43dae7a",134,74,78,12.025641025641,134,0,3,3
"4882","21cd6b3c7cbbc2f70e8a435dc29d4176",52,52,0,52,0,52,1,2
"4883","21ce13c9c2dabb69458035115fd5da72",7,7,0,7,7,0,1,2
"4884","21d12f4a428db328da9dada0990d78db",130,31,69,13.1884057971014,130,0,2,3
"4885","21d201cacbd39690270831925967cb4a",22,22,0,22,22,0,1,2
"4886","21d2a7baf1cd9bc8425d81804c7835af",102,74,72,9.91666666666667,102,0,3,3
"4887","21d4c955a722ad2702936e94e60ba61e",22,22,0,22,0,22,1,2
"4888","21d69aa00224569bf9dda24882082e06",19,19,0,19,19,0,1,2
"4889","21d9246a5e59511f6605eecd5d418ace",6,6,0,6,6,0,1,2
"4890","21d948fdc3a9398d0505806cddf1831f",35,35,0,35,0,35,1,2
"4891","21da3289081700bf459c76ce2dd091db",99,72,50,13.86,99,0,2,3
"4892","21da7c277e3143250897f708462e9e5f",163,93,80,14.2625,163,0,3,3
"4893","21dc9616b6caf4894fa98db776a28d0d",15,15,0,15,15,0,1,2
"4894","21dcacae0500d961a61d23d843da3afb",16,16,0,16,16,0,1,2
"4895","21debbfc6a7c3d14418487ba353026a0",51,25,77,4.63636363636364,41,10,2,1
"4896","21e20a6a53438f9d07ebc0c42c34d462",41,41,0,41,41,0,1,2
"4897","21e389d596b01310e0d95b05245cca59",81,65,24,23.625,44,37,2,1
"4898","21e46944c56f2e7dfb3a339951dee60a",30,30,0,30,30,0,1,2
"4899","21e54849d894ea8ec5fba78045550925",167,98,70,16.7,167,0,3,3
"4900","21e66c1b81a40b9a7926566e168f3cb3",101,79,35,20.2,101,0,3,3
"4901","21e9be643b77a6597ab12bf88b1e6af2",108,85,14,54,108,0,3,2
"4902","21ea96117579cef8aa32eb947dce11ee",31,31,0,31,31,0,1,2
"4903","21ed61b4515a1edf71ff7f3567c78e9c",7,7,0,7,7,0,1,2
"4904","21ef0ab3d384031cfa5b20c548825071",49,44,17,20.1764705882353,49,0,1,1
"4905","21ef35fec5d9a1601a31d6f46eb3ef4c",131,90,38,24.1315789473684,131,0,3,3
"4906","21f248697971346b6037e7a3a21561d1",172,50,88,13.6818181818182,145,27,3,3
"4907","21f2c335e554fd1299f7409a905a863b",63,50,24,18.375,63,0,2,1
"4908","21f37304b938bf2692b3fca493566d78",37,37,0,37,37,0,1,2
"4909","21f5d130797167551655d09c0a052680",11,11,0,11,11,0,1,2
"4910","21f626afe1227d943863a1375c159f7f",11,11,0,11,0,11,1,2
"4911","21f833690ab6a3dd91bf19c91eaf732c",32,26,31,7.2258064516129,32,0,2,1
"4912","21fa5f5d411455be17371fdf6e2e090d",133,71,48,19.3958333333333,133,0,3,3
"4913","21fb3e9508989771450a1477b4d059cf",123,64,68,12.6617647058824,123,0,3,3
"4914","21fd3590bf6b30246361229edd79dd6a",48,43,62,5.41935483870968,48,0,2,1
"4915","21fd425322751806b0194c2ced4e8cb8",1,1,0,1,1,0,1,2
"4916","21fdb01ae155a9ca87adddbf2a02aa8c",90,78,70,9,90,0,2,3
"4917","2200a915831d063e324012997df2ad11",77,67,82,6.57317073170732,52,25,2,1
"4918","2200d99170e597ff94e37ed7320e7f85",30,27,67,3.13432835820896,20,10,2,1
"4919","220221e20d0b1cbde69a3c4f6d1b808a",25,21,61,2.86885245901639,11,14,2,1
"4920","22065658d82027a7261809760f640ec1",56,56,0,56,56,0,1,2
"4921","2209be3f9251ea4d7dcccd2bb975a462",26,26,0,26,26,0,1,2
"4922","220a28b36a12426e10da80be85d95011",45,45,0,45,45,0,1,2
"4923","220ac8c4e04aa3879d1177fe447ed3f5",7,7,0,7,7,0,1,2
"4924","220b78901bdd6a092e4be12c759e21e2",44,43,8,38.5,44,0,1,2
"4925","220bf7eca155f2d45761e45b3bc9fa1b",51,51,8,44.625,51,0,1,2
"4926","220e39a71ec0cd55c72b0e23cdadc1a0",126,97,73,12.0821917808219,109,17,3,3
"4927","22104876ee7bdf099785f7cfede5579d",37,37,0,37,37,0,1,2
"4928","2211f26efca7581048e80fa920eb24fc",79,59,36,15.3611111111111,45,34,2,1
"4929","22125994b1b725090992ee4729d327ce",43,41,80,3.7625,43,0,2,1
"4930","2212952dae3297da36a733f3ec8e941f",34,25,12,19.8333333333333,14,20,1,1
"4931","221383b253a7b59971d5e7777f8d2289",10,10,0,10,10,0,1,2
"4932","22174c1bdee087b556aa9c6f3a8f9a02",87,75,34,17.9117647058824,87,0,2,3
"4933","22176913f3a68541dd898a4acda2e3e1",15,15,0,15,0,15,1,2
"4934","2217e52f94d524a7528f7e83af74a901",41,41,0,41,0,41,1,2
"4935","2217f2fd8e12eb82ae11d4042b0d0d88",14,14,0,14,14,0,1,2
"4936","221b3f91a6add0eacf95dc2f39d5e7ff",95,57,75,8.86666666666667,73,22,2,1
"4937","221fb813bd197648d0b0a1a15bd9d9ca",25,25,0,25,0,25,1,2
"4938","2220ab88cdd5c98f2a1ac5dea73d8fad",124,67,72,12.0555555555556,84,40,3,3
"4939","2222e44e178fe7f050935ab4c03e4f08",126,81,71,12.4225352112676,99,27,3,1
"4940","2223d2927b9c931089c5b38528b3e6fd",41,41,0,41,0,41,1,2
"4941","2225ead4f1f25d8be049b82e0398e8f3",30,30,0,30,30,0,1,2
"4942","222c4369dc833d86e4b4fccca7c06589",35,35,0,35,0,35,1,2
"4943","222d695df71453709e77591d093e81d2",9,9,0,9,9,0,1,2
"4944","222fe48619ab0079e03d7cbe0c06b8a6",157,99,70,15.7,157,0,3,3
"4945","2230d0d0a4a08737b10ce7d002b5be53",44,31,33,9.33333333333333,44,0,2,1
"4946","223270ec25b9cbd930ff9cdf62af3b30",20,20,0,20,20,0,1,2
"4947","22330b4ee3e6c8e1bedf4120bd075349",55,26,60,6.41666666666667,42,13,2,1
"4948","223521aeb523b6520cf6a57d2c9372b9",4,4,0,4,4,0,1,2
"4949","2235acde384a93703668d6f838c4e7b5",19,13,56,2.375,19,0,2,1
"4950","2235b9fcd2b8651f14f55a39cbe0fb11",192,95,82,16.390243902439,192,0,3,3
"4951","223806958940df0ea1b43e2027a88165",162,76,77,14.7272727272727,133,29,3,3
"4952","2238326444d6b05d9d685289c269e386",151,91,70,15.1,111,40,3,3
"4953","223a6d6e934994686ef64f229b83b1f9",64,48,62,7.2258064516129,64,0,2,3
"4954","223b93dd6c6e31a8662b7905e94e91c5",142,88,35,28.4,115,27,3,3
"4955","223e4e2ad3bcb3ed85b7c7bb2b130395",1,1,0,1,1,0,1,2
"4956","223f6cf500ca171d5229246764d5bc9b",44,36,39,7.8974358974359,44,0,2,1
"4957","223fcb314200476cb6a739f4042cf3e6",23,23,0,23,23,0,1,2
"4958","224141a4903de111eeb0a72312ec9372",78,46,52,10.5,78,0,2,3
"4959","22418317d957dbfd863437371da73257",141,94,82,12.0365853658537,141,0,3,3
"4960","22421a98ed3478bc06ee011615f64ab6",10,10,0,10,10,0,1,2
"4961","224291bdeaf698a6551acce774d2ec6d",51,51,0,51,51,0,1,2
"4962","22485b12e4ff8e91f47e3062d1d4af61",114,75,61,13.0819672131148,114,0,3,3
"4963","224c77929c51043f13f580d3448d344d",115,73,77,10.4545454545455,115,0,3,3
"4964","224e1793b8a21ebbdc5e30c6b7402ecf",33,24,28,8.25,33,0,2,1
"4965","224f91835e72dc3e8233cdd398f469c5",138,78,45,21.4666666666667,96,42,3,3
"4966","22508fc65dc79607b86ce15ab630de74",60,47,31,13.5483870967742,60,0,2,1
"4967","22521678f8527f3e7a100e727c2eaacf",9,9,0,9,9,0,1,2
"4968","22538ee1ca6d1fc0279a414de11b0fae",53,28,29,12.7931034482759,53,0,2,1
"4969","22539da87ea5260d8864b247ff5ed9f2",75,59,32,16.40625,75,0,2,1
"4970","2254194a2ffe753857e4968fe0bda9e1",36,36,0,36,36,0,1,2
"4971","225a58ebb80a5dc0ee0182fc3ae6ea02",20,20,0,20,20,0,1,2
"4972","225d3e69c214dc1047b21046569c7840",62,35,63,6.88888888888889,62,0,2,1
"4973","225ea70e738935ecb1d34b776a7f1d99",62,57,37,11.7297297297297,62,0,2,3
"4974","225fbe2282e74f781cb4dee6d6aa2cff",102,81,29,24.6206896551724,102,0,3,3
"4975","226704e5d016b533374cade0353b8220",87,54,74,8.22972972972973,87,0,2,3
"4976","2268f12c2f6491893b363c82864b34bd",39,32,56,4.875,39,0,2,1
"4977","226c21b0c145320df94ea8858a33ba0f",41,38,12,23.9166666666667,41,0,1,1
"4978","226c70273b75c9a127896cb722aa5753",33,33,0,33,33,0,1,2
"4979","226d854f417a37f7cd72bb42dc7dd557",86,64,61,9.8688524590164,58,28,2,1
"4980","226e6fa7afa14c07809ba7b006b718e5",125,96,41,21.3414634146341,75,50,3,3
"4981","226ee16bf4263f7a77615db8f63e5bf1",91,66,34,18.7352941176471,91,0,2,3
"4982","22700f533b909f0e811171ffe0a353f5",25,25,0,25,25,0,1,2
"4983","22702a83aa14d31322c82ead955ca2cd",145,72,78,13.0128205128205,90,55,3,3
"4984","2277ce6c241fc125371e0ea196f0e579",81,65,14,40.5,81,0,1,2
"4985","2278bf68d9f372c81677646601ee2f03",130,93,44,20.6818181818182,93,37,3,3
"4986","227abe4fa8ca09c62f987dc1bd6e3a75",6,6,0,6,6,0,1,2
"4987","227acf0aff0845f2fb7cd10acfbafc5e",211,118,42,35.1666666666667,211,0,3,3
"4988","227d0af4204821170fa014a3e131e6ca",71,37,63,7.88888888888889,47,24,2,1
"4989","227eec9131c168e4cadad2ad7e3b6d57",123,76,63,13.6666666666667,123,0,3,3
"4990","228280b7300655c6d3aa31c6916f44e7",66,54,58,7.96551724137931,66,0,2,1
"4991","2282efcb3503b7cc3668052ca35bbd01",14,14,0,14,0,14,1,2
"4992","22835da335c2c52f965ee2e5f1da3050",35,35,0,35,0,35,1,2
"4993","2285d811e6eb5830b0b50ab4dc2e0946",160,91,82,13.6585365853659,160,0,3,3
"4994","2285e0b30cb10cd185ebbccb855dfbbc",25,19,64,2.734375,25,0,2,1
"4995","22884b56c6565a67173095c92f4b0540",110,73,65,11.8461538461538,110,0,3,3
"4996","22896a71c21c85265602606c38767bb1",16,16,0,16,0,16,1,2
"4997","228d8a543c1ffb373e2a4146c1ed8ba7",56,54,40,9.8,27,29,2,1
"4998","2290b22b040506c391a5c1697114964b",1,1,0,1,0,1,1,2
"4999","2290d7e18b14b54f6f92da82731b6d57",7,7,0,7,7,0,1,2
"5000","2291d744ef96b4f1901c3b2313bd2037",37,37,0,37,37,0,1,2
"5001","22920c6065e5b694c14490cf047f3d4c",51,51,0,51,51,0,1,2
"5002","22939fdb5eda98d58397d7de3c95b203",41,41,0,41,41,0,1,2
"5003","2293ab08588ed274638a48fb7a1e1b52",36,36,0,36,36,0,1,2
"5004","2293ba9d1e764c2add0e70344cd408bb",48,48,0,48,0,48,1,2
"5005","22959cfcfe7c296f389f7835e4a67739",25,23,38,4.60526315789474,25,0,2,1
"5006","229606e8485700171b96bd2ee5b92a1d",27,27,0,27,0,27,1,2
"5007","22990dc4a3ece41d4add8d3ad487267d",62,53,85,5.10588235294118,62,0,2,3
"5008","229958b7c1e6e9be82a5dbd67d916639",163,123,49,23.2857142857143,163,0,3,3
"5009","229b09cab238fca54ced5f7d8350dcf3",37,37,0,37,37,0,1,2
"5010","229ce1fb0a88c139000bb2ff8a2f1636",58,36,74,5.48648648648649,58,0,2,1
"5011","22a1c645cea5b00b1c38a6fbdd7271dd",64,48,45,9.95555555555556,64,0,2,3
"5012","22a4f04866e4a4914b92c5a738893e86",103,71,41,17.5853658536585,103,0,3,3
"5013","22a4f83f828e6e40dd01638bb45629b7",16,16,0,16,16,0,1,2
"5014","22a532c6a8aeb9d488783c13383035f3",43,37,69,4.36231884057971,43,0,2,1
"5015","22a660e5d742266f0f1ca44ac2324123",89,58,67,9.29850746268657,89,0,2,3
"5016","22a6b52296c030fb3aec1ca0d0b23aac",250,114,82,21.3414634146341,205,45,3,3
"5017","22ab20f38bb9a9cf97fce1ed47850213",110,75,76,10.1315789473684,65,45,3,3
"5018","22ada005156e441b3e0bbe58dc95bde7",48,48,0,48,48,0,1,2
"5019","22aea192fa5e03f88db18a4cca6d1550",129,99,46,19.6304347826087,90,39,3,3
"5020","22b616fdc0346191ecc386840540b8de",87,44,52,11.7115384615385,87,0,2,3
"5021","22b81e6d298a4b888d94296386f14728",12,12,0,12,12,0,1,2
"5022","22b9b94b9b09a434cc62a51c949d4f29",36,36,0,36,36,0,1,2
"5023","22ba2f5bb10e0101f138abf2ab6bac9f",1,1,0,1,1,0,1,2
"5024","22bb018accc9a33405747e2d34e5a187",18,18,0,18,18,0,1,2
"5025","22bbc97b50cdaaa7e2ad205cd5bc63f0",10,9,21,3.33333333333333,10,0,1,1
"5026","22bbe42245af1dc92fceafabe5fb826b",172,111,57,21.1228070175439,172,0,3,3
"5027","22bd79a438b9e6c2227339b74260cbb6",75,51,59,8.89830508474576,54,21,2,1
"5028","22be11a955a2d2ca6ab01db469fdec01",119,93,63,13.2222222222222,119,0,3,3
"5029","22c4adb059bfcb7808a65ea7c257150d",95,63,62,10.7258064516129,70,25,2,1
"5030","22c6b5bb996c3ea1afc07f5ae93defe9",66,49,33,14,66,0,2,1
"5031","22c89553c1c9312df87f2be0f8b3b5b3",27,27,0,27,27,0,1,2
"5032","22c9c300d036216caad43dea54117ad6",45,45,0,45,0,45,1,2
"5033","22c9d146ff20af06acc0f69d50516057",18,18,0,18,18,0,1,2
"5034","22cb28a3c3cf7f1c216a34a1dc52db6f",40,36,9,31.1111111111111,40,0,1,1
"5035","22cdde4de635658c4bbd1349e9f8503a",197,150,69,19.9855072463768,197,0,3,3
"5036","22cde148cafb66a2d1ebb442b21c5ea7",156,119,28,39,156,0,3,3
"5037","22cdf7e1531ee0f1ee292484755c6cbe",28,26,23,8.52173913043478,28,0,2,1
"5038","22d8053345f5e5b6fa2762450f413e93",27,17,45,4.2,27,0,2,1
"5039","22d9a88695aca478b039c0dee10fca1f",36,36,0,36,36,0,1,2
"5040","22d9ea86db056b839852e62caccbda35",18,18,0,18,18,0,1,2
"5041","22da0b396b7e5a99969bc4cc00789fa4",45,45,0,45,45,0,1,2
"5042","22da73b81374d1c2300b3f4ec1613bbd",76,68,46,11.5652173913043,21,55,2,1
"5043","22dd482d9ef5c29585e0bc5b3f98ed11",29,17,67,3.02985074626866,29,0,2,1
"5044","22ddbf30d8c33b09369108d072b79e2d",44,44,0,44,44,0,1,2
"5045","22decac7f054a028c94f8d5a9b1da7e6",17,17,0,17,17,0,1,2
"5046","22df32601437345c730a7282ccadf38c",64,51,33,13.5757575757576,64,0,2,1
"5047","22e3aa607f897088b11528c6e37b3e7b",50,45,58,6.03448275862069,50,0,2,1
"5048","22e5c375c4573cfc236098acffc5093f",25,25,0,25,25,0,1,2
"5049","22e701fb2fbaa9998820a46993680e68",125,63,57,15.3508771929825,125,0,3,3
"5050","22e86fed9d796911c4064aff51dcf5e3",21,21,0,21,21,0,1,2
"5051","22e995e8f96d12aa9c63ec7a779d478c",164,91,83,13.8313253012048,120,44,3,3
"5052","22ea141636e3b1e35d93ee7e648a3bc5",138,88,70,13.8,138,0,3,3
"5053","22ebc162560e5d8defa86a8b94e2b72b",104,83,65,11.2,71,33,3,3
"5054","22ec24211bf6240f7f8e5f7a2d646d62",175,70,60,20.4166666666667,146,29,3,3
"5055","22eea1c9ea1f7cf02bf63a0a3f0e6393",55,46,69,5.57971014492754,17,38,2,1
"5056","22f477dca7ba462d77d7d72601c4c24c",22,22,0,22,22,0,1,2
"5057","22f932787e14191fc6d274f703b44c58",80,62,42,13.3333333333333,80,0,2,3
"5058","22f9676d2d20722d8f59228e456c20cb",27,27,0,27,27,0,1,2
"5059","22fd6916dc95bc1483a8afc3a1c8e3e6",49,38,69,4.97101449275362,49,0,2,1
"5060","22fdcb2195792658e2dc866a57da91ee",171,90,71,16.8591549295775,171,0,3,3
"5061","22fe5e1f97e19491bb7fe1983bbdc8e4",24,24,0,24,24,0,1,2
"5062","230340c5ccb3b4310ead30ac599d5809",22,22,0,22,22,0,1,2
"5063","230c21b7d8f44400961713ab52f0ed7d",56,54,7,56,56,0,1,2
"5064","231a3923638aaca5c4f2e12bf32a8015",65,52,67,6.7910447761194,65,0,2,3
"5065","231cfe4a3b903d6611653fbfd56f1442",27,27,0,27,27,0,1,2
"5066","231eb46e2d400a5e8877fd369feacd5c",33,28,27,8.55555555555556,22,11,2,1
"5067","231ec87501027071cb744feee10cc428",1,1,0,1,1,0,1,2
"5068","2321385443865cc2b3f098d8e44794c5",23,23,0,23,23,0,1,2
"5069","2323bf55a01620c26c9fe2142231d3a1",71,51,51,9.74509803921569,71,0,2,3
"5070","2323e777e9a6269c3a8522b11ad2186b",181,83,89,14.2359550561798,172,9,3,3
"5071","232561f7b1943bc7c699f0d0feb2fdde",32,32,0,32,32,0,1,2
"5072","23262ce4c9f980a4c9de5b045f7a5f80",10,10,0,10,10,0,1,2
"5073","2327299454e026c8c00546f14942275e",42,42,0,42,42,0,1,2
"5074","2328cbd805c91ef1baa2eb99fd65d024",72,58,79,6.37974683544304,72,0,2,3
"5075","232acd1569f103eeb1e566c9efa5c5f9",12,9,9,9.33333333333333,12,0,1,1
"5076","232ca2118ec827003e6e5b5ed481aea2",183,87,72,17.7916666666667,183,0,3,3
"5077","2330fd4ddee37ddc3a3819557d062f8c",81,55,48,11.8125,81,0,2,3
"5078","2331a815b09aa45be59c52cd62c0cd9b",15,15,0,15,15,0,1,2
"5079","23338f953ea7add7641dc06b3b91a678",145,92,53,19.1509433962264,145,0,3,3
"5080","23356f6e3622d197c91652dfbcd53606",26,26,0,26,26,0,1,2
"5081","2335a89a36a6c96d187d9bb4153b2aec",21,21,8,18.375,12,9,1,1
"5082","233758b06821d4e85794fe170c9249aa",207,121,69,21,207,0,3,3
"5083","2339a5038041bd29e9f0e52b6ae80d5b",50,42,53,6.60377358490566,50,0,2,1
"5084","233b26bb054c0e2313df20ca16f4a231",48,36,12,28,48,0,1,1
"5085","233b83e621bb855a23dec382a372da85",22,22,0,22,22,0,1,2
"5086","233d2faea7cee2d630feab2767ebac6c",29,25,28,7.25,29,0,2,1
"5087","233d43ca62a7e2074a87f71d11335eec",99,82,33,21,99,0,3,3
"5088","233ddf7d37916b1eeb2fc4dcc0b8cabc",69,61,50,9.66,69,0,2,3
"5089","233fd7e4f43dd82016d8ea5dae56982e",41,41,0,41,0,41,1,2
"5090","2340fa2651daa5038c4fbacd3bd2f2d7",139,82,59,16.4915254237288,139,0,3,3
"5091","234266af2a5b30f6fe6737cc7379ec25",17,17,0,17,17,0,1,2
"5092","2343c67458909c7e5a4aec6027c294ac",4,4,0,4,4,0,1,2
"5093","234428fef47e59eb8afdc43ce44410a0",151,107,26,40.6538461538462,151,0,3,3
"5094","234a73d33cdae0813af0b7b561c89448",77,54,45,11.9777777777778,77,0,2,3
"5095","234ac8bc9e0bb1306906ebf1eb801679",14,14,0,14,14,0,1,2
"5096","234dcf0a9a114aa1b6bb8c7145142494",15,15,0,15,15,0,1,2
"5097","234f2ed76943697a82fd08878e39a1a6",215,95,62,24.2741935483871,215,0,3,3
"5098","2353146d8e41b9620132280a9002018e",65,53,51,8.92156862745098,65,0,2,3
"5099","23532f6c6ecf886b032b8769dea375e4",236,141,65,25.4153846153846,208,28,3,3
"5100","2353b34c0fd5b7ad7075a14e1b45fad9",101,61,69,10.2463768115942,101,0,2,3
"5101","23550a08663778c29d2b1e645fa62f65",71,48,50,9.94,71,0,2,3
"5102","23555a0c0bcf70bd496f2d64ccb05b13",94,64,81,8.12345679012346,94,0,2,3
"5103","235650f697b595db210ac011b2c81276",79,69,79,7,79,0,2,3
"5104","235a4e04b0ae69c514318f12402fdb5f",129,84,52,17.3653846153846,93,36,3,3
"5105","235c3f8e56a10c51b9d17badb6c52ce6",33,32,14,16.5,33,0,1,1
"5106","23605c408c96f9908b0eb7d33f1efee0",47,39,12,27.4166666666667,47,0,1,1
"5107","2366d7be878e9ca7f878e06a8ed2aeb9",145,72,63,16.1111111111111,145,0,3,3
"5108","236e2176dfd3ea5b3c548bd2f6a9a4e3",40,40,0,40,40,0,1,2
"5109","236e3b64318738cfb8fcf1dbe5040dd9",63,54,21,21,31,32,2,1
"5110","23704259c0deded5c1f016752792c055",54,43,49,7.71428571428571,54,0,2,1
"5111","23733f8ea37419f9460d3c25cf0ff299",71,69,30,16.5666666666667,71,0,2,1
"5112","2373980474ba9e6e503d86fb79b26c5d",12,8,40,2.1,12,0,2,1
"5113","2373f1d914c41883eef18304c35fd3b7",39,39,0,39,39,0,1,2
"5114","2375ab7598b9cea4d203574628aa8cf2",249,104,82,21.2560975609756,198,51,3,3
"5115","23770c80e3eddc96fdc08d256e4e4931",38,38,0,38,38,0,1,2
"5116","23785f5a67bb4edfb11ce5e47bf95802",38,38,0,38,38,0,1,2
"5117","2378b8c63ea288dd8fcf95512a8c4127",93,66,65,10.0153846153846,61,32,2,1
"5118","2378cd594dc9e9f120864fa4c20dd5f1",13,13,0,13,13,0,1,2
"5119","237a6d21fc5811cc042c668e161ce97c",7,7,0,7,7,0,1,2
"5120","2381ff544b1962304dba0d630cae22d3",32,32,0,32,32,0,1,2
"5121","2385dba4f1b0ef3c18a12af5c42bac63",32,32,0,32,32,0,1,2
"5122","2388744a793cf117d1574d8e3a67e694",110,71,47,16.3829787234043,92,18,3,1
"5123","238a5b0e973053f3a00ca8c04b94f4e2",102,73,68,10.5,102,0,3,3
"5124","2393446f78100466fd5618925513f8cf",52,38,49,7.42857142857143,52,0,2,1
"5125","23934f77311795ba48f3794c3ef7d25a",34,34,0,34,34,0,1,2
"5126","239461aaf2b6a44331333aee900f69da",48,40,7,48,48,0,1,2
"5127","239a36b19d95a8a633209c0f9e907700",81,55,56,10.125,63,18,2,1
"5128","239afc5dd8bbb68714ae2a775008ee05",123,77,63,13.6666666666667,93,30,3,1
"5129","239ce320190c6013cd8e23b74af71767",140,99,75,13.0666666666667,102,38,3,3
"5130","239e2974be748c75e5be5fc8a43be12b",51,44,12,29.75,51,0,1,1
"5131","239e453a47b3f15bfea9e2bd6141c52d",35,35,0,35,35,0,1,2
"5132","23a2c550c5cccbdff564c84dde7def21",150,79,63,16.6666666666667,150,0,3,3
"5133","23a5ab82c0845ca2a6ad0e6811c85aa7",79,64,55,10.0545454545455,79,0,2,3
"5134","23a71011b5b9b00c5d83fdeb0e6da112",18,18,0,18,18,0,1,2
"5135","23ab1b71d652b9839c848c45780d1652",49,43,31,11.0645161290323,49,0,2,1
"5136","23af7589fa30170d5a507ced200a4933",166,101,62,18.741935483871,166,0,3,3
"5137","23b613dd2b22092a608f52ee6f07f248",14,14,0,14,14,0,1,2
"5138","23b68f08c09adcf81df2322f819991fa",48,32,37,9.08108108108108,48,0,2,1
"5139","23b6ccde3f9c2bb2079989a8a609b9df",89,70,18,34.6111111111111,89,0,1,2
"5140","23b86aff26f56d26c0905c3d041334e7",36,36,0,36,36,0,1,2
"5141","23c15ac37f6d5137628533196526f429",21,21,0,21,21,0,1,2
"5142","23c28550db779b991a54396948646779",87,69,55,11.0727272727273,36,51,2,1
"5143","23c59cc8dd934c900c6f91010bf7ef7b",43,30,61,4.9344262295082,22,21,2,1
"5144","23c5f57d6d6b998d94f875979ac95788",40,40,0,40,40,0,1,2
"5145","23c67ac30475101ef7a9caa87c80cd65",14,14,0,14,14,0,1,2
"5146","23c6898a0acfacae717899188e1647c5",32,24,55,4.07272727272727,32,0,2,1
"5147","23c6c8b557a7bf2b9a107db716646d7c",51,51,0,51,51,0,1,2
"5148","23c832fd7c06dbbea920b6b2fcde79ac",168,77,63,18.6666666666667,168,0,3,3
"5149","23c96291ab1adf9f317c5cf2a587530e",24,24,0,24,0,24,1,2
"5150","23ccc32615bcb85583da66dacd27f8ae",160,87,89,12.5842696629213,160,0,3,3
"5151","23cd07210cb6a0f0586b1f316569127f",20,20,0,20,20,0,1,2
"5152","23ce2d7720622df61db73babad413cb9",140,94,69,14.2028985507246,86,54,3,3
"5153","23cebed479f1baa6933464d724b59190",6,6,0,6,6,0,1,2
"5154","23d510c8e869476e002c15bdc76a4a01",68,47,39,12.2051282051282,35,33,2,1
"5155","23d69a689ce8a2ee2307d2b9e6760df4",34,33,31,7.67741935483871,34,0,2,1
"5156","23d758c3f92c5604e7198184442f4a56",7,7,0,7,7,0,1,2
"5157","23d9383431fb8ef2d89504967aa65c38",137,89,67,14.3134328358209,137,0,3,3
"5158","23e02d97d6664fb770e1435636db58cb",65,47,27,16.8518518518519,65,0,2,1
"5159","23e093110b4afd6c58b08368537caa77",10,8,42,1.66666666666667,10,0,2,1
"5160","23e6e4910194b4f89bde545ddfb394b8",52,41,13,28,39,13,1,2
"5161","23e76b020383f2cd49f59b2c599c2f8f",27,19,43,4.3953488372093,27,0,2,1
"5162","23eb4655e76031bb23a6fd7d0bd4299b",39,32,38,7.18421052631579,24,15,2,1
"5163","23ed2081b45e25bfd6bc9301aaed5515",27,27,0,27,27,0,1,2
"5164","23efb6e3ed3157ecda9f0739b6f96baf",25,24,6,29.1666666666667,25,0,1,2
"5165","23f0da67c35d1f7e9756dfc0af392947",21,21,0,21,21,0,1,2
"5166","23f281912f94b148745a01743836bc26",25,25,0,25,0,25,1,2
"5167","23f38e07a2e9ae7c9ce365282d923593",51,51,0,51,51,0,1,2
"5168","23f4c523eb6dce8f10dfeb6cd7ee7ea6",66,60,59,7.83050847457627,39,27,2,1
"5169","23f6b7d563ac20abd94316041c0255e6",76,48,84,6.33333333333333,34,42,2,1
"5170","23f780fc08e9773ad317a4953b132466",15,15,0,15,15,0,1,2
"5171","23f9cec45904bc97e750e77f640d8bb3",155,75,65,16.6923076923077,155,0,3,3
"5172","23fb404ebc7f33d788cee20bca302603",32,32,0,32,32,0,1,2
"5173","23fcd52fc66361d5e6a5d8ca9c86257f",46,38,56,5.75,14,32,2,1
"5174","23fdcbf9114999e1366fce099bcfc4ce",29,29,0,29,29,0,1,2
"5175","23fed710f5941ea2f25a68f56f536a1b",35,25,18,13.6111111111111,25,10,1,1
"5176","2404a2b83d4d1f2c13a4ff2f6fe450ef",15,15,0,15,15,0,1,2
"5177","240adc6e9f4d3d440f2ed4db0a560b1d",110,79,49,15.7142857142857,110,0,3,3
"5178","240c586d85c7fb2433ce7a59c73a3398",161,96,63,17.8888888888889,161,0,3,3
"5179","240db6d6bc8096a5ec5082d276baabc1",4,4,0,4,4,0,1,2
"5180","240fc96b5e946f0229a091adba10af71",15,9,27,3.88888888888889,15,0,2,1
"5181","241119c2c0793cd593be8cbd884cd2ae",43,43,0,43,43,0,1,2
"5182","2411677611cea34f7205a2ce2eb7fd4d",19,19,0,19,19,0,1,2
"5183","241280b7d9062f98106df7acec16b5d6",58,42,22,18.4545454545455,58,0,2,1
"5184","24188cb644e06a3dbcedae4c10e844ca",174,106,79,15.4177215189873,156,18,3,3
"5185","241b8234aa80f4bf8180e80882e249b6",102,82,26,27.4615384615385,102,0,3,3
"5186","241bd1a831833dce559dcc78907ab181",27,27,0,27,27,0,1,2
"5187","241de19166f4ae4767e829a545019731",22,22,0,22,0,22,1,2
"5188","241e3ac30a63c7a06c95085e8a6f25c2",31,31,0,31,31,0,1,2
"5189","24229c23b3a246960f4c635270da11de",57,49,37,10.7837837837838,57,0,2,1
"5190","2428bdc4d370eb5e0f40e596f6105b4f",39,39,0,39,39,0,1,2
"5191","242cd6442183d38f0a8f317985b480a9",19,19,0,19,19,0,1,2
"5192","242f393d465cf4abd9634e9d4318e9b1",64,48,24,18.6666666666667,64,0,2,1
"5193","243119b9d341d6a61065af1c4d146f64",37,37,0,37,37,0,1,2
"5194","24324544b2e6d0469cf0569c5459e763",54,43,14,27,0,54,1,1
"5195","2434e96766087a9bb75f3a5295a15e5f",166,71,86,13.5116279069767,166,0,3,3
"5196","2435c7710e47dae7c0f54e9ca570c39a",56,56,0,56,56,0,1,2
"5197","24365a8fb26280361d533363bcbd1e9e",13,13,0,13,13,0,1,2
"5198","243b22169266903ef77518926323a3f2",154,93,70,15.4,154,0,3,3
"5199","243ea1af2aa44e2c86e04ddcb1b6a1a8",57,48,27,14.7777777777778,57,0,2,1
"5200","243f70a8bc70090761b6fbbc96cb54f2",20,20,0,20,20,0,1,2
"5201","24400a95bf15c4be17cb7a22abf51e73",53,47,8,46.375,22,31,1,2
"5202","244417ce8b277191a5b7d318c1fa47da",190,78,84,15.8333333333333,190,0,3,3
"5203","2445d9ff8f6b9c0a39bc1198738a7a3d",170,96,60,19.8333333333333,170,0,3,3
"5204","2448813977df58a90b5ff257fff8c426",62,39,56,7.75,50,12,2,1
"5205","24495ad088875e9e93dfde548a897ced",30,30,0,30,30,0,1,2
"5206","244c82e1d6818630b2e03bd48668fa10",75,59,81,6.48148148148148,75,0,2,3
"5207","244dae08ba76202c25a0cd62193ab25b",38,38,0,38,38,0,1,2
"5208","244e51dcd55736bd63841b637a983f7f",1,1,0,1,1,0,1,2
"5209","2451fd90d33429d7b4da5c286fe15877",72,55,49,10.2857142857143,72,0,2,3
"5210","2452a6dd0915fb81875d9974d9c77f12",4,4,0,4,0,4,1,2
"5211","24565cfe7288932cbf2e134cb29074ce",50,47,34,10.2941176470588,50,0,2,1
"5212","245a3d8aee97443ecdac53d0ad00f419",20,20,0,20,20,0,1,2
"5213","245bb79de6849b5fb465d3650f047b3c",16,16,0,16,16,0,1,2
"5214","245c906919794ebaadc0ff13e62cfc7f",61,47,73,5.84931506849315,55,6,2,1
"5215","24601dd5509e7564e62801b829994054",64,39,57,7.85964912280702,46,18,2,1
"5216","2460c04f45dc84d64b641f824ce470a2",34,34,0,34,34,0,1,2
"5217","2462cdd4edfa378e4530c65b9e78cefe",65,43,83,5.48192771084337,65,0,2,3
"5218","24654025fdcd32b89e3d2022e10902e4",25,25,0,25,25,0,1,2
"5219","2465dd81a5b6505c1fbe63146869422a",73,65,80,6.3875,28,45,2,3
"5220","24679669f131326afa1e1d536b704860",4,2,37,0.756756756756757,4,0,2,1
"5221","2468d077e9cb9ff24e38c53a34bed539",18,14,59,2.13559322033898,18,0,2,1
"5222","246a0bb420a9d36dca95f6494c89edd0",54,47,60,6.3,54,0,2,1
"5223","246aa88d33a8e963bd8f386d32d46c63",112,68,56,14,112,0,3,3
"5224","246cd361340432a9e253a876eac62eae",31,31,0,31,31,0,1,2
"5225","246ed14085cbf92cbf2583726ef998c6",1,1,0,1,1,0,1,2
"5226","24755e524e58e733ca616a60615c330b",67,60,60,7.81666666666667,67,0,2,3
"5227","2476872c7b700db3534ce7d53ccb3d86",39,39,0,39,39,0,1,2
"5228","2477c10ec56aa5b3e545052af0fde65b",122,90,52,16.4230769230769,122,0,3,3
"5229","24795a87589e18dd90741a2c4ceb8fb8",74,43,70,7.4,20,54,2,1
"5230","2480fd1aac9f41800da51b2712e37aac",46,44,63,5.11111111111111,0,46,2,1
"5231","248454e46888dcc6bde5a2e2503bf679",200,98,70,20,200,0,3,3
"5232","2485ee2e0aef0d51ac5f3380a6f3bf80",29,29,0,29,29,0,1,2
"5233","248617692ee25513ab0bfa20b89ef46f",6,6,0,6,0,6,1,2
"5234","2486582b8cd16510b7b288891176f435",187,93,74,17.6891891891892,187,0,3,3
"5235","2488c89767aa5c6a0287c6ebb0fc0676",25,25,0,25,0,25,1,2
"5236","248985898ffbddc8a1ffd5de453dd672",21,21,0,21,21,0,1,2
"5237","248a09f21b5617624e97f1a63a0d89e8",11,7,55,1.4,11,0,2,1
"5238","248d91837566828d9f0f65b35a354f10",36,36,0,36,36,0,1,2
"5239","248ed4a9bb8ae4fba1f6a9500356bca4",162,135,60,18.9,109,53,3,3
"5240","24923d8e30165570539543722d828af3",10,9,38,1.84210526315789,10,0,2,1
"5241","24995fa7ba8995f09c7ce25f267e0933",64,54,54,8.2962962962963,49,15,2,1
"5242","249ac58c966a732c725cac6f85b3a019",139,74,47,20.7021276595745,89,50,3,3
"5243","249e3e3d65c083f0ee40e2a31c61ea6a",45,34,21,15,45,0,1,1
"5244","249e6b355f8a89e9beb14cc457e357df",47,47,0,47,0,47,1,2
"5245","24a0e63840eb7362c6b1aa96fac12dc7",69,55,41,11.780487804878,43,26,2,1
"5246","24a220f716e3edef1a1069aa838309ec",16,16,0,16,0,16,1,2
"5247","24a260114fc9a7f0f3d87b02bfe4a1c5",112,72,56,14,112,0,3,3
"5248","24a2dc56db5b39a11cb6ca1b2868fd32",27,20,43,4.3953488372093,27,0,2,1
"5249","24a2fac9a3d12013ecc31d1833c39c6c",96,65,81,8.2962962962963,74,22,2,1
"5250","24a53a5cd71c20f198abcc5181167d9f",208,93,75,19.4133333333333,208,0,3,3
"5251","24a5993a7110b86ede15e59c8a502081",41,41,0,41,0,41,1,2
"5252","24a76878591bd890b7560e3922df2e7c",130,83,65,14,89,41,3,3
"5253","24a9329b46841ab21ce0f38335931dd1",147,80,75,13.72,147,0,3,3
"5254","24aadc92d94b8becf14e0209487e87ae",174,95,77,15.8181818181818,174,0,3,3
"5255","24abf1e6decb3a1981ac250876892375",75,59,74,7.09459459459459,75,0,2,3
"5256","24ad5c72eee8d168246e0dd1e986421b",182,82,77,16.5454545454545,182,0,3,3
"5257","24b0a91a2110d91f888a6482d728e8eb",60,45,79,5.31645569620253,41,19,2,1
"5258","24b166e96bf3f3a92cbd0c3faa29d2a8",19,19,0,19,19,0,1,2
"5259","24b4791a8c3aa870d0aed7ad3e4b32e2",24,24,0,24,24,0,1,2
"5260","24b4f62b1f3f16eb55df6b0780bbfe4d",33,33,0,33,33,0,1,2
"5261","24b5d41ca4d8eaa317ecc7765ad25e72",14,14,0,14,14,0,1,2
"5262","24b8e4efc442c8e989f6e973ee504914",17,17,0,17,17,0,1,2
"5263","24bb4915bee9263cf70b881dc69aebda",35,35,0,35,0,35,1,2
"5264","24bcfa56855ec3e13add360dd23a201e",16,16,0,16,16,0,1,2
"5265","24be1b9e4bab7ab98347d1ef1e0921cf",68,52,56,8.5,68,0,2,1
"5266","24bed59e4fd67665b24025ac758a21a7",36,32,20,12.6,17,19,2,1
"5267","24bfda270d11558c1fce8942526404b2",21,21,0,21,21,0,1,2
"5268","24c0e9c9ae4e208d547985bc0c2aadec",221,129,72,21.4861111111111,191,30,3,3
"5269","24c44a318ddf0d63049bee7a1223d12e",121,106,23,36.8260869565217,121,0,3,3
"5270","24c578490e678008e9decf4f3850c297",68,53,51,9.33333333333333,41,27,2,1
"5271","24c6ef0d926161bc980f2f1906e94769",30,30,0,30,30,0,1,2
"5272","24c8c7afcdc6bb3543f63b917091f3aa",48,48,0,48,48,0,1,2
"5273","24ca392533665f9fd1870bb052ae3efd",32,32,0,32,32,0,1,2
"5274","24ca8babb3da590a0dd422e5c11675f4",82,65,50,11.48,82,0,2,3
"5275","24cabdbfab3f367dc22b7fe2c3d61538",47,36,40,8.225,47,0,2,1
"5276","24cae3e2be2f83910058664edba6aa6d",94,54,74,8.89189189189189,94,0,2,3
"5277","24d360ce223260589a024cdad101e62b",24,24,0,24,0,24,1,2
"5278","24d616da499c7a562615ce349e77f9c4",50,38,56,6.25,50,0,2,1
"5279","24d65c9f886555713ef18450322defe4",27,25,53,3.56603773584906,27,0,2,1
"5280","24deb8311eb55f87faea014a94b847dd",126,90,56,15.75,126,0,3,3
"5281","24df1b4b325029bbec539ba21785b9ac",78,64,47,11.6170212765957,78,0,2,3
"5282","24dffa8a84004fa40c8dba35870fc47d",89,51,31,20.0967741935484,67,22,2,1
"5283","24e1de711b27e1ddfe309276506e3710",82,54,64,8.96875,82,0,2,3
"5284","24e2dd90a50b73ca3a53538dd1dc3e7a",55,51,21,18.3333333333333,0,55,2,1
"5285","24e6637947ccddf60170d5e8449e8415",55,37,68,5.66176470588235,55,0,2,1
"5286","24e6f121c4dd187493cd8f6eb7128c21",198,99,68,20.3823529411765,198,0,3,3
"5287","24e94be0beb627962e985c9cf29229f0",39,27,55,4.96363636363636,39,0,2,1
"5288","24ec1320624133b91e39cc904ca59dd9",163,104,56,20.375,163,0,3,3
"5289","24ec53c676afc131e982e7668bcaae78",6,6,0,6,6,0,1,2
"5290","24ecc664289440cb58338e23b930a3e9",162,111,62,18.2903225806452,115,47,3,3
"5291","24ecdd045b803c46365633426225e14f",38,32,15,17.7333333333333,38,0,1,1
"5292","24ed8ea7346d6bd7d8cf15c00adb8163",122,94,47,18.1702127659574,108,14,3,1
"5293","24eea98cc466665c5cb254b64b90cd39",22,21,3,51.3333333333333,22,0,1,2
"5294","24eeb05f106fa6e0a186cb3600bdb613",17,17,0,17,17,0,1,2
"5295","24f2620c684130e4ff47914ed0fca17e",157,84,88,12.4886363636364,157,0,3,3
"5296","24f49dc80a1805e4c964ccc0a8cbc25f",19,15,72,1.84722222222222,19,0,2,1
"5297","24f5fd3005e84c73868a0ac3ec0a88bf",116,87,50,16.24,116,0,3,3
"5298","24f6e0034aaf2e323b15d5bc5d349791",47,47,0,47,0,47,1,2
"5299","24fa2b12008ffde777249e0f5978eee3",1,1,0,1,1,0,1,2
"5300","2502f934e3a145b5ddfe6c83765766b8",195,108,77,17.7272727272727,195,0,3,3
"5301","25059de41a6f1d30250505d51ecefac5",91,52,60,10.6166666666667,61,30,2,1
"5302","2509b23890fa8f97e6ba45a26a5ab2db",30,30,0,30,30,0,1,2
"5303","2509b6d242da208db8c84f2d3adb5772",39,35,51,5.35294117647059,39,0,2,1
"5304","250a55da564c491e79331e0a90ab716d",8,5,59,0.949152542372881,8,0,2,1
"5305","250e10bc67a1b465601c10b59ab85258",19,19,0,19,19,0,1,2
"5306","250e77d07bd792193744190b6f84cd33",51,41,68,5.25,34,17,2,1
"5307","250f74c724abe6110842758d42f9de29",16,16,0,16,16,0,1,2
"5308","25105fffc8ecdf65fab86b7ef33d57a9",10,9,48,1.45833333333333,10,0,2,1
"5309","251415dfafce8d62fc81e91860572221",193,34,84,16.0833333333333,193,0,3,3
"5310","251a0adbfcacb73d49e74705ee3dfe96",45,45,0,45,45,0,1,2
"5311","251c9163462fcbaec6bf195cc0aae1da",12,12,0,12,12,0,1,2
"5312","251cbcb32c916506a3b261bd52ba4552",45,45,0,45,45,0,1,2
"5313","251eb7b012d8f3bc5a37113b67410265",55,55,0,55,55,0,1,2
"5314","251f26fc7e953abd4d0081c219459120",126,80,54,16.3333333333333,73,53,3,3
"5315","2525ce51d63e5c5a0324c50ee03fe2d0",26,26,0,26,26,0,1,2
"5316","2526e888907a3a2b2f0065fc7ed459a1",195,99,66,20.6818181818182,195,0,3,3
"5317","252b41aaa40abf3772586daf22cfffc2",120,86,46,18.2608695652174,120,0,3,3
"5318","252d796a39a890db8fa078a0f27521b2",155,73,56,19.375,155,0,3,3
"5319","253070ba06c7641c5418138321291688",6,6,0,6,6,0,1,2
"5320","2530fc74f117271b3f14bda87191391b",168,116,66,17.8181818181818,168,0,3,3
"5321","25311cb70c2177f6ab5ba5227bcbfbf7",164,91,75,15.3066666666667,164,0,3,3
"5322","253444607ee7ebf98668adbd12d2ce44",74,63,35,14.8,74,0,2,3
"5323","25368f265b511819ffd32089e3cd3cef",25,14,73,2.3972602739726,25,0,2,1
"5324","25379a1b675c5b24065e428346cd2328",30,30,0,30,30,0,1,2
"5325","25379af8403eff64e738e3513b888acc",121,60,57,14.859649122807,121,0,3,3
"5326","253bf2eaa5e73e326f5297fed8210aef",165,124,75,15.4,122,43,3,3
"5327","253d64b1d2908a1ffccd397e1d0a7710",83,70,56,10.375,83,0,2,3
"5328","253e9abb0fa25221997cc62420dc792a",113,81,38,20.8157894736842,77,36,3,3
"5329","2540c8533a4940bf7a03c75ee0f4c9f1",120,85,57,14.7368421052632,120,0,3,3
"5330","254150678b326251390735c2cfeea770",53,42,54,6.87037037037037,53,0,2,1
"5331","25420ee8eee264c22f3f61c4f5e8ba98",24,24,0,24,24,0,1,2
"5332","25428645356994b31a61a0da159fcdcc",125,58,47,18.6170212765957,125,0,3,3
"5333","2542b7453291d4db3fa751ea8d8382b4",105,34,77,9.54545454545454,91,14,2,1
"5334","254536b6b31a5f8e4c396c46e2650278",210,101,76,19.3421052631579,172,38,3,3
"5335","254823e9828e5e40adb54d79ecfaefc2",44,40,37,8.32432432432432,44,0,2,1
"5336","254c92776143baabaa64bbf9013f3eef",169,85,36,32.8611111111111,169,0,3,3
"5337","254ed92eef9e6ed22480ff87b6060a22",102,76,26,27.4615384615385,102,0,3,3
"5338","255037a68e464123f4f378487fbbe1d7",86,68,31,19.4193548387097,43,43,2,3
"5339","25525eb7d8d875c35cd056a7dbaede2f",41,41,0,41,41,0,1,2
"5340","2553df8523a184bedc5db309d2115407",27,27,0,27,27,0,1,2
"5341","25574a376c67be517e54e56ae57b8358",53,53,0,53,53,0,1,2
"5342","2559e8fe7437dc5d5e17db971179ff0c",176,42,70,17.6,158,18,3,3
"5343","255a6e6ee1396b08d702436dd0af6e14",208,126,65,22.4,175,33,3,3
"5344","255d10bc0c39bae97a701e1d8e25d68a",219,107,67,22.8805970149254,219,0,3,3
"5345","25601c488918ea29a52c581d0a2fb962",31,17,78,2.78205128205128,9,22,2,1
"5346","256464e4d3ea656c2b1d381e38784a9e",44,38,25,12.32,22,22,2,1
"5347","256b4634c66d6b2d8001520ebda9c645",49,49,0,49,49,0,1,2
"5348","256b5abf6253a5ca516031e7a3e3a853",54,36,65,5.81538461538462,42,12,2,1
"5349","256db02521093f40c55453bcbc1d3b66",100,71,78,8.97435897435897,100,0,3,3
"5350","25729ad62b1bad80a92a3407499e7f93",25,25,0,25,25,0,1,2
"5351","2578520cc9449b4da1d2bbc606b3e13c",33,33,0,33,0,33,1,2
"5352","2579e68aeea7af46fdc855cc81eb7c0d",17,17,0,17,17,0,1,2
"5353","257a3707bc23b2a94318172d9eebf35d",15,15,0,15,15,0,1,2
"5354","257f346257d1838eb6104ebef7c53e08",60,45,77,5.45454545454545,60,0,2,1
"5355","257fe5c5afd4952118e40cc8c0feb41a",165,67,74,15.6081081081081,122,43,3,3
"5356","2580966c45bdbba8146191405d6862d0",53,53,0,53,53,0,1,2
"5357","258283c650992aa1a3e49e9b84b3ad36",62,43,48,9.04166666666667,62,0,2,1
"5358","258380032ea0b2e1b54add5b7ecbbc8f",9,9,0,9,9,0,1,2
"5359","2583b73e29554295b16ec5770c75543b",20,20,0,20,20,0,1,2
"5360","2584a5781b1ca4b9896fb97ed8fd040b",97,68,76,8.93421052631579,97,0,2,3
"5361","2585715e8a5415843b565ea737585600",56,56,0,56,56,0,1,2
"5362","258eb0a5facb1ccab9e127314207d894",69,57,20,24.15,69,0,1,1
"5363","25916f5cf3fdfce75b264931e939ab8a",18,18,0,18,18,0,1,2
"5364","25922936c2754a1ced1ada62b1dbe0b3",38,30,8,33.25,23,15,1,2
"5365","259383fa35e1e4e804d22e65c47719c9",107,90,23,32.5652173913044,107,0,3,3
"5366","2593902299df72fe42eb701fd1781da5",117,92,62,13.2096774193548,117,0,3,3
"5367","25971a4b9c52c868aa5da8dc1563f57e",20,20,0,20,20,0,1,2
"5368","259cccc1dc6572484b606673f1ed4177",217,132,70,21.7,217,0,3,3
"5369","259d7dfa1b5eaa79387693e72ec15b2e",83,68,53,10.9622641509434,83,0,2,3
"5370","259e3ebb408b9496e3b7747d80af388b",47,42,7,47,47,0,1,2
"5371","259f47bd1d8cc66b97f3e840f9034055",53,53,0,53,53,0,1,2
"5372","25a2c1002ca0552cfe60abd98860d5c8",14,6,74,1.32432432432432,14,0,2,1
"5373","25a8f045829fd11d18905634b6b82592",27,27,0,27,0,27,1,2
"5374","25aa7694c06a6381797eb506c4ef6dce",27,27,0,27,27,0,1,2
"5375","25aac8d1b9b70dbe7874d83a99570da4",106,56,74,10.027027027027,106,0,2,3
"5376","25abcaf64f60d4bb5541dbc3166dc752",8,7,5,11.2,8,0,1,2
"5377","25ad58e0835ae8e9230c27f8d6b2deb3",1,1,0,1,1,0,1,2
"5378","25ae5ad8eb3672c6752d64e7923b5b1f",194,125,71,19.1267605633803,166,28,3,3
"5379","25af1efacfcde8ca896c50007422d4da",21,21,0,21,0,21,1,2
"5380","25b06e2adcb5743ce6f7ba49c44d1fc8",59,38,82,5.03658536585366,59,0,2,1
"5381","25b5e12dea20d4236c1142cf4d33f4ab",95,59,47,14.1489361702128,73,22,2,1
"5382","25b71dcb63b8980be35aa2e96b7867e9",54,48,16,23.625,17,37,1,1
"5383","25b7b7044ab4629ec1e3550866b387d4",89,65,49,12.7142857142857,89,0,2,3
"5384","25b907b1eecb715e9125656640f48593",89,69,34,18.3235294117647,63,26,2,1
"5385","25bad94401d5095012469878986b9836",87,67,28,21.75,87,0,2,3
"5386","25bafa3a9451375b3165bdd9dd9cea8e",16,16,0,16,16,0,1,2
"5387","25bd007cbd7989d33c612fd8bda3e423",204,119,69,20.695652173913,204,0,3,3
"5388","25bdb80d4d4eeb65624ffcf6289122dd",26,26,0,26,26,0,1,2
"5389","25be68e80b308c0cd8dbef601266448c",114,75,15,53.2,114,0,3,2
"5390","25bf1fa4fc8ff7bad106ee38e327aa95",29,29,0,29,29,0,1,2
"5391","25c10f9c9253c8e7c544a7c4a4b52873",44,44,0,44,44,0,1,2
"5392","25c8f7b2c7e7562c4872d34392d8c48d",24,24,0,24,24,0,1,2
"5393","25ccacfbeaaa392abf99059200f84047",97,56,61,11.1311475409836,97,0,2,3
"5394","25cda3fd23d6fb84b15e7d0477b69f7e",151,86,70,15.1,151,0,3,3
"5395","25cdf72e27cdb8f4603dfa71e0df80e4",36,36,75,3.36,36,0,2,1
"5396","25d136bf024b90bd1b4a4f88ff335082",34,34,0,34,0,34,1,2
"5397","25d259d32a2bc254343715f2e347c518",21,21,0,21,21,0,1,2
"5398","25d32ab7e9b1305b7f9d232cac522a08",44,44,0,44,44,0,1,2
"5399","25d5585dea2e919d178a5df6429a5bd0",27,22,50,3.78,27,0,2,1
"5400","25d66b7770948acace1f5e6bb6b5e1b5",111,58,67,11.5970149253731,111,0,3,3
"5401","25db2cbcdfb318af569c1206e2cfea0d",37,30,27,9.59259259259259,37,0,2,1
"5402","25e3d4ba9f741132529255db3608d075",1,1,0,1,1,0,1,2
"5403","25e65488c4b5fb4e9f29b98c12cf7286",138,90,72,13.4166666666667,138,0,3,3
"5404","25eb585547d3d95f93b6c1c55fef5d6b",191,125,70,19.1,165,26,3,3
"5405","25eb669c9407ce9c060244c4ccc2c63e",10,10,0,10,10,0,1,2
"5406","25eda77f319f1cb3b361753aae2eb6ac",23,21,3,53.6666666666667,23,0,1,2
"5407","25ee1eeaf4740509979412b99c513635",32,32,0,32,0,32,1,2
"5408","25eef44da61b7d7e661130c8e970aae4",47,36,14,23.5,47,0,1,1
"5409","25f06058563b183bf45d4f08014df936",210,130,83,17.710843373494,210,0,3,3
"5410","25f184ed4ff6a6120fefbf045f5c104e",204,103,85,16.8,204,0,3,3
"5411","25f5e1923f6eb5d72a63a55354e96552",10,10,0,10,10,0,1,2
"5412","25f8487bc58e560d904e412e3126bbe6",115,64,74,10.8783783783784,115,0,3,3
"5413","25f8dee2afd57454bd20e0690f821970",8,8,0,8,8,0,1,2
"5414","25f99c417d2c2abfefa8a6ccc35d3f96",63,53,62,7.11290322580645,63,0,2,3
"5415","25fb8c9c9692821d36afd8f9773b5c48",135,98,47,20.1063829787234,135,0,3,3
"5416","25fc7ddc42adad108d7cbca32166edd4",110,61,53,14.5283018867925,83,27,2,1
"5417","25fd087e52b3401b3bf6ccdb3f0c9fe0",39,24,20,13.65,39,0,1,1
"5418","25ff0852bd4c81b58d9626bdf9c6f129",23,23,0,23,23,0,1,2
"5419","2604a24374e270d5fc2004e81797cc3b",100,59,19,36.8421052631579,100,0,1,2
"5420","2604da409cdbc79ae452d93e09dd77b2",174,119,54,22.5555555555556,174,0,3,3
"5421","260759d9c7a5ca48b50cf68427252a4c",42,34,56,5.25,42,0,2,1
"5422","2608fbb2e00ba804ca6587209de17347",156,72,76,14.3684210526316,156,0,3,3
"5423","2609c2ec1905aa50215f5389eb56a9f8",33,24,31,7.45161290322581,33,0,2,1
"5424","260b31b0ca7a3e9a8431522a92b0cf60",32,32,0,32,32,0,1,2
"5425","260b46706b0ad47163faa3293422bd1f",67,49,76,6.17105263157895,63,4,2,3
"5426","260efd2365bbd62dd407e4d2eb573224",41,41,0,41,41,0,1,2
"5427","2610deb64bb1219cbd6613807230a58d",139,85,60,16.2166666666667,139,0,3,3
"5428","261220a8efd49c67cba5db3c37d237c9",26,26,0,26,26,0,1,2
"5429","2616f5842c631cc3a2a0a170f87ec019",67,53,40,11.725,42,25,2,1
"5430","2617f6ab189b2b20f7390dfeb9e01630",92,73,30,21.4666666666667,83,9,2,1
"5431","261b66d7a5caad114dd8a8f86f0a49d0",19,19,0,19,19,0,1,2
"5432","261b7ab8189b6d492faeff743b4d7013",55,47,37,10.4054054054054,55,0,2,1
"5433","261d5a404569e804da3e94a6854a4954",97,83,42,16.1666666666667,97,0,3,3
"5434","261e2a6fcc8059973fb7135cdb45f020",189,88,69,19.1739130434783,189,0,3,3
"5435","261e904fb5c128a61210dbfb78345d0b",32,32,0,32,0,32,1,2
"5436","2620218148769e3fce209f97ff8c2ae4",23,19,19,8.47368421052632,14,9,1,1
"5437","2623c4ce4b28acc873f8954030aad2c1",29,29,0,29,29,0,1,2
"5438","2626e9e3726a7d208789d07b7156e61f",20,20,0,20,20,0,1,2
"5439","26294685b0ef43230118d8cbd2d7b3c6",89,39,75,8.30666666666667,89,0,2,3
"5440","262b1f317d22b7b2e40fbd418f06ca76",11,11,0,11,11,0,1,2
"5441","262b88ac1eef218bdde2b30f89a2fb24",16,16,0,16,16,0,1,2
"5442","262f418d5d75490e6174d9ad9e8e00b8",169,94,63,18.7777777777778,169,0,3,3
"5443","2630a589beddcdce9aeaa293d46b572e",198,71,69,20.0869565217391,173,25,3,3
"5444","2632af5fe6ab77beedee0ce7306b6e67",192,94,84,16,192,0,3,3
"5445","26336213a547eb5e05c02bbb165b99d9",16,14,46,2.43478260869565,16,0,2,1
"5446","26348bab5a889250a7bbc96a340fe408",26,24,6,30.3333333333333,26,0,1,2
"5447","2635d92faf19a2b20e82a190f82d7bec",38,38,0,38,38,0,1,2
"5448","2638425578f0bdd89a4c94904e04f6f2",119,83,76,10.9605263157895,119,0,3,3
"5449","263a2eb2a27d2335dd4a3d75ad5e53ae",38,38,0,38,0,38,1,2
"5450","263bc3e6165892f057b904a7bb796ec1",9,9,0,9,9,0,1,2
"5451","263dddc3592723198f450a0e826f1161",23,23,0,23,23,0,1,2
"5452","2641fbe3954f7d3fed22b48b93f25153",63,47,68,6.48529411764706,49,14,2,1
"5453","26421074e529d3ad5760cea2ff53af0e",11,11,0,11,11,0,1,2
"5454","26422f93279e9240258d9b7ceb660e9e",63,54,73,6.04109589041096,63,0,2,3
"5455","2642b6284bcf4b33acc6bbe7b9bc2ede",174,114,72,16.9166666666667,153,21,3,3
"5456","2642cdd439ec6d6e0b8d45a53365a352",207,105,89,16.2808988764045,207,0,3,3
"5457","26434ddb150bda98979471da51a35dc7",49,34,38,9.02631578947368,49,0,2,1
"5458","26443be9dd04cbaffcd228babba5973e",154,103,57,18.9122807017544,154,0,3,3
"5459","26455754f1d1a00838cc3443699f4b5a",35,35,0,35,35,0,1,2
"5460","2648a616c4054705275af33bbe416d57",44,44,0,44,44,0,1,2
"5461","2648c1725b69de9fcfeed940ef4ac170",50,42,30,11.6666666666667,19,31,2,1
"5462","264a8f2a041f5ee3658559586642bba0",15,15,0,15,15,0,1,2
"5463","264d8219cd1b0f6d6e80100fee8d0cd2",138,81,74,13.0540540540541,117,21,3,3
"5464","264df01f81ba4168f393876e9c4f0072",104,74,67,10.865671641791,104,0,3,3
"5465","264ed0b4720defa847c1ff2668e5a551",187,108,53,24.6981132075472,138,49,3,3
"5466","2652045330099324b8ed5cf413e09cec",42,42,0,42,42,0,1,2
"5467","265372c259830aa8e8cc910a389791de",44,40,71,4.33802816901408,44,0,2,1
"5468","2654a9a00b78a87d33ad9c7745f416ca",71,36,73,6.80821917808219,60,11,2,1
"5469","2656633986052d2143ec6158a802c333",224,82,82,19.1219512195122,200,24,3,3
"5470","2657ffcc0914c29dcc3229e4017dd13c",107,87,51,14.6862745098039,107,0,3,3
"5471","265b13e3bdb3c3382e328d3ff1c70cac",38,38,0,38,38,0,1,2
"5472","265b21871cc65d44e172b08a372901d1",44,44,0,44,0,44,1,2
"5473","265c34350ab45107e7b44183a5ba65ed",117,61,62,13.2096774193548,117,0,3,3
"5474","265d2215f1730f13ac75c8af848eb363",88,57,78,7.8974358974359,88,0,2,3
"5475","265d78ddcb0dc04e8667a9e8e6b07760",147,102,55,18.7090909090909,147,0,3,3
"5476","265d795e47aad8f8b6b8b525de9b4e68",90,56,73,8.63013698630137,79,11,2,1
"5477","26614bfffbe0b284fa22e0f87ac33eea",174,75,66,18.4545454545455,130,44,3,3
"5478","2665940b90c6ef5ac4a3700daf94cd15",63,46,50,8.82,63,0,2,1
"5479","2666949201cc0ef4031d792fd71eb964",180,113,56,22.5,180,0,3,3
"5480","2667aeec6d31de274ac2f6162fc25a2e",67,56,52,9.01923076923077,67,0,2,3
"5481","26683eb98b471a000b0fca50f4491ce4",152,89,86,12.3720930232558,108,44,3,3
"5482","266a77c50829be6d6e37ef4bd574d70b",55,29,74,5.2027027027027,55,0,2,1
"5483","266d07d493b0b808634e50a3a61ec9ca",163,115,74,15.4189189189189,163,0,3,3
"5484","266f4d06fbad75537fa95e3d72735fab",195,125,59,23.135593220339,161,34,3,3
"5485","2673ae0433ef34653cd37c67ee3ad68b",84,70,53,11.0943396226415,84,0,2,3
"5486","26745fcc7acf59bbb06039b675f9f476",48,42,6,56,48,0,1,2
"5487","2677e6352de06352d6bcecc5149de828",21,16,48,3.0625,21,0,2,1
"5488","26794da95c05463fb544c4fb0b6f6aa9",9,9,0,9,9,0,1,2
"5489","267ca58134a46f5297f4a40265ff1cac",7,7,0,7,7,0,1,2
"5490","267e173efd9bda5f06b41e6660256cfa",51,38,25,14.28,22,29,2,1
"5491","267f3a79efc26c7e6219cbb48e9d005f",114,66,62,12.8709677419355,114,0,3,3
"5492","2683780ff4de63abbeb723801e2497c5",41,39,43,6.67441860465116,22,19,2,1
"5493","268456ed93f4c474c9b30ae751ffe562",15,15,0,15,15,0,1,2
"5494","2685f0a66e1d10b8b87e97bdbde0ed11",13,13,0,13,0,13,1,2
"5495","26879d7bbdb837ddc19f3f58383a0a04",49,43,83,4.13253012048193,49,0,2,1
"5496","2689acf7b95ef7ab633a6bd5e117a56e",22,22,0,22,22,0,1,2
"5497","26908abe0b80d1062baf3b02500f86ec",60,49,65,6.46153846153846,60,0,2,3
"5498","269164b1e6c32d58ea549ded3c305403",53,48,35,10.6,53,0,2,1
"5499","2691e304ff98ede613608eafe54a0578",19,19,0,19,19,0,1,2
"5500","2693b690f4ffcd12cb1d4f94606590b1",106,80,60,12.3666666666667,106,0,3,3
"5501","269a6d9bc2089a8ae20868469d1b792e",52,47,25,14.56,19,33,2,1
"5502","269abf24ceefb68fdc98dab24154aaf8",89,62,89,7,89,0,2,3
"5503","269cb00bb9b91f5dc7d3f967dc66b379",84,46,56,10.5,84,0,2,3
"5504","269dced216f4b3dca0075e5c756b2aaa",10,10,0,10,10,0,1,2
"5505","269de82f84af7668823da5c86b0b80fa",19,19,0,19,0,19,1,2
"5506","269e2637c067e41213852c68dc54a3f4",36,26,25,10.08,36,0,2,1
"5507","26a124918d62345a59121d7f86e6524b",29,29,0,29,29,0,1,2
"5508","26a1c0d8630af515ca42eea131bbe587",41,34,30,9.56666666666667,18,23,2,1
"5509","26a384b57ab9972890b0716ae3f65610",28,28,0,28,28,0,1,2
"5510","26a418c64741ec68ef867012a519cfd9",169,71,67,17.6567164179104,169,0,3,3
"5511","26a6cbf75044406206875d0cecda0698",18,18,0,18,18,0,1,2
"5512","26a750849ecef237366d95f745ed6cc7",75,64,56,9.375,75,0,2,3
"5513","26a75432a54d86f64095f426c3e7e027",114,84,65,12.2769230769231,87,27,3,1
"5514","26a8bb70b0d3cf7f21c810d4e6b892aa",79,64,53,10.4339622641509,79,0,2,3
"5515","26ad529731eb2aadf67492c28f177123",13,13,0,13,13,0,1,2
"5516","26ae084ad434c750215293554f9e0665",218,129,79,19.3164556962025,177,41,3,3
"5517","26ae24b250e9124f4e6e1771092f3606",88,56,66,9.33333333333333,88,0,2,3
"5518","26aee386bfc4fb9783bff760132bca59",23,23,0,23,23,0,1,2
"5519","26b555f667fbc4ca29cc44004a276e6f",37,37,0,37,37,0,1,2
"5520","26b5e337f9efa7e635c56f1ed5f4173c",29,29,0,29,0,29,1,2
"5521","26b725057b19cc25ad0a29bbdb0c0acd",90,55,63,10,90,0,2,3
"5522","26bcc937bfea7b5fcbe6be7ca465194f",20,20,0,20,20,0,1,2
"5523","26bdb41f49cf45e0b8c84cdb2536cc40",40,35,11,25.4545454545455,40,0,1,1
"5524","26bf7c6e4c6bf2f117608fbd0b17e481",159,91,71,15.6760563380282,159,0,3,3
"5525","26c1d9a63e0061c1619a40a719b11b14",13,13,0,13,13,0,1,2
"5526","26c2a564eb5056d2adcb857f201b2319",47,34,61,5.39344262295082,47,0,2,1
"5527","26c2c0312d92ee62e2724d5e65750f3e",44,29,62,4.96774193548387,44,0,2,1
"5528","26c5e007fcfc3dc7cef465504aaa904e",13,13,0,13,13,0,1,2
"5529","26c61234e501128a276a59ecd6ef3e13",37,37,0,37,37,0,1,2
"5530","26c6d1d5a804246a83b159a70eda33ee",45,41,27,11.6666666666667,45,0,2,1
"5531","26c71854d9f9e346518cc76912a902b7",25,25,0,25,25,0,1,2
"5532","26ca708babf0dd2ca35f8ad66c0bf33f",191,124,60,22.2833333333333,191,0,3,3
"5533","26ca8d196d6b748886762ec571f14f7c",134,92,57,16.4561403508772,106,28,3,3
"5534","26cb292984d3cf84fcc238795b60a9c7",38,29,74,3.59459459459459,38,0,2,1
"5535","26cf4abf08a1d5d721593554e55625b1",48,48,0,48,48,0,1,2
"5536","26d438a449ce401feb6492951c1a10e9",132,78,64,14.4375,132,0,3,3
"5537","26d4fec40bc52d3b29fdf2aa2c584fcf",47,43,36,9.13888888888889,47,0,2,1
"5538","26d783c60f155f581b2a49c94b8ce71b",19,19,0,19,0,19,1,2
"5539","26dacf50f1657ea8e5a799198fe6556f",39,39,0,39,0,39,1,2
"5540","26dc0e87d55636b66cc4f5e9df197978",63,61,34,12.9705882352941,63,0,2,3
"5541","26ddac12b555db27f993d5ba07a54f06",12,12,0,12,12,0,1,2
"5542","26deb0b895708eeb2c3c6c22906ce8f2",65,56,56,8.125,65,0,2,3
"5543","26df206329c774d863236a573545e0a7",67,61,24,19.5416666666667,67,0,2,1
"5544","26dfe611bdd6c75fa96d96125632e5f1",47,47,0,47,47,0,1,2
"5545","26e049bf5b6aacecceb6c6b336972dac",20,20,22,6.36363636363636,20,0,2,1
"5546","26e0a085728a7e0c9bc1c25663cd5d4e",2,2,0,2,0,2,1,2
"5547","26e129636c06c16225c8586cfda9768c",29,29,0,29,29,0,1,2
"5548","26e14a071a9c1c56f27950555874333a",14,14,0,14,14,0,1,2
"5549","26e345d738b11168558a0da2d7aa41e8",100,72,39,17.9487179487179,55,45,2,3
"5550","26e3909299d8fc585a751649ef691483",45,34,62,5.08064516129032,45,0,2,1
"5551","26e3fb6f8b688f64f7b585226900250b",51,42,23,15.5217391304348,36,15,2,1
"5552","26e5a940f225abe8d9c6ee9eac779fb9",49,45,65,5.27692307692308,29,20,2,1
"5553","26e698d3d4c2f57e474108fe8b05a190",32,27,14,16,32,0,1,1
"5554","26e6d27044c30a8d9be3406539899263",140,112,52,18.8461538461538,100,40,3,3
"5555","26ea8a1bead8dc059301019545ab3079",31,30,5,43.4,1,30,1,2
"5556","26ebdff0056e727fae3bcc9d00c70328",79,60,55,10.0545454545455,79,0,2,3
"5557","26ebf222e168960a234a7e61d85049a9",137,74,80,11.9875,137,0,3,3
"5558","26ec78279d1f1aacadeeacd441375c25",82,62,25,22.96,82,0,2,3
"5559","26ed6a007310bffdb6d8d6e4993e8463",64,50,67,6.6865671641791,64,0,2,3
"5560","26ede3c66d08cbf0bdd1012aa4c5ac29",32,28,64,3.5,32,0,2,1
"5561","26ee10a5c291cde71cc055e95a9000d6",25,25,0,25,25,0,1,2
"5562","26f00c0dfa556e394f1101cb7430671c",158,114,77,14.3636363636364,158,0,3,3
"5563","26f18cdf451c83d51734a15eb3c6c805",110,61,54,14.2592592592593,58,52,2,3
"5564","26f424b3bba6aaf97952ac599ed39f75",68,61,21,22.6666666666667,68,0,2,2
"5565","26fd2620c590a20d07803d74eb098e41",84,68,14,42,84,0,1,2
"5566","26ff4738ccabbef3c4681b393e56e61e",98,67,71,9.66197183098592,98,0,2,3
"5567","2701c33bb969ddc70860de22477ab41a",57,46,22,18.1363636363636,57,0,2,1
"5568","27025248f22913ab1cb9688d58bbe820",83,78,37,15.7027027027027,83,0,2,3
"5569","27028ce7d6dfad397fd788bd12147760",66,50,49,9.42857142857143,66,0,2,3
"5570","27038d4b496a54f7158b2a3755dd7f96",30,30,0,30,30,0,1,2
"5571","2704e7eb96cd75540af00431f4cb5bbc",7,7,0,7,7,0,1,2
"5572","27053c70f245c0ca747ffc53cfe5f5ac",30,27,50,4.2,30,0,2,1
"5573","2706d37e73de97b869447afff92dd3d5",25,25,0,25,25,0,1,2
"5574","270961e7325c6ae0cd60109e6562af3c",57,50,75,5.32,57,0,2,1
"5575","270f856aa56578bf2c6d0287743c3f54",42,40,6,49,42,0,1,2
"5576","270ffcfd5538442198f30b9584d3d6ab",81,61,54,10.5,53,28,2,1
"5577","271203cc60379f1cd64b6db79c7aeb4f",215,110,61,24.672131147541,215,0,3,3
"5578","27127888129004019f5707dd989ee180",63,41,50,8.82,63,0,2,1
"5579","27183bd1be5e5294ae75d4af47379396",52,46,64,5.6875,52,0,2,1
"5580","271c611026bbf5552609878284008617",27,27,0,27,27,0,1,2
"5581","271e6066d80459ec93b4eb4bebf9c200",15,15,0,15,15,0,1,2
"5582","272086ad17787113e08515d290bb7889",35,31,44,5.56818181818182,35,0,2,1
"5583","2722c1a688a82d8a425141923915c269",27,19,84,2.25,13,14,2,1
"5584","272405bee50d4f000008153b87a2a38f",41,38,22,13.0454545454545,28,13,2,1
"5585","27245a811de787fa17ae04ca4b97cd2a",123,67,69,12.4782608695652,123,0,3,3
"5586","272b6914889418f8928203ae960975bf",15,15,0,15,15,0,1,2
"5587","272c04ad43026f26552e742ece8519e2",11,11,0,11,11,0,1,2
"5588","272cae58d62cb01ae19066b662191fb2",77,55,59,9.13559322033898,54,23,2,1
"5589","272d2b03b0b7e9989ff1181726556ea0",50,37,19,18.4210526315789,27,23,1,1
"5590","2733928fad39b713331f0933700328ab",27,20,27,7,27,0,2,1
"5591","2734d7544ee57995e13837f0808f7252",26,26,0,26,0,26,1,2
"5592","2734dace33c85e62ab516735643382a7",71,52,48,10.3541666666667,71,0,2,3
"5593","27373532bf824148e39f1bc1a7b89fea",25,25,0,25,25,0,1,2
"5594","273f5e435637ecd816df5de6c074ca42",33,33,0,33,33,0,1,2
"5595","274029a636ebe78b387551abeae169ae",85,68,53,11.2264150943396,85,0,2,3
"5596","2740755219cc4dc0f30017737dd775c2",22,22,0,22,22,0,1,2
"5597","27412a8331715a05d89ef3baf5185245",112,71,15,52.2666666666667,112,0,3,2
"5598","27436b5f0e5b564e5c2740aaf0c1c119",104,69,55,13.2363636363636,104,0,3,3
"5599","274474bbaf920be44b08e17e8c5986ea",33,33,0,33,33,0,1,2
"5600","2745bb2ddae57742a13695296c06b869",69,52,82,5.89024390243902,53,16,2,1
"5601","274c52fb5b4774fd913b62c3bab40053",119,82,57,14.6140350877193,119,0,3,3
"5602","274d9f8dfa4efd4ddf755168596798d1",171,99,70,17.1,171,0,3,3
"5603","274e80d2dab901dee866301bd4ca8a80",25,25,0,25,25,0,1,2
"5604","274f0e46cfa1b959be32c7f27aec681f",64,48,56,8,64,0,2,1
"5605","274f149512e75555767ae4850a7990f2",25,25,0,25,25,0,1,2
"5606","27509b883154e26f7e75c3cc4f26c2f4",27,27,0,27,27,0,1,2
"5607","2751816c0b807de49b88cbb94883e74f",67,47,36,13.0277777777778,67,0,2,1
"5608","27539867df2640d10aae0890b2920918",18,18,0,18,0,18,1,2
"5609","275409070f9114a08ff615d35b521279",20,20,0,20,20,0,1,2
"5610","275412bfbd9e4d8a95f95a828a1e1b5a",118,88,74,11.1621621621622,118,0,3,3
"5611","27562f9364caf5330c1602f9e93fdde3",81,57,77,7.36363636363636,81,0,2,3
"5612","2756c389a1a0cd1bea43eacaafdb48ab",5,5,0,5,5,0,1,2
"5613","2756ff10f85c363df3494fa1fb935860",140,84,82,11.9512195121951,140,0,3,3
"5614","27574188281bdeff4e68c3380c338ee0",31,21,50,4.34,31,0,2,1
"5615","2757559c8a9d80fdd67378b038b36ba3",82,63,16,35.875,82,0,1,2
"5616","2757a26ebccb70c9d40e07beb005bbcd",145,93,89,11.4044943820225,145,0,3,3
"5617","2759006c9c8c992a65af511ab92bb170",15,15,0,15,15,0,1,2
"5618","275b93eef91f7aa752e91e191626efc7",25,25,0,25,25,0,1,2
"5619","275f6f57a490ccf77dd47bf789ca6424",7,7,0,7,7,0,1,2
"5620","2761820d3308d68f07b3994e6228bb56",12,7,34,2.47058823529412,12,0,2,1
"5621","2763484b7eac90e57a88e13c871adf2f",8,8,0,8,8,0,1,2
"5622","2763e5bc33d3255fd4113eb565fb9916",27,25,74,2.55405405405405,27,0,2,1
"5623","2765f8366ef9b2f289c48dfe831c93bd",73,65,78,6.55128205128205,73,0,2,3
"5624","2769f1ded0f6e99541eafe9ec9782a8f",25,25,0,25,25,0,1,2
"5625","276a9ad26571b8fc616ef767a06cb564",62,50,13,33.3846153846154,62,0,1,2
"5626","276c1d371df5338df5933e6d8b35ce60",65,56,51,8.92156862745098,65,0,2,3
"5627","2771026c165fa8f6f11b7981fd190dbe",8,7,7,8,8,0,1,2
"5628","27713cb802e28a846e9d0c082f03ca10",13,13,0,13,13,0,1,2
"5629","2771979b4bda99359841027e5c7f3282",142,111,36,27.6111111111111,142,0,3,3
"5630","2771c6a00c691e7cd701062b5eac157f",126,97,42,21,126,0,3,3
"5631","27726635fa562b8913b63c62878b79cd",48,48,0,48,48,0,1,2
"5632","277302345181db464750f009ebc3e8a2",17,17,0,17,17,0,1,2
"5633","277539007eee5922d8ba513e032b3389",32,32,0,32,32,0,1,2
"5634","2775a9a6cd3354268b15883874f81b03",84,57,40,14.7,84,0,2,3
"5635","277a061f90c78dcba94b0fc7139c8512",30,21,23,9.1304347826087,30,0,2,1
"5636","277b4890429a3e0f16de5abb5e559966",195,121,55,24.8181818181818,195,0,3,3
"5637","277c3e747080dc168685e030b8e1bf49",64,54,46,9.73913043478261,64,0,2,3
"5638","277e7a707f93b1d2eb8404092ba079c2",1,1,0,1,1,0,1,2
"5639","27802d652e19679b553fcf833aa28657",102,93,37,19.2972972972973,57,45,3,3
"5640","2784a59864f61a666e0f79f3b19275b0",10,10,0,10,10,0,1,2
"5641","278736b8cbe767c5bb24550fe0f0608b",170,73,84,14.1666666666667,141,29,3,3
"5642","2787657a0795138b8423cfca8065cd68",25,25,0,25,25,0,1,2
"5643","2788239ea86fafbcd4275c894bc36544",5,5,0,5,0,5,1,2
"5644","2788a207befbd77bbd5fc18c5fa36b48",210,99,61,24.0983606557377,210,0,3,3
"5645","2789614607e8398acc9c485ce8823f87",108,76,62,12.1935483870968,108,0,3,3
"5646","278ed5b1e422c7c3d405f8eb6c864993",31,31,0,31,31,0,1,2
"5647","27923b11afbadb5c64450c550e83e3b1",46,46,0,46,0,46,1,2
"5648","2796e83fd1e2f5b785befa2330700545",114,78,68,11.7352941176471,114,0,3,3
"5649","279861bc077f075e0e8d85f7a66a00dc",25,25,0,25,0,25,1,2
"5650","279a2d9e42512fe1042db32371782aba",88,34,67,9.19402985074627,77,11,2,1
"5651","279ad989ff893d5d325b821bb515d7f2",3,3,0,3,3,0,1,2
"5652","279ccc9213124157343a00611348c043",159,117,71,15.6760563380282,132,27,3,3
"5653","279dd9a299876f7b27a1693d6ab86d3b",13,13,0,13,13,0,1,2
"5654","279ea14a5c4578083ae4cfa95e29a346",23,23,0,23,23,0,1,2
"5655","27a0461b1f17792c165adef3771aff30",39,39,0,39,39,0,1,2
"5656","27a1b5bb105f2aa712866eb9779d3afb",2,2,0,2,2,0,1,2
"5657","27a2b2c4d69fb1b87d23dbb6ddafcf64",36,36,0,36,36,0,1,2
"5658","27a5aeb9120a5328bf07fa0dac297b8e",33,29,18,12.8333333333333,33,0,1,1
"5659","27a60b22b19425f831f0171708e776b9",171,97,82,14.5975609756098,150,21,3,3
"5660","27a6f1c658b728e8bf0cb2ceb75d524f",13,8,62,1.46774193548387,13,0,2,1
"5661","27a9e54891e2cb180ce9a7ec51fa9f79",30,30,0,30,0,30,1,2
"5662","27ab3c0043013bf4bdf7a1776106f46e",84,57,36,16.3333333333333,84,0,2,1
"5663","27aca654961f73e68c32110330851b53",79,55,18,30.7222222222222,79,0,1,2
"5664","27adf1316d30f75f95733b7e00910293",10,10,0,10,0,10,1,2
"5665","27afd75622b55b389c0d3cc592b9aace",7,7,0,7,7,0,1,2
"5666","27b0acaaaef878145c54c0902dbc5c40",75,67,33,15.9090909090909,29,46,2,1
"5667","27b3d0b039184851bf42bc58ede83c0d",71,57,37,13.4324324324324,71,0,2,3
"5668","27b7f5c5e8f64401318c3e5f2a8033ee",79,54,73,7.57534246575342,66,13,2,1
"5669","27b909d1765b4010f8d5070e3db2efc1",28,20,54,3.62962962962963,28,0,2,1
"5670","27b9277a9dc8c3e559ec0e952760a2ac",116,92,53,15.3207547169811,64,52,3,3
"5671","27bc1beaf4cb98d3e9ea8eb1a61c7d73",49,26,27,12.7037037037037,49,0,2,1
"5672","27bd1a52ecfa3164678fbdd57c4fb36d",47,47,0,47,47,0,1,2
"5673","27bd4cad35f723533f3a349a9a612356",108,73,48,15.75,108,0,3,3
"5674","27bd564c0ec241432befcd1cd2cf5c28",33,33,0,33,33,0,1,2
"5675","27bf221ab798f91dee74cf3a2444b66a",42,42,0,42,42,0,1,2
"5676","27c00af8d3a2923a7b2178b6a7bd3a7f",202,118,63,22.4444444444444,159,43,3,3
"5677","27c076bded685c15150a46e64354913d",112,54,86,9.11627906976744,112,0,3,3
"5678","27c0c373e7cdfd773e5ae439fae6ce7c",50,36,63,5.55555555555556,50,0,2,1
"5679","27c25bdc272f616efb94bfc00ea851ce",13,13,0,13,13,0,1,2
"5680","27c4887646225fbe96c48492593ebc5c",79,47,63,8.77777777777778,79,0,2,3
"5681","27cc61a3ba5f13394d3cce97bb3e5736",34,32,20,11.9,34,0,1,1
"5682","27ccc8f4f57b53ac9f1284154b12685d",17,17,0,17,17,0,1,2
"5683","27cdfa71028c3686727d3e2e02a2ba63",102,62,33,21.6363636363636,102,0,2,3
"5684","27ce83eca1ecdbf83ecdfd94f407fd36",168,95,86,13.6744186046512,168,0,3,3
"5685","27cee9d807b1152d548d29fb8cd8efa7",25,25,0,25,25,0,1,2
"5686","27d0fbf182b18c31ba9008f02c0a0a73",1,1,0,1,0,1,1,2
"5687","27d1984d0ba069efb0df3531ba77897b",47,38,14,23.5,0,47,1,1
"5688","27d28a16414f7dfc6966ed44b303bd9a",84,65,61,9.63934426229508,74,10,2,1
"5689","27d4080aae99585573bb7b3e79972752",33,27,7,33,33,0,1,2
"5690","27d64737e412a69c59a6d443d2bb24b7",41,41,0,41,41,0,1,2
"5691","27d6aa5c55ffc0801118f3f8d8f180b5",19,19,0,19,19,0,1,2
"5692","27d757979b844d6272c28861f445ac8a",170,98,58,20.5172413793103,170,0,3,3
"5693","27d76b388ffddf08aea1ba4dd9d5f30b",51,34,63,5.66666666666667,13,38,2,1
"5694","27d7e2e7af65bba3ef711200ec1d60f6",66,38,82,5.63414634146342,50,16,2,1
"5695","27ddf52b73178b7ba4f04d8f475fb7e6",7,7,0,7,0,7,1,2
"5696","27e0be2ba8c9df31fc21e526729b9a6a",52,50,35,10.4,52,0,2,1
"5697","27e4da0e1460a899051ab0fe80542542",15,15,0,15,15,0,1,2
"5698","27e51480fee664659f43bf58f8e21db5",35,35,0,35,35,0,1,2
"5699","27ea4d41bcef35886b7f2d9cb6768eb3",13,13,0,13,13,0,1,2
"5700","27ecfcc88692fb816372f7c8cc906ec4",44,44,0,44,44,0,1,2
"5701","27ee59759f208bb3bf769888c575327f",96,73,38,17.6842105263158,74,22,2,1
"5702","27ef525066b56dd601c32524d27ce30e",17,17,0,17,17,0,1,2
"5703","27f1bec521e279cfb16f7578f3371765",11,11,0,11,11,0,1,2
"5704","27f5dc01fd8473558eafe001594b2fdf",114,76,23,34.695652173913,60,54,3,3
"5705","27f949e91b957d2f11c1abe162bd21ab",20,18,25,5.6,20,0,2,1
"5706","27fcf2769cad8f65e7a7a4b4896dd46a",42,37,37,7.94594594594595,42,0,2,1
"5707","27fe227c335123d15b48ce6a52dd3f7f",17,14,17,7,17,0,1,1
"5708","27fea3993ce3851d43634953ceb935be",28,28,0,28,28,0,1,2
"5709","2801915af6dd0e1f193f933845e6e2c2",27,27,0,27,27,0,1,2
"5710","280663871278975c92c697ccbd2485ce",110,81,43,17.906976744186,110,0,3,3
"5711","280b08068372b11868144130c0abf405",56,38,43,9.11627906976744,47,9,2,1
"5712","280b750083d2f34f1f6b32785ec66bf8",24,24,0,24,24,0,1,2
"5713","280ef753b86382bb26a48595a40ea08f",36,36,0,36,36,0,1,2
"5714","2811a5ccdb02dd29411352de53e82c33",64,52,70,6.4,64,0,2,3
"5715","281355b1abc20e09d4150579b01641ff",5,5,0,5,0,5,1,2
"5716","2813b4fd1ddaaae08d2013e1fc88b417",157,88,59,18.6271186440678,157,0,3,3
"5717","2818b7df94230a4a2e7de340f94fe6ca",34,34,0,34,34,0,1,2
"5718","28194ccbb2b3265fdeb58eae8011d43f",50,50,0,50,50,0,1,2
"5719","281a24479f27c3c5bc2a07a68a433d74",20,20,0,20,20,0,1,2
"5720","281a68e633f974b33da34dc2a9f81811",16,16,0,16,16,0,1,2
"5721","281a7083855de5f6fd63be06bd46e4bf",33,32,14,16.5,0,33,1,1
"5722","281dcaadaf81e8a9eb5c62f0139c6f41",9,9,0,9,9,0,1,2
"5723","28220746acc92a05a96c587a1d081654",75,68,16,32.8125,75,0,1,2
"5724","2825abff99306d0aa90a12e59f8b7aa5",43,40,57,5.28070175438596,19,24,2,1
"5725","28261ad44cd67393fe7a30e3eb92c163",185,90,64,20.234375,185,0,3,3
"5726","282a00986d742dd6b68311c97aa81995",30,30,0,30,30,0,1,2
"5727","282cffc3264791fef9c564707e363118",45,40,50,6.3,45,0,2,1
"5728","282dda1d563b425ab8320fa62863f0e0",25,25,0,25,25,0,1,2
"5729","282e6349c8c664d0795d4f29aa0ad63f",172,130,44,27.3636363636364,153,19,3,3
"5730","2830b953b1873f41a465b67f70308145",133,76,50,18.62,133,0,3,3
"5731","2833bb53d1c994e325aa874121e24a8f",72,50,48,10.5,72,0,2,3
"5732","2834f45a1849b940923b5ad14d4b067c",37,37,0,37,0,37,1,2
"5733","283640bcb1d4723be96e8868b510d034",109,89,34,22.4411764705882,109,0,3,3
"5734","28367bc32d9e42311f1713d881234f05",7,7,0,7,7,0,1,2
"5735","2837e18c5ff4685263f1f6464c1c9930",90,64,48,13.125,36,54,2,1
"5736","28385d1ffe15bd21a9b7b2938e3da035",128,83,34,26.3529411764706,105,23,3,3
"5737","283ac5b7eb283d3d8abb4ee35fa9b982",195,88,78,17.5,163,32,3,3
"5738","283df7476f0f8f64c78d0a08ad160597",12,12,0,12,12,0,1,2
"5739","283e4be0e8740e33c35bbb0173086c65",92,58,60,10.7333333333333,62,30,2,1
"5740","2840831289e13edf4338600f5260d670",47,40,9,36.5555555555556,16,31,1,2
"5741","2848a289179ce9ccad5dd41862febb34",27,27,0,27,27,0,1,2
"5742","284940c7c03a7d1776c7631cdaf2ab12",31,31,0,31,31,0,1,2
"5743","2849a1fd12337d445a5594b0bdd2c8cf",59,41,35,11.8,59,0,2,1
"5744","284b6e33f2cfdae72faf7269b51ff2cb",7,7,0,7,7,0,1,2
"5745","28502a8f99a358ef3b9060a9f046dbd1",50,47,15,23.3333333333333,50,0,1,1
"5746","28506545149cf55708d87c2597f4d84e",41,23,63,4.55555555555556,11,30,2,1
"5747","28571b1e0a1b1d17d784aae3fc86d9a7",58,44,61,6.65573770491803,58,0,2,1
"5748","285af1ecb3851e6dcceb1fa7b982e747",180,103,57,22.1052631578947,180,0,3,3
"5749","285b08c937f0eec583a247433f3557a2",88,72,33,18.6666666666667,39,49,2,1
"5750","285baeb7d684dd766b1bccc3b4be3e61",64,38,73,6.13698630136986,64,0,2,1
"5751","285cb2187e625991ec52c78cb07343e6",198,97,77,18,198,0,3,3
"5752","285d422e2d3ad242ffe10b43fc41441e",2,2,0,2,2,0,1,2
"5753","285e11211d60869d3eff9a417b2e791c",48,39,66,5.09090909090909,48,0,2,1
"5754","285ea9dc18cd46f7649bf39b756a4816",14,14,0,14,14,0,1,2
"5755","285ebcc1324cd183df7f1d4790cc9eca",64,54,51,8.7843137254902,44,20,2,1
"5756","285f91a67189df41230ceeea5906cff9",39,39,0,39,39,0,1,2
"5757","285fa4e9a77f8a2bf9cc7ef13e809ddc",19,15,0,19,19,0,1,2
"5758","28624473ba856fb5a8c9f2551cfbf345",18,18,0,18,18,0,1,2
"5759","286364fe506ac4382ffb2953a45865e2",32,32,0,32,32,0,1,2
"5760","2863a1cf1f3e303fdc425f3d0a42317b",27,27,0,27,0,27,1,2
"5761","2863fe077e4504e491fb4b325ad17cb1",200,112,75,18.6666666666667,200,0,3,3
"5762","286578077c0963ba94d21122f5d633e3",147,112,67,15.3582089552239,147,0,3,3
"5763","28662cf5a6219a4f72fb9e00eae15751",37,28,82,3.15853658536585,37,0,2,1
"5764","286700717f5ee7c643a2ea20ff81f2f5",40,40,0,40,40,0,1,2
"5765","28685ec1582e5c4bcbf3b4e938383763",40,40,0,40,40,0,1,2
"5766","286a16534ce694821347e3ece4cc8acd",25,25,0,25,25,0,1,2
"5767","286aad6995d7fc65dabb10371bbdf610",28,27,81,2.41975308641975,28,0,2,1
"5768","286c4bd359c3bb76d40db75d80df1c08",31,18,63,3.44444444444444,31,0,2,1
"5769","286c5a6a2e19f3ebf1e3cd69e461d4fb",40,40,0,40,40,0,1,2
"5770","286deee7ecfc484789e07ed072a096a4",32,32,0,32,32,0,1,2
"5771","286f64f3732131cd9484bbc31e7780a1",99,52,71,9.76056338028169,99,0,2,3
"5772","28714dd5de457275519ae8ae9b34b2ee",17,17,0,17,17,0,1,2
"5773","2871a89202bb33cffb2755bbf519792a",155,103,63,17.2222222222222,155,0,3,3
"5774","2871cb629d4a849ee81d5c3bbaab807c",21,21,0,21,21,0,1,2
"5775","28735adaae9ad81cc7d871a20d4283e6",60,47,55,7.63636363636364,25,35,2,1
"5776","28744c98a3646852d5d7ff9fda2903ba",18,18,0,18,18,0,1,2
"5777","2876e75e71b31b08d20729da81647a63",46,40,19,16.9473684210526,20,26,1,1
"5778","2877845c052f89911335255ee46ade87",13,9,43,2.11627906976744,13,0,2,1
"5779","2879b7320d027ef084396166a79a8685",62,55,25,17.36,28,34,2,1
"5780","287b77af30933a0e3ae2fb4f614e06d6",45,45,0,45,0,45,1,2
"5781","287bc941a77e61dae7dee6aa5be123d5",12,12,0,12,12,0,1,2
"5782","287c28dba0a8531a7ab9bfaced1e195f",51,37,21,17,51,0,1,1
"5783","287ede473a0e9fa3888eac251efbfbbd",27,23,19,9.94736842105263,18,9,1,1
"5784","287f861f492d41f363c6012916373c08",26,26,0,26,26,0,1,2
"5785","28800adfec572876331e419ab30da6cb",103,66,35,20.6,103,0,3,3
"5786","2880f91b73a73d7e586ad6c97c50c25e",115,70,71,11.3380281690141,113,2,3,3
"5787","288144fa1423222a4d1075f0c8cca50f",193,96,84,16.0833333333333,193,0,3,3
"5788","28827661db09c43351823ce8663157bb",101,60,82,8.6219512195122,101,0,2,3
"5789","2882d8f8daf060617ed7d171e4163e2f",49,39,71,4.83098591549296,42,7,2,1
"5790","2885b9f54a8d4013e69f78c73f7aca9e",106,71,35,21.2,106,0,3,3
"5791","288bd00acecb31c73d265158b846659d",35,35,0,35,35,0,1,2
"5792","288de1dcbb8e7591d2bd05713d14e273",134,81,82,11.4390243902439,101,33,3,3
"5793","288e6c37a48c15b1974ad167a8e581ce",93,79,29,22.448275862069,93,0,3,3
"5794","288e85f02268ebc05fdd1153d128e783",73,50,53,9.64150943396226,73,0,2,3
"5795","288f924adb3087c2c63f361c28df691a",33,33,0,33,33,0,1,2
"5796","28915f694934747a3b06d0848cd28f2f",25,25,0,25,25,0,1,2
"5797","2892b373915a18dec62f5c8e45d75350",49,49,0,49,49,0,1,2
"5798","28936914f462b0249a3983ef58a27b2b",3,3,0,3,3,0,1,2
"5799","28944ae199cbbf4cb926b608ae375c03",155,88,63,17.2222222222222,155,0,3,3
"5800","2894994a05ad7997357273f58a735d2a",9,9,0,9,9,0,1,2
"5801","2895be0d5f7e6120a56342114b93f63e",113,97,42,18.8333333333333,113,0,3,3
"5802","28961031e871912ba12e361826a3f4b3",18,12,15,8.4,18,0,1,1
"5803","28988d639605271be833e55b1e609572",54,54,0,54,54,0,1,2
"5804","289a55c47b42d77184a0c5c1b6e831a7",35,29,71,3.45070422535211,35,0,2,1
"5805","289b97bf7c0fbcf250f2c07703dedc82",107,48,81,9.24691358024691,107,0,2,3
"5806","289bd440bcbc857b9564d97703de6825",128,70,57,15.719298245614,128,0,3,3
"5807","28a0d8ed9b20bd6fc9ace17728341a74",38,38,0,38,38,0,1,2
"5808","28a1324326f0c2ffdd81c46a5212b0f4",171,120,73,16.3972602739726,171,0,3,3
"5809","28a23db430618478f5bd773fc1a8e7c5",37,37,0,37,37,0,1,2
"5810","28a407093053e0aee710fcedda559f69",60,48,16,26.25,29,31,1,1
"5811","28a469fb509236b3b3ff26bfb8248db3",179,127,68,18.4264705882353,179,0,3,3
"5812","28a58ce43dd7aeab82f35bddca24986c",114,66,45,17.7333333333333,79,35,3,3
"5813","28a6adbe7af3c2b94e9745ae235863df",2,2,0,2,2,0,1,2
"5814","28b4f39a2e99f6830d999e7e587197dc",9,9,0,9,9,0,1,2
"5815","28b7047adeca83f724f36148eeebecf7",81,68,30,18.9,51,30,2,3
"5816","28b7ba8e56f72e4c086e40eedc1b4ec9",74,34,75,6.90666666666667,74,0,2,1
"5817","28c0dde394987a40d8cd359a571969c3",7,7,0,7,0,7,1,2
"5818","28c235fef3b9aeb56425f3032a23236a",18,18,0,18,18,0,1,2
"5819","28c30654b9225ff552315c50af08a029",59,35,75,5.50666666666667,59,0,2,1
"5820","28c4d880887a34ea4609c1de86518407",48,41,56,6,48,0,2,1
"5821","28c5b037e09c7daac37339639312a350",1,1,0,1,1,0,1,2
"5822","28c5ce07cddad7da17613ab942758ad7",74,54,67,7.73134328358209,74,0,2,3
"5823","28c8412e2cf5ccfb93befeea5920d5db",15,15,0,15,15,0,1,2
"5824","28c84dc45ca3f3c6ea7ba8858af6873b",15,13,6,17.5,15,0,1,2
"5825","28c8765e53b3b4aa9af0117528059572",185,92,70,18.5,185,0,3,3
"5826","28cce03f2a14d2bd4787c1def8cb4db6",40,40,0,40,40,0,1,2
"5827","28cd138a034a508897acb45a124ca043",70,52,61,8.0327868852459,42,28,2,1
"5828","28ce198ecc7a38627fb580c097120473",19,17,52,2.55769230769231,13,6,2,1
"5829","28ceb87cfa4707ef644954d201e97955",122,95,61,14,99,23,3,1
"5830","28d0d7a3924f65953cb0952b60c10126",43,32,10,30.1,43,0,1,1
"5831","28d0fc1412004ea3cc043f3c900ca281",137,81,71,13.5070422535211,126,11,3,3
"5832","28d1b34a088369038453bb499054bf23",76,56,48,11.0833333333333,76,0,2,3
"5833","28d27e64bd5874e22e36f2c1ebf3d9a6",16,16,0,16,16,0,1,2
"5834","28d2ef93f19214ae9702ba5b5eb4ccc1",19,19,0,19,19,0,1,2
"5835","28d3779227477526bae3e315c22efba8",16,16,0,16,16,0,1,2
"5836","28d7b21bc6fe86c27f1156cc79fc7d72",23,16,75,2.14666666666667,23,0,2,1
"5837","28da68fddc860df15da2a12fd59ac7e9",44,34,67,4.59701492537313,44,0,2,1
"5838","28dc4fccc0d2ca702d8d99979aedba3b",105,74,67,10.9701492537313,65,40,3,3
"5839","28dd162af8df663c81a631088e40dfe0",123,55,64,13.453125,123,0,3,3
"5840","28deeebd20e5bcf0dc6baafa4e9420f1",194,88,60,22.6333333333333,194,0,3,3
"5841","28df123c0c8cf7aadb2dccfadf050ffe",92,48,48,13.4166666666667,57,35,2,3
"5842","28e00c90c5cb386c51b7fe20008f880e",9,4,65,0.969230769230769,9,0,2,1
"5843","28e0dcbc5a8d3228031b7a457b43e2a2",26,22,55,3.30909090909091,26,0,2,1
"5844","28e23744dbb4abf2324bfda57748ab42",127,62,81,10.9753086419753,127,0,3,3
"5845","28e31ea1b10a98aa4a3cf5a412362646",4,4,17,1.64705882352941,2,2,1,1
"5846","28e327a080df69ef4cc5a594388b628f",99,75,28,24.75,99,0,3,3
"5847","28e35079b113f38678527130581a2b0d",107,56,80,9.3625,107,0,2,3
"5848","28e41423745c6f4347cc8643fdbec00e",65,50,78,5.83333333333333,65,0,2,3
"5849","28e8c997bc115c8d2f5dea698b2762bc",37,37,0,37,37,0,1,2
"5850","28ebf42845ddd06d279eb5681a1de053",103,76,56,12.875,103,0,3,3
"5851","28ec84360bc9cd29f63606a1a4939226",97,82,31,21.9032258064516,97,0,3,3
"5852","28ed55f04a6533250b50c1d28d46ac12",40,36,84,3.33333333333333,40,0,2,1
"5853","28eee661b51da1d854b8a0075ca40870",21,21,0,21,21,0,1,2
"5854","28f70196167f5971e666ddf4f94e71d0",49,32,63,5.44444444444444,49,0,2,1
"5855","28f95120c22a240fe227c2ac714b1e00",65,54,78,5.83333333333333,65,0,2,3
"5856","28f97cbf7564e20554ae55b45246f547",27,27,0,27,27,0,1,2
"5857","28fa922b0f2a7ff4a00051673a631c19",47,39,8,41.125,47,0,1,2
"5858","28faef534854f5d8c1867918aa6cca0a",16,16,0,16,16,0,1,2
"5859","28fba30bd1cf46fc4bffe698427c2ad9",36,36,0,36,36,0,1,2
"5860","28fbea0f25e4d3015f41472a2861f72c",34,34,0,34,34,0,1,2
"5861","28fcbe34696d99910ebc0270205edc84",116,65,70,11.6,116,0,3,3
"5862","28fd26310f1efcb24cc5009b3e664fdf",73,57,21,24.3333333333333,73,0,1,2
"5863","28fe4b25d3d5870939b3ab3c052bd4c6",55,39,56,6.875,55,0,2,1
"5864","28fef1b3c0f2191a63935950b2da9941",62,49,63,6.88888888888889,62,0,2,3
"5865","2900cc168547104006e5d7a0edfad69f",47,38,40,8.225,24,23,2,1
"5866","290148f13bea54da58c608da843212c1",132,58,64,14.4375,132,0,3,3
"5867","2901517b69b34113b233beddd9eaa96c",61,40,56,7.625,47,14,2,1
"5868","290249c495521517e8b3f44ae2d5846d",51,51,0,51,51,0,1,2
"5869","2902eaf57c47278b9652f9f9c8b29a27",46,46,0,46,46,0,1,2
"5870","2903b7144ca8ef5c684edd993deb0bd2",127,95,73,12.1780821917808,77,50,3,3
"5871","2905a4058401bb7a730b5434ddcf6426",184,62,84,15.3333333333333,184,0,3,3
"5872","290649145453ae795a580d90a55f68d2",89,57,84,7.41666666666667,89,0,2,3
"5873","290685659d9e4884e2b39e4834b6b048",1,1,0,1,1,0,1,2
"5874","2906cb8601f133f7e69d35319303b68c",90,69,15,42,90,0,1,2
"5875","2908aa5e01a38be86e75a76184ce2e8e",18,18,0,18,0,18,1,2
"5876","2908dff0e48e13c57095f2729770797e",246,146,77,22.3636363636364,214,32,3,3
"5877","290a188e532b6cf11dc95ee0df2d1485",179,101,66,18.9848484848485,179,0,3,3
"5878","290ab086a3a9e06fbdd14eae1c1b0cdf",151,80,67,15.7761194029851,97,54,3,3
"5879","290ce756a096a48c6449411fd9c23161",32,32,0,32,32,0,1,2
"5880","290fa5ed5763dd80d9694adfe7cb4fb5",91,64,35,18.2,91,0,2,3
"5881","2910f76ccc68f9252348f19b2131ca80",12,12,0,12,12,0,1,2
"5882","291237b86d37104b4769054b4be54100",40,40,0,40,40,0,1,2
"5883","29130ec69df7193a5f489554b3a2e99a",56,51,0,56,56,0,1,2
"5884","2913108b564f5e1ad72b2501337d80ca",32,32,0,32,32,0,1,2
"5885","291353e72af091daad691692033eacb5",53,46,29,12.7931034482759,53,0,2,1
"5886","2913d94e4f1a66e7d6bf35d115bae7de",24,24,0,24,0,24,1,2
"5887","2915ae17fb2144619b5a6af2a1adec34",45,45,0,45,45,0,1,2
"5888","2915e97c4bb7e9b9efba17d09ec82bbf",37,37,0,37,0,37,1,2
"5889","291629c21b16aaa73aef88f75760f70f",3,2,53,0.39622641509434,3,0,2,1
"5890","291679a81c6d6eed7398e48440388035",92,64,70,9.2,92,0,2,3
"5891","2916f00f0a219ae69a677ef276e9a731",28,28,0,28,28,0,1,2
"5892","2918fd78a3909610b00e1ee0bc3bf46e",218,71,70,21.8,186,32,3,3
"5893","2919c6250506d3b4bf88e9144fee542d",56,44,41,9.5609756097561,56,0,2,1
"5894","291c364c540a30674ad41cf7e2c8a86b",38,38,0,38,38,0,1,2
"5895","291ffde67fbdfa280e7f82a306a7c971",16,16,0,16,16,0,1,2
"5896","2925505af928a5d05e0b7e027f8f4c54",23,23,0,23,23,0,1,2
"5897","2925d09d82f65be9d168107b70a959b5",71,54,86,5.77906976744186,48,23,2,1
"5898","2925fd606567aabfc90b22d29a7c51fc",22,22,0,22,22,0,1,2
"5899","29275f230bc488041f7bf2b1f3a6e39e",8,8,0,8,8,0,1,2
"5900","29286f3f5ce847e561e2932d717aec19",101,56,55,12.8545454545455,101,0,2,3
"5901","292aff3a5596a2337265af42a571468f",21,18,85,1.72941176470588,21,0,2,1
"5902","292e7c0a1d56b59c8471a96047c3f4ba",19,19,0,19,19,0,1,2
"5903","2930c865317a00df871ebe78aa64f69d",7,7,0,7,7,0,1,2
"5904","2931e04ab316f954cc2c23985b736b63",49,49,0,49,49,0,1,2
"5905","293386babebabce4bc11168b197e4dea",22,22,0,22,22,0,1,2
"5906","29350a4722c3bea6688ccbbd717e5242",28,28,0,28,28,0,1,2
"5907","2935e49e7c0fee068d81e622ffa48173",13,13,0,13,13,0,1,2
"5908","2938a06532e0a946a4b49cc3186ca5f1",19,19,0,19,19,0,1,2
"5909","293d64c6da64e1a6624565b8e1119a20",110,80,50,15.4,74,36,3,3
"5910","293f4266fb8f713c0458e9b36bfa22ab",43,38,25,12.04,21,22,2,1
"5911","294020b1ef8518992d504f8745773622",25,25,0,25,0,25,1,2
"5912","29406eec5ac743e97bd119a63d2e026a",51,51,0,51,51,0,1,2
"5913","2940e9e176c1bb521443565021d091f4",31,31,0,31,31,0,1,2
"5914","2941f35801d72beb48daa21bdef377d2",37,37,0,37,37,0,1,2
"5915","2942a232158140cd9295351ebb511dde",32,32,0,32,32,0,1,2
"5916","2947c48ad88fc93fcffedaa40618f199",23,23,0,23,0,23,1,2
"5917","2947ea72ca103a5086e25e7037866cf1",45,45,0,45,0,45,1,2
"5918","29481947cfbb7a1d84ec5cd7356ed5b9",10,10,0,10,10,0,1,2
"5919","294970e5254e97f14da6c098e730b77f",41,33,37,7.75675675675676,41,0,2,1
"5920","2949e8dc143a2a1375831c66c7c84c9b",4,4,0,4,0,4,1,2
"5921","294a2db3f98046810edf4dc18753211e",43,23,65,4.63076923076923,43,0,2,1
"5922","294f8f5906ee4c8ab2fb5f618193e47c",171,117,79,15.1518987341772,171,0,3,3
"5923","29551cf4f2e187c9295f6c8b4a7a9561",122,86,71,12.0281690140845,122,0,3,3
"5924","2956fd44b1070a1a39437bb62183ab66",25,25,0,25,25,0,1,2
"5925","29597c31ce96fbddc54af81b23adba16",43,38,27,11.1481481481481,43,0,2,1
"5926","295bd4e2fbadbcbda64646d1f5581e5a",55,44,70,5.5,55,0,2,1
"5927","296158fc0012f63afe5e7a7b55b3d96f",1,1,0,1,1,0,1,2
"5928","29641c812ed6684c14edf82060c85187",28,28,0,28,28,0,1,2
"5929","29653aa4aededec92a4ceb7c5981008f",2,2,0,2,2,0,1,2
"5930","2967491367cd855ecdecb6a18fc0ec20",12,10,23,3.65217391304348,12,0,2,1
"5931","2969175afbe0774e5d8f0103373b722f",83,63,52,11.1730769230769,83,0,2,3
"5932","296dfd099d00630b5a0a85a8923cc372",32,32,0,32,32,0,1,2
"5933","296e351309c0e4e62c57bf5283f83a92",158,116,37,29.8918918918919,158,0,3,3
"5934","296f149b5063186f589be0cc6a51aa0b",60,45,19,22.1052631578947,60,0,1,1
"5935","296fae99c6581b4ff59fc971f43d0e70",45,43,33,9.54545454545454,45,0,2,1
"5936","297094f0349dd9a212992a9ae5727c0c",19,19,0,19,19,0,1,2
"5937","29729b0f66912e3541e2ad8fd8d19f4d",173,90,78,15.525641025641,173,0,3,3
"5938","2978fe0eb0b07405787ce53b6e4ade2d",92,25,83,7.75903614457831,92,0,2,1
"5939","297b5bf955cb0fad08042d5d60de5f93",16,16,0,16,16,0,1,2
"5940","297d7efbdc889a8e79e958b7860eeda2",101,47,83,8.51807228915663,101,0,2,3
"5941","297e6455377a8bacba9c89088db2874c",11,11,0,11,0,11,1,2
"5942","297f5ed3753ebe0fbb73cc13c3999c41",203,64,85,16.7176470588235,173,30,3,3
"5943","2980ab6a94403971deb5337a53188910",14,14,0,14,0,14,1,2
"5944","2982b5db1179ac9675da6d0095d7ec4a",165,124,69,16.7391304347826,110,55,3,3
"5945","298356680c8387a220726717167c80e8",39,39,0,39,39,0,1,2
"5946","2985d2434ff85cbc776b52ebff686819",30,30,0,30,30,0,1,2
"5947","298619ce56b92d93f64577ac13cf19c1",21,20,8,18.375,21,0,1,1
"5948","29891a0672027d1ea00b3135b595102d",23,23,0,23,23,0,1,2
"5949","298bbd2ca44d21f3e42c37ff23f9a71f",36,36,0,36,36,0,1,2
"5950","298bf55a9f88305822912997ea252f4a",137,74,65,14.7538461538462,98,39,3,3
"5951","2990bae3dc888c5f0cde012a3a7ba3b6",49,27,77,4.45454545454545,0,49,2,1
"5952","29921705d638cad48f1236fda77ca108",38,29,43,6.18604651162791,38,0,2,1
"5953","29947aa7370f36f8bb947ac58a133ebf",75,52,26,20.1923076923077,38,37,2,1
"5954","2999133c6f74710ab63d989c8d01f903",35,30,42,5.83333333333333,35,0,2,1
"5955","299968a67a502113554d4ddd5bfb1f77",59,50,40,10.325,59,0,2,3
"5956","29998ec981bc90a10cb9aac676b5ba4a",21,21,0,21,21,0,1,2
"5957","299a995ce40392ecb6e7977dc9d5bc61",16,16,0,16,16,0,1,2
"5958","29a0c4be5f9b061f853aad0b59e8f0b5",31,29,5,43.4,31,0,1,2
"5959","29a0cd208a872f6cab46eb9df772c905",150,49,78,13.4615384615385,128,22,3,3
"5960","29a15edb27b6f638f058c66d7c4dc7a4",72,44,77,6.54545454545455,72,0,2,3
"5961","29a22de109b58003978e8b2e1cb0d0bd",39,39,0,39,0,39,1,2
"5962","29a2653b28d60f537a5a40d490994c7c",48,48,0,48,48,0,1,2
"5963","29a27e417b42a2371be5dad69093f012",62,33,65,6.67692307692308,62,0,2,1
"5964","29a5fcd4a3867ff35f7df40133b4869f",35,35,0,35,35,0,1,2
"5965","29a7152bb7b93195a8953f1514036220",32,32,0,32,0,32,1,2
"5966","29a84be1be6ae3e808e24dbc808f4ee5",8,8,51,1.09803921568627,8,0,2,1
"5967","29a94838b9d46dcd00d421555acdfd5a",11,11,0,11,11,0,1,2
"5968","29a9808f434f1a0513c78f97d74f9432",148,113,43,24.093023255814,148,0,3,3
"5969","29ab5fb0ec86bfe96af864e4e6d9a62f",63,50,71,6.2112676056338,63,0,2,3
"5970","29ab990cbd73f3e293303444685d7b5b",101,72,56,12.625,101,0,3,3
"5971","29adbd484d2cb9d36adad30052a29b4c",122,82,62,13.7741935483871,69,53,3,3
"5972","29aecfc411417e07c3d3ff7babfe44cc",47,38,10,32.9,47,0,1,2
"5973","29afcf97d982c7269cf71f9c324b7e27",73,57,49,10.4285714285714,73,0,2,3
"5974","29b01c5cbd3d332b3c0ccca1f4433d5f",92,51,32,20.125,70,22,2,1
"5975","29b12a8a668d89288aaa1d037166119e",10,10,0,10,10,0,1,2
"5976","29b23e52f8d0404bf20abd5f803e78da",88,63,69,8.92753623188406,55,33,2,1
"5977","29b4f0faabd72dab306bb42b1a0d5ee0",5,5,0,5,5,0,1,2
"5978","29b79442ba991f38aeb3927a9ee23a27",172,50,87,13.8390804597701,159,13,3,3
"5979","29bc68b584cee11693b1e13875995f1d",124,87,54,16.0740740740741,90,34,3,3
"5980","29bcbc92a703160b399238e7fa9d3367",31,30,4,54.25,31,0,1,2
"5981","29c017a9eed8a06b87276af2b1f2134f",20,20,0,20,20,0,1,2
"5982","29c1b0b02220aa1f3b368b2f5d67662e",110,75,44,17.5,89,21,3,1
"5983","29c2f5a25343c99ee9473855f723733d",144,107,63,16,116,28,3,3
"5984","29c353e86ee7e737f1a7b7c3b74dc648",4,4,0,4,4,0,1,2
"5985","29c41b1bfd41dfa339ecbce6ddf2b60e",32,32,0,32,32,0,1,2
"5986","29c7696737e39bd70b795a8b9a0f2b02",47,47,0,47,47,0,1,2
"5987","29cd10ca98ada58176445dd72f8c50c5",43,43,0,43,43,0,1,2
"5988","29cd4b9b523a1ddc29ebe4062a9bc7ea",41,41,0,41,41,0,1,2
"5989","29cfed559a418bfed10e36c762de191a",41,41,0,41,41,0,1,2
"5990","29d0c54aefa683185294295bccc54b2f",166,80,81,14.3456790123457,166,0,3,3
"5991","29d397f1157f79d97635ee8b4499635f",31,31,0,31,31,0,1,2
"5992","29d4d307ae0271400b313eae5341f35d",15,15,0,15,15,0,1,2
"5993","29d525fd2a193c252f218871de0aabc9",34,26,15,15.8666666666667,34,0,1,1
"5994","29d5f975aa69ee50e80681fe9bb2e379",24,24,0,24,24,0,1,2
"5995","29d784a96becd09c5ca8630269ccdf49",43,43,0,43,0,43,1,2
"5996","29d7a2642ded58a7ccabcc19b4de195b",47,47,0,47,47,0,1,2
"5997","29d95f16cddc4e272192d885278cb9db",82,61,50,11.48,43,39,2,1
"5998","29d993572f181588e1a76fcd7d852489",126,80,71,12.4225352112676,126,0,3,3
"5999","29db85197d56c3cc3ce9ec71074e035b",245,140,88,19.4886363636364,201,44,3,3
"6000","29dbb9c942fa31e94dc8a25d7471841e",67,56,57,8.2280701754386,67,0,2,3
"6001","29e579ad69f8ae224ac2f4938af0a206",12,12,0,12,12,0,1,2
"6002","29e60eba5484021c283a03e4dfc686fe",47,47,0,47,47,0,1,2
"6003","29e6ab4b3e0c1371b38bd02da3b6cb17",82,56,61,9.40983606557377,82,0,2,3
"6004","29e9acc2c32755346ce74aba88134697",41,41,0,41,41,0,1,2
"6005","29eb3840c9cfa2af6cfda42f8b28b344",17,17,0,17,0,17,1,2
"6006","29ee137199a582da3cb8b0b8b03e5104",45,45,0,45,45,0,1,2
"6007","29efb89ceeed630798020b40fe3a5385",14,14,0,14,14,0,1,2
"6008","29f4d660138e4ebb5b136233066a3e0e",44,44,0,44,44,0,1,2
"6009","29f55a97c2391ccc9437370bc5e69688",23,17,65,2.47692307692308,10,13,2,1
"6010","29f75fc659584288a57d1ba66162279a",1,1,0,1,1,0,1,2
"6011","29f7da6329b41102a76a012261a9827d",169,114,44,26.8863636363636,169,0,3,3
"6012","29fb4ac6db55ce873511a02866861f19",100,79,57,12.280701754386,100,0,3,3
"6013","29fc8d4244a5e23f3c314f450ce721ec",37,37,0,37,0,37,1,2
"6014","29fe1a5e1dcb134fa86c115262b5fb99",29,29,0,29,0,29,1,2
"6015","2a017ab4f3a3c5da3acd7e6801fd029f",18,18,0,18,0,18,1,2
"6016","2a0579bc1824712f47bd50f9577a3337",116,89,56,14.5,116,0,3,3
"6017","2a071b59a03db5cb19cc88221ee68395",18,18,0,18,18,0,1,2
"6018","2a08632c258be6478b8daa90ac2aa690",11,11,0,11,11,0,1,2
"6019","2a08b691bdde14f5a7b0f86731724ec4",18,18,0,18,18,0,1,2
"6020","2a0959bab679aa5d030281201fd3cf6a",40,36,57,4.91228070175439,40,0,2,1
"6021","2a0b1579553772a7a6e8718e97d04d37",44,44,0,44,44,0,1,2
"6022","2a0d406e990e7edfffa1acbc0ff3a8b3",83,41,53,10.9622641509434,43,40,2,1
"6023","2a111ca81c67b776129d2808a7b2bd61",40,40,0,40,40,0,1,2
"6024","2a1470391f9ae296e67922e76618655a",10,9,17,4.11764705882353,10,0,1,1
"6025","2a17086bbb62070cbfd6a642bb9d77db",133,89,44,21.1590909090909,133,0,3,3
"6026","2a181a10bed317d7de8f5ee58ed1ad7a",149,120,58,17.9827586206897,149,0,3,3
"6027","2a18f4a3e204beb9ab9ee100a9b9cfc4",100,58,72,9.72222222222222,100,0,2,3
"6028","2a19133f7731250a77a0d0de471e63e7",99,74,70,9.9,69,30,2,1
"6029","2a191e371d81ccc91c3863f09c5e0fd6",2,2,0,2,2,0,1,2
"6030","2a19d88199b2a8f3ce0b995b5b3ddb87",77,52,31,17.3870967741935,77,0,2,1
"6031","2a1ade811deb0681a6528f6ec163b371",39,39,0,39,39,0,1,2
"6032","2a1b5e4ae0cc871c188aa1ab8bcfaf98",8,8,0,8,8,0,1,2
"6033","2a1befafa66795a3dafc03e7be870377",1,1,0,1,1,0,1,2
"6034","2a2299ff612d6785fa024f37e74cfeab",32,32,0,32,32,0,1,2
"6035","2a24aaf813c4907df3fdde265cd634b1",18,18,0,18,18,0,1,2
"6036","2a2a4d23164ac035409831b849954afe",27,27,0,27,27,0,1,2
"6037","2a2c085b8a9eba2acfd47e1f7efd2675",62,41,54,8.03703703703704,55,7,2,1
"6038","2a2d81d6e057c633c1e0b384b042b923",129,67,56,16.125,129,0,3,3
"6039","2a2de33d1acc83111ac1ff6ebe8240bf",121,88,75,11.2933333333333,96,25,3,3
"6040","2a2f55baf952264fef8ef8f2d110bd45",19,12,68,1.95588235294118,19,0,2,1
"6041","2a353895cce5ac58600588e164643112",13,8,52,1.75,10,3,2,1
"6042","2a370534807df91995c765c78050fad2",9,9,0,9,0,9,1,2
"6043","2a377a5a10d972f8dd041ece4c29771e",35,35,0,35,35,0,1,2
"6044","2a3853f0cda61a82d41be23cdf1907cc",21,18,51,2.88235294117647,11,10,2,1
"6045","2a3b9e603a293b6563b0e7bbcf0468f1",140,46,77,12.7272727272727,140,0,3,3
"6046","2a424f034798688023cf531d363acaae",51,43,29,12.3103448275862,51,0,2,1
"6047","2a43da1ca91d020ef49dc592ed87b84d",24,24,0,24,0,24,1,2
"6048","2a4432b7d2e9b0675a0d317abbef5d6c",51,41,20,17.85,51,0,1,1
"6049","2a46cfc79421262e1e9258c97f81b3c1",136,71,56,17,136,0,3,3
"6050","2a48ab0e32111ef9167e287ac6c3e6b9",18,14,49,2.57142857142857,18,0,2,1
"6051","2a49067ab28c2da86a653a373440801c",23,23,0,23,23,0,1,2
"6052","2a4b0c6e5a9ebf06a1e23f507f813a04",90,58,76,8.28947368421053,90,0,2,3
"6053","2a4dd92da6bd6975abcd501a690dc423",24,2,85,1.97647058823529,14,10,2,1
"6054","2a4f48b227d28614ad5c976134dd947b",90,52,70,9,90,0,2,3
"6055","2a506c8044804388c10950a5a39a819a",21,21,0,21,21,0,1,2
"6056","2a511271077261142dabf2787c6a6f78",14,14,0,14,14,0,1,2
"6057","2a513ddfb71b51f0184465974823adab",103,71,23,31.3478260869565,48,55,3,3
"6058","2a51b903df59bacfb03cf05a8aaf0c54",53,46,20,18.55,53,0,1,1
"6059","2a51bbbd53a571264af2341957c8d591",133,117,31,30.0322580645161,133,0,3,3
"6060","2a52a8750c34648873d75f80bfc798ad",23,23,0,23,0,23,1,2
"6061","2a5394c3c18cbcd7783e99fbdab96853",22,22,0,22,22,0,1,2
"6062","2a55bf6b66802ba7c2c25e7079e6d2e3",55,50,33,11.6666666666667,25,30,2,1
"6063","2a56dbdd98c00dd6c58f795ed688f9f3",83,57,58,10.0172413793103,52,31,2,1
"6064","2a577e7c8a641aac0856d6fd7b26e624",149,110,62,16.8225806451613,149,0,3,3
"6065","2a57ba975abced8169d16c12a7f71e5e",88,69,14,44,88,0,1,2
"6066","2a59093c28d2c999c98c492eb080d926",77,52,59,9.13559322033898,77,0,2,3
"6067","2a5b735400a9d7e69a34329a2d0d5df0",129,60,71,12.7183098591549,129,0,3,3
"6068","2a5d07ffcd8a573dd5f33f9c127ce84e",31,27,59,3.67796610169492,31,0,2,1
"6069","2a5e6a95c27b7a3d3547a1f6a1d653f3",98,76,44,15.5909090909091,98,0,3,3
"6070","2a5f7106b8bfd9d2788ee9f1a2edb258",55,50,19,20.2631578947368,49,6,1,1
"6071","2a619f82879f5985b0963083fdea790d",48,32,27,12.4444444444444,48,0,2,1
"6072","2a61be09f55a4db656cdf7243be9693e",44,31,32,9.625,20,24,2,1
"6073","2a67198bcc6ee017c5aa410cb74b6544",118,72,62,13.3225806451613,118,0,3,3
"6074","2a6ac8d054978eaf9340d72d8ced1a15",94,71,55,11.9636363636364,94,0,2,3
"6075","2a6c3cfb187756c0ca41262e055acfce",23,23,0,23,23,0,1,2
"6076","2a6d863d608552923f5bd89ccf19bb76",106,79,29,25.5862068965517,106,0,3,3
"6077","2a6edaddfda297ce37a2c86c38f3c4e9",26,26,0,26,26,0,1,2
"6078","2a710ab7ace9b41ac0845703aef388ad",79,69,17,32.5294117647059,79,0,1,2
"6079","2a714318aa7dc20cb2183f865d00e855",165,124,29,39.8275862068965,165,0,3,3
"6080","2a73333a57be622ae7a691729cd9bbb9",9,7,35,1.8,9,0,2,1
"6081","2a7444d0c792612c93e9bd1727244e66",213,148,62,24.0483870967742,213,0,3,3
"6082","2a7610325757bc45c47d9cf088f3a2eb",66,42,54,8.55555555555556,66,0,2,1
"6083","2a7d4b61254629afd2127814e7ad19b6",204,127,78,18.3076923076923,171,33,3,3
"6084","2a813bf96dd0389c9237440198df20b0",40,40,0,40,40,0,1,2
"6085","2a84e9fc75af2890587a1f483b5d0aa1",29,29,0,29,29,0,1,2
"6086","2a8a6653d8647d2509d087d72e49ca05",12,12,0,12,12,0,1,2
"6087","2a8c305986e6b77c44b48cb7b24605e1",30,27,77,2.72727272727273,30,0,2,1
"6088","2a8c7f41f2af9d6b4b997317d9b8b33b",159,90,58,19.1896551724138,112,47,3,3
"6089","2a926302e80c2e8605a746c64013bf5a",89,72,29,21.4827586206897,89,0,2,3
"6090","2a9330260c149ec304ba82cb218ff95d",51,42,9,39.6666666666667,25,26,1,2
"6091","2a93b93e1918b74f15bcec419bb286bf",147,70,77,13.3636363636364,147,0,3,3
"6092","2a97d6b885f36b5b25af88b8fe918df0",93,82,42,15.5,93,0,3,3
"6093","2a99c8322846e52ba4f60b194bbbdf8b",152,83,60,17.7333333333333,152,0,3,3
"6094","2a9aa9369841c9185acdd72d4bfa620e",27,27,0,27,27,0,1,2
"6095","2a9b0f351e1e5e6acb90fb92899aa7cd",45,29,54,5.83333333333333,45,0,2,1
"6096","2a9ba38b8f99aff37b826b80ffba9667",116,83,51,15.921568627451,69,47,3,3
"6097","2a9c38e1635a9207c60c8055b75cd64a",12,12,0,12,12,0,1,2
"6098","2a9d34bdc1e03851690ffbbc6e45ba12",14,7,3,32.6666666666667,14,0,1,2
"6099","2a9f7ab98aaff142788e4bc43fc21bff",27,23,72,2.625,27,0,2,1
"6100","2aa0a3cf6be586bc35909eb8037d683c",79,67,67,8.25373134328358,79,0,2,3
"6101","2aa1867f20fba91d432ca0021044646e",75,56,57,9.21052631578947,75,0,2,3
"6102","2aa50db39e1a292b15e1846740b627bf",17,15,29,4.10344827586207,17,0,2,1
"6103","2aa53958c00fedf0476ed7e41241a38b",87,71,75,8.12,87,0,2,3
"6104","2aa7335cb94e2bc022b06fce5024086d",28,28,0,28,28,0,1,2
"6105","2aa9d5b878debefc80ea0ed970f1a3ae",68,56,16,29.75,32,36,1,1
"6106","2aaa27c891ff47aa2fa3d7d3d5d160cc",184,97,74,17.4054054054054,184,0,3,3
"6107","2aac52cf4630bb5f62aeac03ee2fda53",96,65,28,24,96,0,2,3
"6108","2aad6d95af5ed3cc9925227c17e2f0cf",31,31,0,31,0,31,1,2
"6109","2aafaf38b356325e72733cf4dc7d6f6b",65,51,50,9.1,65,0,2,3
"6110","2ab14040729c199bd8f60f7e28d8ae77",16,16,0,16,16,0,1,2
"6111","2ab22a72dccce5beeecdd1b10131ab56",20,20,0,20,20,0,1,2
"6112","2ab31dd3d0ee83490bb67d02065c8bfd",27,26,7,27,27,0,1,2
"6113","2ab5ef90f5f42b98e0dddd38c6d9cf72",58,37,36,11.2777777777778,58,0,2,1
"6114","2ab6d68797a0406d671339174b132128",24,24,0,24,24,0,1,2
"6115","2ababca822be540f7b33e1704fb9cd38",24,19,35,4.8,24,0,2,1
"6116","2abc1d3f415dbc9c21568b02a1a584f3",202,72,75,18.8533333333333,202,0,3,3
"6117","2abf136b4267c58ffb490631ec162e02",8,8,0,8,8,0,1,2
"6118","2ac3f950972e7d3991970fd92de86773",48,38,44,7.63636363636364,21,27,2,1
"6119","2ac9e20e94e1227c9353085f78fe23e7",65,58,55,8.27272727272727,42,23,2,1
"6120","2ad09570cc710a03de344f48bf70161b",157,83,39,28.1794871794872,157,0,3,3
"6121","2ad0e533133b99bdb571816db8edef60",115,54,70,11.5,115,0,3,3
"6122","2ad54b075cf8f777c3b9302ae51c873a",97,75,64,10.609375,55,42,2,3
"6123","2ad5d4ef7bb0cbe015a4f87ed702f31c",12,7,21,4,12,0,1,1
"6124","2ad7bef3e856a624cc0c19150a109d6d",64,51,42,10.6666666666667,64,0,2,3
"6125","2ad8f655c0e5eb192336f6e6eaecc661",75,67,50,10.5,75,0,2,3
"6126","2adabec10d1ec47f0a90661ec8d1d223",75,63,47,11.1702127659574,55,20,2,1
"6127","2adb84f493fac85aad8d74b2bbc14285",11,11,0,11,11,0,1,2
"6128","2ade5612142011d8e8929f3b0f861835",39,33,41,6.65853658536585,39,0,2,1
"6129","2ade5906b1a9972e4afba8fcb6d8fb8e",168,53,85,13.8352941176471,168,0,3,3
"6130","2adea4b63cc13036f8d0400a3f75afe2",130,96,23,39.5652173913044,130,0,3,3
"6131","2adec1eb6bf9b83c8d20d1eb43ba311b",101,81,50,14.14,101,0,3,3
"6132","2aded0e49b9a42211d0dda443eb0e398",30,22,27,7.77777777777778,12,18,2,1
"6133","2ae0744f3a338409452e2467f4b58165",46,46,0,46,0,46,1,2
"6134","2ae73703bf71dd1d04f6fb9f9b67ca14",101,78,51,13.8627450980392,101,0,3,3
"6135","2ae78f283bcf16877bd396bf27902f17",48,40,29,11.5862068965517,48,0,2,1
"6136","2ae888c3016782294625f735c50ce53c",21,21,0,21,21,0,1,2
"6137","2ae8fb26754d0461bc94ac5af058aeb2",42,31,89,3.30337078651685,42,0,2,1
"6138","2aebc48919c874f43b2da6cf6b6ab12f",16,16,0,16,16,0,1,2
"6139","2aebc9dec6816992ff38b55782497496",1,1,0,1,1,0,1,2
"6140","2af0c558a372cdcee95ac887265db47d",100,76,56,12.5,100,0,3,3
"6141","2af3290a1c42a4f11c31aa4eabc01fb6",14,14,0,14,14,0,1,2
"6142","2af6df3d10197e314b6d2766cdce6696",111,93,40,19.425,73,38,3,3
"6143","2af7113919a6f4b5d96492e288447461",65,56,60,7.58333333333333,65,0,2,3
"6144","2af7819f9c66f491fd94b29308b25d14",78,66,62,8.80645161290323,78,0,2,3
"6145","2af7863ac5b36ec0821cea8447e5995f",25,25,0,25,25,0,1,2
"6146","2af7e5deb9a595c0479ba88722dd5f52",56,48,43,9.11627906976744,56,0,2,1
"6147","2af9012b5dceda1b96501d42b945a40b",26,26,0,26,26,0,1,2
"6148","2afa866e817475e13458817c88d242e9",33,33,0,33,33,0,1,2
"6149","2afafe9474fa2d7504e6c84700b7011d",41,41,0,41,41,0,1,2
"6150","2afb20a16f0e896f72339fb92f10ddba",34,34,0,34,34,0,1,2
"6151","2afbaf52bd8b7edee54a1987f585333b",12,12,0,12,12,0,1,2
"6152","2afde65ec03cf6199c55b637b0ecf804",130,82,53,17.1698113207547,105,25,3,1
"6153","2b0044bdcc7ce444ac8a558c71ad4ebc",133,87,80,11.6375,133,0,3,3
"6154","2b0146ed48c1a0767f29a6bf72be951a",76,58,19,28,76,0,1,2
"6155","2b02753f1dc9c075ab75d7e317d0e1c5",18,18,0,18,18,0,1,2
"6156","2b0598cfa6459928389e43a0ffcd64a0",5,5,0,5,5,0,1,2
"6157","2b0c9e944e260285fc95cbaf6abaeebb",18,18,0,18,18,0,1,2
"6158","2b0fe1420e4ed69bc691f4767e4d1f4d",209,108,63,23.2222222222222,209,0,3,3
"6159","2b10969b1fd6cc64d9483eb2429a0a39",210,93,88,16.7045454545455,186,24,3,3
"6160","2b11ded996440af4f893c68999e7271a",23,23,0,23,23,0,1,2
"6161","2b14619ba68acb28cf079beed9403bf3",210,123,76,19.3421052631579,210,0,3,3
"6162","2b1539759aa3ae49f7776240626bfb1c",3,3,0,3,3,0,1,2
"6163","2b16bc69fb470e9fef115ee3306536d5",9,9,0,9,9,0,1,2
"6164","2b17ef6eb80d9c81b4f1e2cecfdae983",60,47,10,42,37,23,1,2
"6165","2b1b1644da8ec7b7f86f80a4e35d4a94",5,5,0,5,5,0,1,2
"6166","2b1b390e363eee449d1efedbcad7c62e",50,50,0,50,50,0,1,2
"6167","2b1c7ccc9ab54e5c761d7c18e3a1477d",42,42,0,42,42,0,1,2
"6168","2b252b35d8e447e9dc69994ae984a8ea",29,29,0,29,0,29,1,2
"6169","2b27a9d52687397f703044f11251154e",4,4,0,4,4,0,1,2
"6170","2b29ca01c27996beb8034d39f5460029",123,80,80,10.7625,92,31,3,3
"6171","2b29d51f8994d19cfbb3159a30d6edd4",39,34,18,15.1666666666667,23,16,1,1
"6172","2b2a792d2b4ae6e937d1bafe2f8e831f",125,77,81,10.8024691358025,125,0,3,3
"6173","2b2a83e26f22257ec84629b211385723",30,30,0,30,0,30,1,2
"6174","2b2f311c8372504dc6ea835e12ad7660",48,42,7,48,48,0,1,2
"6175","2b3051e4eb6bc0151bb9c88450b1ffaa",86,72,31,19.4193548387097,86,0,2,3
"6176","2b306429f777e8f087cf2feee889d70b",39,39,0,39,0,39,1,2
"6177","2b316814a108e9e257c35ff62b3a9120",49,41,47,7.29787234042553,49,0,2,1
"6178","2b31ec0874b54db4778fe29b97642113",128,58,74,12.1081081081081,96,32,3,1
"6179","2b325139f4f75947cab2e2734eee335e",8,6,70,0.8,8,0,2,1
"6180","2b330bd782da4a3e416cb74a9704d79a",50,46,8,43.75,50,0,1,2
"6181","2b399d0005d9a55135cee4df09315902",21,18,36,4.08333333333333,21,0,2,1
"6182","2b39d0d70034fba0c6a0aeb159c45be6",46,46,0,46,46,0,1,2
"6183","2b3dbb061db2274371c14498af308ff7",29,29,0,29,29,0,1,2
"6184","2b3f9ec36a17c39c058463483939beff",113,87,42,18.8333333333333,113,0,3,3
"6185","2b419b0957c1d91fb179bc8d6450410a",8,8,0,8,8,0,1,2
"6186","2b47dfadfab04c9c8588ae2fdf6902a0",49,49,0,49,49,0,1,2
"6187","2b484ac1cd245b1646ac610d1c431ed1",60,51,50,8.4,60,0,2,1
"6188","2b4a0e34d66ce4f88b670f509ce34713",162,101,81,14,162,0,3,3
"6189","2b4da4faa0dc63aee46f923d2545e6eb",48,42,36,9.33333333333333,48,0,2,1
"6190","2b4db7197f05a8bded873402c38e6312",36,36,0,36,36,0,1,2
"6191","2b4de2332b4bc29178d62f23c9001c7a",15,15,0,15,15,0,1,2
"6192","2b50ce32b6383e206ba51e2c4877801e",96,73,70,9.6,52,44,2,3
"6193","2b514473e266b5a8ba6d78b927a8d215",64,33,64,7,64,0,2,1
"6194","2b52dadfe18dfeb5af0fff4bbe2dd32c",90,66,37,17.027027027027,90,0,2,3
"6195","2b539cd2d65d076aea4fba849529e869",60,55,36,11.6666666666667,22,38,2,1
"6196","2b57b6e6834b1fd555766af3de95e232",96,50,63,10.6666666666667,96,0,2,3
"6197","2b58454ee4cb980cb97c096a3c50f1d7",52,43,42,8.66666666666667,52,0,2,1
"6198","2b5937e81e675477e3287ac42d79187a",26,22,62,2.93548387096774,26,0,2,1
"6199","2b5975c0bbf834584fca498588aa5803",38,38,0,38,38,0,1,2
"6200","2b5b06fa2edc31335ee651f0915137bb",22,22,0,22,22,0,1,2
"6201","2b5eab6f34599f09fd5ddcde4781abf7",23,23,0,23,23,0,1,2
"6202","2b5f44d6d31bd45e21ede69cbfd1cea1",112,80,86,9.11627906976744,112,0,3,3
"6203","2b5fb2087fb045216c11e3b44030adb1",4,3,49,0.571428571428571,4,0,2,1
"6204","2b6139c1c237fa7c4e894f0fb03f95fd",156,103,38,28.7368421052632,104,52,3,3
"6205","2b661d953e96cef7ed9d0fbb0601bfbe",58,43,62,6.54838709677419,58,0,2,1
"6206","2b667339212dd92ac8bfbcb144ef20a4",62,52,64,6.78125,62,0,2,3
"6207","2b67138462a36fdb4f81309d98a67b24",30,22,23,9.1304347826087,30,0,2,1
"6208","2b67d3456fb5d71ef97ef2edceb0104b",36,36,0,36,0,36,1,2
"6209","2b695c67e1aa417350d3be021315b3a6",19,19,0,19,19,0,1,2
"6210","2b6a828b716b3ca7b30e7c3d87b2d54f",197,116,81,17.0246913580247,197,0,3,3
"6211","2b6beaa5b7483d6c104ce74b519fb195",107,86,32,23.40625,107,0,3,3
"6212","2b6e1d609760b94f5e33e223c22d5163",167,81,74,15.7972972972973,167,0,3,3
"6213","2b6f35528fe07c5116485dbf529ba901",42,42,0,42,42,0,1,2
"6214","2b7054294935b5163f375df9c07ad507",27,27,0,27,27,0,1,2
"6215","2b716c5bbb4854be461cc70a921f7dcf",65,51,54,8.42592592592593,65,0,2,1
"6216","2b72e806103811a8573940998e782af8",174,75,70,17.4,174,0,3,3
"6217","2b75e5b610a8943bae27295c7f2a91a8",9,9,0,9,9,0,1,2
"6218","2b763c0e0c2d08f2896b803d469bf3ff",70,57,46,10.6521739130435,70,0,2,3
"6219","2b7755291a31003aa13e109190d835a7",9,9,0,9,9,0,1,2
"6220","2b7868d1abf1acb9eecb4a1581a5fd57",3,3,0,3,3,0,1,2
"6221","2b7916a2c421134b9ade41fb89b92841",105,66,48,15.3125,105,0,3,3
"6222","2b794d7417eadbeeb0387565e89605c2",1,1,0,1,1,0,1,2
"6223","2b7a3c69d018aaa6603fc60313a1a16c",26,26,0,26,26,0,1,2
"6224","2b7b041a170cdb7d1ae869bc9cc2fae4",28,28,0,28,28,0,1,2
"6225","2b7f371396ea59a152e65340d510cc11",59,51,78,5.29487179487179,33,26,2,1
"6226","2b80dcdb7bac57d6834471eaea647b54",44,33,63,4.88888888888889,0,44,2,1
"6227","2b821d0059226a3f563668455594adc2",12,12,0,12,0,12,1,2
"6228","2b8244dabd72fd3128bc342d63f3afe7",10,10,0,10,10,0,1,2
"6229","2b828345ac7f9c4cc25e52c0e9961c65",24,24,0,24,24,0,1,2
"6230","2b8577a3d2f079db2097ccee70e58441",11,11,0,11,11,0,1,2
"6231","2b85f8c540dc364185badceb94cec76e",38,37,15,17.7333333333333,17,21,1,1
"6232","2b88e91011de91e0a8e768434d4c6e64",99,83,77,9,99,0,3,3
"6233","2b894c45823106ce5160c01372734112",28,28,0,28,28,0,1,2
"6234","2b8a51918a59b0269325a643f60203e9",39,39,0,39,39,0,1,2
"6235","2b8a6bb9222721454b8d873af748da7f",51,48,56,6.375,51,0,2,1
"6236","2b8a91e235e21e14c698ff74ad1970e5",45,45,0,45,45,0,1,2
"6237","2b8c0acc197954ead1e336b2bab7e724",36,30,56,4.5,36,0,2,1
"6238","2b8d058365b03c049530c527b2cfabe5",26,26,0,26,0,26,1,2
"6239","2b8e737fa814efe1bc9ab6a8b4b38512",16,16,0,16,16,0,1,2
"6240","2b8ff60b12cd2ea906111c9573cad73e",137,106,76,12.6184210526316,137,0,3,3
"6241","2b900b827ecf28e7d9318888f5e6cf8d",219,122,89,17.2247191011236,181,38,3,3
"6242","2b9136d8636eb1a25df32b55ff354fa3",50,25,74,4.72972972972973,40,10,2,1
"6243","2b915d1e605050aec3b75b47c03425bf",30,30,0,30,30,0,1,2
"6244","2b971bd829852beba2b1416bcb156a00",89,74,50,12.46,89,0,2,3
"6245","2b98be170b6b118b714253903fe8611d",43,32,43,7,43,0,2,1
"6246","2b9a9ff8158694e13b5f0e6b46fc660a",20,20,0,20,0,20,1,2
"6247","2b9cf7c431520f991cd8801e5f6c8b8f",28,28,0,28,28,0,1,2
"6248","2b9ed0c5529c5bb1e5456033234eacfd",37,37,0,37,37,0,1,2
"6249","2b9f838119ba0728c27be48c35e416e9",75,59,32,16.40625,37,38,2,1
"6250","2ba1bf6e5053e1f7206246b4db42e4e3",33,29,16,14.4375,26,7,1,1
"6251","2ba200477f27b955193db088ecb6eff5",134,93,70,13.4,134,0,3,3
"6252","2ba4f7575d4542cd0123d2241cb384f1",129,101,25,36.12,129,0,3,3
"6253","2ba6b3b3c54d52f424c5a9c758409979",29,29,0,29,29,0,1,2
"6254","2ba7868b659ae99293d6c876008a9738",34,34,0,34,34,0,1,2
"6255","2ba7d46ba576667811f18f2d21b14a0f",97,66,72,9.43055555555556,97,0,2,3
"6256","2ba82223a332edd97cb0559e92a0df60",25,25,0,25,25,0,1,2
"6257","2ba9e6d8f571b938d0c681960396d1d1",27,27,0,27,27,0,1,2
"6258","2babbb2985734d7988ca1bababb2e6bb",56,45,33,11.8787878787879,56,0,2,1
"6259","2bb391ff6542d7eb418ecb2e6f0b6370",155,117,77,14.0909090909091,155,0,3,3
"6260","2bb3f09b1846268073e012f3ebcb8f85",138,85,84,11.5,123,15,3,3
"6261","2bb6fae6b26dc72329fd02f95cb87f4a",15,15,0,15,15,0,1,2
"6262","2bb7bd31fd318a523a2d3462e4f59cd5",98,67,64,10.71875,98,0,2,3
"6263","2bb7e4c80996e33348aed997612f2a8f",17,17,0,17,17,0,1,2
"6264","2bb7f3a03ca1792e0052b346e17e1c36",88,65,41,15.0243902439024,88,0,2,3
"6265","2bba909f8fbd908250fff6bc83e79bbe",15,15,0,15,15,0,1,2
"6266","2bbb5b02e6a1c27f0ffd654df3c3b081",178,113,63,19.7777777777778,156,22,3,3
"6267","2bbbd807e8c6c9e1622390d89a19f994",34,34,0,34,34,0,1,2
"6268","2bbd682424fdca867b7f6929dd084556",80,60,37,15.1351351351351,56,24,2,1
"6269","2bbed04df38ffdf2c6b9a13c711d85b9",49,42,27,12.7037037037037,49,0,2,1
"6270","2bbf3193ce271122eba57da9294cd6f3",34,24,17,14,34,0,1,1
"6271","2bbf358c588e9fcf4457ca7cbf493569",22,16,62,2.48387096774194,22,0,2,1
"6272","2bc1255fe283f6062780ab8b22009a5b",30,26,35,6,0,30,2,1
"6273","2bc1bf256dd65ee5c169681a926f05f0",69,58,49,9.85714285714286,36,33,2,1
"6274","2bc58448045736226128965a9ecf985f",73,41,52,9.82692307692308,73,0,2,3
"6275","2bc5c54400bc76c16f0f6397fad4d21d",46,46,0,46,46,0,1,2
"6276","2bc6c98fd780258eba0d83463940f955",32,32,0,32,32,0,1,2
"6277","2bc783e1da49ec9e5ebec9342c2e5523",107,96,40,18.725,107,0,3,3
"6278","2bc8940ab4a5d2647f139126b52eff3a",42,37,22,13.3636363636364,42,0,2,1
"6279","2bc8a2a872ad8403ff129cff5e7d8a20",140,78,82,11.9512195121951,118,22,3,3
"6280","2bcafe9c77f3fef24857796e74da4a3a",18,18,0,18,0,18,1,2
"6281","2bcbe020c94ff1ba25685cc3da274989",16,16,0,16,0,16,1,2
"6282","2bd322e845cb78b85cd27a148922a862",18,18,0,18,18,0,1,2
"6283","2bd4ca8a638c3f117c48edec54f89205",82,58,67,8.56716417910448,82,0,2,3
"6284","2bd61708f9b943bf390ac08638b15cc9",9,9,0,9,9,0,1,2
"6285","2bd6638220f463fca6b0d90c212a660d",34,27,5,47.6,16,18,1,2
"6286","2bd7591fac009a28b99d5add5df6001d",22,22,0,22,22,0,1,2
"6287","2bd75cf36d4a4ba957fdcd154c98e128",124,73,63,13.7777777777778,124,0,3,3
"6288","2bd7b7895862bd742308eba0e8be847b",3,2,49,0.428571428571429,3,0,2,1
"6289","2bd98c4c9ea3a247eee249755b812c09",42,42,0,42,42,0,1,2
"6290","2bdbf9a0f819b41a21b6ec812bf6717e",17,17,0,17,17,0,1,2
"6291","2bdce5d7952fb881bc07c3cda075be67",139,92,59,16.4915254237288,139,0,3,3
"6292","2bdcf3118cec292572d73dbef226e282",64,49,61,7.34426229508197,26,38,2,1
"6293","2bdd383278b55f40b744b757becca404",103,76,78,9.24358974358974,103,0,3,3
"6294","2bdef1a94a85f3a7662fd5fc8b623427",5,5,0,5,0,5,1,2
"6295","2be014bb1ae54a9372fba45b8f983125",29,29,0,29,29,0,1,2
"6296","2be2b36eb184ec2f216d8a7c5961f586",25,25,0,25,25,0,1,2
"6297","2be35f469671f0650469ab983d396150",48,47,23,14.6086956521739,48,0,2,1
"6298","2be37a1f7cb5e6e9a1cd43f99f5874ca",147,74,62,16.5967741935484,147,0,3,3
"6299","2be41c50cc973e2ddb3b88bca93616da",2,2,0,2,2,0,1,2
"6300","2be7e4aa5e103a1dd509648b242078d2",51,31,63,5.66666666666667,0,51,2,1
"6301","2be7fe4e13203190b6bc26b9ef62de12",204,74,84,17,204,0,3,3
"6302","2be93c3d08aecd6ad6f79b50b6e4ba65",15,15,0,15,15,0,1,2
"6303","2be959ca777f313d2b0513bc1159df06",24,24,0,24,0,24,1,2
"6304","2beb0c0e3a63e427cd7f42dac49e97a6",29,29,0,29,29,0,1,2
"6305","2bed76a2470be74887055453ddeb0aef",62,50,74,5.86486486486486,50,12,2,1
"6306","2befa0f8b853a77105ddcae24e187f11",82,62,63,9.11111111111111,82,0,2,3
"6307","2bf070bc0b509d88779ef7d7a0b2fec0",28,28,0,28,28,0,1,2
"6308","2bf13196f7b0c5998b695f49f0e35e81",20,20,0,20,20,0,1,2
"6309","2bf195096b911a49c3eabea4afa96111",120,58,62,13.5483870967742,120,0,3,3
"6310","2bf7b57288b197686723390bf4ee4cf1",19,19,0,19,19,0,1,2
"6311","2bf82a31e78096d63fc86a7166b0ebca",159,117,81,13.7407407407407,159,0,3,3
"6312","2bfaa1374ef3de99b546b18974fd405f",58,47,63,6.44444444444444,58,0,2,3
"6313","2bfb435bedb321ebfd0dbdc5f4770c51",39,36,26,10.5,25,14,2,1
"6314","2bfbeda170f796f07fe68523acdd2f05",66,55,77,6,66,0,2,3
"6315","2bfc441038ba0676ae4becf3c07e4f9a",5,5,0,5,5,0,1,2
"6316","2bfc48dee057d827441cc5829a7b5a96",9,9,0,9,9,0,1,2
"6317","2bfc6b03ba42fb2a641c35024428762d",18,18,0,18,18,0,1,2
"6318","2c01f94851eae19fc2f690b537156008",104,66,39,18.6666666666667,104,0,3,3
"6319","2c05f1d3ac30289711fd0cad1115704b",30,29,5,42,30,0,1,2
"6320","2c0837db45c1c0caab3155e852f5d625",85,58,45,13.2222222222222,85,0,2,3
"6321","2c0a276d82afe2cbf2a1aa00e82b2bf9",10,10,0,10,10,0,1,2
"6322","2c0c77eb0992bf78b8e01e466f859f70",33,33,0,33,33,0,1,2
"6323","2c0d81912908db995559546edbd320d3",183,95,73,17.5479452054795,143,40,3,3
"6324","2c0eea6fbd7e2d5ba28cb8423550d9d3",118,96,48,17.2083333333333,118,0,3,3
"6325","2c0f21d207073adbbbb4079680ced2a3",133,77,52,17.9038461538462,133,0,3,3
"6326","2c10e649f528356eef5ccfc7ae1603ef",12,12,0,12,12,0,1,2
"6327","2c154e73645294bc25f890d0a7192d71",193,100,70,19.3,193,0,3,3
"6328","2c15a7ae2767bdc63c88ae066bb5ec27",22,22,0,22,0,22,1,2
"6329","2c1774ed3958aef5deabe6babcde1ded",119,78,61,13.655737704918,119,0,3,3
"6330","2c1bf73a8258597ad3695bb9ecf54ad7",174,106,68,17.9117647058824,151,23,3,3
"6331","2c1d50cc7affcb6e598cded82d0d8125",94,68,30,21.9333333333333,52,42,2,3
"6332","2c1dc62bc73fcf419fc43cb32f3bb384",24,24,0,24,24,0,1,2
"6333","2c20f6d29acc8e53801deb5a7f120bce",98,75,58,11.8275862068965,98,0,3,3
"6334","2c2145fae4a5b5b266e001c9fa225dae",121,86,27,31.3703703703704,121,0,3,3
"6335","2c23c006a8a9151307a53b736a79c6b9",9,9,0,9,9,0,1,2
"6336","2c2552a46b7d9e1542baa3922792aedd",30,30,0,30,30,0,1,2
"6337","2c25549b1cba6b0854a104692e556754",40,40,0,40,40,0,1,2
"6338","2c273b1d9b117414643bda8be5864daa",6,6,0,6,6,0,1,2
"6339","2c27f88ad5dfeb3f4debe432c460d581",35,35,0,35,0,35,1,2
"6340","2c2dd4d08d7006080172c3869ca181fb",23,23,0,23,0,23,1,2
"6341","2c2f193691a07b6e9f2fa844dad77b5e",185,67,69,18.768115942029,165,20,3,3
"6342","2c31689f8188e2c9cb41904582433e66",79,48,47,11.7659574468085,59,20,2,1
"6343","2c31eb23db5cbaec1cf2a2cd3f54567d",118,55,68,12.1470588235294,118,0,3,3
"6344","2c3265382de15bf40d320b73bead3c12",42,40,55,5.34545454545455,42,0,2,1
"6345","2c338c53e4675fc871f6109a455d9e0a",56,50,14,28,56,0,1,1
"6346","2c354d3c9e15388a606c305f6ca8301d",133,26,84,11.0833333333333,127,6,2,3
"6347","2c35aef97b78cd5a78871d5e8450809a",37,37,0,37,37,0,1,2
"6348","2c389df13f348802f34601c1b3c1650b",74,34,81,6.39506172839506,50,24,2,1
"6349","2c38a222910c827edd162dedd887ff33",14,14,0,14,14,0,1,2
"6350","2c390521a5e0fe7926fc65cfc3cde235",33,33,0,33,33,0,1,2
"6351","2c39db007aa5d79e1df3d4e7401102f5",64,49,62,7.2258064516129,40,24,2,1
"6352","2c3e63061b567bcc68353879b3b4c733",56,48,30,13.0666666666667,56,0,2,1
"6353","2c4083404039be74c396a3fe4247f9f1",94,69,71,9.26760563380282,81,13,2,1
"6354","2c465ca1776eb95ffc528ddfa62b770d",184,71,78,16.5128205128205,130,54,3,3
"6355","2c494ef16c2fb3d4bcb5a2e8a85077a5",34,34,0,34,34,0,1,2
"6356","2c4a1f3801603e88f08f34d6315b0328",44,39,88,3.5,44,0,2,1
"6357","2c4af36df20974187358e8b184145f41",78,59,63,8.66666666666667,78,0,2,3
"6358","2c4b6dc87de48c4de006066cc83c04e5",29,29,0,29,29,0,1,2
"6359","2c4ce71eb3f39937e8a5b1ed657642e8",39,39,0,39,0,39,1,2
"6360","2c4d0dc5db430aad4b06c4ed7fa66fc1",150,75,71,14.7887323943662,150,0,3,3
"6361","2c4d13f7b6c0e29128bb8bc0b9940889",19,19,0,19,19,0,1,2
"6362","2c504a2b4a79d6118f63b00dff893c86",84,47,77,7.63636363636364,84,0,2,3
"6363","2c520a455a31ebc5c32da7925ce767e9",100,59,79,8.86075949367089,82,18,2,1
"6364","2c545122d4f3f293d82895bd619f828e",36,18,55,4.58181818181818,36,0,2,1
"6365","2c55aa058daae731e5543de7f8a4dce1",25,25,0,25,0,25,1,2
"6366","2c5d8dae43616957a14eb3453b1891eb",170,92,63,18.8888888888889,170,0,3,3
"6367","2c5f1b5c175dee4135c02c8ef1d55737",64,52,34,13.1764705882353,64,0,2,1
"6368","2c5f4402f63aa17006f2bc9ac428354b",18,18,0,18,18,0,1,2
"6369","2c5fb2f246d7f133344116b532f6c85f",181,102,50,25.34,181,0,3,3
"6370","2c602177d7fd3739597794c479ee6110",75,52,83,6.32530120481928,58,17,2,1
"6371","2c60af6be3a3fccb4d2c184bc3224f95",129,74,73,12.3698630136986,129,0,3,3
"6372","2c652b1ae7f5a415b9e2a554ac7fcd97",29,29,0,29,29,0,1,2
"6373","2c65b0b07ced5abd942f6239c2462d19",61,54,39,10.9487179487179,61,0,2,3
"6374","2c668ed8774329835f33797b18b64904",45,39,19,16.5789473684211,45,0,1,1
"6375","2c684d2af799bad9e5268a12518802bd",5,5,0,5,5,0,1,2
"6376","2c6a16b1175ccd8778ea24afe3b2a0bc",42,42,0,42,42,0,1,2
"6377","2c6a2ee04fa9aa98d0ff84d758464ca9",65,44,44,10.3409090909091,65,0,2,1
"6378","2c6a839c6423f2b91c7e24a9797e05b7",28,28,0,28,0,28,1,2
"6379","2c6abd99360026256f735a64d9df3adc",152,76,53,20.0754716981132,152,0,3,3
"6380","2c6f754e0d39923babca87213081ec7f",43,38,78,3.85897435897436,43,0,2,1
"6381","2c72ead245484c38b3198492ba1d0c88",27,19,62,3.04838709677419,27,0,2,1
"6382","2c74b8048b8ea4e5703493c57f308aa1",142,93,58,17.1379310344828,111,31,3,3
"6383","2c74e3509a7fd463ca086b48488fd065",9,9,0,9,9,0,1,2
"6384","2c77f845806e55bfd7f48559d24bdcc3",46,26,81,3.97530864197531,46,0,2,1
"6385","2c78256ed9660db766324c1dedf39803",40,40,0,40,40,0,1,2
"6386","2c788b44fb95129311d4ba7272f0b06f",30,30,0,30,30,0,1,2
"6387","2c78dec2181a66df9dbef841950bf006",11,11,0,11,11,0,1,2
"6388","2c793f2f3f945ec449777fea32bd879e",23,23,0,23,0,23,1,2
"6389","2c7d0bd7c974ad3fc7f5fbca50cbd701",10,10,0,10,10,0,1,2
"6390","2c7d2b2a9d67f9c671ef18e4217fd1f6",53,40,84,4.41666666666667,53,0,2,1
"6391","2c7d71eb53d85901a00db4b3b8784cff",25,25,0,25,25,0,1,2
"6392","2c7f8919b4aeb27367d476f7555dcc97",130,83,63,14.4444444444444,130,0,3,3
"6393","2c81141f793d81c7c2bd4d81d36e14d1",30,30,0,30,30,0,1,2
"6394","2c8330b679c5b1655d29895580f4565f",114,59,77,10.3636363636364,114,0,3,3
"6395","2c8a2712553cd1b0df640040e5c13030",33,26,14,16.5,0,33,1,1
"6396","2c8cf246f2d9531beb562e49c4853b6b",56,43,32,12.25,43,13,2,1
"6397","2c8f3748327e3dd652c55f4fe8ca76f8",37,37,0,37,37,0,1,2
"6398","2c9371c7954560feab3d978c19c2e13f",22,22,0,22,22,0,1,2
"6399","2c988881fafa33fbdce980cfd242b067",3,3,0,3,3,0,1,2
"6400","2c9a9699c6f625fa4d1e9eaf2fef082e",49,22,35,9.8,49,0,2,1
"6401","2c9b7004d92604a0fdbc9e702080ad4e",17,12,47,2.53191489361702,17,0,2,1
"6402","2c9e7417124113dd3a9f3c03eb19c4cb",167,98,88,13.2840909090909,167,0,3,3
"6403","2c9e9548a39b030bec25a9a99049065c",43,37,22,13.6818181818182,43,0,2,1
"6404","2c9ee491b8f859ef0212d630f7a7abc0",112,71,56,14,112,0,3,3
"6405","2c9ee73dc809bbd8e49b50409d8d4cbf",38,38,0,38,38,0,1,2
"6406","2ca309df1bad0566e6a5a78cfb3d1b1c",101,74,30,23.5666666666667,84,17,3,1
"6407","2ca61c4f886b38008bab04816963cc05",85,76,33,18.030303030303,85,0,2,3
"6408","2ca62a1fded73530d9a5d315d97f5a19",146,105,83,12.3132530120482,98,48,3,3
"6409","2ca7dd4bfd82541b6cb926c6fc83999c",174,128,61,19.9672131147541,174,0,3,3
"6410","2ca7ef176b5a2eaeafb3f0d2e39737dc",247,117,57,30.3333333333333,208,39,3,3
"6411","2ca8b1b92713a13a57a5cf575d42c50a",23,23,0,23,23,0,1,2
"6412","2caa436573062a0ea11151a8938f399c",49,38,47,7.29787234042553,22,27,2,1
"6413","2cad84bbffc43a496ffb0675ce8ce6f8",58,43,60,6.76666666666667,28,30,2,1
"6414","2cb094cd6be22ba204615b94e60d4ca9",34,34,0,34,0,34,1,2
"6415","2cb148848a00f844cdcf6dc477fd96d3",1,1,0,1,1,0,1,2
"6416","2cb18b81a28faed8457c48427e7053ab",146,84,76,13.4473684210526,98,48,3,3
"6417","2cb5f4caf0e10391e37be086e9f174ed",98,69,49,14,98,0,2,3
"6418","2cb9dbe44d11ba2dd5632bebd89b4f66",11,11,0,11,0,11,1,2
"6419","2cba462a9ac4bd26d469ef23d9e4355d",42,42,0,42,0,42,1,2
"6420","2cbb4cde766764ca3515ba507c9ec528",133,107,59,15.7796610169492,133,0,3,3
"6421","2cbf21b4cca7df960e14c00f1404923d",96,68,61,11.016393442623,96,0,2,3
"6422","2cc4b4a1ee171e23b8d2cb56acdd378f",58,39,24,16.9166666666667,32,26,2,1
"6423","2cc570970817601b49dda50548a681f0",56,46,72,5.44444444444444,51,5,2,1
"6424","2cccd1a5f6a3d2420cc0e6ceeb1e8523",35,35,0,35,35,0,1,2
"6425","2cce70ff9930bd28185af00c56d8e2eb",52,52,0,52,52,0,1,2
"6426","2cd2aacdf3ecaa701c95fc5149305605",21,21,0,21,0,21,1,2
"6427","2cdb0b7adaf356b1a81455fff1428276",30,30,0,30,30,0,1,2
"6428","2cdc20586e3ae9bc04297d5d3de873bf",20,15,12,11.6666666666667,11,9,1,1
"6429","2cdc39c70af025eb87a60cc897ba12c9",138,103,42,23,138,0,3,3
"6430","2cddd7aeb12ad9a3b3102435b925fbd7",99,68,72,9.625,72,27,2,1
"6431","2cde92b34186990b37f96047840270ab",98,54,60,11.4333333333333,69,29,2,1
"6432","2cdfbe81954b937b682499c50ab554ed",122,56,82,10.4146341463415,122,0,3,3
"6433","2ce08081c5be03d07343b81ae3eb8b03",24,20,35,4.8,24,0,2,1
"6434","2ce91fde0461028eda44794772e0d10c",46,46,0,46,46,0,1,2
"6435","2cec92df8c2ac6dd21983619c57b942b",73,55,35,14.6,37,36,2,1
"6436","2cecbeb0fc5c0af0ca447e2dc774a0f2",23,23,0,23,23,0,1,2
"6437","2cf010aede228034559813e4af71b111",135,86,68,13.8970588235294,135,0,3,3
"6438","2cf1a991063a0037613edd8e0a7d3e41",51,39,56,6.375,51,0,2,1
"6439","2cf24a844fe16fe936ac577a1f21bf31",27,27,0,27,27,0,1,2
"6440","2cf2d6a0ebf89bf1f9a041198449b66f",59,51,51,8.09803921568627,59,0,2,1
"6441","2cf3a137abf9748b34c0abef99f48261",34,28,31,7.67741935483871,34,0,2,1
"6442","2cf47491ad186224d9589b28f64cd212",59,41,26,15.8846153846154,59,0,2,1
"6443","2cf5af98682154194e9097ccf022b64b",38,38,0,38,38,0,1,2
"6444","2cf970532b7e76d2ad367dcb981816c2",127,66,70,12.7,110,17,3,1
"6445","2cf9a916930e32963218540861b402bd",48,48,0,48,48,0,1,2
"6446","2cf9b87b6d1d010eaa2b88ad0584a06b",11,11,0,11,0,11,1,2
"6447","2cfa03650840787c69f3a23b4c9e4b67",114,79,76,10.5,94,20,3,1
"6448","2cfab67ab81ee67a56e6f491fdb253b6",34,34,0,34,34,0,1,2
"6449","2cfb103a32100f7785d777cde10e6a4a",30,30,0,30,30,0,1,2
"6450","2cfece141f69d6122ac33a3ad791b570",24,24,0,24,24,0,1,2
"6451","2d01900b277a7f1e5ff1d885cf7adae5",41,33,56,5.125,41,0,2,1
"6452","2d01f6c105b19b318b05de128fba7bef",147,83,62,16.5967741935484,147,0,3,3
"6453","2d04207446f9666eaaf84e2e627b3853",75,59,12,43.75,47,28,1,2
"6454","2d0630f5454ee3e12d3a32564702c2b0",18,18,0,18,18,0,1,2
"6455","2d063a8d6f6f651a83211a5c9959b8ed",34,29,71,3.35211267605634,34,0,2,1
"6456","2d06567598e16a99702fe20bd3065752",10,10,0,10,10,0,1,2
"6457","2d070648fe28f018955c87d46541cc15",52,39,59,6.16949152542373,22,30,2,1
"6458","2d07414594619126d13ef700a1ada36a",43,28,6,50.1666666666667,43,0,1,2
"6459","2d0842b5419f096583d985eb50959bb2",11,11,0,11,11,0,1,2
"6460","2d09ae9aa716ddda0c8c07b407cce692",128,81,70,12.8,128,0,3,3
"6461","2d0b0b4e9bdc473262a024a46ccc2d44",29,29,0,29,29,0,1,2
"6462","2d0d39766a84632ac61b492b8dff6bee",18,14,46,2.73913043478261,18,0,2,1
"6463","2d106a92ad06427ddcf330ac58a849bb",126,100,75,11.76,126,0,3,3
"6464","2d120154a11a46aac73ab7e3652d45d5",34,34,0,34,34,0,1,2
"6465","2d136ffe02535b685a3cbed501f6d803",25,25,0,25,25,0,1,2
"6466","2d16f0e26e66e8c43811738fc214921c",36,31,37,6.81081081081081,36,0,2,1
"6467","2d172507f8f900e4f12499acbfad3188",9,9,0,9,9,0,1,2
"6468","2d1761dba3a70d2fc7c990e0b1762cf0",36,36,0,36,36,0,1,2
"6469","2d178f6d75d0ae9607da7d1e3e9a5d7b",113,85,79,10.0126582278481,113,0,3,3
"6470","2d1a43b67b802b982a51baf5f9d27dd4",50,35,63,5.55555555555556,50,0,2,1
"6471","2d1f2393972a86580126cce087eb2fd4",185,114,60,21.5833333333333,133,52,3,3
"6472","2d2104909c67bb4c0ba07ac0df0fb807",51,47,22,16.2272727272727,51,0,2,1
"6473","2d24acd4690aaac4b3491144e28c3cb6",19,19,0,19,19,0,1,2
"6474","2d268f8c854b5c0ad9e6fda268c70c5c",6,6,0,6,6,0,1,2
"6475","2d2994e6269bcd976e6428108691d50b",14,14,0,14,14,0,1,2
"6476","2d2aff534b35540154766cc6311bf37b",64,56,68,6.58823529411765,42,22,2,1
"6477","2d2b0b58c626440266e729d85b82ea00",32,32,0,32,32,0,1,2
"6478","2d2e0c431efcc795f02670a130c4974b",33,33,0,33,33,0,1,2
"6479","2d2ecd0b23709653249cc0105d32299d",17,17,0,17,17,0,1,2
"6480","2d2f81b4e17f116447a3ed23df794338",137,87,56,17.125,137,0,3,3
"6481","2d2f83657f0b336f5fe31c26d5993a0a",10,10,0,10,10,0,1,2
"6482","2d30fb1d257aecbe1dfaa50fd99215e6",12,9,64,1.3125,12,0,2,1
"6483","2d320fe9a83f6c9c6003f0e5d0e7fad2",75,58,45,11.6666666666667,75,0,2,3
"6484","2d336a39cfe980017fc9b5384f83f682",169,82,73,16.2054794520548,169,0,3,3
"6485","2d33b60e267816a22495cb5cf81d416a",59,52,11,37.5454545454545,59,0,1,2
"6486","2d35f53047e6041a1613dc3742894365",85,54,35,17,85,0,2,1
"6487","2d390f3d6cf1596e37888325df79506b",26,26,0,26,26,0,1,2
"6488","2d3c8c8405bf0839502dd760e326349a",44,37,50,6.16,44,0,2,1
"6489","2d3d4029e5150367b7c8b60815d56991",120,88,55,15.2727272727273,120,0,3,3
"6490","2d3db5b0be172988da985c4b625ed290",112,47,37,21.1891891891892,88,24,2,1
"6491","2d3dc07526e2001a17f2dfa677c49c14",16,16,0,16,16,0,1,2
"6492","2d3ef927939b5377e021b8d5f4be373a",34,34,0,34,34,0,1,2
"6493","2d45c75e0dd1aae3739e152ba3a8583c",33,33,0,33,0,33,1,2
"6494","2d46dcd000cfe8975f3efe75ed2046d2",40,26,50,5.6,40,0,2,1
"6495","2d4caf7120ef5e1599df3037d85a5291",63,55,57,7.73684210526316,63,0,2,1
"6496","2d4e09c9e876e68959ecdb26bd9c12af",52,42,67,5.43283582089552,52,0,2,1
"6497","2d5091675d15b944fb093f6a61c8ce85",183,97,78,16.4230769230769,144,39,3,3
"6498","2d53d16635aea276039b550a2f49a20f",208,128,85,17.1294117647059,208,0,3,3
"6499","2d54b04c02e31619fdbbbf1f48e78955",19,19,0,19,0,19,1,2
"6500","2d55c05af14a1751985934be0d828302",32,32,0,32,0,32,1,2
"6501","2d56d23cf6d3cd8b749aa8016471d99d",26,26,0,26,26,0,1,2
"6502","2d57c1415674943dc235221026ceb3d0",23,23,0,23,23,0,1,2
"6503","2d5a9267cdde053f3004ba72eb0a96cd",7,7,0,7,7,0,1,2
"6504","2d5c83305910a7b9f3abf53c7d7a5626",79,49,68,8.13235294117647,55,24,2,1
"6505","2d6331e4cd3ef940abc979a0eafcc97e",112,88,60,13.0666666666667,112,0,3,3
"6506","2d667dad60564b073c989ca5294f4a68",78,57,53,10.3018867924528,63,15,2,1
"6507","2d66c170cc3c197aac62d8876795b563",21,21,0,21,21,0,1,2
"6508","2d67e1210c8ba2fa4a0c78437ff9c206",79,71,51,10.843137254902,79,0,2,3
"6509","2d6a729b79174ebff2b9bc0ef096757a",53,44,14,26.5,53,0,1,1
"6510","2d6b62d478183d197a5175b280dbd229",128,73,53,16.9056603773585,90,38,3,3
"6511","2d6f01f55bfcba19aee40afbbe0e4e94",178,88,61,20.4262295081967,178,0,3,3
"6512","2d7192f0b4587a8cc90cfbc1d365a143",94,76,27,24.3703703703704,94,0,3,3
"6513","2d71f0d941689f11ae6ba843d165cf25",42,33,65,4.52307692307692,25,17,2,1
"6514","2d7401d591d296baf59b445dbd48ed27",123,79,68,12.6617647058824,123,0,3,3
"6515","2d7549afd26f96f93d7fb5acee17b339",206,121,66,21.8484848484848,206,0,3,3
"6516","2d79f5e87e50e6601f73a422c647628a",18,18,0,18,0,18,1,2
"6517","2d79f846a5dd974c73d6a62e8376734c",118,98,51,16.1960784313725,63,55,3,3
"6518","2d7ab7472b542ae5a8d03a309f1e40ab",10,10,0,10,10,0,1,2
"6519","2d7ae4fbc310dbe5ea586fbf6a153e78",6,6,0,6,6,0,1,2
"6520","2d7b4320c2e414d711ac78e5668ebae8",159,80,73,15.2465753424658,124,35,3,3
"6521","2d7b4a7b7184a12abb67b31869bfcec5",69,50,13,37.1538461538462,69,0,1,2
"6522","2d7eae4ebda4279d75bcddc38d66257e",55,48,32,12.03125,55,0,2,1
"6523","2d837ebcf888aff9312266af697efbf1",66,52,32,14.4375,66,0,2,1
"6524","2d8434e0490f51ac14f2980e6a33870b",28,19,49,4,28,0,2,1
"6525","2d86b7d735af51da01df3aab38a61bb5",207,92,83,17.4578313253012,170,37,3,3
"6526","2d8b190b005a46126e89c309023d233f",23,23,0,23,23,0,1,2
"6527","2d90b04579285a9c692408c969680d5f",50,26,72,4.86111111111111,18,32,2,1
"6528","2d91dd436b4a1de5439fabc326772c57",44,44,0,44,44,0,1,2
"6529","2d92f25a757e56d1f5c594feef1383b9",32,32,0,32,32,0,1,2
"6530","2d94ecc9024e0b7ca880cbf64bf4e1ff",40,40,0,40,40,0,1,2
"6531","2d97982fa6d1f2358fcae991f3e69e63",100,80,49,14.2857142857143,100,0,3,3
"6532","2d98b8548183859072a6ab589643fa34",50,45,42,8.33333333333333,50,0,2,1
"6533","2d9b54cdcc9b6d639cfd4d9c7ec6fcb2",31,31,0,31,31,0,1,2
"6534","2d9ea2596d798435d51e16108c15773c",32,25,47,4.76595744680851,32,0,2,1
"6535","2d9f9f67aa63761ce78df1f3e1f0de65",47,47,0,47,47,0,1,2
"6536","2da2344463ef2934a71b1f39ebbe4266",110,51,76,10.1315789473684,110,0,2,3
"6537","2da3f7eb3854231edae891623cf97786",4,4,0,4,4,0,1,2
"6538","2da5083f6532d81228da310148fcfbd8",28,28,0,28,28,0,1,2
"6539","2da7df9e9f418631a5e75d9af2d00156",56,56,0,56,56,0,1,2
"6540","2da87adc3647b18fe9716ab5c6b93682",29,29,0,29,29,0,1,2
"6541","2da9bb10b0e1cd9214bec6f1fa1aa883",60,43,28,15,60,0,2,1
"6542","2daabaa668de64d09844b2a0488b7db6",244,113,70,24.4,199,45,3,3
"6543","2dafe4fc0bf2213b0c06adeedd4d854c",51,38,77,4.63636363636364,51,0,2,1
"6544","2daffd845466b06e327a5043f69705a5",117,81,70,11.7,89,28,3,1
"6545","2db045c7f9c646dc68bc516336dc0be9",23,23,0,23,23,0,1,2
"6546","2db23db8273ef73584074c521d450d71",71,54,34,14.6176470588235,34,37,2,1
"6547","2db2a3999675fb87446c4a21a9bd75cd",51,33,62,5.75806451612903,51,0,2,1
"6548","2db385a9ec74d289b88cc2eeb55429cc",17,17,0,17,0,17,1,2
"6549","2db3e775c194b890e021d4f75d1baf4a",25,25,0,25,25,0,1,2
"6550","2db47275bf60dd4116bef7830f655069",76,58,64,8.3125,50,26,2,1
"6551","2db881665f2584d65917698310c6fa7c",45,43,31,10.1612903225806,45,0,2,1
"6552","2dbac034c92aac30fce488b2ff2b0b29",182,80,84,15.1666666666667,182,0,3,3
"6553","2dbb6735c81537950641052c2fab01bb",94,83,84,7.83333333333333,94,0,3,3
"6554","2dbc2ae3965480c3b4b84175333be2ec",13,13,0,13,13,0,1,2
"6555","2dc1197bec658dac795e8b5b6aca8bbc",62,48,72,6.02777777777778,27,35,2,1
"6556","2dc1d169f56e464f4b53d418c89d058d",33,28,35,6.6,33,0,2,1
"6557","2dc251aa32be4d4e12bd0f976dddbd76",86,49,70,8.6,86,0,2,3
"6558","2dc57d63c42b2504af78dfbe99f0f867",17,17,0,17,17,0,1,2
"6559","2dc69b333ba0fbff0130c8088ed70779",26,19,36,5.05555555555556,26,0,2,1
"6560","2dc6ca36eca7e50961b508428cf62445",15,15,0,15,15,0,1,2
"6561","2dc75a465a0d0d187d81acd017efddfc",33,33,0,33,33,0,1,2
"6562","2dc8e403214eb152f406ac9bcffc7add",30,30,0,30,30,0,1,2
"6563","2dca5d2165a3fc767e8cf15ad8c320e9",4,4,0,4,4,0,1,2
"6564","2dcec0dfe0791159921c6596dfc41979",21,21,0,21,21,0,1,2
"6565","2dd10a17a61d59eed81afadd05679aae",46,41,22,14.6363636363636,19,27,2,1
"6566","2dd2ffcb596f3ebb840e6799242eba38",49,49,0,49,0,49,1,2
"6567","2dd386e00ae742374f1ac6e8b47c3875",17,17,0,17,17,0,1,2
"6568","2dd465fd48c03fecc36199a9d7d9704e",127,80,62,14.3387096774194,89,38,3,3
"6569","2dd6ee6b647a5c3d3fc7ba77472a59ea",76,61,35,15.2,76,0,2,1
"6570","2dda05a0f6c9f8e4047e65c8b39b5073",33,33,0,33,0,33,1,2
"6571","2dda9fa92569908b03ff0eeb8413c7c2",26,26,0,26,0,26,1,2
"6572","2ddafd765632bf527a9b1d1f8f8528ac",40,40,0,40,40,0,1,2
"6573","2ddc550213d50e10f8d91b365fc64e3f",24,24,0,24,24,0,1,2
"6574","2dde71addeeb26f4da342440f13aa096",32,32,0,32,32,0,1,2
"6575","2de20f764788f6bf280cd0759dcfcff3",16,16,0,16,0,16,1,2
"6576","2de3c23f5c2fffad838586eb11a01e5b",47,38,29,11.3448275862069,47,0,2,1
"6577","2de5471adcb6787e9237b1db6f239d11",55,51,14,27.5,0,55,1,1
"6578","2de89535be9eddcecf31383f4e580689",24,24,0,24,0,24,1,2
"6579","2debf8891a6a802733df145b5c424680",140,110,41,23.9024390243902,101,39,3,3
"6580","2decddc5dd4357d52b5ce7eecc82e8c7",71,29,72,6.90277777777778,71,0,2,1
"6581","2ded20059c8fae5f0e511a7f7ef2f7f5",50,41,41,8.53658536585366,31,19,2,1
"6582","2dede139cab26211bcc9851b53b961ee",32,32,0,32,32,0,1,2
"6583","2dee94d7413fad120912380db99887fc",26,26,0,26,0,26,1,2
"6584","2df13c2ebb3874a22e7f50c51e17de7e",202,93,73,19.3698630136986,202,0,3,3
"6585","2df3f43366be7524c30d120884a2730e",62,43,62,7,46,16,2,1
"6586","2df5e911d16c4ff0d2347c85c1f0d2b4",43,33,44,6.84090909090909,43,0,2,1
"6587","2dff7b167b8ae3f6121d032084b5fb4f",25,25,0,25,25,0,1,2
"6588","2e0248495bcc3874e12ec067d6ebc9fd",192,91,88,15.2727272727273,192,0,3,3
"6589","2e075c49536c10b033292e86c319f849",24,22,53,3.16981132075472,16,8,2,1
"6590","2e0b413c2168ad4b7898d856a55c1041",78,57,30,18.2,42,36,2,1
"6591","2e0ba53b6268cd0a98d7ca7838999def",18,18,0,18,18,0,1,2
"6592","2e0ff4ab721f702956dc29bb800b15ca",116,100,20,40.6,116,0,3,3
"6593","2e10c9baaa4000740dac5a5beff1f83a",110,65,87,8.85057471264368,110,0,3,3
"6594","2e10e3e736f8c6f9aeab49865c4287ae",16,16,0,16,16,0,1,2
"6595","2e13aa79d6aaf0b5e964ae202af2f0e1",19,19,0,19,19,0,1,2
"6596","2e153e263e83b638c21888e70530b01a",69,56,64,7.546875,69,0,2,3
"6597","2e16d019712cafa6f1e067f1b7783118",66,57,12,38.5,66,0,1,2
"6598","2e1bb9162fad5817058f12ad846a7ed1",79,65,26,21.2692307692308,30,49,2,1
"6599","2e1c663a0247e249398936c1046eac36",48,27,56,6,48,0,2,1
"6600","2e1ebf6ae46c3c99c3c564511d71a109",114,59,82,9.73170731707317,101,13,3,1
"6601","2e20a01279a08b40a5a812081cb4a21f",16,16,0,16,16,0,1,2
"6602","2e235e3297bf98ad611f879923b6a59e",78,55,60,9.1,78,0,2,3
"6603","2e238065893ac92524558a8a963fadd3",25,24,25,7,25,0,2,1
"6604","2e2a851cce2dd3fc4ad0925082f00cf7",52,52,0,52,52,0,1,2
"6605","2e2bb3d73d71911ae3d5b8d09703de90",51,41,59,6.05084745762712,51,0,2,1
"6606","2e2c8cc41675b6a5de4616cadc987e35",2,2,0,2,2,0,1,2
"6607","2e2fc236e2f26f23da51cd5f0ac50882",30,30,0,30,30,0,1,2
"6608","2e3217c6eefad3026f6ffc744c003d18",9,9,0,9,9,0,1,2
"6609","2e3304b9b6a08a1e6f27f2d74901b945",15,15,0,15,15,0,1,2
"6610","2e3b1ee6dc29c5196a5d1fe88118fb53",12,12,0,12,12,0,1,2
"6611","2e3cb8dba06fa4d0ae336446679ba265",70,57,78,6.28205128205128,70,0,2,3
"6612","2e3e850bda88c45c121f0b4ad40ccffb",153,96,78,13.7307692307692,153,0,3,3
"6613","2e40729516b16c0fa44206cfe64a4ff9",175,109,74,16.5540540540541,175,0,3,3
"6614","2e40b1c13353e196711025f298f53042",7,7,0,7,7,0,1,2
"6615","2e41827d54de1a3375f7aec7952adde3",16,16,0,16,16,0,1,2
"6616","2e41bef31366312a0a5c263aff7c78c6",51,40,28,12.75,51,0,2,1
"6617","2e429bb4a0030c53665688c827ac99d4",36,36,0,36,36,0,1,2
"6618","2e446a9f1129bcb75bdd89e664527d05",27,27,0,27,0,27,1,2
"6619","2e47fdbd22a86c0f6f2a3d2b7ebc2b50",109,79,76,10.0394736842105,109,0,3,3
"6620","2e49673b408219477ddf5722ec5cddaf",118,72,53,15.5849056603774,118,0,3,3
"6621","2e4bb2b47229bd452f5ff1209292dc4b",51,29,52,6.86538461538461,51,0,2,1
"6622","2e4bc08627b01a6d02a4328d7d7c6590",68,27,90,5.28888888888889,68,0,2,1
"6623","2e4e1d32a115bab6454253dc3bd38208",22,22,0,22,22,0,1,2
"6624","2e4ef8192ca289589583d91a96241f1c",38,38,0,38,38,0,1,2
"6625","2e4fdbe1e0539373bfce3ca4035110b8",232,92,75,21.6533333333333,205,27,3,3
"6626","2e50f41dedbb0d0da4806613cd56ccb3",127,97,25,35.56,127,0,3,3
"6627","2e51e5e82613d4d38e827f9bbc6fbe80",2,2,0,2,2,0,1,2
"6628","2e5b43a9cd230849210dd81c7b4c95d5",84,68,69,8.52173913043478,84,0,2,3
"6629","2e5c99a3492577ba3f0db49409505357",32,32,0,32,32,0,1,2
"6630","2e5fb21ac7abbf0dde40a7b04bd19e9c",21,21,0,21,21,0,1,2
"6631","2e6c34ccee8d2fac8dcf28c970f7a80f",47,39,42,7.83333333333333,0,47,2,1
"6632","2e6ccda2ffae5f730deeccdb4fbd947d",15,15,0,15,15,0,1,2
"6633","2e71007040d707548abad6c1ff4c4b93",21,21,0,21,21,0,1,2
"6634","2e7253a2f6146ee1fb9bb441a068b5f6",183,131,58,22.0862068965517,183,0,3,3
"6635","2e72dcd36cc156d0bd02c0e0ea9a6ef1",70,60,14,35,70,0,1,2
"6636","2e73b0ef0822dfa7e2eaf96988293a1e",37,37,0,37,37,0,1,2
"6637","2e7668efdb48dd07d6c54b2226a3ca65",21,21,0,21,0,21,1,2
"6638","2e76c02ae08f93b943e017146a10d37e",31,21,58,3.74137931034483,31,0,2,1
"6639","2e791666da4db0169ef8c7ef52f61b23",81,67,54,10.5,81,0,2,3
"6640","2e7986fc082a7de54e9f57140bccf091",16,15,13,8.61538461538461,16,0,1,1
"6641","2e799ffd52143fbd186c7fd728fcc2da",72,62,63,8,28,44,2,1
"6642","2e7aa4517fd4dea580c9f39fa07a2270",5,5,0,5,5,0,1,2
"6643","2e7c225ac20f96e85a873eabac606cb8",18,18,0,18,18,0,1,2
"6644","2e7c6ac9f8ca6db4fea873e47b12071b",144,78,55,18.3272727272727,106,38,3,3
"6645","2e7f36078664840f6b713c0b1909e99d",18,16,14,9,18,0,1,1
"6646","2e80ec1ac6a96eb127e70af36f051535",74,45,64,8.09375,47,27,2,1
"6647","2e835d2be06872e04433cd565bf3f82e",94,73,63,10.4444444444444,94,0,2,3
"6648","2e8469f5bae592af17537f0150eb940b",1,1,0,1,0,1,1,2
"6649","2e853b33a18431353704f38bc3248562",104,64,77,9.45454545454546,77,27,2,1
"6650","2e856a6bdc722834a6ae3e395c164776",29,29,0,29,29,0,1,2
"6651","2e86456987baf3f822884d424e994827",1,1,0,1,0,1,1,2
"6652","2e883d695c5d7752fda10938c1a5a39f",33,33,0,33,33,0,1,2
"6653","2e88d5cd73d5b3f32587e38d6ba04f9a",57,47,45,8.86666666666667,57,0,2,1
"6654","2e8c52da3fd9ea639ea349af3241e6cc",113,86,87,9.0919540229885,113,0,3,3
"6655","2e8ca782a6b8434f2597392f63054249",50,35,52,6.73076923076923,34,16,2,1
"6656","2e8d761e9e312853e8c6de3e66a238c6",10,9,3,23.3333333333333,10,0,1,2
"6657","2e92360dba71c2bca29f210a2260f244",78,65,68,8.02941176470588,78,0,2,3
"6658","2e94ef0e24253cc918e8b8e29d51e3c8",61,50,60,7.11666666666667,61,0,2,3
"6659","2e9738c312fe2b6aff669fffd84cc034",98,63,63,10.8888888888889,51,47,2,3
"6660","2e975ddcce1e5155f23d5b06cf34f1d0",68,57,79,6.0253164556962,68,0,2,3
"6661","2e993b0c0e109b2b058ebbd7ebc10548",17,17,0,17,17,0,1,2
"6662","2e9b2b25de8ce81a6071eb4cc21220c5",47,17,72,4.56944444444444,47,0,2,1
"6663","2e9e4e6461271eb748ad0ea6ac5e0e0e",64,42,46,9.73913043478261,64,0,2,1
"6664","2ea0a9cb1ede19675d7d90c37aa5adc6",22,22,0,22,22,0,1,2
"6665","2ea264a16e71b73e20459d97480e8dea",56,43,28,14,56,0,2,1
"6666","2ea4aabd3ce0cb5b0e017d1800cdce97",25,23,89,1.96629213483146,25,0,2,1
"6667","2ea949d57e05c9d28823039bd3eb4125",34,34,0,34,34,0,1,2
"6668","2eab9b3de70567c6bc3017dd59bc29c5",53,35,25,14.84,53,0,2,1
"6669","2eadeab1796d2b3db4769df5c1d9fdd7",42,35,31,9.48387096774193,23,19,2,1
"6670","2eadf0c243c35bf04e4294f30d2aa149",32,32,0,32,32,0,1,2
"6671","2eae90532fa1bf18240748ff19bf2db3",46,37,33,9.75757575757576,46,0,2,1
"6672","2eafe0ec0d0d96e2b031f774addec7ee",98,39,56,12.25,98,0,2,3
"6673","2eb2daad362aff7c01d782dc6427fa80",102,61,51,14,102,0,2,3
"6674","2eb56840a2645dd5ca1ef47845d0832d",7,7,0,7,7,0,1,2
"6675","2eb8851d11566cd73ced39942e501615",51,40,62,5.75806451612903,51,0,2,1
"6676","2eb891f89115fd1ec06bf8d2fedd0121",66,45,43,10.7441860465116,66,0,2,1
"6677","2eba13eac040f7ee803434afb29021c5",15,15,0,15,15,0,1,2
"6678","2ebae3950bd4e29876ff20a61cbebffc",39,39,0,39,0,39,1,2
"6679","2ebb8f50b6dd1321fba26ed9e0f1a6d4",77,60,70,7.7,77,0,2,3
"6680","2ebde13e20f172f27b95d5c26d112e91",119,97,19,43.8421052631579,119,0,3,3
"6681","2ebffef60ba31a8cdfabb823e4e74c7a",1,1,0,1,1,0,1,2
"6682","2ec0f04a1230030fc8336ae85880111f",170,146,49,24.2857142857143,170,0,3,3
"6683","2ec4c79ec15cc4a1ae6b99b6897defc0",55,53,23,16.7391304347826,27,28,2,1
"6684","2ec659da5e3e5f8b88d532496a321f64",132,94,70,13.2,132,0,3,3
"6685","2ec71b4a5ef7b5c3b2b2641bdae35e7c",62,41,74,5.86486486486486,62,0,2,1
"6686","2eca405eb2d769e2d9b7c7b077077e44",16,8,77,1.45454545454545,16,0,2,1
"6687","2ed0ace39de3e0fd12f05ad03bbeb468",15,15,0,15,0,15,1,2
"6688","2ed0e56520b1f173cd8acf5747ce2dda",112,69,59,13.2881355932203,112,0,3,3
"6689","2ed15951d64b79b10622e80bbca3601a",34,34,0,34,34,0,1,2
"6690","2ed2b12e10443edecd712c67b10cf08c",132,67,72,12.8333333333333,100,32,3,3
"6691","2ed4a572e803bd504f40f362528bf445",42,42,0,42,42,0,1,2
"6692","2ed773c706d509cd72d581fab3604024",67,48,26,18.0384615384615,67,0,2,1
"6693","2ed8f8b8c08433ea7ac5597c7ea8c851",195,81,80,17.0625,163,32,3,3
"6694","2ed9893dac99e3f4c5bdd822b27c082f",64,48,85,5.27058823529412,64,0,2,3
"6695","2edce15d14813b3531caa543cb3e215e",92,11,78,8.25641025641026,85,7,2,1
"6696","2ee3572e7faf2c79e3626b4f1c72798f",45,39,63,5,45,0,2,1
"6697","2ee442768bdd7f6751a942586297c188",46,28,51,6.31372549019608,46,0,2,1
"6698","2eeb34a4f57dae68bb6523fd54ebbd4e",195,120,89,15.3370786516854,195,0,3,3
"6699","2ef00616a4e86e55ce07efab25f97315",145,87,60,16.9166666666667,145,0,3,3
"6700","2ef00790bd2f70672eb3000e45c5e500",46,36,67,4.80597014925373,46,0,2,1
"6701","2ef4e78a1a844307e2e2492a7a928741",97,63,74,9.17567567567568,97,0,2,3
"6702","2ef6629c16fec16ca72ba701b9a3a82b",74,45,90,5.75555555555556,53,21,2,1
"6703","2ef8f8864d03bdd9ee02edb008858ca6",1,1,0,1,1,0,1,2
"6704","2efb16ee5746ff62123f1b6ea146d72c",51,51,0,51,51,0,1,2
"6705","2efd6c5ad397b68d510bec8527fe6502",21,21,0,21,21,0,1,2
"6706","2efe895947330ec0e5fa44cc49a5e46d",88,73,56,11,88,0,2,3
"6707","2eff2f927a5f48f9dd314d87e288b2b2",28,28,0,28,28,0,1,2
"6708","2f0229e8ab0db0452a042646a238cc48",44,44,0,44,44,0,1,2
"6709","2f088e103493e99f345d70f9c638de82",58,50,42,9.66666666666667,58,0,2,1
"6710","2f08df1c383a56546410d1efd2e6cf36",55,52,37,10.4054054054054,55,0,2,1
"6711","2f0958f79404b677508caf77c4af7e95",4,4,0,4,4,0,1,2
"6712","2f09beb59486f3f0cdc2081f8f9596bd",32,32,0,32,0,32,1,2
"6713","2f0a55d4cb881bc77e64a81e58966877",38,30,25,10.64,17,21,2,1
"6714","2f0b30d2dba78ed26c03823b7890bddf",49,33,72,4.76388888888889,32,17,2,1
"6715","2f0b4d8b59b7bf0a4df66eb8f5d4e2f3",41,41,0,41,41,0,1,2
"6716","2f0bc2689df0138c1e73d1087a02e318",152,105,55,19.3454545454545,104,48,3,3
"6717","2f0bf4d119aab201139ccc226c82a5e6",56,49,42,9.33333333333333,56,0,2,1
"6718","2f177403ac2512d0d9199ed3e0d450ec",187,86,56,23.375,158,29,3,3
"6719","2f186e17a013d0f5f05e6719962e941e",19,19,0,19,19,0,1,2
"6720","2f1888ff7551d3b1eb4ae5e2316f49a0",108,75,63,12,108,0,3,3
"6721","2f19f5fdbe831fa47667105ec421e1be",33,27,29,7.96551724137931,33,0,2,1
"6722","2f1a6eafcae0b40ccf7e4b272a3d54d3",181,111,89,14.2359550561798,142,39,3,3
"6723","2f1b2357b4f23fe65cefc259f48674d1",14,14,0,14,14,0,1,2
"6724","2f1eca0822a75dd3f1e26fcfb7e98ab0",42,27,72,4.08333333333333,25,17,2,1
"6725","2f2128cd0ffd1a071c39cdf2b9e6b431",39,39,0,39,0,39,1,2
"6726","2f216d12229c515a4030160209ae07d8",7,5,35,1.4,7,0,2,1
"6727","2f21a5eb59c29b50dbc33eef3dfa09d6",9,6,34,1.85294117647059,9,0,2,1
"6728","2f2676cb0420d508898c949ca9e043b7",99,51,62,11.1774193548387,99,0,2,3
"6729","2f2883eb011c4fd4a44b1d55cc458e98",120,84,56,15,71,49,3,3
"6730","2f29a1ff5d5e86b2bf6d3e36e8e4c4cf",23,23,0,23,23,0,1,2
"6731","2f2b2f711323d5c04d1bc1166c384510",19,19,0,19,0,19,1,2
"6732","2f2eb4ae1d3389f520f9b80006fbfaa6",96,65,32,21,51,45,2,3
"6733","2f2ec2b5408f8a4448e3f3fb6c69627a",47,41,33,9.96969696969697,47,0,2,1
"6734","2f307fc1c3b24c694e445afd2a30ebb7",51,47,18,19.8333333333333,29,22,1,1
"6735","2f3500719e605d1c813dcaa4a39bccf9",16,16,0,16,16,0,1,2
"6736","2f3504d6f07ee4e49fdea06d73857e91",60,52,35,12,60,0,2,1
"6737","2f36bfd794b2dffe39afae4b7ad4b655",1,1,0,1,0,1,1,2
"6738","2f37d98fbd1e54d0f3cf38dfdcb50bc7",113,84,42,18.8333333333333,68,45,3,3
"6739","2f3944c7bf1af7dd8d3bbd3e60ddc9cd",29,29,0,29,29,0,1,2
"6740","2f3b0a3d13e80c931e047ce507a13ed0",90,49,63,10,74,16,2,1
"6741","2f3d82092ec23a2fa2ed81c43da9f50b",31,31,0,31,31,0,1,2
"6742","2f402e79137936aa14f8f898e21978b9",29,29,0,29,29,0,1,2
"6743","2f413309cc2c525d3a95091f3cc12ac4",76,44,54,9.85185185185185,76,0,2,3
"6744","2f4153feab7434fb70a97e9e3e7942c3",150,103,75,14,150,0,3,3
"6745","2f41da19b1978b7abc05c2fb2ea64a8a",24,23,3,56,24,0,1,2
"6746","2f42182134a7181686fc429d9771122f",54,47,27,14,54,0,2,1
"6747","2f42e70c5311c7c5aca90aef11a644b8",62,40,47,9.23404255319149,62,0,2,1
"6748","2f440ab67810f87d6f7bcaf18b187e9c",2,2,0,2,2,0,1,2
"6749","2f47ce5bb64a892cb502129f41217108",30,17,84,2.5,30,0,2,1
"6750","2f49e59dc2a8c7940c529f76a4cfee67",72,55,33,15.2727272727273,72,0,2,1
"6751","2f4c5426a80bfdcc40ca89a8a3298edd",25,25,0,25,25,0,1,2
"6752","2f4dbabb297c8df6a433f3a7be00f618",33,29,36,6.41666666666667,33,0,2,1
"6753","2f5068dce34a68ec5a30a00f24bf2822",55,51,21,18.3333333333333,55,0,2,1
"6754","2f51f72cb0de67c05088ca94a1d91e78",199,76,72,19.3472222222222,157,42,3,3
"6755","2f52c3ca29234c4a453bbdcfb31dafad",25,25,0,25,25,0,1,2
"6756","2f52f569f9f992c0c9ee721f52e9eb44",3,3,0,3,3,0,1,2
"6757","2f5495bf21cd04df3ed06ad81f675a51",5,5,0,5,5,0,1,2
"6758","2f55980cad813406ad9759b9bd22d151",58,48,43,9.44186046511628,58,0,2,1
"6759","2f5692b7dfc67480dd4e6105d2ece5f5",49,49,0,49,0,49,1,2
"6760","2f5711809c9bb20c4978dc0823bc0421",45,45,0,45,45,0,1,2
"6761","2f5745d186d7af11ccdb34c8d640e172",216,107,63,24,216,0,3,3
"6762","2f587c0a57690456e35514d0fc086d4a",19,19,0,19,19,0,1,2
"6763","2f594454c90a78a9d32d10b96ba1dc50",61,44,66,6.46969696969697,61,0,2,1
"6764","2f5d2cb212d449204d3ccd45050140e8",147,91,65,15.8307692307692,102,45,3,3
"6765","2f6302da53f52479f325993151d0a24a",17,17,0,17,17,0,1,2
"6766","2f64634f1e5cd8f397d756ef9b113e83",152,96,59,18.0338983050847,152,0,3,3
"6767","2f64f8c7709b8c89b70a46f9707e152e",136,99,28,34,136,0,3,3
"6768","2f6a3cedd6f6c03e55243f1b6c25d665",96,73,68,9.88235294117647,70,26,2,1
"6769","2f6b649cd1b17603aefcfe9620354e4a",102,67,36,19.8333333333333,68,34,2,3
"6770","2f711e5ebec1545ebd2639c68c64228a",29,29,0,29,29,0,1,2
"6771","2f724e81ad47eb6c92f67d07079e93eb",25,25,0,25,25,0,1,2
"6772","2f7320e30970cb7749295230e054689e",33,24,31,7.45161290322581,33,0,2,1
"6773","2f7669839e1f62476c677e0f3ce92900",205,133,66,21.7424242424242,205,0,3,3
"6774","2f7822682e3d8af05cbe30cb0e1cfc88",69,52,32,15.09375,37,32,2,1
"6775","2f7eb8cd2ed418d202d89a10b3db3f41",2,2,0,2,2,0,1,2
"6776","2f7edb990d4ee490226e6973908825ca",110,88,28,27.5,110,0,3,3
"6777","2f81861f9085c0e2f7a19d46efc3d09d",8,8,0,8,8,0,1,2
"6778","2f833c64e6ab7593b286c10ca736c3e3",71,63,13,38.2307692307692,71,0,1,2
"6779","2f836ee9b6bc534fb29b5f72470204dd",8,8,0,8,8,0,1,2
"6780","2f88dc94ecdabe798715f927e732717b",31,31,0,31,31,0,1,2
"6781","2f8a20ae8e4c2c6d547da2e67d5a5c41",29,29,0,29,29,0,1,2
"6782","2f8a8dc12d9708bc4cbb2d25c08dbd52",173,99,69,17.5507246376812,173,0,3,3
"6783","2f8d71b1c7252fa4f36fc485dce85152",48,48,0,48,48,0,1,2
"6784","2f924d4552b32cc507183d2694da2d24",34,34,0,34,34,0,1,2
"6785","2f92d0b7c98aac85af8712eac99b9bb3",4,4,0,4,4,0,1,2
"6786","2f937b84a5737bb436d6cc212ce96f76",145,86,68,14.9264705882353,145,0,3,3
"6787","2f975a64ea9b0da4147cf48068d8d755",85,68,31,19.1935483870968,67,18,2,1
"6788","2f986011edc801465d629e0ce9bd68d6",95,58,43,15.4651162790698,95,0,2,3
"6789","2f9887d463325b0198dca07abcae0d36",40,40,0,40,0,40,1,2
"6790","2f98b93d7d135a91ae1c2ce8903480f3",121,79,55,15.4,121,0,3,3
"6791","2f9a25cb5633d0c29115ecb2c6e55ff6",37,37,0,37,37,0,1,2
"6792","2f9b9970afb88304325a017d4029d24a",37,37,0,37,0,37,1,2
"6793","2f9c48052eb4f5d7c83e47d2b3cf9193",24,24,0,24,24,0,1,2
"6794","2f9d905bd9eb9dcfce4719923187b723",90,63,35,18,90,0,2,3
"6795","2f9fb63ba70a0a0bdf2b4de15fc48ca9",116,94,61,13.3114754098361,116,0,3,3
"6796","2fa09d174109bb3e5392547bcf02dbab",71,56,43,11.5581395348837,71,0,2,3
"6797","2fa15daaae15f440d0fb2afc94312efc",25,25,0,25,25,0,1,2
"6798","2fa3d24f8bacc4dc627a5e21fa21e644",223,63,82,19.0365853658537,209,14,3,3
"6799","2fa5509180b8ec5f810b02cc21db888b",64,44,35,12.8,64,0,2,1
"6800","2fa5ab09b69c3685c3bf951fd2bf6dc4",100,71,56,12.5,100,0,2,3
"6801","2fa74f230d9727592c0bd7ea3e435a86",104,63,73,9.97260273972603,104,0,2,3
"6802","2fa9e8f31f980ec001bea8908ec8d5dc",160,65,72,15.5555555555556,127,33,3,3
"6803","2fab1f506e23b351a2b997f477a9ed2d",84,66,21,28,84,0,2,2
"6804","2fabbaf256cbe62a6f3f857c345f9424",44,44,0,44,44,0,1,2
"6805","2fac0a86d1c3b25164dd4ed46c6e10cf",13,13,0,13,13,0,1,2
"6806","2facdf67ebe9bb7310b2e180c09caa27",35,35,0,35,35,0,1,2
"6807","2facfdd5cd44a0044b8e890646d32a2a",44,44,0,44,44,0,1,2
"6808","2fad882855e13016fd1f2f4cbf4eac10",147,86,77,13.3636363636364,147,0,3,3
"6809","2fb0653df0d55b9a61b6e58ecb3f00a8",101,76,63,11.2222222222222,101,0,3,3
"6810","2fb0a4330c2effa806513e1babea57ed",98,63,81,8.46913580246914,82,16,2,1
"6811","2fb1a2f7bed4bb23ddf696f5607e599c",100,78,22,31.8181818181818,100,0,3,3
"6812","2fb2bd4893111f31cef4b5aec2c60992",77,66,57,9.45614035087719,77,0,2,3
"6813","2fb6e86a336d7cc1a9905fab6ea12542",61,51,63,6.77777777777778,61,0,2,3
"6814","2fbcb45135acd46f956c0692d604c8b8",33,33,0,33,33,0,1,2
"6815","2fc2533b33442f1bccb285cdb8e43bf4",56,56,0,56,56,0,1,2
"6816","2fc2a577ef10ff4a9ca5b63eff7c7bfc",15,15,0,15,15,0,1,2
"6817","2fc3002f71fedaf920951421433e2d10",18,18,0,18,18,0,1,2
"6818","2fc6446d91e39a2732d136d4baee8a1d",43,42,6,50.1666666666667,43,0,1,2
"6819","2fc6ec74d8358ebbd7b6a492f582afe0",28,28,0,28,28,0,1,2
"6820","2fcc9ab647411f5367eb836fda44b040",84,71,70,8.4,84,0,2,3
"6821","2fcdf53e9c05ca6730a1276f48728fa3",158,93,79,14,132,26,3,3
"6822","2fd1432eb6f569aa8645ebde26aeb295",73,58,24,21.2916666666667,37,36,2,1
"6823","2fd194e70b31890a135c46693a7098d9",45,45,0,45,45,0,1,2
"6824","2fd5dc0dfcddcb153969352ba7e96c18",133,84,73,12.7534246575342,86,47,3,3
"6825","2fd5f324a774a7af47000418cb6e4f67",64,60,63,7.11111111111111,64,0,2,3
"6826","2fd6a8830578ec2db555cdfa3943d2c9",50,35,28,12.5,44,6,2,1
"6827","2fd899158f235ec6c6f7980fabb6d191",3,2,65,0.323076923076923,3,0,2,1
"6828","2fd91cbbad680f1ea52aae7759424555",40,40,0,40,40,0,1,2
"6829","2fda43a6fc99a242b98c25737394f941",28,28,0,28,28,0,1,2
"6830","2fdb047b908ab156b13344cdc5ea50a8",107,79,65,11.5230769230769,74,33,3,3
"6831","2fdd0aad529c32fa8bd9bc4f29e56792",57,51,56,7.125,57,0,2,1
"6832","2fe217e888875b9ce743c0eb4f707149",15,15,0,15,15,0,1,2
"6833","2fe3491de6ed42ef2e27c5ad155dd426",26,26,0,26,26,0,1,2
"6834","2fe5cbc871bbcbbaf16aa318b0950922",20,19,23,6.08695652173913,20,0,2,1
"6835","2fe64313f6b09acd422aee77ff527264",49,49,0,49,49,0,1,2
"6836","2fe6fc00b1d4bf25943f0119815f2b73",102,43,72,9.91666666666667,102,0,2,3
"6837","2fe79cd821f71eca1493b811c5b48b3f",17,17,0,17,17,0,1,2
"6838","2fe87c80cd381efd2d7f2235ef885e06",10,10,0,10,10,0,1,2
"6839","2fe889c0a63ff3fdf87623df706cfa80",3,3,0,3,0,3,1,2
"6840","2fe96c46655c101df1b981383e61b4ea",53,34,43,8.62790697674419,53,0,2,1
"6841","2fea70a99a58d0d25817b1693ee84bde",36,36,0,36,36,0,1,2
"6842","2feaa8fb3579a9fbbbdee593ecb52e2b",53,53,0,53,53,0,1,2
"6843","2fefdbb957dea8e7c6c77885e20d1232",39,39,0,39,39,0,1,2
"6844","2ff123cd71ae4ec44cbb25d974f6cecd",30,23,35,6,30,0,2,1
"6845","2ff41a5f72c3d613ba96bbf623527249",62,44,56,7.75,62,0,2,1
"6846","2ff7726b37521da7c3373fb8374ade7a",51,51,0,51,0,51,1,2
"6847","2ff7be55fcbb8fdc0db085a529c9ef57",180,115,58,21.7241379310345,180,0,3,3
"6848","2ff82aeeb79d1a1e01a6487f869c307f",83,55,47,12.3617021276596,83,0,2,3
"6849","2ff9cba89bd864e106e14919158da61f",17,17,0,17,17,0,1,2
"6850","2ffa403ca78fb2fe2181188e7f9e18ea",38,38,0,38,0,38,1,2
"6851","2ffa5084fd6d6ea9c55667a402feb51e",31,28,72,3.01388888888889,1,30,2,1
"6852","2ffae6c33334d34e9e2447ab97162898",26,15,76,2.39473684210526,26,0,2,1
"6853","2ffced32e27aa0b02cc8667d174f6205",81,60,50,11.34,71,10,2,1
"6854","2ffd4e7927eec40a059bf1c51ca08a70",4,4,0,4,4,0,1,2
"6855","2ffe91d4ff8de9d45b4c0689c0f0d190",25,25,0,25,0,25,1,2
"6856","3000bc65caeae5e7b9a0bd9ecf4b4641",155,91,61,17.7868852459016,155,0,3,3
"6857","3001bb7b50a28b866d55a1ef51de60e6",47,47,0,47,47,0,1,2
"6858","30028d4c2c744da50b2b146d33094a2a",80,60,72,7.77777777777778,80,0,2,3
"6859","30071becdea3aa909a3c738be707ccf7",27,27,0,27,27,0,1,2
"6860","300837cfc4b3efdb7ae38af34a3c1cbf",27,27,0,27,27,0,1,2
"6861","30083b25347edb1110ca8e57fa51e699",92,66,37,17.4054054054054,53,39,2,3
"6862","300948b3ff33898a0383cf40fcd6851a",85,68,76,7.82894736842105,49,36,2,3
"6863","300b9fc27c02e877c14f3797288f3b4b",10,8,38,1.84210526315789,10,0,2,1
"6864","300d0d0012be6dc96148502a4cb4248c",55,55,0,55,55,0,1,2
"6865","300de03d15d5cab12298f8cd028baabe",50,50,0,50,50,0,1,2
"6866","300df88d51f4ac36490bd2a14dcdb38d",33,33,0,33,0,33,1,2
"6867","3010e3dac6a028f8a089d1ef7fcb78f3",21,21,0,21,21,0,1,2
"6868","30113bc711ad57103caf94c3b8b241e2",51,51,0,51,51,0,1,2
"6869","3012dfe5cf6964ca0b32a7312fc7eed2",176,88,66,18.6666666666667,176,0,3,3
"6870","30139fdaa2652cf103488261c5be5b56",87,52,52,11.7115384615385,42,45,2,1
"6871","301b1e18bc8c159aec435124cc7a38fb",42,19,57,5.15789473684211,27,15,2,1
"6872","301ee5fb6a3b4923ee45da6ea092c2f2",25,22,8,21.875,25,0,1,2
"6873","301f57b66c76d5e60ede382a052d1112",141,80,74,13.3378378378378,141,0,3,3
"6874","3020218b8ce8a82ff14f05ee5d58f107",46,35,49,6.57142857142857,46,0,2,1
"6875","30205aace14e78421f6dcf07347349cb",61,34,60,7.11666666666667,44,17,2,1
"6876","3025509ca4f3833e0aa2ae9fe25d2323",16,16,0,16,16,0,1,2
"6877","30266166872e139b7afd994daec2337d",51,32,68,5.25,35,16,2,1
"6878","3029aea11cfbf6526264142da8d84219",115,86,42,19.1666666666667,115,0,3,3
"6879","302a6d96207aaa9cfaf77518e768e110",106,82,47,15.7872340425532,106,0,3,3
"6880","302a9048c273b6db198c00d4b6ca5e9d",3,3,0,3,3,0,1,2
"6881","302b6af74dc349b60a37f3e84ad2dc35",101,72,33,21.4242424242424,101,0,3,3
"6882","302c05a3030f75a1f7cf5f2bc77f83f5",10,10,0,10,10,0,1,2
"6883","302cc03a7ba0f72427f49cf88f94743f",1,1,0,1,1,0,1,2
"6884","302d86240d46e7a83faac0bbbb57a5d7",111,73,35,22.2,111,0,3,3
"6885","30308ec1d23b066d31c8d0e9f0ee10cb",38,36,19,14,38,0,1,1
"6886","3030e834dc9de90eb02b21d19c4b2780",27,27,0,27,27,0,1,2
"6887","303401c8bedbfcaf983d8663ab3ad452",39,31,30,9.1,39,0,2,1
"6888","3035fc4b8eb64343965fe2b5bbc159a9",175,84,77,15.9090909090909,175,0,3,3
"6889","30372881bb04f135b5171431b0ce5a5f",152,81,78,13.6410256410256,129,23,3,3
"6890","303909d90916025a426c2958065e6e49",54,32,42,9,54,0,2,1
"6891","303a1d0a084bf0bc25e3f042c31ac212",122,75,72,11.8611111111111,78,44,3,3
"6892","303a7ee02fc25a6ad6b6e985495e07a3",68,45,75,6.34666666666667,68,0,2,1
"6893","303ca15dbd3eb3791e22b36135102368",76,55,35,15.2,76,0,2,1
"6894","303ddaf746f4dd5433c98d3c5da748c9",39,39,0,39,39,0,1,2
"6895","303e8760f93a727fdb39b605346a5939",70,54,78,6.28205128205128,70,0,2,3
"6896","3043d28d05ffb71b7a1f43dbc3b58c3e",64,42,46,9.73913043478261,64,0,2,1
"6897","3045179ef3a328e477019ecade42f177",15,15,0,15,15,0,1,2
"6898","30457ab1050358ad9abc01f80501ca77",19,19,0,19,19,0,1,2
"6899","304707173ccdc351ff97ac4d033d1e5a",79,45,44,12.5681818181818,79,0,2,3
"6900","3049f22a9757ed50c07b00a4c00f4c44",29,26,17,11.9411764705882,29,0,1,1
"6901","3049fc8088679ec457b4737102b06719",11,11,0,11,11,0,1,2
"6902","304af701f47ea10c7ebde6b0150f2ed8",1,1,0,1,1,0,1,2
"6903","304cf36037e32a6c1ece716f09333d58",37,35,17,15.2352941176471,37,0,1,1
"6904","3051012749a921405d1e4b717da39ea8",95,66,36,18.4722222222222,82,13,2,1
"6905","30530b45e0b825667b9cdfb6f3511713",190,104,87,15.2873563218391,190,0,3,3
"6906","305d19b96165e5a825cc513df982d6c1",36,20,53,4.75471698113208,36,0,2,1
"6907","305e7ee63dd99258f942134f76e6bdc9",59,46,63,6.55555555555556,35,24,2,1
"6908","305ebf2bbea1c381727fc2476afd2dbd",24,24,0,24,24,0,1,2
"6909","305fa460575980a8b01b65c985932fca",89,58,47,13.2553191489362,64,25,2,1
"6910","306012c05ccc3ad7c280553eddfe72e3",170,105,73,16.3013698630137,170,0,3,3
"6911","3063a104ab487cccbbc2d1f428941071",30,30,0,30,30,0,1,2
"6912","30647c6165cde2ea480f83d362f9580e",36,36,0,36,36,0,1,2
"6913","306513344b518cc7d12dd34af3d5025a",48,38,49,6.85714285714286,0,48,2,1
"6914","3065a234c0a7f4244e6be1ce934b005e",138,54,74,13.0540540540541,138,0,3,3
"6915","306c0017d28f7d7a3e6909eeb7328e1e",9,9,0,9,9,0,1,2
"6916","306e1f5a665e904070afb3a6e8181a2a",27,27,0,27,27,0,1,2
"6917","306f7765a1517eeb21a1b76c9b488621",20,20,0,20,20,0,1,2
"6918","30731d2944f809e155090d46b4d635e1",104,95,28,26,104,0,3,3
"6919","307772efd7d05ea85907fd26a54aff60",146,114,66,15.4848484848485,97,49,3,3
"6920","307934c63dd1d23af60506edf19271dc",18,18,0,18,18,0,1,2
"6921","3079fa119f6bc02d7b62a3ff38d3adc0",84,45,61,9.63934426229508,84,0,2,3
"6922","307becb2bfd05c13c39e8a237e98c430",36,36,0,36,36,0,1,2
"6923","3081540ded83c620aa3bf1045d49ec34",7,7,0,7,7,0,1,2
"6924","3087229edd9a0e197a787ff0d989d3b0",13,13,0,13,13,0,1,2
"6925","3087d05ffc8a0a675bfcb5cb13b0b166",11,11,0,11,11,0,1,2
"6926","30889f5e829aa9bfb099ea8f84040414",151,77,35,30.2,110,41,3,3
"6927","308cc98578a22a81aa801c102b21f346",1,1,0,1,1,0,1,2
"6928","308df039a32522898333bbb7b996a2e2",29,29,0,29,29,0,1,2
"6929","308eea034b3bd02db71afdc337127ae1",109,77,40,19.075,109,0,3,3
"6930","30901907fc3178d9aac50eef32cf5500",16,16,0,16,16,0,1,2
"6931","30915d74d50e796e13c16ead370230bb",45,45,0,45,45,0,1,2
"6932","30952eec2c198506777d417f157c3a7c",161,101,84,13.4166666666667,153,8,3,3
"6933","30961da94df74ee158765f684d5a6602",187,138,81,16.1604938271605,187,0,3,3
"6934","30978c480971e8c466555e2c3d83fdca",40,40,0,40,40,0,1,2
"6935","309871ef70460abc7869e36e4652a916",48,48,0,48,0,48,1,2
"6936","309a7a6a466a689d317c63b97688225a",42,35,42,7,42,0,2,1
"6937","309fa414a29c2eb799f311eeb30a3db3",12,12,0,12,12,0,1,2
"6938","30a42ce834e1b3a16e483dd13ae883f8",39,36,14,19.5,39,0,1,1
"6939","30a4511546f9a6267ec98ac1b47e3a75",143,76,80,12.5125,130,13,3,3
"6940","30a6a673ade54acb05ed228bf3489890",29,29,0,29,29,0,1,2
"6941","30a9032a9aa8da11b24f2513361ec764",39,26,82,3.32926829268293,39,0,2,1
"6942","30acaf164892ea904bee1bdc8cfba6b8",88,64,80,7.7,67,21,2,1
"6943","30af63b2ba437811020083af26e5cd42",100,66,46,15.2173913043478,100,0,2,3
"6944","30b1360e44a40321c7c249a47918c87e",37,33,43,6.02325581395349,37,0,2,1
"6945","30b3544003306a4c7596a1376fab4319",60,40,70,6,42,18,2,1
"6946","30b44fddacbd61134470432fad0c4f6b",93,66,49,13.2857142857143,93,0,2,3
"6947","30b770733ea7a3e79e626c8531721e56",153,85,72,14.875,153,0,3,3
"6948","30b779388df61659efe3cf8182482088",18,18,0,18,18,0,1,2
"6949","30b7f02bbeea0df6ea83b51029e0a07c",44,29,42,7.33333333333333,44,0,2,1
"6950","30b8c541370f197ec52776cc193b78eb",13,13,0,13,13,0,1,2
"6951","30bbf47d929cdfbba6650afc04e2789b",64,55,54,8.2962962962963,64,0,2,3
"6952","30bf9f35da836689a7696f37a3c1cb27",178,73,85,14.6588235294118,137,41,3,3
"6953","30bfb30478fdc2c0a472ea26967b12d5",2,2,0,2,2,0,1,2
"6954","30c14590502e36b2fa5da840f7304270",37,37,0,37,37,0,1,2
"6955","30c18d299d8a53afa7d6aae30984bb30",31,31,0,31,31,0,1,2
"6956","30c1f6b09573c7a0049551878a51c63f",18,18,0,18,18,0,1,2
"6957","30c30542cbd9538595c315a8d8cfe618",111,86,75,10.36,111,0,3,3
"6958","30c5a3f3a70b0f9316e50b41010b085b",14,14,0,14,0,14,1,2
"6959","30c6cf1d2e2a9dacf8e66ca9558698d8",59,54,41,10.0731707317073,59,0,2,3
"6960","30cb316bbcec6e5ab68633ca2ed99692",90,69,67,9.40298507462687,90,0,2,3
"6961","30cb385b5312e35e751ff01be1fe5324",16,15,18,6.22222222222222,16,0,1,1
"6962","30cbd9300ecec99105d633999e1bb2be",18,18,0,18,18,0,1,2
"6963","30cd09d2b3c8ff2e7ae49abf0b45c83c",48,43,39,8.61538461538461,26,22,2,1
"6964","30cd3cceacc0b99fcf64e6c4acbc6627",44,38,26,11.8461538461538,43,1,2,1
"6965","30ce6b06c091cb9f99008ecd92a29a1f",82,51,39,14.7179487179487,82,0,2,3
"6966","30ce9c7ad9f4f65d1e599915e96d610a",88,68,73,8.43835616438356,88,0,2,3
"6967","30cf9e04d8fdb352cf2df73ab43e75fa",13,13,0,13,13,0,1,2
"6968","30cfa3e40bc41474c56beb68cd600abb",153,102,84,12.75,153,0,3,3
"6969","30d009c5cff300d1cf0d73a003799426",132,78,83,11.1325301204819,110,22,3,3
"6970","30d0f6dadc3314125bd51b2db3190f3a",5,5,0,5,5,0,1,2
"6971","30d3de83034be443ea946051b3b97d3e",183,85,75,17.08,150,33,3,3
"6972","30d4a831759d042e4494f365cd4a0cd9",31,31,0,31,0,31,1,2
"6973","30d89c311ad179009b667f39e3117730",246,98,84,20.5,209,37,3,3
"6974","30d979eeb4bed710aa50ec88754359a7",61,38,56,7.625,61,0,2,1
"6975","30da148a04fa06070780bf016cd1140d",233,90,83,19.6506024096386,211,22,3,3
"6976","30db3e4bad20e7eb367c932a718acf72",50,41,77,4.54545454545455,50,0,2,1
"6977","30dc0fd40ab61fd0391fe4b549cfedd8",57,40,33,12.0909090909091,57,0,2,1
"6978","30e153d0b5d8e1cc7818e3953d9a966a",27,27,0,27,27,0,1,2
"6979","30e29b1210fe2eeff4fc48ee1cfba52e",17,17,0,17,17,0,1,2
"6980","30e4026b036f5fc774de4e68297e6de3",29,29,0,29,0,29,1,2
"6981","30e5b4e380283a8f844d6a118b9e6d83",71,41,69,7.20289855072464,52,19,2,1
"6982","30e79bbb258387722f6a49d3e75bbe50",42,34,33,8.90909090909091,18,24,2,1
"6983","30e851720726454a44c774d50ae487ff",82,69,54,10.6296296296296,82,0,2,3
"6984","30e8fdc7eaea2152bb57f8f778a0a2ae",46,46,0,46,46,0,1,2
"6985","30eadb9dc05d76156f24df9088c9257d",167,83,62,18.8548387096774,136,31,3,3
"6986","30ec56bbde2ce5254434cb47da2a45ee",21,21,0,21,21,0,1,2
"6987","30ed581de0f4f6b6c309c12d009a35af",42,42,0,42,42,0,1,2
"6988","30f5a5c2661ede9b17ff3cabbbb40e45",29,29,0,29,29,0,1,2
"6989","30f88efe5f3ffd20a26c574586f41594",9,9,0,9,9,0,1,2
"6990","30f97431fa13016a607abd265e88268f",4,3,21,1.33333333333333,4,0,1,1
"6991","30fb6278ed7a78e298b8d7c548c2f377",22,18,28,5.5,22,0,2,1
"6992","30fcdf0e8fced1c439107fb861fd558d",119,63,84,9.91666666666667,119,0,3,3
"6993","30fd9848a6cacee9ff162aeb5154cd1c",30,30,0,30,30,0,1,2
"6994","30fee9051612df12799435a3c33f2c05",8,8,0,8,8,0,1,2
"6995","30ffebd04846af014c6765a21dc1635f",108,59,77,9.81818181818182,63,45,2,3
"6996","31031f17c473dca6105e779450219be5",41,41,0,41,0,41,1,2
"6997","3104b70ac17df855235299df8c05a1be",139,80,76,12.8026315789474,139,0,3,3
"6998","3104cfbdc28ca254eb9d92f06e5c09e1",50,50,0,50,50,0,1,2
"6999","310689c8f89b1771539b3ed851771f9d",120,46,56,15,120,0,3,3
"7000","3107811f9b4725581aaf277fe77c692a",156,111,46,23.7391304347826,156,0,3,3
"7001","310b2937cc3a5df94eae86e6eac99f2a",122,87,32,26.6875,75,47,3,3
"7002","310c0b68081d274519de12cc5de72c27",33,33,0,33,33,0,1,2
"7003","310cb0664f2d834e5d3b9521a507f1c2",16,16,0,16,16,0,1,2
"7004","310fa79b1ec1f67df5bc33e8ef863442",90,62,60,10.5,65,25,2,1
"7005","311302595925b2d170779334650c631b",200,76,83,16.8674698795181,149,51,3,3
"7006","3116765329683dab2ad18f1c4a878719",20,20,0,20,20,0,1,2
"7007","311967be5b3c8ea21a1b397f935a28a5",20,20,0,20,20,0,1,2
"7008","311a91067f2f7a9d8c4098f450c82c5d",38,30,55,4.83636363636364,38,0,2,1
"7009","311d19360b8fb2887464d3dcbe1d81d5",8,7,4,14,8,0,1,2
"7010","311d53de4da62c796787d8fc74056348",26,26,0,26,26,0,1,2
"7011","311f77d0e4f75ca39d1478109e6ca07d",22,22,0,22,0,22,1,2
"7012","31214c5b59fb6bea3db0284ddfcc61a8",30,30,0,30,0,30,1,2
"7013","3123cacad9ee2a4f728268eac99ecdbb",213,88,70,21.3,213,0,3,3
"7014","31251877702d6eb50a74908b1587ce42",116,95,83,9.78313253012048,82,34,3,3
"7015","3125ecae5f8b953838dbb197f75d2ec1",81,58,63,9,81,0,2,3
"7016","3127934cf18e7b561acfde69705401e1",24,24,0,24,24,0,1,2
"7017","31297846be255b8dbbb004675ed4162e",173,115,71,17.056338028169,128,45,3,3
"7018","312beae056df5acb5c94e0340d39486f",7,7,0,7,7,0,1,2
"7019","312c97b9cda074e4369382b58f74837d",46,39,22,14.6363636363636,46,0,2,1
"7020","312e362213ce453f31db6ca627424185",37,37,0,37,37,0,1,2
"7021","3131c75a583decd7c2bca5daa9d39fba",20,20,0,20,20,0,1,2
"7022","3131d022ed680815e162ed26ad8cb456",22,22,0,22,22,0,1,2
"7023","313433f2f748045f49e4db3d2bdbecf6",29,29,0,29,29,0,1,2
"7024","31361f12a17fd529fb743da71bd4563c",48,35,21,16,48,0,1,1
"7025","313d6d2b4ec536adb37858477d0b5de6",34,31,5,47.6,34,0,1,2
"7026","314b5c7e4b6af9d4d2981719dd7411c8",73,56,60,8.51666666666667,73,0,2,3
"7027","315074981949d4b325172b2091b059ae",69,56,53,9.11320754716981,69,0,2,3
"7028","3152c2bda1b69cebc3689a636b72eb02",137,118,34,28.2058823529412,137,0,3,3
"7029","3155c213c290da5832e8ae55c9a6d87b",37,31,35,7.4,37,0,2,1
"7030","3155d3f1fab5a17e7f48100099a70e94",43,43,0,43,43,0,1,2
"7031","3159bfc8b719d354acd05141ce9dfecf",66,46,43,10.7441860465116,25,41,2,1
"7032","315a42260c87772b4fa3c0b55e8bd27c",14,14,0,14,14,0,1,2
"7033","315b72518a68cf83ae648dfd6cc211b0",25,19,81,2.16049382716049,25,0,2,1
"7034","315c1c50107992fe92f8539ec2fd2a92",9,6,49,1.28571428571429,9,0,2,1
"7035","315e1393662c9dd5a6a04f4c9c472435",21,21,0,21,21,0,1,2
"7036","315ef63c0bda9da29611d03050f597df",68,61,45,10.5777777777778,68,0,2,3
"7037","3165a6ef1fb086a09667e765d36b3ed3",142,100,54,18.4074074074074,142,0,3,3
"7038","3166471fe1cef875c19f8020b8914ad1",14,14,0,14,14,0,1,2
"7039","3168184e2f2485f0dfeb5a0c44fea0fe",59,37,44,9.38636363636364,36,23,2,1
"7040","316d702edfc6e2b8a0c136d2f49d45b8",24,24,0,24,24,0,1,2
"7041","3170c2eb654cdf606cc3017011923c2e",71,66,55,9.03636363636364,71,0,2,3
"7042","31731a89fe01d04e81f3e02b903f0fd2",180,90,74,17.027027027027,180,0,3,3
"7043","31738d7c094dab70527f330a39db2258",62,59,79,5.49367088607595,62,0,2,3
"7044","3173c483f1d5ebd982c9ea78ab3143fc",51,51,0,51,51,0,1,2
"7045","317407e22caefeb074c16e709eef2cd4",46,46,0,46,46,0,1,2
"7046","31746d53e2a9db1963d82a763970475d",116,52,56,14.5,116,0,3,3
"7047","317682e2b9dc93d483a887cbd83282eb",26,26,0,26,26,0,1,2
"7048","317a450a450ee32e9b2c0410453fa0d1",192,77,76,17.6842105263158,192,0,3,3
"7049","317b10f443fddca6303952d727642bed",103,90,34,21.2058823529412,103,0,3,3
"7050","317e61a54996c0324998f5ee0d9c3cf2",35,35,0,35,35,0,1,2
"7051","317ef8e129269d16b0c356788ff9680a",86,59,60,10.0333333333333,31,55,2,3
"7052","317fb43b3a6660f05d47feaf275f51c7",19,19,0,19,19,0,1,2
"7053","3181073f19208056acc72563a7deba55",22,22,0,22,22,0,1,2
"7054","3182ec23b081ee0eaa2d8eb521c36052",30,30,0,30,30,0,1,2
"7055","318763821da55546958ff9f6f2c82ec4",149,106,57,18.2982456140351,149,0,3,3
"7056","3187b7c10260ec4d841be8b94eb213f3",47,47,0,47,0,47,1,2
"7057","3187d8e53e5ebf84dee2ebe236d932c3",16,16,0,16,16,0,1,2
"7058","3189de7be9e4a3d99d766db5105d0016",127,80,82,10.8414634146341,127,0,3,3
"7059","318a912d47570a6aefa48fb1c3e3b009",54,43,30,12.6,31,23,2,1
"7060","318b6ae4ab78f74059c90dc5fc397528",27,27,0,27,27,0,1,2
"7061","318bdb63c3c9a1b04c2dbc25e59b45a7",62,59,58,7.48275862068965,35,27,2,1
"7062","318cd91a3f1d2d63cbf0e2313e5109e5",108,63,64,11.8125,108,0,3,3
"7063","318d77c86738be2491968291b978808c",49,49,0,49,49,0,1,2
"7064","318e0c9b679503d70eb0ec79e8b92ff5",17,17,0,17,17,0,1,2
"7065","3190595136a88655cdd7545ccc566c2b",32,15,84,2.66666666666667,27,5,2,1
"7066","3191f6bf05b38fe9e978bb78ddb9ce8d",28,28,0,28,28,0,1,2
"7067","3192c30d9ad468343af410a148a5bc93",32,32,0,32,32,0,1,2
"7068","319379af3df1936315d430baaa8330ce",38,38,0,38,0,38,1,2
"7069","31952aaa2d15e49139b46a056e5dba27",27,27,0,27,27,0,1,2
"7070","31976b9b89d0510106577e65d0da950d",182,112,55,23.1636363636364,140,42,3,3
"7071","319b0c2d5acdd2f5f12c4d78c636b872",152,89,75,14.1866666666667,152,0,3,3
"7072","319dea9bff1dc91e90e77dfb0b869de5",120,81,77,10.9090909090909,120,0,3,3
"7073","319e09e04b5c38821f70e7ed65ac62ca",50,50,0,50,50,0,1,2
"7074","319fb2489ea0e4cb7e241286f86a718c",186,66,84,15.5,186,0,3,3
"7075","31a54276088e037556e2e06d94f32a7e",70,54,55,8.90909090909091,70,0,2,3
"7076","31a6067edcc5e6eff51d10271c0242e4",46,46,0,46,46,0,1,2
"7077","31a7102529241f0cca88180c4149f856",29,29,0,29,0,29,1,2
"7078","31a8ef0b94d9b944ed9c2a598399d948",161,87,79,14.2658227848101,139,22,3,3
"7079","31ac05ffae2f7c8ad1a32c5778d7bcd0",75,63,26,20.1923076923077,26,49,2,1
"7080","31aec14f4dcaeccd2541326648ba6719",5,5,0,5,5,0,1,2
"7081","31af209a40e7d2f6f18e8801cdff75fe",104,67,24,30.3333333333333,104,0,3,3
"7082","31af560d2931608ee73279bb8748273a",124,73,61,14.2295081967213,124,0,3,3
"7083","31b1099d8dceb63817985c18fee99aee",7,7,0,7,7,0,1,2
"7084","31b4308aa75186cdd65e164c8d945e52",13,13,0,13,13,0,1,2
"7085","31b5331ba6e9569bab72c16d00fbeeb1",51,51,0,51,51,0,1,2
"7086","31b8091afc234a4b7f893c535cab6fee",10,10,0,10,10,0,1,2
"7087","31b9f399ff14473ed18b91a8c4cba338",63,46,32,13.78125,30,33,2,1
"7088","31baaa36669f539c508eae7de55cf1d3",14,14,0,14,14,0,1,2
"7089","31bb48e85aa8850929bc300764d180f9",134,99,53,17.6981132075472,134,0,3,3
"7090","31bcb5ddbc68e8ce5ff532f563ea8b1e",71,64,16,31.0625,71,0,1,2
"7091","31bcdc86785f8c2bf53345aa2ce669fa",38,38,0,38,38,0,1,2
"7092","31bee1963771b7027ff8f6540c850ef6",14,14,0,14,0,14,1,2
"7093","31bf884d1eb8f11194f7a1fc942da1b0",61,50,60,7.11666666666667,61,0,2,3
"7094","31c0cfed4bccea9f8bd7a845517d6bb6",14,14,0,14,14,0,1,2
"7095","31c180f7222b38cb44f1406f3af4eaba",26,26,0,26,26,0,1,2
"7096","31c1b4d196234d497fa870fbda0b7260",69,53,60,8.05,69,0,2,3
"7097","31c34b3f81b389c8c3755f210854eeac",180,114,56,22.5,180,0,3,3
"7098","31c4f3db44cc17e133f3139211b7ae83",15,15,0,15,15,0,1,2
"7099","31c5bf3b66724e4b611ba3a341ff908e",34,34,0,34,34,0,1,2
"7100","31caa73da60021c776351706dd53c058",57,33,22,18.1363636363636,57,0,1,1
"7101","31cd9fb8dbe27087ff1b208e9fb765da",22,22,0,22,22,0,1,2
"7102","31cf76367f31db00aa47398f5be92801",84,64,78,7.53846153846154,70,14,2,1
"7103","31d0f6eeca50fab80a77f9b029a7a1d4",59,28,74,5.58108108108108,59,0,2,1
"7104","31d36eeca6d68cdcff67b5872939c110",41,31,34,8.44117647058824,41,0,2,1
"7105","31d3991bf326b1a14fd23eff5429033e",145,39,76,13.3552631578947,95,50,3,3
"7106","31d59d3c99241d0fb0ed81fe26f6f79a",63,57,35,12.6,63,0,2,3
"7107","31d5bdaddb2f2423014030acf98fe4e2",139,70,74,13.1486486486486,139,0,3,3
"7108","31d7f58f17ecbbf7b82a7e2a23ea0231",42,42,0,42,42,0,1,2
"7109","31d924b7afcb00641b97d2d9eb7fc639",33,33,0,33,33,0,1,2
"7110","31dbad20731940e8291008c1f16d6328",169,104,71,16.6619718309859,169,0,3,3
"7111","31dc9cf4e1ff8194dd11bb71d7b50bcd",125,95,75,11.6666666666667,125,0,3,3
"7112","31dde4c9ce6c2a13d7008dcddde48055",80,54,63,8.88888888888889,80,0,2,3
"7113","31e03f18b81d8408eb1de2bd157c1e52",32,32,0,32,32,0,1,2
"7114","31e0b8a2c4d90d6820c58573bb2ea032",24,24,0,24,24,0,1,2
"7115","31e31fc5a91aab0b48a21672be85e44c",53,53,0,53,53,0,1,2
"7116","31e6493a0528a9e46b49810230fa94bc",172,68,68,17.7058823529412,139,33,3,3
"7117","31eae64da900867dd1514c4bd0ed6d2f",32,32,0,32,32,0,1,2
"7118","31ecc82988ed47b0f38501165992b700",25,25,0,25,25,0,1,2
"7119","31efaa9ec20f4859d02d145f90bfc31e",37,37,0,37,37,0,1,2
"7120","31f0b83a9546ef4e9e37d17090d78875",23,23,0,23,23,0,1,2
"7121","31f713bb38a991e6ecd10e8909ef5bbc",5,3,18,1.94444444444444,5,0,1,1
"7122","31f776b8a74792d7e6a04b8a4536f14e",126,74,67,13.1641791044776,126,0,3,3
"7123","31f7f5da16c4e3511f92e3b87a81171e",6,6,0,6,6,0,1,2
"7124","31fa5c37e566d3479ac1f5807246759c",132,69,37,24.972972972973,132,0,3,3
"7125","31fbec26867f54c2233035b391258548",27,27,0,27,27,0,1,2
"7126","31fc58fa7de88c800550e8fcc7c7ebc8",39,39,0,39,0,39,1,2
"7127","31fcc4404502108d84a9409693fb3ae4",44,38,16,19.25,21,23,1,1
"7128","31ffc5e84cadb0e5a8ea6945c46a03c0",98,71,29,23.6551724137931,52,46,2,3
"7129","32004bc6fe5e80cd5c869b2573e8cfdf",203,94,84,16.9166666666667,173,30,3,3
"7130","32009f2096c7b1bed9553669dcb62e20",10,10,0,10,10,0,1,2
"7131","3201f06a0032b05332bd2eb7b3ac9724",6,6,0,6,6,0,1,2
"7132","3202a8aef08de760bf654ca61afca346",108,60,49,15.4285714285714,108,0,2,3
"7133","3205b8d2423f5bae3117935445b3736c",43,43,0,43,43,0,1,2
"7134","320829b2f438751c8a98dab1f5edfded",55,47,77,5,55,0,2,1
"7135","32095631b0dee1555fff2f6305ef3c76",32,27,28,8,32,0,2,1
"7136","3209804ad7f99d853147414208de1abd",38,38,0,38,0,38,1,2
"7137","320a4da22b11ac718f6cd49e25a55283",50,50,0,50,0,50,1,2
"7138","320c0ba3849798867e6606da5765fa2c",130,73,56,16.25,130,0,3,3
"7139","32150eb9f8a371e0948499b258997f03",182,102,40,31.85,133,49,3,3
"7140","321b84128ddba2ccc1aa5a5e78470ffa",9,9,0,9,9,0,1,2
"7141","321bc910fd20b86f39cfd54640804489",100,82,57,12.280701754386,100,0,3,3
"7142","321d2702507d539a1db361e5527cdde1",85,68,48,12.3958333333333,50,35,2,3
"7143","321d2e94db0952295f1c711ed0e3b0ab",35,35,0,35,35,0,1,2
"7144","321d81e548a6aad01af7c9f92e8cf437",51,48,49,7.28571428571429,0,51,2,1
"7145","321e50e5e026b64d72ba488c7406aa77",5,5,0,5,5,0,1,2
"7146","32201fb66c027e4d5657fe9b51a5f170",107,81,70,10.7,72,35,3,3
"7147","3222c3f3dddc6d6f76292a6ec4a80b5a",50,36,70,5,50,0,2,1
"7148","3223a2bf34cdccbddba6c76b32ff38c0",53,44,38,9.76315789473684,53,0,2,1
"7149","32247a0680c2a138705572437d5a2ecc",89,64,60,10.3833333333333,55,34,2,1
"7150","322570428b9af5ace5efc5e43eb39cd9",32,32,0,32,32,0,1,2
"7151","32259d60779949d8ef1d143f3e9b95a4",20,20,0,20,20,0,1,2
"7152","3229c1744bc9ad6f735fb8fd73617a6a",35,35,0,35,35,0,1,2
"7153","3229e1322724c99bbb9751ed87c0cdb7",35,28,14,17.5,35,0,1,1
"7154","322ac21f922a41914dceb649d1b62f58",35,29,43,5.69767441860465,35,0,2,1
"7155","322b283eb85919b7763c891cbf2c99b8",106,65,70,10.6,59,47,2,3
"7156","322bb6c60a971f7fb5b0d4503491ad7f",17,17,0,17,17,0,1,2
"7157","322d4a19eb9d430f8b312152e5aaa078",11,11,50,1.54,5,6,2,1
"7158","322db85f1819dd3f0240fa4acb479a58",64,51,71,6.30985915492958,64,0,2,3
"7159","322eb75d1cd7c66f50236cbb1563876c",37,37,0,37,0,37,1,2
"7160","32303d069e6cbaf6038c1e24dec1d0e8",71,64,32,15.53125,71,0,2,1
"7161","323199766bfc1af98ebc7f5b1163cb3c",24,24,0,24,24,0,1,2
"7162","32348fa262f7552c4ad717a1b645cd6d",159,70,86,12.9418604651163,159,0,3,3
"7163","3234a035c06ea234ec91315c40aa2a26",170,89,49,24.2857142857143,116,54,3,3
"7164","3235ac8c885b49877f4b50e44d81bc1d",152,90,67,15.8805970149254,152,0,3,3
"7165","3237d1144cd3617956f94bc5e37b1b34",27,27,0,27,27,0,1,2
"7166","3238d2c9e166940d5441d0def91e56d1",20,20,0,20,20,0,1,2
"7167","323911b23337c1a76ed0d7cae6aeddc3",23,23,0,23,0,23,1,2
"7168","323967ee180d919b1227aa6188b32775",136,94,53,17.9622641509434,136,0,3,3
"7169","323aaa5e310985cdc3a40b77887fe4d9",36,36,0,36,36,0,1,2
"7170","323d875c58a2f144afeeb8d58941d903",227,111,61,26.0491803278689,174,53,3,3
"7171","323ddcda4f4b00485162c28cf60a37c0",96,74,48,14,96,0,2,3
"7172","323dfbd5982755faff2b95b9053b30ed",22,17,28,5.5,22,0,2,1
"7173","32400c84dd03b630f9aac88ca853b983",77,61,69,7.81159420289855,77,0,2,3
"7174","3242e5012b8f710d4632e52048ddd112",50,50,0,50,50,0,1,2
"7175","3243c2bf09b6e6f3e4f80ad63a0be285",81,54,44,12.8863636363636,38,43,2,1
"7176","32451349c3b1dc52562aa71a459d1b19",117,88,66,12.4090909090909,67,50,3,3
"7177","324579c57681838f914916a06603ec43",14,14,0,14,14,0,1,2
"7178","3249a2276c873bcc13dcce4cbe536f00",100,52,60,11.6666666666667,65,35,2,1
"7179","324a22e87ad5ea70de09be3c0ae9caa9",22,22,0,22,22,0,1,2
"7180","324df50f8bea1aabeb5a6aec12dfcb74",25,25,0,25,25,0,1,2
"7181","325079044213559a3129b5bb0ecfef96",52,41,35,10.4,22,30,2,1
"7182","3250925553a18134d3f8b43ee2756a95",93,73,39,16.6923076923077,93,0,2,3
"7183","325357dbb1da9aedca7431828a6b500d",73,41,81,6.30864197530864,73,0,2,1
"7184","325515ca4da1fdec79896a7a10f90592",37,16,78,3.32051282051282,37,0,2,1
"7185","325820f957af91e3a514ccf2f405e121",116,74,76,10.6842105263158,116,0,3,3
"7186","325a6d82018f4ce4f0945ce1d210a696",157,85,73,15.0547945205479,157,0,3,3
"7187","325b7ec0d2918afe2fd34129706f1fe4",39,39,0,39,39,0,1,2
"7188","325d1333d1ba7d82f6de7b370c0cb03c",7,7,0,7,7,0,1,2
"7189","325f45fb05bd4303af73da3e6617f58c",77,49,49,11,77,0,2,3
"7190","32600db4de03a701e339bd832b3e70f4",36,24,39,6.46153846153846,36,0,2,1
"7191","3261789b63a20f7c42e4197ba5cbac5e",110,77,63,12.2222222222222,110,0,3,3
"7192","326788a14b9bbb24fb73340e079b7f47",25,25,0,25,0,25,1,2
"7193","32682137404ee5b0f62a208a795254cd",67,40,27,17.3703703703704,67,0,2,1
"7194","326a3d0b3433f8db904e182dd2481af2",7,6,2,24.5,4,3,1,2
"7195","326ab579551906e111f317def78373f2",55,46,9,42.7777777777778,55,0,1,2
"7196","326c682d72de9204aeb777699e8b3fd3",58,55,30,13.5333333333333,58,0,2,1
"7197","326d2b34a00a436e4f649de45c886754",22,22,0,22,22,0,1,2
"7198","327111c3a6577843a078170f717f9d80",37,37,0,37,37,0,1,2
"7199","32712f619c69b254918235f708190310",16,16,0,16,16,0,1,2
"7200","3273a4f6fae049bc6707d7aeb7c39a7f",101,60,36,19.6388888888889,101,0,2,3
"7201","32745de2d3082339a420e8bc16a10039",101,77,65,10.8769230769231,101,0,3,3
"7202","32748f224cc9339e5b025a376349d1d0",111,64,70,11.1,111,0,3,3
"7203","327767c22fe5bc0faf8c3ce2e9aca06f",116,82,70,11.6,116,0,3,3
"7204","32780aff07c90e667a93fac0cd32c09c",86,55,46,13.0869565217391,86,0,2,3
"7205","3278be17078f4fe9dfa12fa994ddf117",106,63,63,11.7777777777778,106,0,2,3
"7206","327907c64ae300859cbabda05ad6578a",123,94,69,12.4782608695652,123,0,3,3
"7207","327b67d50c8bd5676c2321e8f0e46f19",123,81,78,11.0384615384615,110,13,3,1
"7208","32811e14931bfc7a263f5d55d4495c49",196,57,51,26.9019607843137,141,55,3,3
"7209","328123fc55963a306c7965f0bc1c4607",37,29,81,3.19753086419753,37,0,2,1
"7210","32815db142c27e3b6a4a59bf751330c6",29,25,56,3.625,29,0,2,1
"7211","32829cf08e3e559e71c42b708871d780",48,40,27,12.4444444444444,23,25,2,1
"7212","32843ef527de9fe059a268eac7ac0b37",173,121,70,17.3,173,0,3,3
"7213","328691740d5a1721a94306b0d6afad79",43,32,57,5.28070175438596,43,0,2,1
"7214","3288dfea0e54516d5640278927870bea",104,53,81,8.98765432098766,104,0,2,3
"7215","328a95e5b359d8e4b0c4482d4f045894",30,30,0,30,30,0,1,2
"7216","328b079972f765a340b3c9cefed4c2ef",26,26,0,26,26,0,1,2
"7217","328bfa7b4081dd38d4817da00e53ce9b",5,5,0,5,5,0,1,2
"7218","328f60bda002456db4a7a0358b468389",28,28,0,28,28,0,1,2
"7219","32907a277e8e4d01420eb89d4d787198",16,16,0,16,16,0,1,2
"7220","3296099f8d9d32c445f6ea1c0545fd97",6,6,0,6,6,0,1,2
"7221","32980f513e486c0c7417328709f56751",2,2,0,2,2,0,1,2
"7222","3298b7f84faaff656b7f9d0f96685eab",23,23,0,23,23,0,1,2
"7223","329992d8c1bcac6ea464d02f45f3f7d2",42,42,0,42,0,42,1,2
"7224","3299ab22ed388cc99f57cd6b73531a67",18,18,0,18,18,0,1,2
"7225","329dfe5355845737949ba7a4da893fad",121,72,39,21.7179487179487,121,0,3,3
"7226","32a34a8dd90b8e76bff4b58653c4f1f7",18,18,0,18,18,0,1,2
"7227","32a460cec5a32e6a6602230cc091b4a4",53,38,50,7.42,35,18,2,1
"7228","32a6e90d580d7c8b226bff21c4f8d394",109,64,42,18.1666666666667,109,0,3,3
"7229","32abc7128c08923a7133b800a43e9136",28,27,5,39.2,2,26,1,2
"7230","32b02bb95fa00a8d6ea4b25d9bb628c9",37,37,0,37,37,0,1,2
"7231","32b105b4ffe3ba0eaaebd0f6cb925761",28,28,0,28,28,0,1,2
"7232","32b31caf8fcc80c2f09564ae28f2a58b",24,16,61,2.75409836065574,24,0,2,1
"7233","32b6561f25da92867b6c2d6b35515792",11,11,0,11,11,0,1,2
"7234","32b7ab2236b1e4e73dc9f66947e825ff",26,26,0,26,0,26,1,2
"7235","32b7b3be97a0f0652945b5744623fec9",33,28,20,11.55,33,0,1,1
"7236","32b8bc582cacf70a116747069c43f4f7",100,59,37,18.9189189189189,100,0,2,3
"7237","32b979f4409ab0f856c7579d8768954d",1,1,0,1,1,0,1,2
"7238","32ba706da131a8c67989b719038e5f2a",83,55,65,8.93846153846154,61,22,2,1
"7239","32bc3f25b32e954d65ff81e6b7f5c815",20,20,0,20,20,0,1,2
"7240","32bf855266bdafcc74afbef4c357cb0b",29,21,56,3.625,29,0,2,1
"7241","32bfed8a40075b4a167c0ba99fa94476",23,23,0,23,23,0,1,2
"7242","32c173ce18c05682f5cde0479001f34d",64,39,61,7.34426229508197,64,0,2,1
"7243","32c4041274acd9216161d6531fb845c3",22,22,0,22,22,0,1,2
"7244","32c5e578e75c66614ee0d03ae7b61cd2",42,34,33,8.90909090909091,42,0,2,1
"7245","32c6e5d07be6a6be3d353215dac32252",126,88,42,21,126,0,3,3
"7246","32c8c72a4be8aab69de62e9fb96a4f8a",120,81,61,13.7704918032787,120,0,3,3
"7247","32ca02c4ef47b00708276d12205f7a84",104,59,71,10.2535211267606,92,12,2,1
"7248","32cc820ac27ff143c3ea976f3fe69d34",27,27,0,27,0,27,1,2
"7249","32ce80d212f714dfed1ed2ed8daa74c2",15,15,0,15,0,15,1,2
"7250","32cef4f320da3de7aaf1e7fcfb1eb3bb",200,95,83,16.8674698795181,200,0,3,3
"7251","32cf32674033e95e43036d219218948a",204,68,74,19.2972972972973,204,0,3,3
"7252","32d34d2620603e65e74f6550ede3272b",17,14,40,2.975,17,0,2,1
"7253","32d70b3422694250c120718e6dfd6b19",117,83,20,40.95,117,0,3,3
"7254","32d71704dcea3de14b67aca18cf447c9",83,47,70,8.3,83,0,2,3
"7255","32d77aa547bbc34e3acf48ae8133cdaf",69,47,13,37.1538461538462,34,35,1,2
"7256","32dc471a978bbfa6faf556bb1968ab61",2,2,0,2,2,0,1,2
"7257","32dcc4324833041f0aec45a558f9b191",99,63,84,8.25,49,50,2,3
"7258","32dd4bd6496e87f866a578336f787413",36,36,0,36,0,36,1,2
"7259","32ded70853a0f62740488397ab6600d0",38,38,0,38,38,0,1,2
"7260","32dfb20c56e9edd1bf1556a0ba841478",4,4,0,4,4,0,1,2
"7261","32dfebec6dad0269a9efcee1b6c232fb",136,87,63,15.1111111111111,136,0,3,3
"7262","32e07461578192687c74f7c57045e56e",106,69,63,11.7777777777778,106,0,3,3
"7263","32e7964f921a42975d1c3c585a8d17f0",206,123,89,16.2022471910112,206,0,3,3
"7264","32e83bf17854709f34d18ffda8f94970",58,36,74,5.48648648648649,45,13,2,1
"7265","32e867b2c2cb16b0cc36a8317cd768ad",10,9,4,17.5,10,0,1,2
"7266","32e8c10feb112e60e336b2f55fceabe8",40,40,0,40,40,0,1,2
"7267","32ea20a14f161d4010fc4e3835114ac0",20,20,0,20,20,0,1,2
"7268","32ead8b9f5d4800a5ea62138e446db26",223,89,84,18.5833333333333,198,25,3,3
"7269","32ebeeca27c67e9faa284aa028dd6cca",32,32,0,32,0,32,1,2
"7270","32ed4659ee5927c04d87a0dc4367c391",26,26,0,26,26,0,1,2
"7271","32f2be0173fd495e0625e9974e94462a",71,29,74,6.71621621621622,71,0,2,1
"7272","32f4a68e7d0c9ed2ee28977cceeb3f97",117,94,34,24.0882352941176,117,0,3,3
"7273","32faaf025d2655db924d1da84e100833",28,28,74,2.64864864864865,28,0,2,1
"7274","32fc06763c71d8750d65d8ef628c8a30",23,21,11,14.6363636363636,23,0,1,1
"7275","32fd106b3f029b82f325d8fb92098f6d",51,37,56,6.375,51,0,2,1
"7276","330200ca67ea70be109da24641360a57",55,55,0,55,55,0,1,2
"7277","331101db47f3e886084bf854398b1314",17,17,0,17,17,0,1,2
"7278","33123c14703f249a06a37bfa78df5060",43,35,74,4.06756756756757,43,0,2,1
"7279","3313565bc76d4c85365a2850fa16af04",52,52,0,52,52,0,1,2
"7280","3313b42393deafde774759ae910d11f0",6,5,6,7,6,0,1,2
"7281","3314059e61b678ef9c7ed1ebb8cfcf01",37,37,0,37,37,0,1,2
"7282","3315efc1ea11e1c86f71e3b8bc918e12",46,37,17,18.9411764705882,19,27,1,1
"7283","3318a5e03d64bc7dbed88383f21aebf7",13,13,0,13,13,0,1,2
"7284","3319aac2ee3a076e837f19c3ac509d09",125,88,61,14.344262295082,125,0,3,3
"7285","331ab627741c273581d4397bda4b5e6a",51,43,67,5.32835820895522,51,0,2,1
"7286","331ad116b2c199b043784db9f2164e7e",13,13,0,13,13,0,1,2
"7287","331b92eadc28821f662303280d0efbf1",57,21,85,4.69411764705882,57,0,2,1
"7288","331c1fbf07a7c3a72f3bfec3562e62d5",14,14,0,14,14,0,1,2
"7289","331c5cb6e22c527ab24c9f61cf0680b0",87,67,72,8.45833333333333,87,0,2,3
"7290","331cd667f23a26d7c6835bbf6f577306",92,64,19,33.8947368421053,92,0,1,2
"7291","331e74a0b12929cadcbffe6ab288ed6a",131,112,24,38.2083333333333,117,14,3,3
"7292","331ee65cd1791ea5ce75e8db425e53b8",35,35,0,35,35,0,1,2
"7293","331eefb3f01c5b6e268e88b9ba6d9220",121,73,24,35.2916666666667,82,39,3,3
"7294","331f603f9eb44039f100e1ed3fae5da4",7,7,0,7,7,0,1,2
"7295","331fa567d256d28e5448c2240025847d",60,48,76,5.52631578947368,27,33,2,1
"7296","33224c7fd311a0119be8156f4ad11146",21,21,0,21,21,0,1,2
"7297","3322bc44141bb31fb9174e92882a80ee",9,9,0,9,9,0,1,2
"7298","3323ca0d68876e5aa41dd1470d958956",101,74,63,11.2222222222222,75,26,2,1
"7299","3324afc197f7481bfdfc695ffad68920",20,20,0,20,20,0,1,2
"7300","33280b56d7fc59a7d1cd067958cea772",31,31,0,31,31,0,1,2
"7301","332b67526b2346acce1be74cdb1b70eb",70,42,66,7.42424242424242,70,0,2,1
"7302","332b9b82b5172ecfb86f1c0f5a91bda4",128,77,56,16,105,23,3,1
"7303","332c3395ead91178297733f0599af3a1",65,54,21,21.6666666666667,65,0,2,1
"7304","332cb88b09d9653b7dc2fbe33c50255e",77,64,61,8.83606557377049,77,0,2,3
"7305","332e71063795768a15046169e28fa0bc",122,80,47,18.1702127659574,92,30,3,3
"7306","33312d604eeee46692728048b770bcab",76,60,68,7.82352941176471,76,0,2,3
"7307","3332cc9187ffe81bbd4cdb9949f429f2",29,29,0,29,29,0,1,2
"7308","333481031ae22da09271e5d62c155406",38,38,0,38,38,0,1,2
"7309","3336fd16cdc98a323082ebb97d9e8257",22,22,0,22,22,0,1,2
"7310","333823273abaa80e4ec732627021a0ba",63,48,34,12.9705882352941,63,0,2,1
"7311","3339de0a59e3a619a9260b5f31da3cd5",106,69,19,39.0526315789474,106,0,3,3
"7312","333ce9792308e964a9d84399594ecc1e",128,82,87,10.2988505747126,112,16,3,3
"7313","333dcd460b986d92b9c681d7df4648f5",92,77,41,15.7073170731707,92,0,2,3
"7314","333ef66d678283cdea062964aa5a71b5",12,12,0,12,12,0,1,2
"7315","333fbc5490cf9077964109438c18d757",31,29,14,15.5,0,31,1,1
"7316","33401a13396c10f0b4fc5f2d720d7525",21,17,16,9.1875,16,5,1,1
"7317","3342fbc3b1623955fd0db604fd3356e0",61,38,42,10.1666666666667,61,0,2,1
"7318","33446715d6155ecda6392b76dbbb5c94",147,74,61,16.8688524590164,147,0,3,3
"7319","3346dc508f83aab2812b44dfec04dcd4",88,68,28,22,88,0,2,3
"7320","3349e82b19be7449585e499c6944e258",170,53,84,14.1666666666667,170,0,3,3
"7321","334c42a31ab4c41fc4a4b57859c56351",37,37,0,37,0,37,1,2
"7322","334c55041449115b6c202e84b164cec3",51,41,67,5.32835820895522,35,16,2,1
"7323","334d2a8ced8e2092a3208efd51d4520a",39,39,0,39,39,0,1,2
"7324","334f4407c8834d2e605921052d29fea7",15,12,66,1.59090909090909,5,10,2,1
"7325","33506ea6a764ce8477dacf0b2839d681",27,27,0,27,0,27,1,2
"7326","3351ca18d2fe5969dd5d73ea467ff49b",37,37,0,37,37,0,1,2
"7327","3351d7859c33a34cfbb59bf68ec52e18",102,88,63,11.3333333333333,102,0,3,3
"7328","33544cd72bbf77af02a7c56f15c3f20f",43,29,46,6.54347826086957,43,0,2,1
"7329","33549fb6b78bbddee68791f608ab6c59",15,15,0,15,15,0,1,2
"7330","3357492154ec926d11a270fc9542d588",33,33,0,33,33,0,1,2
"7331","33588dd4413692492dc314216f8341e3",172,106,85,14.1647058823529,172,0,3,3
"7332","3359ea7d24b92a36b22ae32c081c83a7",49,49,0,49,49,0,1,2
"7333","335a6db2f12c72a2d9090bef349cc3aa",82,67,24,23.9166666666667,82,0,2,2
"7334","335d98d1935f3caa9850e043f5d08570",68,57,12,39.6666666666667,31,37,1,2
"7335","33615907dccb9a93ad51c959a8af1595",18,18,0,18,18,0,1,2
"7336","336223960c2c8fdf76d52f3b8c661245",20,20,0,20,20,0,1,2
"7337","33662bb9ecfa0698762bbbddb3e7e87e",123,82,69,12.4782608695652,123,0,3,3
"7338","3367ebc763f825aca04803d5144c56e8",11,11,0,11,11,0,1,2
"7339","336e0e66ce49adce41c2e6c2f181af22",65,41,64,7.109375,65,0,2,1
"7340","336e7266cee5413e43c30e6cac68e276",13,13,0,13,13,0,1,2
"7341","336fc0f4fea121544fa1550eca209c9f",12,12,0,12,12,0,1,2
"7342","33702390c873516d04572e2bce7a072d",36,28,13,19.3846153846154,23,13,1,1
"7343","337079d560d00c4c8071cbe5e25c7f7b",41,39,11,26.0909090909091,22,19,1,2
"7344","3372721dbda5b1778a05ed0bb6733b8e",22,16,28,5.5,22,0,2,1
"7345","33729061bdfda0a92b4ea0560864a4c9",108,74,28,27,108,0,3,3
"7346","337305ee5df0463c929d977c13344614",27,27,0,27,27,0,1,2
"7347","337566e23851fbccafa4b188e005f55f",62,35,50,8.68,62,0,2,1
"7348","337646c54331ea5186c5bc2d2561ec38",37,37,0,37,37,0,1,2
"7349","3376967694f6884226d22559dc11bea1",55,42,35,11,55,0,2,1
"7350","3376cca98601ae96a8d3cbafa8d4cbe2",117,70,45,18.2,117,0,3,3
"7351","337893e6193fe9f23fe10f40b7e7bb55",18,18,0,18,18,0,1,2
"7352","337998e76377404455d2ffd43645aafc",62,34,89,4.87640449438202,62,0,2,1
"7353","337b80bccfd0ab139874cd1698346c27",96,33,67,10.0298507462687,80,16,2,1
"7354","337c332d8cbbc497a3d6b156f8143af7",17,17,0,17,17,0,1,2
"7355","337e0684cb51f7650e2c2978640075f4",16,16,0,16,16,0,1,2
"7356","337e62a7e47ffcbf9829ae1bcd57cd27",25,25,0,25,25,0,1,2
"7357","337eeec06751e70529d8d19f1943e6a6",177,85,86,14.406976744186,177,0,3,3
"7358","3380510186506bd3a3605e26a9d487ef",35,25,42,5.83333333333333,35,0,2,1
"7359","338259b5bdee762209f519d4891f7a54",60,43,42,10,60,0,2,1
"7360","338482ae6a48e6d19f50440834cfeb1e",55,41,31,12.4193548387097,28,27,2,1
"7361","33858a3d54c3d881abd42a984abb7cf1",10,10,0,10,10,0,1,2
"7362","33868ec457a124ca9934d6f0895ebea0",27,27,0,27,27,0,1,2
"7363","3387a65d3350b1a7cf6d756760aefecf",110,74,71,10.8450704225352,67,43,3,3
"7364","338d93ad03eb12477f6b754fe3eb4b30",12,10,64,1.3125,12,0,2,1
"7365","338ee161b27477d119367f8e0ba9d960",19,19,0,19,19,0,1,2
"7366","3391644356b21f216732e1653b603434",5,5,0,5,5,0,1,2
"7367","3398dccf9759e2b722036548265e48f9",24,24,0,24,24,0,1,2
"7368","3398e8557a108f13d73572f7d8533b6f",38,31,61,4.36065573770492,38,0,2,1
"7369","339911d50d614a358d86c7a1904524c6",156,79,72,15.1666666666667,131,25,3,3
"7370","339b41afa36418c9e08b84ae07878c8d",18,18,0,18,18,0,1,2
"7371","339ca2f9d3371b9e8e685208ef967440",81,63,56,10.125,81,0,2,3
"7372","339dc0c4719f8513314d5c3aab781fbf",54,45,62,6.09677419354839,54,0,2,1
"7373","339f60858b616e858260b901097983bd",33,33,0,33,33,0,1,2
"7374","33a291bed5078f0db918d320207b2985",41,21,56,5.125,34,7,2,1
"7375","33a2fad9a325a2dc6bc8ec17e1289f41",85,48,39,15.2564102564103,55,30,2,1
"7376","33a7f45b698a5b7f31780a4ae3a6502e",120,86,50,16.8,120,0,3,3
"7377","33a855ec325d999cc96ad405ff337970",122,88,29,29.448275862069,95,27,3,3
"7378","33a8c8238643fc9ff98ab14d4146ba90",14,14,0,14,14,0,1,2
"7379","33aa016e8aea97a95aff27b2c3244a38",164,93,63,18.2222222222222,164,0,3,3
"7380","33ad00cb22399e08504138969aec6df0",87,55,49,12.4285714285714,73,14,2,1
"7381","33ade7b3b85b4879537eea4a0ba038f8",69,59,43,11.2325581395349,54,15,2,1
"7382","33ae44b7c81ef3cc71bf57140ded3659",44,44,0,44,44,0,1,2
"7383","33b0353ae5c3595a85275f7e1f5afac6",54,44,35,10.8,54,0,2,1
"7384","33b0fc8fb8d9527ed8518a809d97f8d1",10,10,57,1.2280701754386,10,0,2,1
"7385","33b1c995610fa0ffd80ea6f259699d97",1,1,0,1,1,0,1,2
"7386","33b599688a48c39c3faceaa416c0ed48",43,32,44,6.84090909090909,43,0,2,1
"7387","33b6bde9b6906cd487f74b9735958681",12,10,56,1.5,12,0,2,1
"7388","33b8ce8bc5ca33bd405488ee977ae915",38,31,68,3.91176470588235,38,0,2,1
"7389","33b9c39a4a5000b25e7df27e3bee1f23",15,15,0,15,15,0,1,2
"7390","33bbadc7094210bd39adaf0ea884d642",41,41,0,41,41,0,1,2
"7391","33bcf14008f89319312cbfb557d29bcd",46,41,27,11.9259259259259,46,0,2,1
"7392","33bd3199db43265988e2432ab0aa95c0",217,110,75,20.2533333333333,217,0,3,3
"7393","33c091869fea107dcf01bd28e183d4b0",10,10,0,10,0,10,1,2
"7394","33c0e86b43b1e59de9789ddda314f06c",50,39,72,4.86111111111111,50,0,2,1
"7395","33c243abde87a5050e643a07bd9ef893",54,37,73,5.17808219178082,54,0,2,1
"7396","33c2e5cef05438505ed96d44613420bd",16,16,0,16,16,0,1,2
"7397","33c33d96269ad467eae378b0ee7c5416",49,46,47,7.29787234042553,49,0,2,1
"7398","33c8d7057b44628281313dc50546ab93",40,40,0,40,40,0,1,2
"7399","33cc5ce64606c47e2745825c43192fa6",29,21,56,3.625,29,0,2,1
"7400","33ce5812ab95400d07acb7a02b38ebbc",37,31,21,12.3333333333333,37,0,1,1
"7401","33d34524c5c41f204bdfd33e9add3f86",59,53,81,5.09876543209877,18,41,2,1
"7402","33d47be5a720fd83ed8e0f1df96e9c4a",19,19,0,19,19,0,1,2
"7403","33d70ad43ff691ea182bd15d01b25c60",19,19,0,19,19,0,1,2
"7404","33d74546d3dfdefc79e42777a22b02b8",16,16,0,16,16,0,1,2
"7405","33d7956d1a9617829b2f23e23a45bf3a",49,49,15,22.8666666666667,20,29,1,1
"7406","33d7ea9b3fec3f4a2b93bbda3d46abff",6,6,0,6,6,0,1,2
"7407","33da70dfb1da36198466dbda997e08e5",13,11,33,2.75757575757576,9,4,2,1
"7408","33dae729ae4d4feebac399040ee7fe41",201,56,77,18.2727272727273,201,0,3,3
"7409","33db19525a825c4db94f459c2d12c217",24,24,0,24,24,0,1,2
"7410","33dbb4a7c0a20ef88a95b67646a0876d",34,23,56,4.25,34,0,2,1
"7411","33dc8b1f4a07ea1a540d113c825479be",12,12,0,12,12,0,1,2
"7412","33dd693c58814a84d6c3e4e42bb13fdc",2,1,2,7,2,0,1,2
"7413","33dfce5068ff282d2fd26491161753b6",26,20,56,3.25,26,0,2,1
"7414","33e18b88b9f280410c7e5bd718c36894",53,53,0,53,53,0,1,2
"7415","33e19483363f173d2d1d1e5076538ece",97,47,78,8.70512820512821,97,0,2,3
"7416","33e1c4eb78b91d28e64c1188b0598aca",33,33,0,33,33,0,1,2
"7417","33e4d3f6f408108368418b34e8860b8a",27,21,68,2.77941176470588,27,0,2,1
"7418","33e70b48b9eb31ed8aff9a10d5c726cd",38,38,0,38,38,0,1,2
"7419","33e79679f58c2619852245d3f20afd2f",11,11,0,11,11,0,1,2
"7420","33eb7fd4ecd8c1206a24415d18f7a999",21,21,0,21,21,0,1,2
"7421","33eb9297aef7f3db564e0a26537d2f15",154,129,64,16.84375,154,0,3,3
"7422","33ec259268a3a70db2633eed3ca6a308",136,81,88,10.8181818181818,136,0,3,3
"7423","33f11d522862e5cad54ebbb08d45dc16",17,17,0,17,17,0,1,2
"7424","33f40c7e635d3ae08b01fc13cf547c94",8,8,0,8,8,0,1,2
"7425","33f419cad6b0d476318859240cc0f3f2",147,99,42,24.5,147,0,3,3
"7426","33f43a7d294c26bbda3c302da70af94f",15,10,62,1.69354838709677,15,0,2,1
"7427","33f53c15c3b8fee4a32d3e0c4508f69a",156,111,31,35.2258064516129,114,42,3,3
"7428","33f6fdc576a57609fcc20ca1153874d2",32,32,0,32,32,0,1,2
"7429","33ff91bc2619ab873efa47de543d3da1",42,42,0,42,42,0,1,2
"7430","3401eac7602f5cfadd6db38cb773b9a1",30,30,0,30,30,0,1,2
"7431","340551a02556be0a0d82d74f2b8491af",48,36,26,12.9230769230769,25,23,2,1
"7432","34072934445e499928b2697640f4d0b4",4,4,0,4,4,0,1,2
"7433","34092efa2224716ad7781651df834143",173,99,41,29.5365853658537,173,0,3,3
"7434","3409af624a966856d10d0171a63a9306",14,14,0,14,14,0,1,2
"7435","340ae8810ae2a07909a7ed8817a4a93a",39,39,0,39,0,39,1,2
"7436","340eb9901b611d63bdcb8462db6b6770",105,88,25,29.4,105,0,3,3
"7437","34105073463ea5ba648dc5c102a8fe38",32,32,0,32,32,0,1,2
"7438","3411f7cb8e28093c50637396a885c238",103,85,34,21.2058823529412,103,0,3,3
"7439","3412aadfbba0707a76b35029732cfe55",57,45,38,10.5,57,0,2,1
"7440","3414cdbdf15cbc76617c0cbea4b16289",19,19,0,19,19,0,1,2
"7441","34155fcf4c0316213fa0339a8c9c9a0c",60,49,49,8.57142857142857,49,11,2,1
"7442","3416f0e5ec1dde8c8b63f92c9cfc25b9",26,26,0,26,0,26,1,2
"7443","341b3c6587b16f165b0cd88f874dada2",38,38,0,38,38,0,1,2
"7444","341d8550d5c0bc4ac8f3c0c1cb273490",32,32,0,32,32,0,1,2
"7445","341f7036927615de3e85c3716e27592e",19,19,0,19,0,19,1,2
"7446","342073d70d67e6c8666a96c34b8c08d9",60,50,63,6.66666666666667,15,45,2,1
"7447","3421d9c3449f7d51338374aca1a985d2",30,30,0,30,30,0,1,2
"7448","342215354dd2eb2cd1454df41438d524",130,86,64,14.21875,130,0,3,3
"7449","34259cfc4d1391b2e5d5c70670df1d4d",63,52,32,13.78125,34,29,2,1
"7450","34266c8f0ef81f4ab4e0daf5993d5dbc",77,26,88,6.125,77,0,2,1
"7451","3428070b833cb613497ad7025c44b280",83,68,57,10.1929824561404,83,0,2,3
"7452","342aad24800379a0b3ac5ef4f72608fd",20,19,30,4.66666666666667,20,0,2,1
"7453","342b1f91abf41334074ab1b32cdad955",33,26,22,10.5,33,0,2,1
"7454","342cc97fc022ace5aaffbbb8daf0732a",91,40,76,8.38157894736842,67,24,2,1
"7455","342d55be766c61ca9876962ea71405df",37,37,0,37,37,0,1,2
"7456","342fd28fab24f6066f6b42e4b051eb5e",37,27,35,7.4,37,0,2,1
"7457","34314de86e124af5a0341213ab7a3cfa",32,32,0,32,32,0,1,2
"7458","3432156462c8f46d7261284483c11b56",50,46,64,5.46875,50,0,2,1
"7459","343345c5e5de444cd84ab7fd0e4518db",30,27,33,6.36363636363636,30,0,2,1
"7460","3433666c4b8f2df29fab5c9105284824",87,56,69,8.82608695652174,87,0,2,3
"7461","343452fda76cecd880171c8cae70bbe7",14,14,0,14,14,0,1,2
"7462","343551f13074d031e5c25ac128d78c6c",53,43,61,6.08196721311475,25,28,2,1
"7463","3436f8acf63ad0b1497eee031e44241d",84,54,58,10.1379310344828,84,0,2,3
"7464","34377337781f5c83ceae123c42778b40",1,1,0,1,1,0,1,2
"7465","34377df3e201562fdf8b5a9507722401",34,34,0,34,34,0,1,2
"7466","343be611d471c823f70c5280f42e476d",11,11,0,11,11,0,1,2
"7467","343e64be8db5ba4c16a14d1ca7b63874",28,28,0,28,28,0,1,2
"7468","3442c95211e33c4553cf2610d9703f67",47,40,21,15.6666666666667,0,47,2,1
"7469","34439118922fe02439d26059e9692c37",22,22,0,22,22,0,1,2
"7470","3448efb0dc109d2c5b83a9f1ec0f47d9",33,24,37,6.24324324324324,22,11,2,1
"7471","34495faec25f5963fb1bc64bfd4daf0e",25,25,0,25,25,0,1,2
"7472","344e324cc31cd295027b0a25e44b15b6",240,97,74,22.7027027027027,194,46,3,3
"7473","344eea80f83eecc75872d019482e0cbb",191,117,40,33.425,191,0,3,3
"7474","344ef6d5561763443abc19f248e9c6d4",122,96,62,13.7741935483871,122,0,3,3
"7475","34509227c91fc5e0d6d5b72201891e7b",109,79,46,16.5869565217391,73,36,3,3
"7476","34511cd2d682b67e834d53bb6f508388",123,67,64,13.453125,123,0,3,3
"7477","34512764965867d99f5c9e4aee3714fd",74,62,13,39.8461538461538,74,0,1,2
"7478","345179f28e0fae08cad536c2be37bad8",109,81,39,19.5641025641026,109,0,3,3
"7479","3452b60bfaf7a86ed99cd80d99fb68e4",13,13,0,13,13,0,1,2
"7480","3452ce695f95957eff0e826e13513f27",198,141,87,15.9310344827586,158,40,3,3
"7481","345384fb33bf9d59cf0488dee816e201",48,35,41,8.19512195121951,48,0,2,1
"7482","34555a588ec5aaa9c5fdb8e98efa004c",34,34,0,34,34,0,1,2
"7483","34564b89fa3242ae4f834fd7b39bb587",126,73,53,16.6415094339623,126,0,3,3
"7484","345a159781d375ef921216e06fbcb7c5",96,79,72,9.33333333333333,50,46,2,3
"7485","345c41f63abaf0d0ea173779d1702c1f",28,28,0,28,28,0,1,2
"7486","34630090fe136a09173bd283d96da0e4",130,84,57,15.9649122807018,130,0,3,3
"7487","3466a37884c9bf0a34b421dad14c8525",22,22,0,22,22,0,1,2
"7488","34694abd0a1c42ab1337de82a3bf5daf",52,23,70,5.2,52,0,2,1
"7489","346b1bdef2a38c4506ea128ccf8fd772",59,42,36,11.4722222222222,59,0,2,1
"7490","346da5eaace919e9d5158d04b27a2b9f",9,9,0,9,9,0,1,2
"7491","346e77f4269f44627ad221dee3e9a6ce",71,55,26,19.1153846153846,71,0,2,1
"7492","346edb5db71ca736f57bc0063dbeda47",129,90,63,14.3333333333333,97,32,3,3
"7493","346f21a217ec749b96bd74c5e9fe1f1c",25,25,0,25,25,0,1,2
"7494","347301eea0581c928f8d0c6f7f0cfad4",51,51,0,51,0,51,1,2
"7495","34751f8f86bcedbbdda432bb3a3ce345",30,30,0,30,30,0,1,2
"7496","3475ca3c65c6911f17d3fbc9c88f89ac",116,81,77,10.5454545454545,116,0,3,3
"7497","347657d83d02babae915b3c19fcd2115",94,77,42,15.6666666666667,94,0,2,3
"7498","3477baa67296e54cdf78d059791b7a24",89,48,59,10.5593220338983,89,0,2,3
"7499","34780b6966b8b33c95cf165e7d4cc558",17,17,0,17,17,0,1,2
"7500","347acee08fdd3ca5b73b30cd2c0d4048",132,93,78,11.8461538461538,132,0,3,3
"7501","347b316982bac3aa852fbc2dac978ae5",190,122,70,19,190,0,3,3
"7502","347bfd4198c9042de949fc13b3fcd67b",20,20,0,20,20,0,1,2
"7503","347d40940c0c03495277d6c5d7a4036d",42,42,0,42,42,0,1,2
"7504","347d45b71e20d661802fb1ce99a7808f",6,4,68,0.617647058823529,6,0,2,1
"7505","34877d0457c926ee3a68bc06c586014b",12,12,0,12,12,0,1,2
"7506","348991ee4005b874b59f4c176083ebce",63,58,59,7.47457627118644,25,38,2,1
"7507","348eaf7bbdfc9bdb7f5a5714fda1cdea",27,27,0,27,27,0,1,2
"7508","3490a6e1f0af85469e5206dcb0278728",41,41,0,41,41,0,1,2
"7509","3491e3601b85f3308c1f6ed1e4134cd4",36,35,33,7.63636363636364,36,0,2,1
"7510","3496708968f608eb2043a760f6185430",153,75,78,13.7307692307692,153,0,3,3
"7511","3499e860311d1b79827384d067a46d80",40,38,80,3.5,23,17,2,1
"7512","349c111a78315e0323852522ff686b06",25,25,0,25,0,25,1,2
"7513","34a0df8c127d08341357051d0159f1ca",28,19,34,5.76470588235294,28,0,2,1
"7514","34a43df82dee007a9e9715e78fef8064",34,23,52,4.57692307692308,18,16,2,1
"7515","34a6f3a0427b00d0b680369b51962388",20,20,0,20,20,0,1,2
"7516","34a7c7e4a4d460f0a07fa9b61f453cae",14,14,0,14,14,0,1,2
"7517","34aa179de27259ad50ae759a0e323b51",81,51,71,7.98591549295775,81,0,2,3
"7518","34ad07814b5d106429282881e6876245",90,60,64,9.84375,90,0,2,3
"7519","34adfb22bdfcfabb3477c8db615795e3",34,26,23,10.3478260869565,18,16,2,1
"7520","34ae82d78f3ad90171510db8a5f841e0",23,23,0,23,23,0,1,2
"7521","34aee5b193a9836d72fef5f9654cfc4d",15,15,0,15,15,0,1,2
"7522","34b03afdab69161826920c03001fe596",79,62,56,9.875,79,0,2,3
"7523","34b07d977e60672e93794c54f48fb04a",67,45,56,8.375,67,0,2,1
"7524","34b67546fff98d6b9b5a1a9f2ef00116",21,21,0,21,21,0,1,2
"7525","34b6aca05eb77cdd94c6ffce7a7a9230",20,20,0,20,20,0,1,2
"7526","34b787da992969028f610a21a327a1ec",31,31,0,31,31,0,1,2
"7527","34b8148fa249873c24d062b31bb4e11f",71,65,31,16.0322580645161,71,0,2,1
"7528","34b97293db2acb08d991fec2adb84155",237,115,74,22.4189189189189,189,48,3,3
"7529","34bac37bbe0a08835687220cde776897",31,31,0,31,31,0,1,2
"7530","34bb84e14435ed516d594cb5892fd063",66,54,31,14.9032258064516,66,0,2,1
"7531","34bc86d33f09cda4805206fec7bbe907",67,50,59,7.94915254237288,67,0,2,3
"7532","34c04ae3ac9580bbed93281437ec6999",101,59,50,14.14,101,0,2,3
"7533","34c07249bb80d20ce8dde8092577b17d",118,79,77,10.7272727272727,118,0,3,3
"7534","34c325b26157eae340be0cb5c3ab5f7f",20,20,0,20,20,0,1,2
"7535","34cb83359f523b30aa3e6c063d8797c2",24,24,0,24,24,0,1,2
"7536","34cc384959df5360db9ad9296deab349",26,26,0,26,26,0,1,2
"7537","34cc7e123e9e045e66c6d3ab8bd1817c",11,11,0,11,11,0,1,2
"7538","34cd5d91de2165c11ec18e2e80c6f87f",38,38,0,38,38,0,1,2
"7539","34d022617025609209c7af769111e652",212,113,85,17.4588235294118,212,0,3,3
"7540","34d1d4bbfce87f150ff9fdab090eb3d1",86,62,76,7.92105263157895,40,46,2,3
"7541","34d26e113fce71eb4b20e736ef6b8b7c",134,51,73,12.8493150684931,94,40,3,3
"7542","34d3381daf10b0e0a1030860d74cec37",95,72,37,17.972972972973,95,0,2,3
"7543","34d37cf45a08734a446fc8ee7f7e4b17",68,54,41,11.609756097561,33,35,2,1
"7544","34d5b8f36be0b7cbfc1e73d492664ad0",26,16,76,2.39473684210526,10,16,2,1
"7545","34d683c1c0a90d62df47f0fbfa1b9a44",23,23,0,23,23,0,1,2
"7546","34d7398b1781eda3498912387bff13f9",33,27,59,3.91525423728814,33,0,2,1
"7547","34da024ba1fb3630a5bbd56676d439ec",164,104,55,20.8727272727273,164,0,3,3
"7548","34db068ca4c13e15e6759eb4741b0155",19,19,0,19,19,0,1,2
"7549","34de7e66cc930e8303fe8482a818a577",30,30,0,30,30,0,1,2
"7550","34df0f1ec9498575a77e2b8fda93c610",12,12,0,12,12,0,1,2
"7551","34e57b8b3105870be88f33e7d62dbcc4",43,29,42,7.16666666666667,43,0,2,1
"7552","34e5d7ad485f4f21f72faa132876a48b",31,31,0,31,31,0,1,2
"7553","34e6d25aa7828ed2446724cd7bdb6e6f",153,112,56,19.125,127,26,3,3
"7554","34e95c124399e6716c8c9f77a4a1e1c0",28,26,12,16.3333333333333,28,0,1,1
"7555","34ea4633a153b0ec14405bb2cc416da2",14,14,0,14,14,0,1,2
"7556","34eea9c2e27c4106d898cf22cbdfd366",79,63,29,19.0689655172414,28,51,2,1
"7557","34ef2c6bc137c91aa4591d1db7551731",11,10,20,3.85,11,0,1,1
"7558","34f0543e52e33be88898ceb8f20a3de7",55,45,61,6.31147540983607,37,18,2,1
"7559","34f0d7786ddc5c8f7996a09913861a36",32,23,61,3.67213114754098,22,10,2,1
"7560","34f33e3a8fe0cdaff47c4f14a08e7363",50,42,38,9.21052631578947,50,0,2,1
"7561","34f3f5d47d2e34cdc847e7882e83ee0d",55,37,53,7.26415094339623,38,17,2,1
"7562","34f44fdc2a10f8b069ac2b520ee7c7cd",179,100,46,27.2391304347826,131,48,3,3
"7563","34f5998b156d892c24efdd716cb0f971",184,89,55,23.4181818181818,184,0,3,3
"7564","34f5a4cff0b6030dddcac07cc7333253",33,33,34,6.79411764705882,33,0,2,1
"7565","34f7c9c483982c005c0f129ebfb9c133",22,22,0,22,22,0,1,2
"7566","34f902b60557a649486e472a7b6897af",47,47,0,47,0,47,1,2
"7567","34fc415af12b58fb7afe922296a16df6",31,31,0,31,31,0,1,2
"7568","34fdeeb6cdee2341e79f9245c81a180d",101,66,80,8.8375,73,28,2,1
"7569","34ff95266e5f0249ec61aaf61d83edfa",5,5,0,5,5,0,1,2
"7570","35038549b976b55761b5c366efd4464c",101,63,50,14.14,101,0,2,3
"7571","3505c544e063f8045f2a8b65d0f5d9de",22,21,4,38.5,21,1,1,2
"7572","3505dc17ccf2aab57f2302bcb9a6b58c",135,65,59,16.0169491525424,85,50,3,3
"7573","3506858a168fb8c089f5598e0b831767",19,19,0,19,19,0,1,2
"7574","350c102ae04dd7f49af9a8b0740fbab3",39,39,0,39,0,39,1,2
"7575","35108546261f325f716b662022b9b8b4",1,1,0,1,0,1,1,2
"7576","3510d4b9d32a5628471524c67fdb8280",7,2,63,0.777777777777778,6,1,2,1
"7577","351131aa32aaea8806db43de644459ef",14,14,0,14,0,14,1,2
"7578","35114508f906e02335bf6945209c3fb7",76,62,39,13.6410256410256,39,37,2,1
"7579","3511fa0b12c9cab220456f7cb46ddd1f",28,28,0,28,28,0,1,2
"7580","351210e46e5e1c3176889c7ac9a0d75c",95,68,70,9.5,95,0,2,3
"7581","35161674c09b2a4550034c0218efecd5",9,9,0,9,9,0,1,2
"7582","3516c2a3658c95503d72f65bdbbe9cd0",26,26,0,26,26,0,1,2
"7583","35181ee2a53ec4080e2cfc38df72bb86",26,26,0,26,26,0,1,2
"7584","35184151a59de013e91e59287c0c9f41",34,34,0,34,34,0,1,2
"7585","3518a6a892bfb9e51c8a967b3415abdb",32,32,0,32,32,0,1,2
"7586","351a2fa0c093966e6e4137b10b4f8fe5",20,20,0,20,0,20,1,2
"7587","351afa2ca705790ace8e4996308b9b0e",16,16,0,16,16,0,1,2
"7588","351b1d3233a606a18a310a59396fde6e",125,103,65,13.4615384615385,90,35,3,3
"7589","351bbd0939a2cd954aa702a8250149c3",72,56,37,13.6216216216216,50,22,2,1
"7590","351d759f761d08332b26de5dda4c3b1e",23,23,0,23,23,0,1,2
"7591","351db5b89c2eab30f4ce4c89bcf3b573",36,36,0,36,36,0,1,2
"7592","352009064e54a563bd7735499ea7caa2",8,8,0,8,8,0,1,2
"7593","3521e95af041739167351b3100ff4f27",82,71,14,41,41,41,1,3
"7594","35244647fd80a668a274fb6b1ec2680c",45,45,0,45,45,0,1,2
"7595","35245a1b508ae958b9dc3a54e1d6b7b5",135,87,49,19.2857142857143,135,0,3,3
"7596","352a5600dc2ae32ee2668fc2972ef9e2",16,16,0,16,16,0,1,2
"7597","352a8f2ac4f8b14ba6d7faf8c21de85f",15,15,0,15,15,0,1,2
"7598","352cd58a90587ba44ab5a9711e7e0e51",143,84,70,14.3,143,0,3,3
"7599","352f02b1eeed80301a36bc47fc717139",86,73,40,15.05,86,0,2,3
"7600","35314c7f3378be7e7b64f3e343fe1ec5",36,36,0,36,36,0,1,2
"7601","35315bdc8280873db1074a0787b6b6ad",92,65,34,18.9411764705882,39,53,2,1
"7602","35331a1af82f3696347099b08fbc39af",20,20,0,20,20,0,1,2
"7603","3533f079d89fb596f2e62b3a9debedff",160,124,58,19.3103448275862,160,0,3,3
"7604","353405722188302112983d67b4787ad9",69,50,44,10.9772727272727,69,0,2,3
"7605","35346ddc1b76152348a3826cf8e2fc8d",17,17,0,17,17,0,1,2
"7606","353473d7fb5f1d23e486e385e475838c",8,8,0,8,0,8,1,2
"7607","3534d195059388ee8dea6f64fe2d85ed",1,1,0,1,1,0,1,2
"7608","353bb8b7ff4b8464bc7d4168fd7f9673",18,18,0,18,0,18,1,2
"7609","353bcc85b8d2753104f393458fef09b6",32,32,0,32,0,32,1,2
"7610","3540a273ad179677c0300a6ebd5700b7",118,95,54,15.2962962962963,118,0,3,3
"7611","354119a728e53c67f9adffc7b24019a0",54,45,31,12.1935483870968,54,0,2,1
"7612","354124189c7e6a3d9e55a34e25fc0bcf",117,89,64,12.796875,117,0,3,3
"7613","3543139401d4b7f555bd44c15b75fe32",118,69,53,15.5849056603774,118,0,3,3
"7614","3543e67346753c8c91a21f995704b57e",26,26,0,26,26,0,1,2
"7615","3543f24131f2a93343cd34874713c9d0",134,112,65,14.4307692307692,106,28,3,3
"7616","35465517cc67f559f589e88bc5d428a6",20,20,0,20,20,0,1,2
"7617","3547ef9cbf8ccbc5ebdb36e364546b8f",27,22,34,5.55882352941177,27,0,2,1
"7618","354e222507d4e0355a2a9b760bd8ffef",18,18,0,18,18,0,1,2
"7619","354f538f597e618575a0040fe2cb8c1e",108,31,81,9.33333333333333,86,22,2,1
"7620","3552b4b121c5562d9ffb2050b731efe8",92,78,28,23,92,0,3,3
"7621","35538e656f579929baabc769154e58eb",66,52,38,12.1578947368421,66,0,2,3
"7622","3556e5017d0f2a62cecbd096a1f766e2",34,32,32,7.4375,15,19,2,1
"7623","355b3e9a28efcb1d9451c4bba4e8fd62",67,62,11,42.6363636363636,33,34,1,2
"7624","355ca175f851df2ae98e35812895df36",34,34,0,34,34,0,1,2
"7625","355dbec80d29336774238419e54b5da0",48,48,0,48,48,0,1,2
"7626","355f7dc45f260aaebba13bb3e95ebc1b",127,87,55,16.1636363636364,127,0,3,3
"7627","355fc08eeee6590b65607badc3d5bfa1",38,38,0,38,38,0,1,2
"7628","35601eccce7aa5f5b2ac3d5a0e969384",86,70,68,8.85294117647059,55,31,2,1
"7629","35602288f45736b402aa86df4e69a075",145,65,74,13.7162162162162,112,33,3,3
"7630","3561501d8bfe11f049f5c52c8ce051a1",75,53,51,10.2941176470588,38,37,2,1
"7631","3562513f3cb70030da5cd5a1b827c773",32,29,60,3.73333333333333,32,0,2,1
"7632","35633451f98d02b5e70b3282cc2ab1c5",181,98,52,24.3653846153846,137,44,3,3
"7633","356462997d8cfb7067fcbc341b617903",6,6,0,6,6,0,1,2
"7634","35666e3b6cc0152d9026d0379e1c9728",43,20,84,3.58333333333333,43,0,2,1
"7635","3567a7226c100224d8962f30b3a95cfc",36,36,0,36,36,0,1,2
"7636","3568bd85c48060db42fb1b4712a6a649",77,60,29,18.5862068965517,77,0,2,1
"7637","35697f4b958e0bc951599171f669357c",6,6,0,6,0,6,1,2
"7638","3569fb523a68ddeeeda10a30e9c7447e",118,54,89,9.28089887640449,118,0,3,3
"7639","356a4b5e9e754b9942ed88319531fc05",31,11,81,2.67901234567901,31,0,2,1
"7640","356efe9e58ce4f708e2c91cf42dcde76",32,32,0,32,32,0,1,2
"7641","356fd737ddc8366ff6e58b7712d3b202",111,66,72,10.7916666666667,111,0,3,3
"7642","357168e05858548c9f5a0c878f4398ca",37,37,0,37,37,0,1,2
"7643","35728c529b17dde9b118988e907fc995",173,92,89,13.6067415730337,173,0,3,3
"7644","3573ec6e29af9fe2c122ebd92a3450ea",10,10,0,10,10,0,1,2
"7645","357641a7dae5978384f44d2421c26633",21,21,0,21,21,0,1,2
"7646","35780ee7ad123f7b04e4c728daf2dce7",29,29,0,29,29,0,1,2
"7647","357c47d5b738bb58d0a1ee0a5871ef72",80,65,31,18.0645161290323,60,20,2,1
"7648","357cd2af4cc46865f59eba8b261423d7",32,32,0,32,32,0,1,2
"7649","357d70d4bda13cff5df1fd9b344b8af2",148,92,61,16.9836065573771,106,42,3,3
"7650","357f1e168c0b1d9449e828e373975be3",16,16,0,16,16,0,1,2
"7651","357fba51ccc2ccc33fb341b161a4b08a",47,47,0,47,47,0,1,2
"7652","35812114e112a766fb4b5a6926c80f2e",103,51,60,12.0166666666667,103,0,2,3
"7653","35849143923b7d226a4c3a647bfe18c8",213,118,78,19.1153846153846,175,38,3,3
"7654","3585368baa949a3ced522bd553a0d192",29,25,43,4.72093023255814,29,0,2,1
"7655","358688b914133ddabf1d28b5da7e16c9",95,73,51,13.0392156862745,95,0,2,3
"7656","3587ab924d45c47ace67d4ea046d6f7b",176,83,76,16.2105263157895,176,0,3,3
"7657","3588032e50000762c61c5d475f572b8f",50,31,63,5.55555555555556,50,0,2,1
"7658","358964d441ef01174b370b0e18885591",31,28,66,3.28787878787879,16,15,2,1
"7659","358d8c0a51cca3bfa1cf7d3080fcce3b",18,18,0,18,18,0,1,2
"7660","358f75097de4cb982adace3e0865ad29",48,39,67,5.01492537313433,48,0,2,1
"7661","35904388cc75c5a7c1bac3f184c08f82",81,67,37,15.3243243243243,81,0,2,3
"7662","3590b36a0c46c0b375a2e678909fead4",31,24,61,3.55737704918033,19,12,2,1
"7663","3593c55876be11dfc1199c33fc677945",27,27,0,27,27,0,1,2
"7664","359c8e60fe4b02110fb076999389403f",36,36,0,36,0,36,1,2
"7665","359d44793cce7d3b94651d8f72e33f25",147,74,60,17.15,147,0,3,3
"7666","359d787d98c1c7477c121d655f6b23ea",119,64,62,13.4354838709677,119,0,3,3
"7667","359de6d473430e19e412d7c87c2fe680",137,76,85,11.2823529411765,137,0,3,3
"7668","359e17bbd7013ade2b0f6b7b5522b1bb",14,14,0,14,14,0,1,2
"7669","359e72309b772c0a3c0969d4825764ba",15,15,0,15,15,0,1,2
"7670","359ea0c908d46a191df08dfdbe9c65ec",88,71,71,8.67605633802817,88,0,2,3
"7671","35a5bad6b00538c0ba8c8f98375cc76d",123,80,26,33.1153846153846,87,36,3,3
"7672","35a863f20d937237150087f604e805ee",150,78,57,18.4210526315789,150,0,3,3
"7673","35a878600a29720780f9037192d9f5a7",45,45,0,45,45,0,1,2
"7674","35ab14646f8a8eb0d0c4213489d278e0",162,131,28,40.5,162,0,3,3
"7675","35ab354f6de04c17f2a2af48078a82db",70,62,30,16.3333333333333,70,0,2,1
"7676","35ac18ab7549a19b1626f2f89e15a637",51,48,24,14.875,33,18,2,1
"7677","35ac4dc0fdb7a41d03a18ff2a9cd0605",22,18,44,3.5,22,0,2,1
"7678","35ac5abb8d89ad6a414b8571af6275d9",57,51,14,28.5,57,0,1,1
"7679","35ac8f0a7c12dac77d41dd4ad2d866cb",23,23,0,23,23,0,1,2
"7680","35ae65e14c9afdd51f4a5d2d73a05330",46,46,0,46,46,0,1,2
"7681","35b1d47ab31be0e749dd9039888a81d2",29,19,40,5.075,29,0,2,1
"7682","35b2dcd3eac8cd9c16fbd700025d461a",18,18,0,18,18,0,1,2
"7683","35b348e788ae23d0bb8e1352e696a2e8",195,79,81,16.8518518518519,195,0,3,3
"7684","35b566203e9d2edf1f6770de0e3386eb",14,14,0,14,14,0,1,2
"7685","35b6094bdb5f036d083defa52f3732d7",61,45,59,7.23728813559322,61,0,2,1
"7686","35ba9020cae8275dff53883807b79681",18,18,0,18,18,0,1,2
"7687","35ba9da56a321935682ea6323400ce1e",24,20,27,6.22222222222222,24,0,2,1
"7688","35bbf9f035ee1437ceb2ae180786bd07",18,18,0,18,18,0,1,2
"7689","35bc70d047b87b3759e462fc9dafd2c6",36,36,0,36,36,0,1,2
"7690","35bd0f763c612ee743560a4afca58e5f",39,39,0,39,0,39,1,2
"7691","35bdfc3cdb026b90ad9f219becabb3be",113,84,53,14.9245283018868,94,19,3,1
"7692","35be5876415a1964ccdc46589ab6b70f",30,29,16,13.125,30,0,1,1
"7693","35bf8b5f32694c550ac7da088c9f4809",54,43,54,7,13,41,2,1
"7694","35c0be86dd61bbde927ab817d4a42f8f",1,1,0,1,1,0,1,2
"7695","35c14d333fc97a029e24e5f37fb21076",34,34,0,34,34,0,1,2
"7696","35c214853bd3e68bd3060b87c3f0d9a2",46,41,62,5.19354838709677,36,10,2,1
"7697","35c8b1ddeea3941214f73020b355b333",74,57,31,16.7096774193548,74,0,2,1
"7698","35cc9dccf2f29e303dc4324b58909e85",64,50,18,24.8888888888889,64,0,1,1
"7699","35cdbc32c4af0fdedb72016b239284e4",20,20,0,20,20,0,1,2
"7700","35cf48f9b3f534d9972ba9266dda9c39",53,31,50,7.42,53,0,2,1
"7701","35d347e89d12b117e6f027631cc41b3d",128,61,76,11.7894736842105,128,0,3,3
"7702","35d4745f771e9b961a8ce39aede642aa",59,44,49,8.42857142857143,59,0,2,1
"7703","35d6d9868514451d2d0399501a1c1b39",12,9,33,2.54545454545455,12,0,2,1
"7704","35d870fd22166791eee54b3939720c2f",24,17,38,4.42105263157895,24,0,2,1
"7705","35da30fabb6cc94efa4bfd330128533f",10,9,7,10,10,0,1,2
"7706","35db8ddc46534aa16e60c90c6adfe936",115,101,55,14.6363636363636,67,48,3,3
"7707","35ddc29917a8748331591ad7972358cd",67,49,25,18.76,35,32,2,1
"7708","35df73dccd8622977301aaa7116c5d1a",36,33,47,5.36170212765957,36,0,2,1
"7709","35e22de00bbd42e3114e301aac49f299",31,31,0,31,31,0,1,2
"7710","35e3a14aa07e621799fa9eb6a9918390",66,60,37,12.4864864864865,66,0,2,3
"7711","35e42de6b65f4f69e9dc408d96d54f3e",52,47,17,21.4117647058824,52,0,1,1
"7712","35e7b6a9cbe1510e75d8a4cfc946e34d",211,112,65,22.7230769230769,211,0,3,3
"7713","35e8959506a51feadf9947d57211c309",33,33,0,33,33,0,1,2
"7714","35ea038019abc4cfbe6e6777b2972a65",33,33,0,33,33,0,1,2
"7715","35ebf8e403818d4114f78787a2b1c91d",61,52,22,19.4090909090909,29,32,2,1
"7716","35ee885c1e43ab308c5c0f1e1df3ae24",131,76,62,14.7903225806452,86,45,3,3
"7717","35eebbc35ffebd8469df9f25c7bec6eb",45,25,84,3.75,45,0,2,1
"7718","35f1af736de420ccc5d1f326f7578c5b",86,62,42,14.3333333333333,86,0,2,3
"7719","35f37454223ef11af5b05bd2a142158b",196,146,80,17.15,196,0,3,3
"7720","35f8735f130b9ec3ac4d0e467b29aded",95,87,62,10.7258064516129,95,0,3,3
"7721","35fb35f833ac8c77d25cb8fa01972cbe",93,70,75,8.68,72,21,2,1
"7722","35fdc6685c35b42aa0d0bbc6c718f63c",93,67,17,38.2941176470588,93,0,1,2
"7723","36006117cb2713a1bfe69006fb583f4a",41,41,0,41,41,0,1,2
"7724","36017c9c626103917bbdc8db37a4a48c",73,64,42,12.1666666666667,73,0,2,3
"7725","3602a9360d156bc9f138f01da3f9a238",95,58,59,11.271186440678,68,27,2,1
"7726","360343f0612627b0d6ddc622afc373d6",15,15,0,15,15,0,1,2
"7727","36055482996b35b9818352e388792326",9,8,3,21,1,8,1,2
"7728","360a12aacde10074318c98a153bb3bb8",158,133,42,26.3333333333333,158,0,3,3
"7729","360ab365209b49674652c49aab121c9e",47,47,0,47,47,0,1,2
"7730","360b37733e1acdf221f2c24ae8fab207",149,99,79,13.2025316455696,117,32,3,3
"7731","360bd23520b38cd4d70fee0f0705b136",20,20,0,20,20,0,1,2
"7732","360c93ae8b40711842149916a3769c09",20,20,0,20,20,0,1,2
"7733","36101a2c238246b6fdeb50d7168f5a3f",20,20,0,20,20,0,1,2
"7734","36110887d7d8e0f46edbb6a0f85fdf41",19,19,0,19,19,0,1,2
"7735","361152d2995cf9b408065175e8f39315",18,18,0,18,18,0,1,2
"7736","3612d26ad9ad13e0114c73a2daf97c2c",5,5,0,5,5,0,1,2
"7737","3614008b49a59285b206fb63b3deb76a",129,70,54,16.7222222222222,129,0,3,3
"7738","361550ba357877271578ee95efd29b0f",19,19,0,19,0,19,1,2
"7739","3616878de43f89f788acfe56579d87e7",47,47,0,47,47,0,1,2
"7740","36180ee6a0a1486f6721b6d25865530c",16,16,0,16,0,16,1,2
"7741","36185526af4ed99d5f7f11f109e16358",17,17,0,17,17,0,1,2
"7742","361940d1a0fa97842e24b37eb71dbc88",123,64,64,13.453125,80,43,3,3
"7743","361a3b46dc53ba502eda765e023988c2",23,23,0,23,23,0,1,2
"7744","361b350fe2dbbde71ff3002ba94c935d",80,48,55,10.1818181818182,80,0,2,3
"7745","361e9b8d8c99699d8b2676b16eb07023",3,3,0,3,3,0,1,2
"7746","361fabaf09d5aa5e4cfe7a869a372286",49,43,17,20.1764705882353,49,0,1,1
"7747","3622f21801e43f3e82139e5102ada3d0",115,87,28,28.75,115,0,3,3
"7748","362329d91f8a26cef7e92044602a72e1",69,48,42,11.5,39,30,2,1
"7749","36238c0bb0f8eeb50ca8d84491cac077",13,13,0,13,13,0,1,2
"7750","36258f3dfc3a0626b3b5ae5fa96b9701",31,31,0,31,31,0,1,2
"7751","3625f707f8f6331487c41ff6a84b8dae",38,38,0,38,38,0,1,2
"7752","36294544e83d6dc8e932eec9f8e3d786",33,33,0,33,33,0,1,2
"7753","3629e8d641645455317f2b63ad153365",66,54,15,30.8,66,0,1,2
"7754","362dbb84bf7e3dcb8d3a256dafa10032",244,111,85,20.0941176470588,213,31,3,3
"7755","36324972da474cc2940537bbbbe37ba5",41,41,0,41,41,0,1,2
"7756","36339c5da87186a8bc099a2e2f2f13a8",60,43,28,15,60,0,2,1
"7757","3634f17ed19582bb3e312e24cf34a7dd",33,33,36,6.41666666666667,33,0,2,1
"7758","3635c974830ee0e9af5e71eac5257c38",24,24,0,24,24,0,1,2
"7759","36375b30dabd6b38b27b8c8f740a2a78",30,30,0,30,30,0,1,2
"7760","36377a992186a06848c4e78424d9c4ee",119,78,68,12.25,119,0,3,3
"7761","36384cc3861131750ddf8481e1c9fd18",220,118,71,21.6901408450704,185,35,3,3
"7762","3638e3807aa84111cd4d2da74fbcabf1",5,5,0,5,5,0,1,2
"7763","363f5a71f2fc975557206d8f86a5e998",19,19,0,19,19,0,1,2
"7764","364003157a730a45dd00b9b3386b5929",18,18,0,18,18,0,1,2
"7765","3641105354d938c7c1725bfacd7ed09e",27,27,0,27,27,0,1,2
"7766","364328de4cd617feeb74bb979d7100aa",2,2,33,0.424242424242424,2,0,2,1
"7767","3643eccfd614f8fbb19a43321c82df75",17,17,0,17,17,0,1,2
"7768","36449c8aec16aa844508d5aaa5203b26",145,91,54,18.7962962962963,145,0,3,3
"7769","3644c183e1ee0051d3b171bba8596b30",106,99,21,35.3333333333333,106,0,3,3
"7770","3645ae511d30dfade6877ea58d99b56d",17,17,0,17,17,0,1,2
"7771","3646dbbe76086fdac83badd95e027d08",33,33,0,33,0,33,1,2
"7772","364816ce815f7373068d28d951aca82e",31,21,14,15.5,31,0,1,1
"7773","364bf268b181daedf9744027d0533174",43,43,0,43,43,0,1,2
"7774","364dc198f27513a908f8fbad45a02c0e",46,46,0,46,46,0,1,2
"7775","364ea296a40bb46c8f137991d9255142",52,47,47,7.74468085106383,52,0,2,1
"7776","3650668d979e59b3bab49e4c91cd2a14",29,29,0,29,29,0,1,2
"7777","36518be088b8fe3fa74546a7995fc81c",206,80,70,20.6,186,20,3,3
"7778","365939fcd7b06a4b9ae4fb478a438552",107,73,38,19.7105263157895,107,0,3,3
"7779","3659be5448f7312eae1eac5c58da7ad5",21,21,23,6.39130434782609,20,1,2,1
"7780","3659e62bebec929a2521092ce8cefa2a",11,11,0,11,11,0,1,2
"7781","36610c8870c4af105933e1398ac931d9",30,30,0,30,0,30,1,2
"7782","3661d38bb7c8a4658b469c12ed52a7da",103,56,56,12.875,103,0,2,3
"7783","3661fbc3e7c83eee77dea664ba8d5e5c",7,7,0,7,7,0,1,2
"7784","3663a38d26064066b2237ac7ee833aad",38,38,0,38,38,0,1,2
"7785","3663f09d83075317e0bf62231091cb77",107,86,82,9.13414634146342,107,0,3,3
"7786","36646d4ccc795cd5002f268ea628d1f1",88,63,70,8.8,88,0,2,3
"7787","366471ea5721a5f653a8a11db1dc1cbc",5,5,0,5,5,0,1,2
"7788","366587b79a77541e1297c552079fe41a",8,8,0,8,8,0,1,2
"7789","366941e290b64c98fe48ab4a97620b0b",148,85,62,16.7096774193548,148,0,3,3
"7790","366975abb03b8e24b20ea8bd5d481d17",14,14,0,14,14,0,1,2
"7791","366b71e75607a7292166f07eab73049c",77,63,49,11,77,0,2,3
"7792","366bbb2bb20992132f3fb69863b44271",104,68,74,9.83783783783784,76,28,2,1
"7793","3672ff8059ac66c0f27142ab26957f32",110,75,44,17.5,110,0,3,3
"7794","3673975614608f4aa30bac2feb020d75",160,96,71,15.7746478873239,117,43,3,3
"7795","3675bdec4a247148a10fff0dfcc77e29",97,56,39,17.4102564102564,97,0,2,3
"7796","367677ffe505de4a87b02e97bd14812f",33,27,27,8.55555555555556,33,0,2,1
"7797","3677118e0a9be9603ae75fc377d7d305",10,10,0,10,10,0,1,2
"7798","367a29b5ca1173c71449b68f7632ebc9",105,82,51,14.4117647058824,86,19,3,1
"7799","3680810738593b358fa36029e4b6d43b",107,86,59,12.6949152542373,107,0,3,3
"7800","368099fb79e6d3bb55af3efeb3c3cd75",79,56,81,6.82716049382716,79,0,2,3
"7801","3680d6575e2656de676fa94ccae5f345",38,30,43,6.18604651162791,23,15,2,1
"7802","368153b02886337a1fdb43e5a0fd1f4c",22,17,71,2.16901408450704,22,0,2,1
"7803","368653c81cfdf1a1091f60c75dda0e4e",44,38,51,6.03921568627451,44,0,2,1
"7804","3687bf321ad2a1682c478f35a074b477",8,8,0,8,8,0,1,2
"7805","36880eac2f7252e978fa228b1f0c2bba",123,91,61,14.1147540983607,123,0,3,3
"7806","3688529d06fcddad00da5b1875387ade",214,112,69,21.7101449275362,214,0,3,3
"7807","36887576b0b38be7ce6425af8797e571",77,57,19,28.3684210526316,39,38,1,1
"7808","3688f0c831ba4a11c06e1b20081e298f",57,32,58,6.87931034482759,30,27,2,1
"7809","368a262216b74a073021734f034ddbd6",11,11,0,11,11,0,1,2
"7810","368b01c4f6b973c0e2990e8b178f8120",85,61,61,9.75409836065574,85,0,2,3
"7811","368bdf5d944abe845a3d968e1817ab1a",217,94,83,18.3012048192771,172,45,3,3
"7812","368be299a828ff2d2b75543531bb1447",48,48,0,48,48,0,1,2
"7813","368d5efbea04675385cc48c9410e138d",42,42,0,42,42,0,1,2
"7814","368e0de17aafe2af4497972bd72ab1da",11,11,0,11,11,0,1,2
"7815","369109e1eebb6d494799d68eebc05b12",150,90,64,16.40625,150,0,3,3
"7816","369388d1588aa8856731382e2717155a",44,33,21,14.6666666666667,44,0,1,1
"7817","3696e6e3f8a5d8cdb0af125e688fa9a6",18,18,0,18,18,0,1,2
"7818","36983d6f8be33e900e2ab5310630e4e6",97,70,39,17.4102564102564,97,0,2,3
"7819","369ce1dc24cb0b39ecd9fd18412a87c6",17,17,0,17,17,0,1,2
"7820","36a33c884111cae1131287484ee9d401",102,87,75,9.52,102,0,3,3
"7821","36a35ddcb9d78038d1855630c34bc95f",64,41,47,9.53191489361702,29,35,2,1
"7822","36a4e3a5308974b7659c81877f57394a",204,77,70,20.4,204,0,3,3
"7823","36a52d7aebd0e1ae54d8dcfaeecf31c6",38,38,0,38,38,0,1,2
"7824","36a587e0faf79435a9f37a15a542d871",75,40,75,7,62,13,2,1
"7825","36a8cc5a74a6dc030ff03f571e262fc2",70,68,13,37.6923076923077,70,0,1,2
"7826","36ac0141105d1f7b7217a277d2d7de80",52,52,0,52,52,0,1,2
"7827","36ad29a33c1962bece1eef9303d7e911",18,17,40,3.15,18,0,2,1
"7828","36ad5d5e15e948739b26fbd7ef119043",10,10,0,10,10,0,1,2
"7829","36add50d5f8f1260876d9a56c97884e5",76,52,34,15.6470588235294,76,0,2,1
"7830","36ae04375d01be022985a4c4ab5aa9c2",156,100,72,15.1666666666667,156,0,3,3
"7831","36ae651f6c0e7eb79a495531a532d54b",8,8,0,8,8,0,1,2
"7832","36aed42311943a13fabc951519cc734c",134,73,70,13.4,134,0,3,3
"7833","36aee3ba8b84d4719b2542d480ee2736",184,78,67,19.2238805970149,140,44,3,3
"7834","36aff426dbb41424c3b4a5ca20538e0e",41,41,0,41,41,0,1,2
"7835","36b039543ac77ba12eb9c9e0390b6d54",90,72,56,11.25,90,0,2,3
"7836","36b0e674925e9ec966e9e931ff62ae16",186,86,50,26.04,144,42,3,3
"7837","36b4ce46fbbe52f9e0d2f10b09d0db64",32,32,0,32,0,32,1,2
"7838","36b530bdf3f26b88a83b81b7522167c5",100,82,39,17.9487179487179,100,0,3,3
"7839","36b762fd340452f567c2bd1381d2babc",28,28,0,28,0,28,1,2
"7840","36b8dc26e75ab125af755729b633135f",146,101,79,12.9367088607595,97,49,3,3
"7841","36bd4dfc1fb91c28016702e03a771208",44,38,73,4.21917808219178,44,0,2,1
"7842","36bd687071b3f025c5250b9941163aad",2,2,0,2,2,0,1,2
"7843","36be082e37bfe0c6e8a4eb404602759c",19,15,46,2.89130434782609,19,0,2,1
"7844","36bfd26578ac61969643340ce0bf76c9",141,82,88,11.2159090909091,141,0,3,3
"7845","36c1301cba36ac15bfc222b80d69d88f",64,59,58,7.72413793103448,64,0,2,3
"7846","36c1834e8a871bccf202edecd0bbc615",60,44,10,42,35,25,1,2
"7847","36c34fe2fc1e500aacdc5cb85655820d",14,14,0,14,14,0,1,2
"7848","36c4798ec555cc7faf9e5c534071b22c",19,19,0,19,19,0,1,2
"7849","36c8ae0353dbe8076a2e36efb6df221b",42,30,22,13.3636363636364,42,0,1,1
"7850","36c900b274a0706d18616e0ee19155a5",16,16,0,16,16,0,1,2
"7851","36c9df6597f51f043502bafc731afa80",177,104,69,17.9565217391304,177,0,3,3
"7852","36cd0fcd65c1d0968224cfe38c2525ed",54,49,51,7.41176470588235,54,0,2,1
"7853","36cdd82ae25bd8798dbe63acde8aa9c9",55,44,29,13.2758620689655,55,0,2,1
"7854","36cf2260feea50b89e686763ee53fc6e",10,10,0,10,10,0,1,2
"7855","36cf74c8d7afd13c73d954f4ed0b8c11",42,42,0,42,42,0,1,2
"7856","36cf904a1a00a342b0a5ae616091eef1",5,5,0,5,5,0,1,2
"7857","36d28712b60f16fd71db943096212254",71,47,13,38.2307692307692,71,0,1,2
"7858","36d3bd8f0fdb2890929a5a62dbaf8fab",35,35,0,35,35,0,1,2
"7859","36d3e0a39529a49b7fd61925d69472ea",66,42,74,6.24324324324324,37,29,2,1
"7860","36d407e5e7ecc24deade177d0782d66f",23,23,0,23,0,23,1,2
"7861","36d73743463e57fdc5cebe008249f4d1",60,43,60,7,60,0,2,1
"7862","36d7dbf603093664fef752417f1d238e",64,58,29,15.448275862069,64,0,2,1
"7863","36ddde1b25ddde63eb029deb85bcb241",32,32,0,32,32,0,1,2
"7864","36df007ba6cef547cd070a68e301773b",31,31,0,31,0,31,1,2
"7865","36df02690c11e60182e16e397ebcc31b",19,19,0,19,19,0,1,2
"7866","36e0056d0f736a36b03ed323bbe61a52",70,56,59,8.30508474576271,39,31,2,1
"7867","36e14a2cf609b8ddeb9c1a359fa20c0f",36,25,42,6,36,0,2,1
"7868","36e40d180ec7b1b896241f440f9fd960",35,35,0,35,35,0,1,2
"7869","36e4431c5bc3d6fe3273fe7b5bd65584",21,21,0,21,21,0,1,2
"7870","36e4c948a5fcb48e3584e51c685e139c",82,59,63,9.11111111111111,82,0,2,3
"7871","36e568bbc55d0f224aa071f3d8943ed5",108,75,53,14.2641509433962,108,0,3,3
"7872","36e7fc8dc6d39f67237ae615714367c8",28,28,0,28,28,0,1,2
"7873","36e8af4468a0122d72c0b9493a7ca792",14,14,0,14,14,0,1,2
"7874","36e8d721f1a20e136094e6da5db5c45c",121,99,43,19.6976744186046,121,0,3,3
"7875","36eaf2b64ea2042e9a2478820d16d3b0",148,106,47,22.0425531914894,148,0,3,3
"7876","36eed4143bdb602a69fbde05efff1971",155,80,75,14.4666666666667,155,0,3,3
"7877","36eef8b8d2173039ba0c6d64be480f5d",72,65,22,22.9090909090909,72,0,2,2
"7878","36f0f0a7ced6501af70579f35ff9f788",68,53,75,6.34666666666667,50,18,2,1
"7879","36f228e4fadb456b433e7e74de93bc24",106,49,62,11.9677419354839,74,32,2,1
"7880","36f2c1cebef0b4b0785ffb05c1b36878",99,71,32,21.65625,99,0,3,3
"7881","36f4703b63715d6ccea2ba2aef42ab46",97,78,42,16.1666666666667,97,0,3,3
"7882","36f5e3039f67f0601aa30666b8c1bc4d",43,37,89,3.38202247191011,43,0,2,1
"7883","36f8707938b0e32ae682a8635a2fe814",144,69,71,14.1971830985915,104,40,3,3
"7884","36f907f27d812de02549697054e6ce18",81,44,79,7.17721518987342,41,40,2,1
"7885","36f96728cb112c9c7f2195aff7b90053",28,15,57,3.43859649122807,28,0,2,1
"7886","36fb5c54e2844fb2e1e8d97000b4a87a",35,35,0,35,35,0,1,2
"7887","36ff8065ec5cbab3898f27fbe6f7c798",116,85,41,19.8048780487805,116,0,3,3
"7888","36ffe57aa60ce38efe6860d0fa91fba4",23,23,0,23,23,0,1,2
"7889","36ffecf6d3599f0d4638fba677de61c1",209,106,50,29.26,166,43,3,3
"7890","3700002989c426b8501c7d9dba949339",27,27,0,27,27,0,1,2
"7891","370002713a3b44809fcd81a207ad4d5a",46,37,25,12.88,28,18,2,1
"7892","37055e29611e5b98f99beea92e7fe4cb",4,4,0,4,4,0,1,2
"7893","37062804a0b303f4b9805ac5e4fd2817",31,31,0,31,31,0,1,2
"7894","3708d527d1d83827b920f860c12b0385",8,8,0,8,8,0,1,2
"7895","370907ef345ea0c880fce4a44854c769",88,48,60,10.2666666666667,88,0,2,3
"7896","370975d8d355cea78de7411c258cb3da",48,46,67,5.01492537313433,48,0,2,1
"7897","3710356b7eb6d518b4944d2fe2b8c836",66,39,59,7.83050847457627,66,0,2,1
"7898","3713277e0b06fddc81141ac9d92dac7d",79,52,39,14.1794871794872,79,0,2,1
"7899","371961ccc4d635a0549ee4561e4b51d3",19,5,85,1.56470588235294,19,0,2,1
"7900","3719d2ea6c4858e052978e36fbab08e9",98,62,70,9.8,98,0,2,3
"7901","371cb76b142328fa2a7f6854c71712e3",4,2,59,0.474576271186441,4,0,2,1
"7902","372106f0517315b3a9b6a126b17fc3c3",124,85,29,29.9310344827586,81,43,3,3
"7903","3721a1832f8cfc3d4c0a695906abe28b",126,76,86,10.2558139534884,126,0,3,3
"7904","37223be29b9ac2f781da8bbbce517fd3",78,51,81,6.74074074074074,78,0,2,3
"7905","37224f051887d884fb25574c535eb6e4",82,53,63,9.11111111111111,82,0,2,3
"7906","372539cd0f6be85272b11862166e0292",110,75,79,9.74683544303797,62,48,3,3
"7907","3725e0f0834b04df653d154e0a4323c5",51,51,0,51,51,0,1,2
"7908","372760197aaab41b45c15df91316ae0c",11,11,0,11,0,11,1,2
"7909","37282073fe002a60e83e5a843b5e504b",180,103,41,30.7317073170732,180,0,3,3
"7910","37286ef2e678e4cf45c6af54a948c14b",51,40,57,6.26315789473684,51,0,2,1
"7911","372a1f466fe5f9c73372b931b5ab0d03",83,69,47,12.3617021276596,38,45,2,1
"7912","373f7f17c6ca9cc1fd766a6f4dc0bb5a",5,5,0,5,5,0,1,2
"7913","37443a610b00156241e2579ecb2e02f1",27,27,0,27,27,0,1,2
"7914","3748e02ba6de473df552ac5e373048b2",39,38,71,3.84507042253521,39,0,2,1
"7915","3748f394f4116ce617d923dc5a1e854c",107,66,65,11.5230769230769,107,0,3,3
"7916","37499ae30fcb4364330cb8e5d1659ddd",53,53,0,53,53,0,1,2
"7917","374a09f9d4b7e8bb8e7d0e1dd0ef4d41",41,41,0,41,41,0,1,2
"7918","374e94fb26f01991774dc88816df3b19",42,42,0,42,42,0,1,2
"7919","375185b538e44c80ab77bc9f03436c23",50,50,0,50,0,50,1,2
"7920","3758b4b3c5063cd90151e92af6ceed7c",37,30,33,7.84848484848485,37,0,2,1
"7921","375cc05f34c1a30b594c8ba57a93bc5a",54,37,40,9.45,54,0,2,1
"7922","375d15d7b583b9a34508fc4ff46e027c",24,24,0,24,24,0,1,2
"7923","375ff533821cf7e475da32985acd39b2",45,45,0,45,45,0,1,2
"7924","3760d6a915e9910302213d7d5e28b2ac",14,14,0,14,14,0,1,2
"7925","3763a3b4b27580d3699a9a99796124ac",23,23,0,23,0,23,1,2
"7926","37663c954c7c22adc0ffd1ef13348d77",2,2,0,2,2,0,1,2
"7927","376daf98df261b3125b5ae1d3860be6b",27,27,0,27,27,0,1,2
"7928","376ddcfe4e1585eac801750ac7490ff8",46,36,64,5.03125,26,20,2,1
"7929","376ea6cfc2c3d5813c487a337b4f69e5",10,10,0,10,0,10,1,2
"7930","377080bdc5e0964bda5a7e0931f2d0c2",23,23,0,23,23,0,1,2
"7931","3770967c7b3543c2669aff909e1777ca",25,25,0,25,25,0,1,2
"7932","3771ad32645026c73450abd9b34b5664",99,70,61,11.3606557377049,99,0,2,3
"7933","37728f91b97d4284eea5e203dcc91bf3",116,70,67,12.1194029850746,116,0,3,3
"7934","3775c3ce3706c46daa929d733818b264",33,33,0,33,33,0,1,2
"7935","37761f125f74e8258cd93d5b04c1139d",44,44,0,44,44,0,1,2
"7936","37764691a19ed32903854048157134c4",42,42,0,42,42,0,1,2
"7937","37767d84a9fd1b996585d3eb7136beaa",46,41,36,8.94444444444444,46,0,2,1
"7938","3779ae4282e77fe46e49d50f7555515f",84,81,40,14.7,84,0,2,3
"7939","377b6fe777e69f071ce6d038d1e28aa3",75,65,22,23.8636363636364,75,0,2,2
"7940","377d1d43e9e91b97d87d9770d4b97a53",149,92,74,14.0945945945946,149,0,3,3
"7941","377f667fde3db43cf99bb93d2e4a2116",96,76,21,32,96,0,3,3
"7942","3780b2f8c2e6f39eae97537e0fb92759",43,35,66,4.56060606060606,43,0,2,1
"7943","378137d53ed47d987eb4a54d28dac5ad",194,126,72,18.8611111111111,158,36,3,3
"7944","3782522bf8140a30ef9c56c5c12713e3",73,48,49,10.4285714285714,73,0,2,3
"7945","3786b30f83b16b0ba62a441df280d18d",176,128,77,16,140,36,3,3
"7946","3789c88d9c4354b0ef1ac04b5e2183fe",17,17,0,17,0,17,1,2
"7947","378f8ab2438f8fd6901eceff951e25b5",14,14,0,14,14,0,1,2
"7948","37920184d73a4d5fcab058750bb20f01",163,80,56,20.375,163,0,3,3
"7949","3793b1b2de6bbbda75d42ee2d9b01b3a",15,14,2,52.5,15,0,1,2
"7950","37983b4e9a0e27b7e8fc2de9b931976a",178,123,54,23.0740740740741,178,0,3,3
"7951","37983ee3dcff7f7db0b4fa4113c03d63",110,65,50,15.4,110,0,3,3
"7952","3798edb238fc3b0d589c377baad7d960",101,76,27,26.1851851851852,63,38,3,3
"7953","3799433438e35d7fa3ddca19d5522ef0",16,15,20,5.6,16,0,1,1
"7954","379f13160cd8179f87bfb4a1204f66a6",91,68,48,13.2708333333333,91,0,2,3
"7955","37a0ee4b0689bdce3bbc6362f6c3cccb",76,43,71,7.49295774647887,76,0,2,3
"7956","37a1d70b4d7c94c44bbf68ad4658b2fe",95,52,80,8.3125,78,17,2,1
"7957","37a22df36bedc0d584a8a859c155521a",31,31,0,31,31,0,1,2
"7958","37a2683edb3bd4612a7ea14ba51f47a9",3,3,0,3,3,0,1,2
"7959","37a7da81eb302bab33fd4a10436be981",67,46,48,9.77083333333333,67,0,2,3
"7960","37a7e91aa8cb54d3c53508a1fe8bed50",36,36,0,36,36,0,1,2
"7961","37a8dbad08f0e352e1ce87a08841d27f",111,93,56,13.875,111,0,3,3
"7962","37ab473e8a019df76f9fdb4697270502",115,70,63,12.7777777777778,115,0,3,3
"7963","37ac35d9cc6b24e546c396bc3f7425b8",61,44,38,11.2368421052632,61,0,2,1
"7964","37ad4f6c6f4623fa1ee7d4925b95fece",31,31,0,31,31,0,1,2
"7965","37aee9360037626a9c5d7e35eb5a3152",93,70,50,13.02,93,0,2,3
"7966","37aefc36dc351b5fa3f8842030346f49",103,46,38,18.9736842105263,64,39,2,3
"7967","37b00ec3db2fab26f2323346e2f85ae7",117,72,22,37.2272727272727,117,0,3,3
"7968","37b04cb88e78f93faf691f1d09843756",136,89,48,19.8333333333333,136,0,3,3
"7969","37b0985b70684e80073dd5a6b7e77327",25,25,0,25,25,0,1,2
"7970","37b42b89560b6771a5f3d9ae91538890",43,43,0,43,43,0,1,2
"7971","37b4a041126e13c79f4c56a61c28ff88",35,27,34,7.20588235294118,35,0,2,1
"7972","37b641f314331dc6e6a93c481d09ec85",10,10,0,10,10,0,1,2
"7973","37b75c2bba63d335f6bc54818f10a940",36,35,19,13.2631578947368,36,0,1,1
"7974","37b807b0cef024cf5ca6164eaabbdc17",20,20,0,20,0,20,1,2
"7975","37b985e9229adcf10b6d4cbb4ff67759",62,47,24,18.0833333333333,24,38,2,1
"7976","37ba31e15ddc3f3edce5b783507a11e0",142,77,82,12.1219512195122,142,0,3,3
"7977","37bcf6fabca25dcbde74dda689f713ed",78,61,77,7.09090909090909,78,0,2,3
"7978","37be7843da19b9180b18b56bc885799f",196,119,79,17.3670886075949,196,0,3,3
"7979","37c53c94d70d9d0271a559fd25082c84",172,94,84,14.3333333333333,149,23,3,3
"7980","37c61e6676199164c098e4728cde076d",20,20,0,20,0,20,1,2
"7981","37c63cb7f98ebcc40c55b9dc5e496615",97,76,58,11.7068965517241,58,39,2,3
"7982","37c824a0e51bd803c62d7ea0cf9de272",98,72,15,45.7333333333333,98,0,1,2
"7983","37caabdeb8069ac40e25ed6261d2a076",11,11,0,11,11,0,1,2
"7984","37d019a16122927f475f0688a588bb54",40,40,0,40,40,0,1,2
"7985","37d3f029eafead85aab001cd011d9684",66,61,36,12.8333333333333,66,0,2,3
"7986","37d62446c1f539242432778d31c17e8c",124,69,61,14.2295081967213,124,0,3,3
"7987","37d6d65e4e4f25f67f245b7520dbeac7",116,79,87,9.33333333333333,116,0,3,3
"7988","37d71a27b94adb8c46e6d38af2ecd549",26,23,44,4.13636363636364,16,10,2,1
"7989","37e2453e440c2b6bccaf08d1e8f15187",11,10,26,2.96153846153846,11,0,2,1
"7990","37e80802dc95a3f278b425e51101c5df",112,101,19,41.2631578947368,112,0,3,3
"7991","37edd44ca86c48c82ce20465a5ae47fb",29,29,0,29,29,0,1,2
"7992","37f1b5801f3e9d9b98ca24df8d8ca7de",16,16,0,16,16,0,1,2
"7993","37f40ac100c9dd477cf9628d57605338",18,18,0,18,0,18,1,2
"7994","37f57bdab79ce1fa1f53a03cb001a70a",29,29,0,29,29,0,1,2
"7995","37f84e10294b6c858a8e5385e626f21d",20,20,18,7.77777777777778,20,0,1,1
"7996","37f88586f7ef6f92a3d6f331bac0a488",21,17,5,29.4,4,17,1,2
"7997","37fce21f61e6faa3b736f85920bbd09d",24,24,0,24,24,0,1,2
"7998","37fd6d7df01190c1c93d210019bb18f7",87,76,62,9.82258064516129,38,49,2,3
"7999","37fdeadcb02a8a2679240a92f253f5ea",72,62,36,14,72,0,2,3
"8000","38008c9f38b62bcc8c9b51bf5165ff94",37,20,25,10.36,37,0,2,1
"8001","3804d1c0135c41b9ddd11bb82f5d024c",21,21,0,21,21,0,1,2
"8002","38054dc3660ccd63ea296e241b382b4b",12,12,0,12,0,12,1,2
"8003","38070cc11c693a24070e6356da11491f",109,90,43,17.7441860465116,109,0,3,3
"8004","3808ed3d894f84823178006f33676d55",78,61,61,8.95081967213115,78,0,2,3
"8005","380b5d42207d632a9293da47d4cdad58",17,17,0,17,0,17,1,2
"8006","380c549bad41febea9dfeea7670991b0",33,24,78,2.96153846153846,33,0,2,1
"8007","380ccf9f922d479673f9586cb4f66ca1",40,35,13,21.5384615384615,40,0,1,1
"8008","380d6349e1ba15e50a7a033c83953489",45,38,14,22.5,0,45,1,1
"8009","380ec01e3ff77d4be0d657f02912dfff",138,95,74,13.0540540540541,138,0,3,3
"8010","380f004d102b86283ceac9e895addae1",50,44,11,31.8181818181818,50,0,1,2
"8011","38112ee0f3c37b227533fed5f3fd9fa5",69,56,79,6.11392405063291,48,21,2,1
"8012","3815f2be9ccf2c158a80e2aef011c204",44,44,0,44,44,0,1,2
"8013","3816d0911240bc08e7123661ecdd49dd",18,18,0,18,18,0,1,2
"8014","38174b445ee1d8dc39cd211e6fb28f85",61,46,85,5.02352941176471,34,27,2,1
"8015","3819ada2f327ee77fd4a000203159353",123,65,61,14.1147540983607,69,54,3,3
"8016","381b4a6d09255c7b9daebf3d536a2a8c",38,38,0,38,38,0,1,2
"8017","381bb2296f287bf2fd1d55a4761d1aac",3,3,0,3,3,0,1,2
"8018","381cfda0e4845e8a2c32c0845bf82ffb",4,4,0,4,4,0,1,2
"8019","381f96c9018fef5be469a1e99e554f21",39,36,47,5.80851063829787,22,17,2,1
"8020","38200a4ddbf765c02ad42ac7eb948962",159,68,77,14.4545454545455,159,0,3,3
"8021","3822c6cf9b22d80a4a51d46cec67da4d",22,22,0,22,22,0,1,2
"8022","3825c321e980f8ec8e24c79c0efad55e",15,15,0,15,15,0,1,2
"8023","382623b62ed2bcb3e08b6f159f82f27d",6,6,0,6,6,0,1,2
"8024","38265f3bd9e4dc438b6432b3d9cc4235",78,73,71,7.69014084507042,23,55,2,3
"8025","382725d65c00341fa71607b9be9fede9",95,61,70,9.5,95,0,2,3
"8026","3827a03f6d6a37046379bc0e4616d1b3",35,35,0,35,35,0,1,2
"8027","38297d71021ff04e3ca9fd3844dadb1f",36,36,0,36,36,0,1,2
"8028","382aa382ace264463a630595c5098780",48,32,66,5.09090909090909,17,31,2,1
"8029","382d575f274e74eb693bd423abd01b49",79,61,53,10.4339622641509,79,0,2,3
"8030","38315a9660f4eb5e416d1f0f3cccfac7",161,111,76,14.8289473684211,138,23,3,3
"8031","3833369cc5cc88581f70c106673a6fd9",4,1,8,3.5,4,0,1,1
"8032","38343050aa1495ab02a1998ced77d7bc",68,50,28,17,68,0,2,1
"8033","3835cf8b550f4bc69c96b10cd10c9a46",93,63,70,9.3,93,0,2,3
"8034","38369e802c089be2ef024445f5755275",61,49,50,8.54,61,0,2,1
"8035","383923a59a9df9c2783d8b43a75b8e7f",48,42,16,21,48,0,1,1
"8036","3839a535424d877fa15ae6c3ef3cc261",26,26,0,26,26,0,1,2
"8037","383ab556acef4182420c059223a5a38e",29,29,0,29,29,0,1,2
"8038","383b093c04c79640cf93ef418d731a79",78,72,33,16.5454545454545,78,0,2,3
"8039","383b3606b34d59bd4599f1e5cd4edbf5",156,80,63,17.3333333333333,125,31,3,3
"8040","383de0d3d6456afe2b9bda922d886b10",31,31,0,31,31,0,1,2
"8041","383e1995f538a6e3a5f6fea537ece8e5",97,73,28,24.25,97,0,3,3
"8042","383e4bc114331248fd92b0d05d92e113",42,38,35,8.4,0,42,2,1
"8043","383fb41edf34514a6b2abefee306674b",36,36,0,36,36,0,1,2
"8044","383fc6214f4b9b9f145c59272a2a11b7",98,71,47,14.5957446808511,91,7,2,3
"8045","3840f4061700092cdf850d171fc21bf0",28,7,79,2.48101265822785,21,7,2,1
"8046","384166025b2ed79e6e4b0920c0b8f30f",36,29,35,7.2,36,0,2,1
"8047","3841e6c9d5eef9b83a0a91e8d045b91d",50,42,76,4.60526315789474,50,0,2,1
"8048","3844e0df0d65e294eaf00dab72e88ac9",27,27,0,27,0,27,1,2
"8049","3845b1d7e28633e7e88cb6a4ffca17cb",53,53,0,53,53,0,1,2
"8050","38480e285437ac0804808b1ea194cd5a",75,52,53,9.90566037735849,50,25,2,1
"8051","38488983c344906ed71ee0664ed3af21",44,44,0,44,44,0,1,2
"8052","3848e7e9c02c7158ec902a539dd8fc84",23,23,0,23,0,23,1,2
"8053","384bacaf0ca6262b9ba890861dd133a9",72,44,26,19.3846153846154,72,0,2,1
"8054","384c6aaaf312f80c10b597fa1ca300dc",137,86,69,13.8985507246377,120,17,3,3
"8055","384dceae268e4e0347794f03fa592ede",120,91,70,12,120,0,3,3
"8056","38520c8529d513119ec9ed589ba820cd",40,35,6,46.6666666666667,16,24,1,2
"8057","38541eb410214fba1af0b73cc667153a",35,35,0,35,35,0,1,2
"8058","38554975693b3fcf64f9b59969d37263",10,10,0,10,0,10,1,2
"8059","385598f49b6cfd4cb929341f4652103b",180,95,83,15.1807228915663,133,47,3,3
"8060","385763dd855f60520e7889ad549f54bf",164,71,89,12.8988764044944,164,0,3,3
"8061","38578e7fa578e7f4855c6d430becab71",145,90,56,18.125,145,0,3,3
"8062","385a000cca7b86aa3e6886ee8667cd07",35,28,18,13.6111111111111,21,14,1,1
"8063","385cdee67d8c59c6c1ebe1d7191eeaf9",55,43,14,27.5,55,0,1,1
"8064","385e577982e567c02d5ac809510771c9",24,22,7,24,24,0,1,2
"8065","3863a71d45a1045f6389ad97d7e521da",108,78,65,11.6307692307692,108,0,3,3
"8066","3864cc6983c49f0f4cc58828c698e80e",28,28,0,28,28,0,1,2
"8067","3869017a7c3f5e50d68f2bb6b74d0234",88,71,27,22.8148148148148,88,0,2,3
"8068","38693d6fd8d00e55e0a8c1239f7824d4",48,40,67,5.01492537313433,48,0,2,1
"8069","386ca6b00ffe90ae5516692fa5c79087",131,89,81,11.320987654321,115,16,3,3
"8070","386e060d2fe047fcca9bac997adb1810",25,25,0,25,25,0,1,2
"8071","386f619d29b38cd3bc1cec9f7ccaac89",5,5,0,5,5,0,1,2
"8072","3871c74341b4d489c1057870a6b9d670",180,77,83,15.1807228915663,147,33,3,3
"8073","38745b3d74b86c18c4fbc981df9b18de",40,31,20,14,20,20,1,1
"8074","387545b9dc15d164ddf0ba458bd3ec8f",89,54,48,12.9791666666667,89,0,2,3
"8075","3875b32e1549cf9775f39ec7adaf76b3",49,36,56,6.125,49,0,2,1
"8076","3878e00be9e8a7a2b470d6fcdc1d07d4",154,99,79,13.6455696202532,150,4,3,3
"8077","387aa1b17599d1e594bd6b41e2e49fb6",33,33,0,33,33,0,1,2
"8078","387cb677bb6125396e42f8bfb169e47d",125,92,21,41.6666666666667,125,0,3,3
"8079","387e6a2b59b831cc4422bfa86ece261d",68,48,66,7.21212121212121,68,0,2,3
"8080","38820b67cad8e7b048393f8677559f7e",10,10,0,10,10,0,1,2
"8081","388281c4f8814d0751cb25a2523287c9",19,19,0,19,19,0,1,2
"8082","38831edb3c34a9cd9bb20003f26b8de9",36,35,7,36,36,0,1,2
"8083","3883da3673608da001ef7bd56ab17a7f",24,24,0,24,24,0,1,2
"8084","3884256508f34c79aa282683975b95e8",56,56,0,56,56,0,1,2
"8085","388523457c6fb557aa389c4d5ae13b27",16,16,0,16,16,0,1,2
"8086","3888958d8637f376a87134be692e2350",1,1,0,1,1,0,1,2
"8087","388cfbfb214c1c316fcfc2c09ec57a7f",88,68,56,11,88,0,2,3
"8088","388d7a53ee6d66b7e19c4d6776560837",28,28,0,28,28,0,1,2
"8089","388e33ffcf09de7e471229212dedab17",128,88,77,11.6363636363636,82,46,3,3
"8090","3891b8dae32823230b39c15a14664a53",67,65,28,16.75,67,0,2,1
"8091","3891f501cd30130fea4a38694597c0eb",29,29,0,29,29,0,1,2
"8092","38943fa4a43f7768ccc8b4a35f5e4272",25,22,49,3.57142857142857,25,0,2,1
"8093","3895c086a7047a41ea86591cca5068b1",57,57,61,6.54098360655738,57,0,2,3
"8094","3895cfe4c4f598092c2cd03a10a40fd0",1,1,0,1,1,0,1,2
"8095","3896040fe085ca57dd200ee647edc05c",14,14,0,14,14,0,1,2
"8096","38968b553808f03bbcf6110251d9f0af",52,44,53,6.86792452830189,52,0,2,1
"8097","3898d85308a683bbcaa58e04be2938ce",63,59,38,11.6052631578947,63,0,2,3
"8098","38a0f880bff3459bc21abeae8902956b",49,49,0,49,49,0,1,2
"8099","38a3d4ea7b0e3395abd9bb7c8339092f",20,20,0,20,20,0,1,2
"8100","38aa77ad6de9f929b4314513853b6b3a",22,22,0,22,22,0,1,2
"8101","38aad441ef09b0e3140e123aa7c824a1",163,100,58,19.6724137931034,163,0,3,3
"8102","38abe3e4f5271c5df27efeb351f77d11",56,32,62,6.32258064516129,56,0,2,1
"8103","38b075f473254f6dc9dee07f260a034e",93,64,56,11.625,93,0,2,3
"8104","38b18150b1d5a7448401ff562d580137",29,29,0,29,29,0,1,2
"8105","38b2a7c9898f5a8ea0a1f0230d66071b",82,67,45,12.7555555555556,82,0,2,3
"8106","38b430269c38b06646769708d7e296cb",43,33,58,5.18965517241379,19,24,2,1
"8107","38b54dda5ea3a49c0699e1b3abdff7d0",70,48,12,40.8333333333333,70,0,1,2
"8108","38b6cc6a74189d62d092ec7d69d11389",118,66,56,14.75,118,0,3,3
"8109","38b6e627c09e73918c3f3906ff97b3fa",23,23,0,23,23,0,1,2
"8110","38b766562923a117a792d7f65ed506d6",2,2,0,2,2,0,1,2
"8111","38b7cf0ba5ea92df6b32e8454f603a09",15,15,0,15,0,15,1,2
"8112","38b88c78642121454b9696baad38dafa",82,54,58,9.89655172413793,82,0,2,3
"8113","38b8b6ac15e5935f65f50ac9b6c03635",20,20,0,20,0,20,1,2
"8114","38ba2d82da0734dc28bda487d9e52344",18,18,0,18,18,0,1,2
"8115","38bb0fa7850c738902a7fc42fbe0a2a5",130,79,81,11.2345679012346,130,0,3,3
"8116","38bb37350b7539a95936fedb9447fb34",28,28,0,28,28,0,1,2
"8117","38bf621d7858f7b954ab4c54e194ffc7",86,60,84,7.16666666666667,62,24,2,1
"8118","38c0d036731061d73a5996e5a4ea9152",105,72,50,14.7,105,0,3,3
"8119","38c84ce5b5c45dcae95102c385f49cee",22,16,22,7,22,0,1,1
"8120","38cadafdee5edaeb5fdf75962e857eab",44,44,0,44,44,0,1,2
"8121","38cef1a3a08006fdceeccba66f795c0d",48,48,0,48,48,0,1,2
"8122","38d0608da4b0aa47fe002f565384b7dc",21,16,56,2.625,21,0,2,1
"8123","38d0fcce1bbc9beb5641111060dd7fc0",9,9,0,9,9,0,1,2
"8124","38d9772a5f2c4c1b9c0dc2ccd8dd2ce9",194,125,67,20.2686567164179,194,0,3,3
"8125","38dca3466a859ddf118f5b3d8ad58844",45,34,64,4.921875,45,0,2,1
"8126","38df9a2554b0daa4e95195de1f5dda0f",144,91,56,18,114,30,3,3
"8127","38dfac0be14b42dc166b82f96e8d1eb6",55,49,60,6.41666666666667,55,0,2,1
"8128","38e1deb2f8c4e3be714e227651e5d468",19,19,0,19,19,0,1,2
"8129","38e5a97b80b85f5702cfbf6e3deaa75d",141,70,70,14.1,141,0,3,3
"8130","38e7d8fef6d2d50240e7a65810269ea3",15,15,0,15,15,0,1,2
"8131","38e9eac7be71f4c1262c43ba88f6fec4",24,24,0,24,24,0,1,2
"8132","38ec425c692a71719d843a39781cda1a",26,24,70,2.6,26,0,2,1
"8133","38ed2be6f3518676a8a24f47edd1161d",22,22,0,22,0,22,1,2
"8134","38ee1a8532cf6d7d6f2db17360e560c5",103,81,28,25.75,103,0,3,3
"8135","38f0c93ea4d484b9d9df856560238bd2",167,81,70,16.7,167,0,3,3
"8136","38f4d7c061bf923e8c0fab314a756467",91,58,33,19.3030303030303,91,0,2,3
"8137","38f86516e07eb68b42c517e525e49fd5",100,75,68,10.2941176470588,60,40,2,3
"8138","38f8851e1895825082983c6266a96a59",116,72,87,9.33333333333333,116,0,3,3
"8139","38fa6ba7cdeea32fc54a14ea788ef135",112,68,54,14.5185185185185,85,27,3,1
"8140","38fe34e4693e93c367cb4e4c4b7f096a",109,31,71,10.7464788732394,109,0,2,3
"8141","38ff23e38aa2c46879dcc61ef8ae7607",82,59,49,11.7142857142857,82,0,2,3
"8142","38ffa945a22b04923cd35f5161706a5a",75,59,26,20.1923076923077,75,0,2,1
"8143","390456dedecee1077da278b6f1f169df",28,28,0,28,0,28,1,2
"8144","3904d55a36551fe3c87c1e11fbcdf40c",170,65,81,14.6913580246914,170,0,3,3
"8145","390718d80cb9303f6d6adbecd3c0559d",51,44,37,9.64864864864865,51,0,2,1
"8146","39075487e2156af2a18b2c59e88d3ef0",136,55,75,12.6933333333333,112,24,3,3
"8147","390ab521583b7a4bf30d6cb365da3e1e",19,19,0,19,19,0,1,2
"8148","390adc7ba2d3a9e840fc2357d0ee65e6",34,34,0,34,34,0,1,2
"8149","390cddf1ecc458807d86d168cba17128",4,4,0,4,4,0,1,2
"8150","390f6cf00f6a060a783cf25b79fdd0d2",41,35,69,4.15942028985507,18,23,2,1
"8151","3913988b638ac4a746fddfa03f8cb80f",61,49,47,9.08510638297872,20,41,2,1
"8152","3916973085b314f11638a18701a89445",31,31,0,31,31,0,1,2
"8153","3917faa59fb68994e69fb6c39c6b6700",28,28,0,28,28,0,1,2
"8154","391aab2552d75ba5c8ce8054b1707008",215,93,70,21.5,197,18,3,3
"8155","391d5a6d7d5714e441787ad14cc1a5f1",11,11,0,11,11,0,1,2
"8156","391d642c8a52696a6967c7872bb85bdd",51,38,35,10.2,51,0,2,1
"8157","391f046a916b78fbb5cb7e4e4d96a371",66,57,17,27.1764705882353,40,26,1,1
"8158","3921e3debe9244617287ae1b84b0d7f0",23,23,0,23,23,0,1,2
"8159","39220e05087ce058e5bafffeceff9905",28,28,0,28,0,28,1,2
"8160","392220d63d51c01055aaa93786f81031",65,56,66,6.89393939393939,29,36,2,1
"8161","3922a7b475781c7298ad59051dacd77d",19,14,25,5.32,19,0,2,1
"8162","3923a704dc315222bb81a31ee9af2d27",47,28,68,4.83823529411765,47,0,2,1
"8163","39288f07b3239c347eedd127430dc1fc",22,22,0,22,22,0,1,2
"8164","3928df1cc07d928efce67d14f4bce1c1",6,6,0,6,6,0,1,2
"8165","3929526c2cf76f1cc9e0096f47525054",49,49,0,49,49,0,1,2
"8166","392a4c8234bf750fec6cfa23e281ac17",42,42,0,42,42,0,1,2
"8167","392bbf00c086eb7d22f4f43812943dd3",43,28,15,20.0666666666667,17,26,1,1
"8168","392bd464915fa76de7618601fd7a5215",96,43,82,8.19512195121951,96,0,2,3
"8169","392c664be36616e35a9c74c1d3bf0e17",38,36,6,44.3333333333333,38,0,1,2
"8170","392cc90afe88c8fdd821407eb5189190",72,51,30,16.8,72,0,2,1
"8171","393202408e5281481fe32d89f1c9897c",199,113,75,18.5733333333333,199,0,3,3
"8172","3934407b99d3adde602873da0417b1f6",30,30,0,30,30,0,1,2
"8173","39354b8510528adec64abfed22ca70a7",1,1,0,1,1,0,1,2
"8174","393563f58bc7d360768e2b050336488f",1,1,0,1,1,0,1,2
"8175","39357a709f51a1156a6d4563c94c269b",24,24,0,24,24,0,1,2
"8176","39365607be5e784c737add78028a3e9a",35,35,0,35,35,0,1,2
"8177","393673137f37a0391f04d9d30e461e71",40,40,0,40,40,0,1,2
"8178","393b1c02cb53ad8db364f5094bb58596",193,101,68,19.8676470588235,157,36,3,3
"8179","393cac61158ffd1c50d52a291bf41168",11,11,0,11,11,0,1,2
"8180","393f644eb174bc3fb96caf7322b47027",67,44,70,6.7,67,0,2,1
"8181","393f95cefcac101144b656a086c95869",32,32,0,32,32,0,1,2
"8182","393f9fad343141735b65d96a73d87608",21,20,3,49,20,1,1,2
"8183","39447116556323bb361a71d501b0ec74",93,66,86,7.56976744186046,58,35,2,3
"8184","394507399817eb1b356988db178702ff",30,30,0,30,30,0,1,2
"8185","3945f95f891b47b3498b60c9f56a23e4",52,52,0,52,52,0,1,2
"8186","39476185017a61fd678cdcd439e25e7e",53,53,0,53,53,0,1,2
"8187","394b8fe1b08e72429d6fed885eb02c86",167,105,79,14.7974683544304,126,41,3,3
"8188","394ca4727c5343e02433360d23273d02",42,42,0,42,42,0,1,2
"8189","394dacfab3a0da0093744c1601156302",28,28,0,28,0,28,1,2
"8190","394ee08f8a0b7dabd1baf30f6dec1133",26,26,0,26,26,0,1,2
"8191","3950de5202607c12f2baf569f793264f",117,83,36,22.75,117,0,3,3
"8192","3956d9bea10e6b29a3ee1b8874248757",202,96,65,21.7538461538462,202,0,3,3
"8193","395722796ac5a22436f31c964b386bfc",22,22,0,22,0,22,1,2
"8194","3957441c6c9a7eafbde644e353521795",23,23,0,23,23,0,1,2
"8195","3958755abf95ebae0c8d36bf17710ebe",26,26,0,26,0,26,1,2
"8196","395901665ecfafb9749081d94c9137b0",1,1,0,1,0,1,1,2
"8197","3964af9b2b57d1f36c3d3b7dbf9e5b7d",67,58,35,13.4,67,0,2,3
"8198","3966d0dbc45c69b064650f9b26c7053e",30,30,0,30,30,0,1,2
"8199","396bc4058f4cbb06dedbdb1c4bba2a20",50,50,0,50,50,0,1,2
"8200","396d9b9aed274cf025e7b1f1307cbf6a",161,99,83,13.578313253012,161,0,3,3
"8201","3971ddb50c67c3a9241af901ebda24d5",5,5,0,5,5,0,1,2
"8202","3973a4c358223ca1c8b7988df85588bb",33,33,0,33,0,33,1,2
"8203","39781030c6a07fd220782e463e19d3ca",31,31,0,31,31,0,1,2
"8204","3978ffd7193eafab80355bc4e76b55c3",12,10,2,42,12,0,1,2
"8205","397a32ad40baeab35ad78ec5e4bd6baa",53,45,7,53,53,0,1,2
"8206","397f0c2904ff9c415ebf0f8d9be7232a",27,26,10,18.9,27,0,1,1
"8207","39803222635fd476f7cc698d7680fbf9",140,73,49,20,140,0,3,3
"8208","3985029ada80208593ab4aefa6b6ea01",79,56,67,8.25373134328358,41,38,2,1
"8209","39883bbe31892f2f5ec1040b03554580",24,24,0,24,24,0,1,2
"8210","3989e1b64c6d4074252329502a1fecc7",28,28,0,28,28,0,1,2
"8211","398da08746078d98f87e55eccc088ade",104,64,68,10.7058823529412,104,0,2,3
"8212","3991f9a6b7b69692eb0ebf605089292c",178,94,89,14,178,0,3,3
"8213","39972ab7314463b27ec504cdbffe5b6a",75,63,29,18.1034482758621,75,0,2,1
"8214","3998ebb6a537d864f406f46cda424fb6",53,36,62,5.98387096774194,53,0,2,1
"8215","399bd1d1e6b4b261797bbd5362d0d901",124,85,75,11.5733333333333,124,0,3,3
"8216","399bddf18739059e56066bb6f51ad41b",39,31,42,6.5,39,0,2,1
"8217","399d3f6b79db713812d0274a176fdb17",187,92,77,17,187,0,3,3
"8218","399fea6725225fbc9a337d4d231efa14",43,43,0,43,43,0,1,2
"8219","39a0727e6900645b749708e03f46dc4b",6,6,0,6,6,0,1,2
"8220","39a201f1cfdee939d4babd9b96166b4d",52,46,70,5.2,52,0,2,1
"8221","39a36118d44ba285c2ad55d84d9d13b5",116,73,44,18.4545454545455,116,0,3,3
"8222","39a491898c41dbe3898a0fbef8bb4d8c",18,18,0,18,18,0,1,2
"8223","39a7295230b527dd6849faf3c9638b92",28,24,43,4.55813953488372,28,0,2,1
"8224","39a8c0a667d8bd3e9643134bff77d324",41,41,0,41,41,0,1,2
"8225","39a999ed983bdfc0e1b89021e6b8d176",152,78,75,14.1866666666667,133,19,3,3
"8226","39aa745e8efadd8469b4515f0a4d507e",54,49,68,5.55882352941177,54,0,2,1
"8227","39ad749868e83a5f02b87c58c578b4d6",27,27,0,27,27,0,1,2
"8228","39af8600e31d5f87f89e4f0e70b67a23",212,128,28,53,164,48,3,3
"8229","39b0cd5e4ee43a32c4b5ec8b4f675fd9",64,61,60,7.46666666666667,64,0,2,3
"8230","39b0dc83d4800f0fd8b336c78021c0c3",67,62,82,5.71951219512195,67,0,2,3
"8231","39b0ee86fe26b3ffd8812071772b6a0a",32,26,42,5.33333333333333,32,0,2,1
"8232","39b449b4fc509aa6d5fe4762dbb868bf",55,48,14,27.5,55,0,1,1
"8233","39b8bbaea75bc201c453f150fd6a74fd",21,21,0,21,21,0,1,2
"8234","39bd1e2701d0efaab6efa8357009a2cb",79,61,61,9.0655737704918,64,15,2,1
"8235","39be6572a4a4750c88f7fd3ec56d6b78",29,29,0,29,29,0,1,2
"8236","39bf29cace5dd8cdc063fd8e415f7bb5",125,73,50,17.5,85,40,3,3
"8237","39c5167cc0bc05dffbe060b40e402009",229,110,58,27.6379310344828,206,23,3,3
"8238","39c83ee1496925cb632d4b26f05dc1d6",12,12,0,12,12,0,1,2
"8239","39c9879ab4f01c54ad6f931231e39ed5",30,30,0,30,30,0,1,2
"8240","39c9f78c0f5a3574b8dcee506e73568e",36,36,0,36,36,0,1,2
"8241","39cbbd392085adcefac098042cb496e8",139,80,68,14.3088235294118,109,30,3,3
"8242","39d400c95e861a029fa66fdb02fe2f9a",54,39,65,5.81538461538462,22,32,2,1
"8243","39d40656a72a645e1961dbec81219fa7",23,23,0,23,23,0,1,2
"8244","39d4790aeb96669733bc5bca4cb0bb1d",55,43,53,7.26415094339623,55,0,2,1
"8245","39dc5ccaaee4558a3d3b802dfdaf3c42",25,25,0,25,25,0,1,2
"8246","39dd2975f9a3e09d7fec6f3f55fbd576",19,19,0,19,0,19,1,2
"8247","39de6d04a4a6e7782515e2b9abd84536",37,23,52,4.98076923076923,37,0,2,1
"8248","39df900ed4b666e940d0d15b49d70d77",54,46,35,10.8,54,0,2,1
"8249","39dfb4e0e7458fc3bcf5f195048574d9",50,43,19,18.4210526315789,50,0,1,1
"8250","39e3f311a2caad1c5f35bc7d9720f7f1",30,30,0,30,0,30,1,2
"8251","39e4a36a8a5dfcc67f994134ca4d6aca",94,70,19,34.6315789473684,94,0,1,3
"8252","39e640d8f0df7487814af75818f21f2d",14,14,0,14,14,0,1,2
"8253","39e72391dba9788e30dc3620ca1b1936",56,42,48,8.16666666666667,56,0,2,1
"8254","39e98705874b3fd3743ab4cfc097253d",35,35,0,35,35,0,1,2
"8255","39ea2a6c73f3fd552bc0caeee623fdf9",1,1,0,1,1,0,1,2
"8256","39ee2cb4d2adafa7b2b1c78094b25525",119,75,70,11.9,76,43,3,3
"8257","39ee6bbca91af8d0a1f47e3b762379b7",124,66,62,14,124,0,3,3
"8258","39f53f9efd95f347225a52280e99638c",134,68,65,14.4307692307692,134,0,3,3
"8259","39f6759dd8413577a10fb96b04c185c8",47,47,0,47,0,47,1,2
"8260","39f7413b5bf49f3535925c922a5ec83b",77,54,40,13.475,77,0,2,1
"8261","39f7cefb8fc47c55ad4e397e761448c6",1,1,0,1,1,0,1,2
"8262","39f8fa641849a69b4d21624a0b2c29bb",9,9,0,9,9,0,1,2
"8263","39f9cf1e25392ab0a90daba9157c671a",59,32,53,7.79245283018868,41,18,2,1
"8264","39fbd69f790fa9e5d9df7b5540faecc2",28,28,0,28,28,0,1,2
"8265","39fe71a7aef48e0e3ef37080df0d6ac0",57,53,24,16.625,57,0,2,1
"8266","39ff2239fabda032fa6acd639117168c",53,53,0,53,53,0,1,2
"8267","39ff4c3716c4ead7c03b2da56a0f5b29",24,20,62,2.70967741935484,24,0,2,1
"8268","3a038cc60c126977f2a48b0a20874a01",34,34,0,34,34,0,1,2
"8269","3a08d40985d284142622cf5c5c19ea58",93,73,49,13.2857142857143,93,0,2,3
"8270","3a09b48204f261589dd2e44e9ca77133",46,46,0,46,46,0,1,2
"8271","3a0df57aa418bfe05e62ae83765a78f4",76,41,67,7.94029850746269,76,0,2,3
"8272","3a1210ec72cc449abc2c4126e6dc12e5",68,47,50,9.52,68,0,2,3
"8273","3a147a9ff8a6e9fbc621cfdd808dc6e3",18,18,0,18,0,18,1,2
"8274","3a153909cede02cc4d8e15668d0347ea",29,26,6,33.8333333333333,29,0,1,2
"8275","3a15e10e64e3a145bc30c062d6a815bc",112,89,69,11.3623188405797,112,0,3,3
"8276","3a16cffffe167185e15fd87cb6529ec6",27,27,0,27,27,0,1,2
"8277","3a18386e1bf7e485f8b012acf37ae3af",8,8,0,8,8,0,1,2
"8278","3a1855ae855110feb7ca60ed3421538e",32,32,0,32,0,32,1,2
"8279","3a1912b7ed8785171f4e796809afbabc",2,2,0,2,0,2,1,2
"8280","3a1950ede579c640accb4bda102f9be3",5,5,0,5,5,0,1,2
"8281","3a1a93267a9ee05f7d08f0946885762e",10,10,0,10,10,0,1,2
"8282","3a1b1b2a5bbe44c9dfa4ec733eb8e476",94,74,63,10.4444444444444,94,0,2,3
"8283","3a1badd7ff098adadf4deebbd0ae9596",94,80,15,43.8666666666667,94,0,1,2
"8284","3a1d344c9adf6a3556224c7c17a6448f",54,50,28,13.5,54,0,2,1
"8285","3a1f1f3d3b8f8aefcd01c61b698d8b7d",57,43,66,6.04545454545454,46,11,2,1
"8286","3a1f441d1f04019fc4597a77ef952ba5",15,15,0,15,15,0,1,2
"8287","3a20933b9febfa83537764170c157d53",46,39,19,16.9473684210526,29,17,1,1
"8288","3a22009e7b211f1a128945bcad62add5",20,20,0,20,20,0,1,2
"8289","3a25406132e1665b352872838a23a1f9",3,3,0,3,3,0,1,2
"8290","3a25de54b7a320ee40611eddfc5d74e8",51,37,74,4.82432432432432,51,0,2,1
"8291","3a26ae3938f11b49598db347dad8d143",32,32,0,32,32,0,1,2
"8292","3a297985b9c74c27d5f14e189941584d",47,37,49,6.71428571428571,0,47,2,1
"8293","3a2b7453be1dfe092cba1db6fc841ada",36,36,0,36,36,0,1,2
"8294","3a2e299c9bf6a516cac12dee4579bb7e",122,76,51,16.7450980392157,99,23,3,1
"8295","3a2f86def639a8ed1e14db563cd35434",44,44,0,44,44,0,1,2
"8296","3a2fcc1d779e5cf97add013474ff7e3c",10,10,0,10,0,10,1,2
"8297","3a30206c2c8087f05807ede287f3ce32",39,39,0,39,0,39,1,2
"8298","3a30c46202c8d148aaeb9eead3fa31f4",23,11,61,2.63934426229508,13,10,2,1
"8299","3a3200c660a923ae4d9c2d99746bd2bc",133,91,69,13.4927536231884,95,38,3,3
"8300","3a34bc7824c78a3be78a66b021f6b62f",98,81,52,13.1923076923077,98,0,3,3
"8301","3a36e49511e9e6f00bb681cc89ddef13",48,48,0,48,0,48,1,2
"8302","3a38d55485462c1373c1a42a2e8d8ff2",108,76,40,18.9,108,0,3,3
"8303","3a3949c7ff83d60a441ce782303a49c3",18,16,29,4.3448275862069,18,0,2,1
"8304","3a3a9298fb876ff1d976140c184c28da",51,51,0,51,51,0,1,2
"8305","3a3c0fe1c7c49cf7b5f6039d42b142e7",46,44,43,7.48837209302326,24,22,2,1
"8306","3a3d03c7ac2782ed16cc7e2bb39e1bf1",28,28,0,28,28,0,1,2
"8307","3a476a5d99c9eaa92dd7c19613be2db5",18,18,0,18,18,0,1,2
"8308","3a47b620f3cfc4b239be8dd2fbec0b90",46,46,0,46,46,0,1,2
"8309","3a49a6da2e26ce6e3b6a6e816c5d70ac",76,55,58,9.17241379310345,76,0,2,3
"8310","3a51ebe1002f7b9ddb303bdacb684d07",60,50,24,17.5,60,0,2,1
"8311","3a539667726f364d6cedd66b399ede63",136,67,76,12.5263157894737,116,20,3,1
"8312","3a57f53c21b2895f12535f9b64729250",68,47,42,11.3333333333333,68,0,2,3
"8313","3a5880f5df1ee51d55700736efa8e1b8",22,22,0,22,22,0,1,2
"8314","3a58e8943a0f67ac82bf281a2abf9aa4",99,80,41,16.9024390243902,53,46,2,3
"8315","3a5ac4ef813b4548b041b9ab2726d9c9",1,1,0,1,1,0,1,2
"8316","3a5d2c4ad4d10a63072c90d1e071a846",106,96,52,14.2692307692308,106,0,3,3
"8317","3a5d8c93a9e60095ad2e74efa1582cf0",29,29,0,29,29,0,1,2
"8318","3a610a1aa33563dfb7d8da7911f2b9aa",43,36,45,6.68888888888889,43,0,2,1
"8319","3a62ad8142c50a5c1f81f6ad4d069375",106,87,41,18.0975609756098,106,0,3,3
"8320","3a6331f8598f9fa9f078a0b12a6d8256",17,17,0,17,17,0,1,2
"8321","3a634fa6a97fe14e122fcb5d5953389b",198,108,72,19.25,198,0,3,3
"8322","3a6a20e198e82875436095ca56dc87d2",37,32,86,3.01162790697674,37,0,2,1
"8323","3a6a8ef8887bf8b469308fb0831e1374",17,17,0,17,17,0,1,2
"8324","3a6aa18979927958aa3bf64d8d88cf99",16,13,24,4.66666666666667,16,0,2,1
"8325","3a6b3aa536840306060427cbc359fd07",92,74,52,12.3846153846154,92,0,2,3
"8326","3a6b8af50c2501db8a8e25a406effc5c",78,60,58,9.41379310344828,39,39,2,1
"8327","3a6bda37407b2af12b0c39e970f79865",53,36,68,5.45588235294118,53,0,2,1
"8328","3a701878c8f0487c328b899afc4cf093",132,70,52,17.7692307692308,99,33,3,3
"8329","3a725d459fa424ac83963486877d411f",5,5,0,5,5,0,1,2
"8330","3a732a4cb0836d78da91ccdf91e76f0d",43,43,0,43,43,0,1,2
"8331","3a73d8d11e172c8299506c48bdab19c5",40,34,13,21.5384615384615,20,20,1,2
"8332","3a74f65613118dc980be158b3507c9db",38,38,0,38,38,0,1,2
"8333","3a78fbb888dda0f6ef8f357d959287e3",26,25,6,30.3333333333333,26,0,1,2
"8334","3a7c0e6791d2140b24372acdf69146d1",17,17,0,17,17,0,1,2
"8335","3a7f6ef3115f5efd82ed8422e05b0dd7",19,19,0,19,19,0,1,2
"8336","3a80b417bba9fe0ba64e465904b37a5d",54,51,15,25.2,54,0,1,1
"8337","3a82a3e28ff67bcaa995e48db1917efe",206,104,75,19.2266666666667,206,0,3,3
"8338","3a83f336d664a0a0f34af4120f785dbe",6,6,0,6,0,6,1,2
"8339","3a8485f2bc55ed80643225e08b50dbba",97,70,88,7.71590909090909,58,39,2,3
"8340","3a876b839d2cfa7649d4a7acda2699f7",185,104,67,19.3283582089552,185,0,3,3
"8341","3a87723c9c844d94a824ea9d9db167aa",61,53,21,20.3333333333333,61,0,2,1
"8342","3a87b0477e6dd4d3920c80d342aab045",56,56,0,56,56,0,1,2
"8343","3a8ac2ef356bd203ecb4f65cbd22ac90",11,8,62,1.24193548387097,11,0,2,1
"8344","3a8c79483edba3a95da9405f0dab2542",179,97,55,22.7818181818182,179,0,3,3
"8345","3a8e06ff0435a8309e8481c570108dde",5,5,0,5,5,0,1,2
"8346","3a8e3c1e96284a928cc948df80972225",46,46,0,46,46,0,1,2
"8347","3a96eeedf43532e79f0e4bf4778f5d06",27,27,0,27,0,27,1,2
"8348","3a97b43ad39e267219608720af6c8b6a",103,53,50,14.42,103,0,2,3
"8349","3a986171336b7c7ebd3761b09947f94f",120,72,50,16.8,120,0,3,3
"8350","3a9918aff3ec2917a3f05fe090b909da",102,65,77,9.27272727272727,102,0,2,3
"8351","3a9997bcee42864249024696a03c8737",23,23,0,23,23,0,1,2
"8352","3a9b562a676dd180f38ea82aff9067bb",24,24,0,24,24,0,1,2
"8353","3a9e2d804d3be04bc5ab77e4847d1f23",16,16,0,16,16,0,1,2
"8354","3aa06ad7b6b505f95098f81cc61c4d22",103,51,62,11.6290322580645,103,0,2,3
"8355","3aa206e2c63eb9cab70bb470a9d0105f",30,25,22,9.54545454545454,30,0,2,1
"8356","3aa330e55cf68ce5f2bfb49f94e058a3",12,12,0,12,12,0,1,2
"8357","3aa65a6f49bdeba23a11de749bae9ad0",87,68,61,9.98360655737705,87,0,2,3
"8358","3aa6a037f0b49d4835e9fc94558520a9",42,42,0,42,42,0,1,2
"8359","3aa6c94cea5d81f9a16409b2193a6647",15,15,0,15,0,15,1,2
"8360","3aa7cb5675ac01e67ca22003437cf6cf",33,27,27,8.55555555555556,33,0,2,1
"8361","3aab1f55d12258419d0459dddef0c4ce",95,83,69,9.63768115942029,95,0,3,3
"8362","3aaba0125c0e2d9effc6c58a04801f1f",224,121,78,20.1025641025641,187,37,3,3
"8363","3aabd9c72760ef01e0896fbf7331efb4",55,34,76,5.06578947368421,55,0,2,1
"8364","3aac11b3278e5f4e2023afb573e0ba6f",61,57,12,35.5833333333333,61,0,1,2
"8365","3aad45bc4895c4575ace8bd681dfe120",19,19,0,19,0,19,1,2
"8366","3aaf1a7ab116ecb228bbee60f194b641",11,11,0,11,0,11,1,2
"8367","3ab086f6f975bc9b9889fec25ed6543e",3,3,0,3,3,0,1,2
"8368","3ab14bf0a5b6d59a1d4cd5cd0010f35e",11,11,0,11,11,0,1,2
"8369","3ab89f7177c82db2061358314cdd0e77",27,27,0,27,0,27,1,2
"8370","3ab8b26b7d29079c043c36e0338125e4",150,96,62,16.9354838709677,100,50,3,3
"8371","3abbcc57cc8dd9214efcadb1920e07c7",50,40,40,8.75,50,0,2,1
"8372","3abd5508ff52adc6402e0897dda8e195",114,80,48,16.625,114,0,3,3
"8373","3abdabd60c45edf505a549f6ba3bd4fc",48,32,46,7.30434782608696,48,0,2,1
"8374","3ac05222fce737b9ab73a5d34d2b40a8",185,77,68,19.0441176470588,167,18,3,3
"8375","3ac0d15636ad1c71b8978a458a1251d7",19,19,0,19,0,19,1,2
"8376","3ac74a4dd456f914e2ce7934515d0e2d",47,43,51,6.45098039215686,47,0,2,1
"8377","3ac76ea700df6b9fedf68db7198c1d25",101,77,36,19.6388888888889,101,0,3,3
"8378","3ac8e3c86d5ea09431b43cbbe7427596",34,34,0,34,34,0,1,2
"8379","3ac95bbbf1b36437b325437ad5adf58b",40,29,43,6.51162790697674,40,0,2,1
"8380","3ac96507cd31dde7e322d5fe46ec920e",49,43,62,5.53225806451613,49,0,2,1
"8381","3aca33d5f6e7e236f054aa9b49dee19f",74,61,54,9.59259259259259,49,25,2,1
"8382","3acd651d9a354647b333e739ba664c19",143,72,70,14.3,143,0,3,3
"8383","3acd8745ffdc48c214e960f8e579f034",19,19,0,19,19,0,1,2
"8384","3acdf90458465de57eac1615d47de5f4",9,9,0,9,9,0,1,2
"8385","3ace7a4b25bc6bbb6eb1ad67cf6b71fc",29,29,0,29,29,0,1,2
"8386","3ad16b4799f9d12ebee71c840629d719",106,48,66,11.2424242424242,106,0,2,3
"8387","3ad22dccc252eb7f34725f03350f6300",98,73,43,15.953488372093,98,0,2,3
"8388","3ad29b4c90693bdce1910862b6f67ea5",14,14,0,14,14,0,1,2
"8389","3ad2b9eff8fb9503f9d3afb47a3be614",47,47,0,47,0,47,1,2
"8390","3ad59768e3889a323b99cdd0e0cdc000",31,31,0,31,31,0,1,2
"8391","3ad5a48135b60f9145ad2b9a0865ba8e",36,36,0,36,0,36,1,2
"8392","3ad5f6cf2109a60f05f50ee8dcc42895",126,89,49,18,96,30,3,3
"8393","3ad6cd0c7a2e716ced5b45520465346e",42,38,71,4.14084507042254,42,0,2,1
"8394","3ad8d5a85cc83d9c7da56a871bc14ad1",34,34,0,34,34,0,1,2
"8395","3ad9058d7111b82d7a3c80e2d3289569",117,71,90,9.1,117,0,3,3
"8396","3adc75ff6dd14f84015e30ef1b7ae2f6",73,66,51,10.0196078431373,53,20,2,1
"8397","3add3d77ce9acc3eed62306729ed3b1d",33,14,79,2.92405063291139,23,10,2,1
"8398","3ae025f418de44dec323bb9c0f7829fd",58,48,19,21.3684210526316,58,0,1,1
"8399","3ae0d234d5b4e315ea7ab75fd4d39b9b",12,9,27,3.11111111111111,12,0,2,1
"8400","3ae59f5495696e112d297a33e43cbba2",15,15,0,15,15,0,1,2
"8401","3aebd29bf72d5fae73704e8a80dae718",1,1,0,1,1,0,1,2
"8402","3aedb8093554abfcd478bb919d2cafc9",46,37,40,8.05,46,0,2,1
"8403","3aefdc73f484efa66d7f2594678364bd",5,5,0,5,5,0,1,2
"8404","3aefe653e887874ce1ae09278b676032",85,74,33,18.030303030303,85,0,2,3
"8405","3af059ea12e0ceb699ec493fb21f194e",22,22,0,22,22,0,1,2
"8406","3af1213df2c174e1381ce7f12784df93",20,20,0,20,20,0,1,2
"8407","3af14f5a6e0f766b62ac0d52ba8323b4",27,27,0,27,27,0,1,2
"8408","3af4303e95f344da4664f21b0d91e5d9",57,43,47,8.48936170212766,27,30,2,1
"8409","3af5ac584e8a563596175bb475112819",77,57,75,7.18666666666667,77,0,2,3
"8410","3af5c02fcacfcc9562253146db654616",32,32,0,32,0,32,1,2
"8411","3af65f95bc7408b5af78c17f60b94b29",108,73,61,12.3934426229508,72,36,3,3
"8412","3af7e76ed73d8641fb0d2e9b424030ca",121,77,60,14.1166666666667,76,45,3,3
"8413","3af82efecfd8d3e372c0e19228814959",12,12,0,12,12,0,1,2
"8414","3afa0885b06e08e90ade63c5e4974d07",66,57,20,23.1,66,0,1,1
"8415","3afa0d8595ae4d69ece9796c257f5cee",159,68,84,13.25,159,0,3,3
"8416","3afb1f93cf09bd567cf14ad325415396",120,79,57,14.7368421052632,73,47,3,3
"8417","3afc7c9dbdcf3135e391ab245ec4dfcb",23,23,0,23,23,0,1,2
"8418","3afda910835850407c338b7efe7d758d",119,56,55,15.1454545454545,82,37,3,3
"8419","3b00ca7d93065ac17238d7c81095c582",28,28,0,28,28,0,1,2
"8420","3b015e6c879e8fcdd4d8a958ff02bade",129,99,69,13.0869565217391,129,0,3,3
"8421","3b02671a4eb1baaa6dbf3a85e862be7d",13,13,0,13,0,13,1,2
"8422","3b07eadd7648d3371bfc40fe47882a6c",58,55,22,18.4545454545455,58,0,2,1
"8423","3b094c7a76c3960a6b76453293f142aa",69,54,42,11.5,69,0,2,3
"8424","3b09b265d56f7babeea6886317c1dddf",32,32,0,32,0,32,1,2
"8425","3b0a7e3cd9e60e956b621839a7510157",29,20,12,16.9166666666667,29,0,1,1
"8426","3b0b8c0213260d9e47227d6dd2f59ad3",48,42,30,11.2,41,7,2,1
"8427","3b0c9c3137606b5336b3ac4f1722a01e",42,42,0,42,42,0,1,2
"8428","3b157eb5a93f00737b26d0e2b5063ef0",106,86,44,16.8636363636364,106,0,3,3
"8429","3b158067f62832fe78ae6aeac264b493",41,41,0,41,0,41,1,2
"8430","3b1922f91daed84dd1f379d18cab03b8",157,99,56,19.625,118,39,3,3
"8431","3b1de418da635e6efa9e7515bce9620f",93,40,69,9.43478260869565,67,26,2,1
"8432","3b217bbe87dad66abe93f14290871df7",32,32,0,32,32,0,1,2
"8433","3b24e37de761dcaeec16c5aa640a63b7",138,101,84,11.5,85,53,3,3
"8434","3b2530dd22a174f310178576e102a430",50,47,35,10,50,0,2,1
"8435","3b278c3e9170acb514ed9fbda870e3c1",81,62,45,12.6,81,0,2,3
"8436","3b287bd6da2d9e3aa81ed0c356ea9979",43,43,0,43,0,43,1,2
"8437","3b287d28a80562b9f23f297b770c6a9e",25,25,0,25,25,0,1,2
"8438","3b28ef9954b2c0dbf4e308d3381d544d",17,17,0,17,17,0,1,2
"8439","3b2b12539e0cb62be5bac737d2524289",29,28,6,33.8333333333333,1,28,1,2
"8440","3b2e1e5099ec0b6dcd4f0688c5ab08a2",15,11,10,10.5,5,10,1,1
"8441","3b302d33c4ab84d761835e4a44a9a20a",141,104,49,20.1428571428571,88,53,3,3
"8442","3b309044aae7465857d2f441c23090cd",17,17,0,17,17,0,1,2
"8443","3b3192fecf54f72b49b324b11c9fff7f",36,36,0,36,36,0,1,2
"8444","3b35f381fdf0da4b356c004cba6dd7db",205,146,81,17.7160493827161,205,0,3,3
"8445","3b363a659d32bb11bed1d0e18ff655d4",69,58,22,21.9545454545455,69,0,2,1
"8446","3b36f82fc812be3fb6d709d561a2f2bd",40,36,32,8.75,40,0,2,1
"8447","3b38aca635c4caa67e8c26d53c034c16",23,23,0,23,23,0,1,2
"8448","3b39cf54818218dab1c02f9387cdc0cc",33,33,0,33,0,33,1,2
"8449","3b3a4fd8e8ffd01272cc804452be088d",37,37,0,37,37,0,1,2
"8450","3b3c708ed65fce0051fc44512df7960f",150,123,68,15.4411764705882,150,0,3,3
"8451","3b3e51a692fcb5d510d067453ca3d05e",121,79,57,14.859649122807,121,0,3,3
"8452","3b446ecf2eccf357ab2b9ca53d5f79f8",2,2,0,2,2,0,1,2
"8453","3b45551af2cee9ccda366ccee5f84aa0",64,60,18,24.8888888888889,64,0,1,1
"8454","3b47984162dc0647be5f897e7f1c79f5",162,61,77,14.7272727272727,135,27,3,3
"8455","3b47a380ecb05e3584020d9248577bb6",74,57,37,14,46,28,2,1
"8456","3b4ad49f7c3db36a4ea516b831df67ec",26,26,0,26,26,0,1,2
"8457","3b4ae791554f6aa6f5d837eb8c876f3f",7,7,0,7,7,0,1,2
"8458","3b4af7ed908528969298063f5c39ae30",7,7,0,7,7,0,1,2
"8459","3b4b8909b7d4071b47f2321fed198d40",33,32,57,4.05263157894737,33,0,2,1
"8460","3b4db5fb0731af9e2f8f45a216a1fd54",45,32,52,6.05769230769231,45,0,2,1
"8461","3b4de2f6709970d11e09b34752c488d1",21,21,0,21,21,0,1,2
"8462","3b4f55cfb052d00ab068b2f5da96d8b8",54,41,55,6.87272727272727,54,0,2,1
"8463","3b4f71e072ca009d20afa74b23f305b1",27,27,0,27,27,0,1,2
"8464","3b4fcb54849266b19ed6ae8fb2d49323",184,135,47,27.4042553191489,184,0,3,3
"8465","3b50f2639479301ecfa0c08f1b929205",18,18,0,18,18,0,1,2
"8466","3b50f45f2b225722900bc9378eae5689",109,62,69,11.0579710144928,109,0,3,3
"8467","3b528ca5dad5451f7d421ff0483c95a2",24,24,0,24,24,0,1,2
"8468","3b5313dbaf4c0fb74e20905e751d9f65",24,24,0,24,24,0,1,2
"8469","3b57bad90c6a0e7def0a58b60bd2cc41",154,81,71,15.1830985915493,123,31,3,3
"8470","3b589da413bf4c894b12751010a49f25",46,42,11,29.2727272727273,21,25,1,2
"8471","3b594b231a7e7c62cccf0e134b44b0bd",62,44,42,10.3333333333333,62,0,2,1
"8472","3b59d918ea445381a393340fd77bc6e0",83,59,41,14.1707317073171,54,29,2,1
"8473","3b5aa803fc5f480490e59abfd7e337b2",17,17,0,17,0,17,1,2
"8474","3b5c5b88d7e95dec45c03fec6932361a",174,73,90,13.5333333333333,174,0,3,3
"8475","3b5c7c4cde7557f8c307f8a297784c59",88,77,35,17.6,88,0,2,3
"8476","3b5cba68c6437e7afe2af60290f41915",1,1,0,1,1,0,1,2
"8477","3b6012af074c2a390ce494b4de262c0a",37,37,0,37,37,0,1,2
"8478","3b6523a3f0fce5bf5e94d573a1c99fe5",60,47,24,17.5,26,34,2,1
"8479","3b6a6c59d1480172dc022daaeb4a42e9",51,41,29,12.3103448275862,33,18,2,1
"8480","3b6b4c104173522351d0e2ea13fb24b8",204,116,77,18.5454545454545,204,0,3,3
"8481","3b6e683409c5a46e10995084c63cd80c",77,56,55,9.8,77,0,2,3
"8482","3b6ebe328c3a11820d2b6403f2cf91e8",77,49,57,9.45614035087719,77,0,2,3
"8483","3b6f304235553187042cd5479fa0e6e9",91,73,21,30.3333333333333,91,0,3,3
"8484","3b70122e75604e3ac2ab4e4e16e5c9e6",13,13,0,13,0,13,1,2
"8485","3b7206372ed842622c469ef8db87b413",215,107,78,19.2948717948718,215,0,3,3
"8486","3b7375e2e14a7ad2e215ef160f4900c9",28,27,71,2.76056338028169,28,0,2,1
"8487","3b75a50c8c081153f7ae989ac45aa220",46,38,29,11.1034482758621,46,0,2,1
"8488","3b76a7a0f8eb9d6e543d85a82d4debdf",20,20,0,20,20,0,1,2
"8489","3b790794e88cec41ca9e73e84d25e319",41,41,0,41,0,41,1,2
"8490","3b7ac2af47d6c1515d7a8dc35a7c2890",185,127,79,16.3924050632911,185,0,3,3
"8491","3b7b69dc677488483fbf8957c6e679ca",34,34,0,34,34,0,1,2
"8492","3b7fad0c032a969af271bf62e687350a",10,10,0,10,10,0,1,2
"8493","3b8008754ebf7c6387224d98aaa80c20",8,8,0,8,8,0,1,2
"8494","3b80b5ebc87702934bd817014bbf182c",13,13,0,13,13,0,1,2
"8495","3b8417dcdb5edddc49befe6cfa581061",99,72,50,13.86,99,0,2,3
"8496","3b84de074de0d634f33c055d1e466ec9",49,36,37,9.27027027027027,28,21,2,1
"8497","3b876aec923c21b8d344e26d1009abe4",16,14,66,1.6969696969697,6,10,2,1
"8498","3b8b1eb30bea731f27f3dbaff3c9aae3",60,57,23,18.2608695652174,60,0,2,1
"8499","3b8bbbb0e53ef3612f711af4505ffc73",47,47,0,47,47,0,1,2
"8500","3b8d4707040d1610854eb37449737a02",25,25,0,25,0,25,1,2
"8501","3b8ed2a9d5b3cf48232b32fe2611b63a",69,56,42,11.5,69,0,2,3
"8502","3b9006cdbc85e0bd04ce77766bc12b8c",103,66,63,11.4444444444444,103,0,2,3
"8503","3b9037eb9efdcd80c3e72d471384839c",40,40,0,40,40,0,1,2
"8504","3b922ac431134ada0db21ee32905fc03",48,36,45,7.46666666666667,48,0,2,1
"8505","3b92d48153f66dc517eaea424068b8f8",141,85,54,18.2777777777778,141,0,3,3
"8506","3b97e6e0b739c79181dffca06f522be4",78,64,35,15.6,78,0,2,3
"8507","3b98d3b9289ea997481f08349a9dfc6a",23,23,0,23,23,0,1,2
"8508","3b9a924e721ec33a920be530b1645cf6",53,53,0,53,53,0,1,2
"8509","3b9d7cd47d9cf25177ce237eba258c84",252,116,65,27.1384615384615,219,33,3,3
"8510","3b9fb188e48b8708e431931acf22b0ae",23,23,0,23,23,0,1,2
"8511","3ba214b095fadc5ce28a3e4a484877f8",175,126,79,15.506329113924,148,27,3,3
"8512","3ba2b7ca3a8e25af541dd1cf64a93fd3",39,32,27,10.1111111111111,39,0,2,1
"8513","3ba34677f0397799a4d87cd9f899c738",41,41,0,41,0,41,1,2
"8514","3ba418d4a226366861039049628fd0d6",86,61,82,7.34146341463415,70,16,2,1
"8515","3ba6a7d81cbcf38dbb5de6a067a6fda2",38,38,0,38,38,0,1,2
"8516","3ba76bf7a5987fea88e4b5ca121a3f6c",51,50,34,10.5,51,0,2,1
"8517","3ba90ee23dd6785f28acc617c368f49a",4,4,0,4,4,0,1,2
"8518","3baff05087109cc6f4cd5ebdb58b5683",71,55,48,10.3541666666667,71,0,2,3
"8519","3bb076412be7eb7fbb4f191dec46715e",26,26,0,26,26,0,1,2
"8520","3bb2f287992c534662ef252e2c9c9541",22,22,0,22,22,0,1,2
"8521","3bb62e26f11e8b4ec88dbda37b6f3357",33,33,0,33,33,0,1,2
"8522","3bb868496842159907f219fca00b9390",139,93,68,14.3088235294118,139,0,3,3
"8523","3bba851982450bd720a1cbf9d8d507d2",35,33,47,5.21276595744681,19,16,2,1
"8524","3bbadef2d2f7f4e3eca53ef7b9a1ef01",126,75,71,12.4225352112676,110,16,3,1
"8525","3bbb1d933966e5d371a856a63ffa5223",68,54,60,7.93333333333333,31,37,2,1
"8526","3bbbac7c9ac9fdc6d5740534c4f7a8ad",59,48,43,9.6046511627907,59,0,2,1
"8527","3bbbe136649bddc6009ca8c13b35d87b",40,40,0,40,40,0,1,2
"8528","3bbc95246b3ce4ccf316cf53e5b724f3",94,60,42,15.6666666666667,94,0,2,3
"8529","3bbe10efa77b0e5fa851e6bf27f84e8c",45,37,70,4.5,45,0,2,1
"8530","3bc22aaeee01da6a55eac1fb0e147b7d",108,79,62,12.1935483870968,108,0,3,3
"8531","3bc368032530c7c03b00a7f40253c886",4,4,0,4,4,0,1,2
"8532","3bc3fe27afc50ccf5bac7e3eda8859c5",52,40,48,7.58333333333333,52,0,2,1
"8533","3bc467492dc6a88341b9c706c536601e",138,100,54,17.8888888888889,96,42,3,3
"8534","3bc46f0b03de7271db90267ed1e444e5",8,8,0,8,8,0,1,2
"8535","3bc4d7492d4ed14de59ceb472dde0506",130,89,65,14,81,49,3,3
"8536","3bc734fc7afd5026262cc858ba8f485d",15,15,0,15,15,0,1,2
"8537","3bc9a078ed04bfb86ba00891ad842933",62,45,33,13.1515151515152,32,30,2,1
"8538","3bccba842f7ac891c00a72285c331a3e",62,48,52,8.34615384615385,32,30,2,1
"8539","3bcdb08793bc5f3305528103508241d8",51,39,82,4.35365853658537,35,16,2,1
"8540","3bcf2c0cb84d7352d170e3765d8c8171",19,19,0,19,19,0,1,2
"8541","3bcf85fe298d7ff1045f87db8393300b",23,23,0,23,23,0,1,2
"8542","3bd118ae018c88a1f2e0321dd14ef755",230,142,76,21.1842105263158,189,41,3,3
"8543","3bd3964377f403d7bc1a2ab449478206",53,53,0,53,53,0,1,2
"8544","3bd7aded6e8fcc6975643e8962b82b8c",43,43,0,43,43,0,1,2
"8545","3bd87ebc9b3d686f481f2feb56dbd5c3",30,30,0,30,30,0,1,2
"8546","3bd92c6aa63914b30cc7dd4c22df6e9a",46,34,51,6.31372549019608,29,17,2,1
"8547","3bd9db835489d8fcb74ab760d9100eb7",31,31,0,31,31,0,1,2
"8548","3bda534fd7cd1a723b73bc66c956625c",66,52,37,12.4864864864865,35,31,2,1
"8549","3bdabb03d744c5a39b69bc98567b653a",21,21,0,21,21,0,1,2
"8550","3bdbb23067f21efb90a3cf0bccc722cc",74,46,86,6.02325581395349,20,54,2,3
"8551","3bdcd2cfa92708f0e77a1f7dddecae4c",45,42,41,7.68292682926829,45,0,2,1
"8552","3be132f4af4798e7c26152d8ab4bcb4c",31,31,0,31,0,31,1,2
"8553","3be18112111cd0f3842c3e46d1fcf7fc",17,17,0,17,17,0,1,2
"8554","3be1b189fdb20140ceffea5f8c8a18c9",169,76,74,15.9864864864865,134,35,3,3
"8555","3be2418ba6c28513c4f3a7017767838f",11,11,0,11,11,0,1,2
"8556","3be2deba9e9b0548452bc212f30901cb",48,48,0,48,48,0,1,2
"8557","3be4defda0f886e305d8104323c1a3bf",86,39,62,9.70967741935484,86,0,2,3
"8558","3be69fe24b258b8d3d4bc82d15649e3b",67,46,69,6.79710144927536,39,28,2,1
"8559","3be99a7a3df814af28c7f3329db60247",33,33,0,33,0,33,1,2
"8560","3beb094884dc760e261b6decf1298efe",5,1,58,0.603448275862069,5,0,2,1
"8561","3bec16ad02e3ae29c16a732d3c183f21",71,48,46,10.804347826087,34,37,2,1
"8562","3bed44d2db36d4f21dc82cf0e2b0e418",3,3,0,3,0,3,1,2
"8563","3beda7e0762a073441fc2e5192f8f628",43,37,6,50.1666666666667,43,0,1,2
"8564","3bef6b7b222d5096113d3004b6d705e7",38,29,30,8.86666666666667,38,0,2,1
"8565","3bf23d1baf318e14e63891331c71389c",28,28,0,28,28,0,1,2
"8566","3bf30f5a7312f4f55dedec54b87379f0",40,40,0,40,40,0,1,2
"8567","3bf4349ea66dc7ba02e538ead06117ab",43,43,0,43,0,43,1,2
"8568","3bf49958e73491b9e6e7ee966066f1ca",18,18,0,18,18,0,1,2
"8569","3bf6d8adcdfdd3b469d5399f140de838",5,4,31,1.12903225806452,2,3,2,1
"8570","3bf8320a2df990063def26151435c3e5",27,27,0,27,27,0,1,2
"8571","3bf9b56ba3f555e321eb72aacc9779af",14,14,0,14,14,0,1,2
"8572","3bf9bf375ca6f95322b43579b7430249",22,18,49,3.14285714285714,22,0,2,1
"8573","3bfd5799f7daa80aa1d46834d4059d58",114,86,58,13.7586206896552,74,40,3,3
"8574","3c03d660900176eba25e67d135990816",40,40,52,5.38461538461538,40,0,2,1
"8575","3c046440e1065a46b448d142fcba24d5",7,6,76,0.644736842105263,7,0,2,1
"8576","3c046e499fd6564e1ffe84a6df7950c8",181,129,78,16.2435897435897,181,0,3,3
"8577","3c05206716bc37d284090c08036fb829",82,67,63,9.11111111111111,82,0,2,3
"8578","3c0797b49285168067f77e789922014c",27,26,18,10.5,27,0,1,1
"8579","3c0d36c6460d36479f5de7824cd21999",80,52,68,8.23529411764706,66,14,2,1
"8580","3c0e52e4e0c1103c3a27b8584eae77e2",13,9,59,1.54237288135593,5,8,2,1
"8581","3c0f6a71c41a1a6d8c9de56efd3c9378",33,33,0,33,33,0,1,2
"8582","3c10ed21dc8442fe9dd10f50ab320158",43,37,46,6.54347826086957,43,0,2,1
"8583","3c1131165a61445b6999a7c401ea7b70",23,23,0,23,23,0,1,2
"8584","3c118ac8d3f8cf7c1c00d40aebbb9f22",165,84,85,13.5882352941176,147,18,3,3
"8585","3c11d0623dfe7475cc6403f41838ca5a",24,24,0,24,24,0,1,2
"8586","3c13c23ccadfd1ed6cf679297bf70378",26,26,0,26,26,0,1,2
"8587","3c150146c6b4825a57587af035741c62",3,3,0,3,3,0,1,2
"8588","3c152db1d5ae099ea6574d3dbfbc1720",92,71,50,12.88,92,0,2,3
"8589","3c153b351200cfe7976abd4865b63364",116,86,66,12.3030303030303,116,0,3,3
"8590","3c18328a0dd7393c3a9fab2a597689ef",25,25,0,25,25,0,1,2
"8591","3c18a0652f59c4d52a854816fcd73e01",48,39,30,11.2,48,0,2,1
"8592","3c1a757b92ff357d784cf625db6a2389",234,118,75,21.84,180,54,3,3
"8593","3c1bf2d274a454594f87e7e7c19a9708",51,46,14,25.5,51,0,1,1
"8594","3c1c981ad44655e9d6e8093666d505cb",30,20,35,6,30,0,2,1
"8595","3c1d9af45a1b38ecf15ce131bc8dd220",115,58,54,14.9074074074074,86,29,3,1
"8596","3c20bd75a0dff65ac5a02ae58b9d9925",13,13,0,13,13,0,1,2
"8597","3c21d7a62b7f6c47f51ff7abcc430555",7,7,0,7,0,7,1,2
"8598","3c22673f984a23c551801cb38c4f21cb",57,39,46,8.67391304347826,57,0,2,1
"8599","3c23031c181e3b4ce041ae66b4f12b36",126,91,65,13.5692307692308,71,55,3,3
"8600","3c24322bb525350c7a277bf39b139f1f",27,27,0,27,27,0,1,2
"8601","3c279ce4925285585b38d54d35973bdb",143,90,84,11.9166666666667,143,0,3,3
"8602","3c2a7d160299401b97713949b8a3ce8a",68,62,51,9.33333333333333,22,46,2,1
"8603","3c2befaf93227e2864237086e1808522",49,45,19,18.0526315789474,49,0,1,1
"8604","3c2c9c5c40a47a456d92aaf0a32b6165",10,10,0,10,10,0,1,2
"8605","3c31836ec21f721edf2bc90181e94e00",46,46,0,46,46,0,1,2
"8606","3c31cde90bf7f66354029e2f05036a90",27,25,24,7.875,12,15,2,1
"8607","3c320ed258b0b0ec7bebfbceab3c4a5c",203,112,69,20.5942028985507,203,0,3,3
"8608","3c32aec9a4bf5083917295a8a011f5f3",81,70,38,14.9210526315789,81,0,2,3
"8609","3c35d801b463181ed4c2b81a37facaaf",62,49,85,5.10588235294118,62,0,2,3
"8610","3c367935cd74d73c1e2446f3d9457634",38,24,83,3.20481927710843,38,0,2,1
"8611","3c3729bab0a6fd931e99da8426e4860c",73,55,40,12.775,73,0,2,3
"8612","3c372def0c465799f2eb2ab86a5087e3",145,81,61,16.6393442622951,100,45,3,3
"8613","3c37736bb133022444fd048afb6cc0d1",47,42,21,15.6666666666667,47,0,2,1
"8614","3c38cb7f4804280780ddae7e943860ba",116,75,42,19.3333333333333,116,0,3,3
"8615","3c38d9f5b2441c65f02f6fbd35d3ec3d",67,57,64,7.328125,67,0,2,3
"8616","3c3c76caf9b53477fdca45a181e0bf6a",36,36,0,36,36,0,1,2
"8617","3c3e14fe36001c3366c08943e471b1a4",62,51,22,19.7272727272727,62,0,2,1
"8618","3c4231cd3767dbb6abd61ec2635df80f",45,39,63,5,45,0,2,1
"8619","3c42f9b89bd2e33e425b3878ac3b4860",9,9,0,9,0,9,1,2
"8620","3c4db6dfdd899e3bb0bb823274812721",102,85,82,8.70731707317073,102,0,3,3
"8621","3c4e207a501b655c654bf829b34be7ba",30,30,0,30,30,0,1,2
"8622","3c508ab931a81fef588e1fb9201d85f4",32,32,0,32,32,0,1,2
"8623","3c513de0c68a914b14ab613fc42f952e",43,43,0,43,43,0,1,2
"8624","3c51a40c24e73c0324ff8c8e253bb86d",49,42,42,8.16666666666667,49,0,2,1
"8625","3c530fe2c3a5d1866acba501e2edd80a",36,36,0,36,36,0,1,2
"8626","3c541166f6915174edfe3d18f4f9b9fb",27,27,0,27,27,0,1,2
"8627","3c55a2b029fdbe8c2fb11836cc45b0f7",133,70,55,16.9272727272727,101,32,3,3
"8628","3c55e75bf884707814b1f42a668db5ad",109,87,29,26.3103448275862,109,0,3,3
"8629","3c578265d857ab5c65af84e80567a149",18,8,55,2.29090909090909,18,0,2,1
"8630","3c57fbc9f202a3214c846d4d081dfd66",108,50,77,9.81818181818182,71,37,2,3
"8631","3c59ab17f87ee6d751fb757ab90a38fe",78,74,14,39,78,0,1,2
"8632","3c5ab28b89cf4579fddb53018e29965c",114,90,70,11.4,114,0,3,3
"8633","3c5e3b61895bcb8ea18c5daa4052e5df",32,19,57,3.92982456140351,32,0,2,1
"8634","3c5e482939be7e619bc4f2c338488939",62,45,56,7.75,62,0,2,1
"8635","3c6406ebb4ed2d953ae67e4f89fa8aa9",86,65,59,10.2033898305085,86,0,2,3
"8636","3c6685eb61c237c7aff5a9dbd23e8601",44,44,0,44,0,44,1,2
"8637","3c66ac31dcaa686890307fdc28672f76",60,46,52,8.07692307692308,60,0,2,1
"8638","3c693590a12089eec1d7e7ffce113d36",68,37,26,18.3076923076923,68,0,2,1
"8639","3c6b2c41aca9a2d726334e8ff1f63146",17,17,0,17,17,0,1,2
"8640","3c6d44bf9fb7abf9128150d8c7f84807",35,35,0,35,35,0,1,2
"8641","3c6daf64dffa0bdaad379b14c266e6b9",70,55,69,7.10144927536232,70,0,2,3
"8642","3c6e46bf7bfef2e48035746bbb9b372d",60,35,59,7.11864406779661,60,0,2,1
"8643","3c6e5675a788da5c36fb251e0c80e25a",7,7,0,7,7,0,1,2
"8644","3c6f5e6765ee79ab2b12c13a830854ca",42,42,0,42,42,0,1,2
"8645","3c714519ef5ccf624f8dde737f718bdc",60,46,39,10.7692307692308,32,28,2,1
"8646","3c730e4346e88f08471fa7a3b5a8d693",31,31,0,31,31,0,1,2
"8647","3c7ed51aef403006834119514e51df56",67,34,77,6.09090909090909,67,0,2,1
"8648","3c800638b988e0bd5be0ed2db70e0a55",80,62,23,24.3478260869565,80,0,2,2
"8649","3c815a92a60165ee66746a2105ef6f24",166,121,43,27.0232558139535,166,0,3,3
"8650","3c8304d1fca0f7509edcd4da3b9fc504",12,10,19,4.42105263157895,12,0,1,1
"8651","3c898093ed0eb76ba0a47f2237d8358b",45,45,0,45,45,0,1,2
"8652","3c8c04d19a33f4040fd65a05990a0832",24,24,0,24,0,24,1,2
"8653","3c8dd491321a3f641445b94597cc4727",28,28,0,28,28,0,1,2
"8654","3c8e53f783d0ecb00b0391ade5c37eeb",141,94,51,19.3529411764706,141,0,3,3
"8655","3c905af7f8d5c53126cbb33e130df191",156,95,77,14.1818181818182,156,0,3,3
"8656","3c921557a65da592024539d3bdb269d4",81,73,50,11.34,30,51,2,1
"8657","3c9227e1e5e2a1b29b0dc7de3fb8c596",84,72,30,19.6,51,33,2,3
"8658","3c9339dddd46b77f9bab8104c588edb6",245,134,67,25.5970149253731,195,50,3,3
"8659","3c9542a1258acace1c2defc14ded245c",62,46,74,5.86486486486486,44,18,2,1
"8660","3c963ad237c42f58484fc457623c9ecc",13,13,0,13,13,0,1,2
"8661","3c96bc9f366059538a098f57267b5739",172,81,82,14.6829268292683,150,22,3,3
"8662","3c97c6e66e6afb6b46ec1e43180cd3b0",22,22,0,22,22,0,1,2
"8663","3c981421c5c63695479e87fae1ca75dc",16,16,0,16,16,0,1,2
"8664","3c99661ea497cece7e5a509555b59b09",55,39,82,4.69512195121951,55,0,2,1
"8665","3c9a0b66001a89a656be954f7fd2a45e",3,1,74,0.283783783783784,3,0,2,1
"8666","3c9ae9bafa7660af781914fedc538b27",28,28,0,28,28,0,1,2
"8667","3c9b054ac3ae0d917177afb9d938e512",1,1,0,1,1,0,1,2
"8668","3c9be4e53b6c97f305c8ffee9b8b9ba3",40,40,0,40,40,0,1,2
"8669","3c9d38e0345416b4bbbffcd587c31067",34,34,0,34,34,0,1,2
"8670","3c9d38f6823a276a5ced1c9bd2ac306b",13,11,26,3.5,13,0,2,1
"8671","3c9ddb6f8ca1d2de889d073906f5e770",72,49,51,9.88235294117647,72,0,2,3
"8672","3c9e2cae8b3f80ce699419c5e52267f1",48,48,0,48,48,0,1,2
"8673","3ca2d966af3428dac0c53206bf1a9977",85,59,64,9.296875,52,33,2,1
"8674","3ca3fde21467932968c3fa438a5b1a0d",73,45,65,7.86153846153846,73,0,2,3
"8675","3ca69292a9cce4143f03cc9a905070ab",35,35,0,35,35,0,1,2
"8676","3cab7d912ab1cbd96d82ff6c3890312b",20,20,0,20,0,20,1,2
"8677","3cad63908dc9846fece74a539d3ab3fe",150,95,47,22.3404255319149,97,53,3,3
"8678","3cad872ab4112fce671312d1eb06f18b",15,15,0,15,15,0,1,2
"8679","3cafdf0f16ea0236031f6e712198afce",58,54,54,7.51851851851852,58,0,2,1
"8680","3cb14beebcf226225690118a8e01d379",18,18,0,18,18,0,1,2
"8681","3cb6c6328b32d5474698227a0b932d3d",21,21,0,21,21,0,1,2
"8682","3cb6eacf47b4b59a398a302915ea5bc3",202,115,78,18.1282051282051,202,0,3,3
"8683","3cb862b7381401e9c59e1ca503961340",16,8,81,1.38271604938272,16,0,2,1
"8684","3cba2bb7cbbbcc92f8b93c4904aa26db",27,27,0,27,27,0,1,2
"8685","3cbcb4011e290888a3a297559fd9b03d",190,111,81,16.4197530864198,155,35,3,3
"8686","3cbd7df7e4e6ab2bc02e6019f4b7725c",12,8,50,1.68,12,0,2,1
"8687","3cbdd44c95b7b42f3f1d593f4da96449",55,55,0,55,55,0,1,2
"8688","3cbfe7771537c3c2c66ac6e6cede5101",122,83,77,11.0909090909091,111,11,3,1
"8689","3cc13029440ab9fce2aff6e8444fddf7",59,41,47,8.78723404255319,30,29,2,1
"8690","3cc19141643d7d1c09773e6767627db9",13,13,0,13,13,0,1,2
"8691","3cc31fa472bfcf414ba5f0a592339cf8",34,34,0,34,34,0,1,2
"8692","3cc372af748f01fe04e243a55a8f8c3d",136,88,40,23.8,101,35,3,3
"8693","3cc40466e2656b82f0213eca04c8f52a",34,34,0,34,34,0,1,2
"8694","3cc5975c2ff35095f298c2472c7d8aee",21,21,0,21,0,21,1,2
"8695","3cc5e55e42bf03c2bb84bc91d10f9af3",107,66,77,9.72727272727273,68,39,2,3
"8696","3cc67fdfe221fb495f5f7e17cbbfb16b",74,54,56,9.25,23,51,2,1
"8697","3cc87878db73e9ca0c5b0a52a89d05ec",68,50,73,6.52054794520548,36,32,2,1
"8698","3ccaa7804e137b9f385f6bdcfdc58773",183,105,84,15.25,183,0,3,3
"8699","3ccd598725aa30c050e7ef17c406a6ed",89,69,71,8.77464788732394,89,0,2,3
"8700","3cd05fc157a8956110c01683ee02afb2",15,15,0,15,15,0,1,2
"8701","3cd1ffccbe1d0cc6dbea6483dc6d2521",15,15,0,15,15,0,1,2
"8702","3cd3b65a772ac28abbc2193f6547b123",49,49,0,49,49,0,1,2
"8703","3cd43d4ae663ad436d1be23761a87418",56,56,0,56,56,0,1,2
"8704","3cd5062f2cbd1be4d0e88277a3ec5411",97,53,49,13.8571428571429,75,22,2,1
"8705","3cd9f6660fa135cfca3fe26cb5bf2f60",25,25,0,25,0,25,1,2
"8706","3cd9fb69e36ea3eefc15c8ee8e6dc4e6",67,28,76,6.17105263157895,50,17,2,1
"8707","3cda5989e92fd8516a33bd39feb83547",59,52,66,6.25757575757576,59,0,2,3
"8708","3cdc8324e9d2de45081e3a2686d9c486",43,43,0,43,43,0,1,2
"8709","3cdd76dd962dc329b3998fdc0cb32229",84,48,46,12.7826086956522,70,14,2,1
"8710","3cdf538b40f777374fafbfac03b13633",132,84,63,14.6666666666667,132,0,3,3
"8711","3ce144d818d57647a7a1640ecf1195de",103,53,72,10.0138888888889,103,0,2,3
"8712","3ce21f250e19bcc4c027607d1c5c3638",28,28,0,28,28,0,1,2
"8713","3ce3645a3ac6b46dae0e9c33a2e20bed",101,75,47,15.0425531914894,58,43,2,3
"8714","3ce43440f5f9c7e43a2000fe28717a4f",41,41,0,41,41,0,1,2
"8715","3ce47c5c540da83712f49932652a8289",140,95,55,17.8181818181818,140,0,3,3
"8716","3ce6958934a2b06abca19f2da8a84f7c",90,48,59,10.6779661016949,51,39,2,1
"8717","3ce91d895ae43b8808070797e5463e29",72,55,48,10.5,72,0,2,3
"8718","3cea1cb5c54fca3e308cb26b0dfdfd9a",129,68,74,12.2027027027027,129,0,3,3
"8719","3ceb82571abd0309cf844094415901bd",179,121,71,17.6478873239437,179,0,3,3
"8720","3cecc384f34eef79a3f9bda0d2097200",141,102,45,21.9333333333333,141,0,3,3
"8721","3cef1386b9164a4c09d85a38311bb5f5",30,30,0,30,0,30,1,2
"8722","3cf111f15dda9d797ca8e4db12cf029a",159,76,70,15.9,159,0,3,3
"8723","3cf1c2a4330b474d759dff09b8769ee5",16,16,0,16,16,0,1,2
"8724","3cf322be1c1aa0af7be3a2faa0415c5e",103,90,14,51.5,103,0,3,2
"8725","3cf33362ae3ab08bd5a428ad0b8ae124",121,82,61,13.8852459016393,121,0,3,3
"8726","3cf39a982754e4af31b90731d049baae",45,38,29,10.8620689655172,45,0,2,1
"8727","3cf54c0b0d09b807aabb42dacd2079aa",85,46,79,7.53164556962025,85,0,2,3
"8728","3cf8c979ffddf3de1b7286144a779325",40,40,0,40,40,0,1,2
"8729","3cfb65a8979705481ba926af81dab046",16,16,0,16,0,16,1,2
"8730","3cfbfacb876ec137029f5c308789c395",31,22,28,7.75,31,0,2,1
"8731","3d02ee19ecbc5ca178a2a317f6b4153a",52,33,38,9.57894736842105,52,0,2,1
"8732","3d0aed33d2fcfdbbb24c45c724c31f4b",187,65,71,18.4366197183099,187,0,3,3
"8733","3d0b6358b28cbbf7a34ba7219826f1d3",44,44,0,44,44,0,1,2
"8734","3d0cafa6ad887771068d8d54ac926f5a",46,37,11,29.2727272727273,46,0,1,1
"8735","3d0cd3e44bf60b24eb085090c56cd97f",76,55,19,28,76,0,1,2
"8736","3d0dff93ee4ed59802c839b4e7b3b1e2",56,56,0,56,56,0,1,2
"8737","3d0f069c4d0cd46da15249f48e248208",28,22,49,4,28,0,2,1
"8738","3d0f1d9a9eeb14c460f580fe7b276572",44,44,0,44,0,44,1,2
"8739","3d10a0becb912c67079116dd9e77ba25",57,42,25,15.96,27,30,2,1
"8740","3d11172820dd5d5a7b744f59a69f2852",5,5,0,5,5,0,1,2
"8741","3d182110ff75b16eea2307e66908b5d9",54,41,49,7.71428571428571,54,0,2,1
"8742","3d199e7aa9959732e73b0fd29fe3f015",16,16,0,16,0,16,1,2
"8743","3d1bd15195ec69f27187f14b40151e3e",108,54,53,14.2641509433962,108,0,2,3
"8744","3d1c91a7d63ee0d8bffc2a453e37bd64",15,15,0,15,15,0,1,2
"8745","3d1ccb299bab44f402835e078ecff444",31,27,49,4.42857142857143,31,0,2,1
"8746","3d1fa68bc2c07e7441a2336aecdac2ed",54,45,22,17.1818181818182,22,32,2,1
"8747","3d2366f1b66ed5ad7105eae34d4c06a6",20,20,0,20,20,0,1,2
"8748","3d2643620159f8d100580c18af1717ca",93,59,46,14.1521739130435,93,0,2,3
"8749","3d27af8e16ac847822145271803c26f0",70,51,45,10.8888888888889,34,36,2,1
"8750","3d30cd4490920c9a97dc04c0c60c9cec",59,55,14,29.5,59,0,1,2
"8751","3d311b72562046a8d09714ed4cd79c67",78,44,15,36.4,78,0,1,2
"8752","3d32e5e673e2b1b5504ceeac7f3c4e77",83,63,32,18.15625,41,42,2,3
"8753","3d336299a914de47d7d1f30ce26e2f64",77,57,59,9.13559322033898,77,0,2,3
"8754","3d34c80aa43cf66c22c3dc9a91ef1f17",75,52,35,15,75,0,2,1
"8755","3d360988fbd3a0b07beb01796aa6a769",72,53,35,14.4,72,0,2,1
"8756","3d415bbf604cadcf7fd1efe50532d417",3,3,0,3,3,0,1,2
"8757","3d4594ec5f1f5554b814851e78aa6e0b",62,34,61,7.11475409836066,21,41,2,1
"8758","3d46527b0559419c454a2d9481aec595",166,112,63,18.4444444444444,166,0,3,3
"8759","3d4841a34e8fb2cec4133f7d4522f316",124,60,63,13.7777777777778,124,0,3,3
"8760","3d49bcb4af485fce2295905f7422198d",2,1,30,0.466666666666667,2,0,2,1
"8761","3d4e58d8e4e9fc950dc19ef86e1c2160",10,10,0,10,10,0,1,2
"8762","3d4e6eaf2c7aeaef4a2067726c2931d6",35,35,0,35,35,0,1,2
"8763","3d4e8228fe72dba2a865b8cd0c28c958",16,16,0,16,16,0,1,2
"8764","3d4e9ea55efaf45454a3f661cfcfb648",60,42,70,6,60,0,2,1
"8765","3d50a78f54ddc946e839e6f0cf064464",25,25,0,25,0,25,1,2
"8766","3d522eb111ccf16196e41bec2ca91a5b",7,6,45,1.08888888888889,7,0,2,1
"8767","3d52c45a7f6467d6bda5f173fb064fea",31,31,0,31,31,0,1,2
"8768","3d56236ea1cc3de22b8e7718c290f82f",65,58,23,19.7826086956522,46,19,2,1
"8769","3d58566857fc93c4ac170ae63524c663",111,81,23,33.7826086956522,58,53,3,3
"8770","3d5ba99ebf4ee10d3763cede9027a39d",48,40,16,21,20,28,1,1
"8771","3d5d6360b294261351f3ccc375a8dc93",197,90,73,18.8904109589041,142,55,3,3
"8772","3d6031d195a8e9ba1ea31955a5e798c1",32,32,0,32,32,0,1,2
"8773","3d6154d342ef6e2d44ab73871d5153c1",52,52,0,52,52,0,1,2
"8774","3d61c4d736602a723e378416873821d1",25,25,0,25,25,0,1,2
"8775","3d632007dcaf8ffec17c1afb702104a0",162,98,56,20.25,162,0,3,3
"8776","3d63e245f1ae0bd18e99269eb9369f1e",103,66,84,8.58333333333333,103,0,3,3
"8777","3d644b11b687e2d8e4e1f2d412e95297",164,83,78,14.7179487179487,164,0,3,3
"8778","3d66526c08fb1b07fc8b0d30451b4be1",180,104,76,16.5789473684211,150,30,3,3
"8779","3d67951cfce841f3a6dfec85b89150ff",38,27,63,4.22222222222222,38,0,2,1
"8780","3d68ffd64d7e4d974164759a3fcc3303",18,18,0,18,18,0,1,2
"8781","3d6f4be40e804dc73ae50cde5bd082f0",81,73,49,11.5714285714286,81,0,2,3
"8782","3d70b12642da63a562480c090d483da7",32,32,0,32,32,0,1,2
"8783","3d7102b369d9d74b1cde220ee54a45cc",8,8,0,8,8,0,1,2
"8784","3d736604ab0a89b16a1a3e0f9a917950",16,16,0,16,0,16,1,2
"8785","3d77772ea213b0d4d2391acd3014a4fd",43,39,12,25.0833333333333,11,32,1,2
"8786","3d7de6571e0952644327d2eb2f54bf4f",27,21,38,4.97368421052632,15,12,2,1
"8787","3d7f1b0410457f73015136a2ef4ba20d",164,81,74,15.5135135135135,164,0,3,3
"8788","3d7f2002e93e3892bf5d572545b0198d",56,56,0,56,56,0,1,2
"8789","3d7fa406ae13d0b16ed6e6715ec3fc54",41,41,0,41,41,0,1,2
"8790","3d801ddc130c2b8da4f1b349cc209859",54,54,0,54,54,0,1,2
"8791","3d81b6e01cc1c494d55df5a204b88867",10,8,69,1.01449275362319,10,0,2,1
"8792","3d84a56da7fd3e0decfebaae59ecf723",44,39,79,3.89873417721519,44,0,2,1
"8793","3d84ed8b9d6bc38b7ce057ba155b8eba",47,47,0,47,47,0,1,2
"8794","3d85df8196fbb873365a6fa6fb484dcb",1,1,0,1,1,0,1,2
"8795","3d86da508f0500b1b3c4ec06676792c5",159,78,81,13.7407407407407,159,0,3,3
"8796","3d870810ada1ca5f9ac3ee2b67fcf89a",39,39,0,39,39,0,1,2
"8797","3d87146b3de2dfe659469393406b904e",31,31,0,31,31,0,1,2
"8798","3d88cb2c17aa329f2ddf950ca105a695",19,19,0,19,0,19,1,2
"8799","3d8a0e28170a20f0c38ae479e891a985",67,28,81,5.79012345679012,52,15,2,1
"8800","3d8c4289d760deaee609a85d425cafb6",90,77,62,10.1612903225806,90,0,2,3
"8801","3d8ed5ea1c95c7fadfc2196ad59094a1",14,14,0,14,14,0,1,2
"8802","3d8f124dec067182df8d960234c3c9ad",136,77,73,13.041095890411,88,48,3,3
"8803","3d91b922cda743bccf7b4ddf00e19188",82,70,16,35.875,31,51,1,3
"8804","3d92d48b61cf493cb53e359ed5d5303b",102,51,84,8.5,102,0,2,3
"8805","3d9494426a90399aad663483d37f1d90",65,50,72,6.31944444444444,65,0,2,3
"8806","3d94a88afe064bb54febd040f79efae4",114,61,81,9.85185185185185,114,0,3,3
"8807","3d94ad1f033592ab5e6212088a7440f8",27,27,0,27,0,27,1,2
"8808","3d97dbd1d4b550a1cd7e9ae92075a82e",14,14,0,14,14,0,1,2
"8809","3d9afbfcda42d407b6729e1262c126cd",13,13,0,13,13,0,1,2
"8810","3d9c687eb3ac973e02a88575f86b4ae6",10,10,0,10,10,0,1,2
"8811","3d9ceda0fda21d26f550e2e15cb4af0c",16,16,0,16,16,0,1,2
"8812","3d9def66cdd634be45772d62394cf2b2",27,27,0,27,27,0,1,2
"8813","3d9f155023e7e56cf73fc4119d533c92",49,40,31,11.0645161290323,25,24,2,1
"8814","3d9fb19fea6445bf5f48af1676424e54",3,3,0,3,3,0,1,2
"8815","3da10d62388e45e5bd5b9b34edc5491d",55,55,0,55,55,0,1,2
"8816","3da136d7b0d20868b461a65de7d7f9ab",18,14,38,3.31578947368421,18,0,2,1
"8817","3da152f0c6549536294b67ae288289fc",13,13,0,13,13,0,1,2
"8818","3da1ffd982d4dbe1b2a10ec44edca321",56,50,27,14.5185185185185,56,0,2,1
"8819","3da284e18c74231e426df26ea4f14421",42,29,28,10.5,42,0,2,1
"8820","3da3a1882d9411c45b5f7ef5d66abf20",41,35,27,10.6296296296296,41,0,2,1
"8821","3da5ade617103d1082c19da37930028d",23,23,0,23,23,0,1,2
"8822","3da7670fc0414e0417c895bb39cde0db",44,33,17,18.1176470588235,44,0,1,1
"8823","3daa1905abac48f8b29b185fe430967f",31,31,0,31,31,0,1,2
"8824","3dac6075c967311a0852fb8549282f7a",80,65,25,22.4,80,0,2,3
"8825","3daceff3a27b4ace8fae96a80e5fc4f4",12,12,0,12,12,0,1,2
"8826","3db180623d82768ba6a13ec91a981954",154,127,43,25.0697674418605,154,0,3,3
"8827","3db1d18e696b945cd467d1a41f4429dc",9,5,7,9,9,0,1,2
"8828","3db3345a57d11aea8b2d6034edc2c585",56,34,56,7,56,0,2,1
"8829","3db50fb936542f06a82a790e32c06737",15,15,0,15,15,0,1,2
"8830","3db7d83d73ed3dab772d85d6227ffe67",61,49,54,7.90740740740741,29,32,2,1
"8831","3db97edd13ee03f0e099bbca9dc9f9af",38,25,45,5.91111111111111,25,13,2,1
"8832","3db9af8b14f654728f2ae9167bd1c6f4",19,19,0,19,19,0,1,2
"8833","3dba2331b4251e297a5701e0d9a75586",39,29,50,5.46,39,0,2,1
"8834","3dbac3074e567ce38008abb65e42e57b",91,71,63,10.1111111111111,91,0,2,3
"8835","3dbd42bc1589d9503a7a19a5a26262ef",98,69,62,11.0645161290323,98,0,2,3
"8836","3dbe3db6ed9b558fb76dfdda7ff8d6a5",22,21,3,51.3333333333333,1,21,1,2
"8837","3dc0cceeee97f530d64ef706880df919",167,116,60,19.4833333333333,167,0,3,3
"8838","3dc1223aa21d58bf1fac7f2974641566",30,30,0,30,30,0,1,2
"8839","3dc79245c542da8afa852418b8334127",147,95,71,14.4929577464789,116,31,3,3
"8840","3dcc1b63dafd731b6967bca0b0888989",37,37,0,37,37,0,1,2
"8841","3dcc7229e540f0d1d229da9aa276a994",13,13,0,13,13,0,1,2
"8842","3dcc8f1504e26af2c3f8e7a0d5d87206",32,32,0,32,32,0,1,2
"8843","3dcd12a1c87b45852b3c946ed1f2dad7",54,34,20,18.9,54,0,1,1
"8844","3dd066cdd1b19ad56703dca3637c17de",23,23,0,23,23,0,1,2
"8845","3dd2d19e2981e8029c3f70afb5e81032",25,25,0,25,0,25,1,2
"8846","3dd5471789c9e6ed92875eee4a5d0328",39,39,0,39,39,0,1,2
"8847","3dd714c4950f0f5ffd31a11694b09f2f",31,31,0,31,31,0,1,2
"8848","3dd92bfd529a51fdc6cae2ac987d946c",52,40,15,24.2666666666667,52,0,1,1
"8849","3ddc18fb58f54f9c746fa7ca53a65082",23,23,0,23,23,0,1,2
"8850","3de3c4740984611556964c5068f4dc4c",13,11,66,1.37878787878788,13,0,2,1
"8851","3de3ec5f29077fa358eda44319081fe9",12,12,0,12,12,0,1,2
"8852","3de6e7924b965886ec3144d1ceb84e57",68,62,25,19.04,48,20,2,1
"8853","3de703c566cf682068e1aadcb2d9ca10",196,113,67,20.4776119402985,159,37,3,3
"8854","3de8a85b9695eaedadadccca1e2b76be",53,53,0,53,53,0,1,2
"8855","3de9a4235deae82c26eca49a5267a404",92,74,19,33.8947368421053,92,0,3,2
"8856","3dea2585a7b6f25dee5d7acf34395c1b",110,64,66,11.6666666666667,110,0,3,3
"8857","3deb76f7b6500d2dbfafa9c59e2814cf",77,70,76,7.09210526315789,38,39,2,3
"8858","3ded5beb57f78ec9a7f48f5ea78f3123",4,4,0,4,4,0,1,2
"8859","3def67d5ff821be70e18a29b43040ab7",18,18,0,18,18,0,1,2
"8860","3df1065fac9827904c623a9e13c44603",160,88,77,14.5454545454545,160,0,3,3
"8861","3df108840ff1c9f185a243e28439e6d0",107,66,36,20.8055555555556,107,0,3,3
"8862","3df3c6927276b36f5db81d4937a83b62",173,90,72,16.8194444444444,130,43,3,3
"8863","3df428e9fcabd8c744174287ecaa8142",65,40,43,10.5813953488372,65,0,2,1
"8864","3df4cfd366cfcfc9a59f00ccc652662d",50,50,0,50,50,0,1,2
"8865","3df553e970795344f2f85b71d4cdd2df",33,33,0,33,33,0,1,2
"8866","3df99a0fbb59995bf16f77fdc664a5de",85,51,63,9.44444444444444,85,0,2,3
"8867","3dfe5668668ed8bd14e3762cab1a2067",172,102,77,15.6363636363636,146,26,3,3
"8868","3dfe6b3bc132cd0432234bfc3409f24c",170,86,79,15.0632911392405,137,33,3,3
"8869","3dfe937b6c28e95c84ffe7e93faceb5a",36,36,0,36,36,0,1,2
"8870","3dff5f0485ce2c40c178fba54a6e5949",37,37,0,37,37,0,1,2
"8871","3e00316aac3ce8a549b838bd06cd99c5",169,96,70,16.9,169,0,3,3
"8872","3e01222b12201c6bfab11b7929409f91",35,20,77,3.18181818181818,35,0,2,1
"8873","3e060d0d8c0e39782c079ff67775966a",3,3,0,3,3,0,1,2
"8874","3e087ac0aeb80c13ac0c8ae90e37cd48",91,66,70,9.1,91,0,2,3
"8875","3e0beaab27164974fca1226c054fa231",47,36,60,5.48333333333333,47,0,2,1
"8876","3e0c8d9ee5be6a357e6572bbcd30118f",23,23,0,23,0,23,1,2
"8877","3e0d406b2e3d410a08ccd5c0d566e2f2",122,91,41,20.8292682926829,122,0,3,3
"8878","3e0eecdbe8b15cef549a1bbffcd96a67",43,32,54,5.57407407407407,43,0,2,1
"8879","3e13710791c24de48aac1b986b61ff1a",79,45,61,9.0655737704918,64,15,2,1
"8880","3e13de6ff6be1c77f016da7c6486ba8c",99,62,56,12.375,99,0,2,3
"8881","3e157fc039c9bee3a244eae4b0c8960a",40,38,61,4.59016393442623,16,24,2,1
"8882","3e1592d21d2bff8d1175680f801e7b3d",111,96,70,11.1,91,20,3,3
"8883","3e17a8fcc8a5b255a75cc06c1f2847fe",38,38,0,38,38,0,1,2
"8884","3e19ccc881c5321e979b146dbc3584ac",85,62,84,7.08333333333333,85,0,2,3
"8885","3e1a13c5232e9359a53fa68e213912ed",17,17,0,17,17,0,1,2
"8886","3e1b38e50e7f236fd271ffc432ae3585",52,44,23,15.8260869565217,52,0,2,1
"8887","3e1d8b228f3415ea4b5cd65b2aa79530",31,31,0,31,31,0,1,2
"8888","3e1ec959a436c101dbaf638c49627909",22,22,0,22,22,0,1,2
"8889","3e1f8fc4ba241cac063e86bc5a5d9c31",39,39,0,39,0,39,1,2
"8890","3e203dbe167ade0558c12b163cea6ec9",72,57,17,29.6470588235294,32,40,1,1
"8891","3e2199820343e5cce8f880c8b2a14605",129,88,53,17.0377358490566,98,31,3,3
"8892","3e222992f04253c291a3cb9a0b9939c2",75,59,59,8.89830508474576,75,0,2,3
"8893","3e22f72ee2ed7e9a409f23e28e128aaf",148,102,59,17.5593220338983,116,32,3,3
"8894","3e241793cd87f063e1f85641d716f6cf",117,84,45,18.2,117,0,3,3
"8895","3e267f9e2bb976337c8451e92f10bbf9",29,29,0,29,29,0,1,2
"8896","3e2761d71b200220a7737c3b4a35554c",82,65,47,12.2127659574468,82,0,2,3
"8897","3e27b44627a201f803bf9363e7a57c74",62,55,47,9.23404255319149,35,27,2,1
"8898","3e29208b4f3f26be1b159a8025aa7641",5,5,0,5,5,0,1,2
"8899","3e2a2a4d0fa874100926c11c2c75c47b",55,44,38,10.1315789473684,55,0,2,1
"8900","3e2b7d475446eb788aad5565f089ecb0",13,13,0,13,13,0,1,2
"8901","3e2bfc1a1307a202dc7886f69ca5373a",45,45,0,45,45,0,1,2
"8902","3e2c8f59772e616122043661837e8b4b",57,46,38,10.5,57,0,2,1
"8903","3e2dcc8b1eec95e7fb3ac114893a6315",16,16,0,16,16,0,1,2
"8904","3e2e09bd92f624bd0723ccc729325c9a",84,55,40,14.7,55,29,2,1
"8905","3e2ed4185b382fe286343dda8efdce19",23,23,0,23,23,0,1,2
"8906","3e2fd30d6d6523500c9678977f3110d4",8,8,0,8,8,0,1,2
"8907","3e2ff9db26c5895461bd87c4691c58e0",48,48,0,48,48,0,1,2
"8908","3e325516400eb8691703697d5fa05c4b",82,72,11,52.1818181818182,82,0,1,2
"8909","3e385b1a92c3dc4bff2fd38f153ac7ce",32,32,0,32,32,0,1,2
"8910","3e394e8542777aa2e338658a197039dc",48,42,49,6.85714285714286,0,48,2,1
"8911","3e3b17877e8ddb6ca99b67b036f084ab",54,48,25,15.12,54,0,2,1
"8912","3e3dda0afd1a5cda0eee130cd1dcb004",48,48,0,48,48,0,1,2
"8913","3e3e19e198ca67ddee686653cde6fc11",129,81,67,13.4776119402985,96,33,3,1
"8914","3e3e5e80de88d77d1cff82be6f022d02",48,48,0,48,48,0,1,2
"8915","3e3eef194c740426ff7c06274043f921",52,52,0,52,52,0,1,2
"8916","3e411261f2157309783a21a5d2ab1e81",46,46,0,46,46,0,1,2
"8917","3e432668d0a4116e11cf2f13bc563d39",88,69,47,13.1063829787234,36,52,2,1
"8918","3e43e8f7628984a975f320b0f2906eb3",91,72,48,13.2708333333333,57,34,2,3
"8919","3e44ab12be0b239a20cf16727f159d5e",188,119,70,18.8,188,0,3,3
"8920","3e44ec56576f23dfc9a1c0a3aea985e0",20,20,17,8.23529411764706,4,16,1,1
"8921","3e46292df148b8eef432870abd51fecd",27,27,0,27,27,0,1,2
"8922","3e46818cf9a075dad79c6761263c826f",222,99,76,20.4473684210526,170,52,3,3
"8923","3e4c69bb5a9345d8da704979a00f2ad6",43,36,33,9.12121212121212,43,0,2,1
"8924","3e50a2575aa0405ac70ea781014ef733",30,30,0,30,30,0,1,2
"8925","3e52b9d5b41306ca72553f8c954f5fdc",201,101,70,20.1,201,0,3,3
"8926","3e52f454fbb66a069e4fd9f9225beccc",9,9,0,9,9,0,1,2
"8927","3e548cc8401a2b161323700bc51addd2",3,2,52,0.403846153846154,3,0,2,1
"8928","3e575561abec8728ec50e9861aab583c",72,55,40,12.6,30,42,2,1
"8929","3e576bd4ffd0676c98a8c7bd47531a4b",73,57,58,8.81034482758621,73,0,2,3
"8930","3e5fd2b1a3eaf914eb6cea72ba37fe96",18,14,62,2.03225806451613,18,0,2,1
"8931","3e60e01416516a84d2f4cb497e5a916c",78,59,84,6.5,32,46,2,3
"8932","3e621a67245a833b6b616415fbf8ec58",71,50,53,9.37735849056604,46,25,2,1
"8933","3e6389ecad44481b1966954e7fe0f306",141,70,68,14.5147058823529,141,0,3,3
"8934","3e652577027e9937c818f6c9375900f7",41,27,75,3.82666666666667,10,31,2,1
"8935","3e6cd3cf5bc7771794e6d4c5067810dd",16,16,0,16,16,0,1,2
"8936","3e6de8847bdb63d5a9173220de20ad78",149,103,80,13.0375,149,0,3,3
"8937","3e6e2279796d740e51b8843d09485c6d",135,66,84,11.25,119,16,3,1
"8938","3e70da595083d1854173d92631935b5f",69,59,13,37.1538461538462,69,0,1,2
"8939","3e72e39631da922bae2405ba175799c0",171,88,63,19,140,31,3,3
"8940","3e72e9706a3eff685013c2b3336152e5",55,44,52,7.40384615384615,55,0,2,1
"8941","3e761209e334dcc8c8243addd83e5e8a",82,56,42,13.6666666666667,82,0,2,3
"8942","3e7699ac085537da43f273e8c7c00498",11,11,0,11,11,0,1,2
"8943","3e78f2c3656cc5a1c400ef87e5e9e67e",190,82,78,17.0512820512821,190,0,3,3
"8944","3e7af12a5921a0366f5ce5c934a43b59",36,36,0,36,0,36,1,2
"8945","3e7fe79e5be34fa8aa771c2f03e8abcf",33,33,0,33,33,0,1,2
"8946","3e85841ea6784c8375efe192f8eb369e",135,89,70,13.5,93,42,3,3
"8947","3e85e8b47959d77181e2a16b397038aa",184,131,58,22.2068965517241,132,52,3,3
"8948","3e85ff33f6317f1337842c408a2523bf",44,36,30,10.2666666666667,44,0,2,1
"8949","3e8ed9b737c56aad5606ec87fdd837b5",72,66,27,18.6666666666667,72,0,2,1
"8950","3e8f43ffe70a8546e1234ed9dd23f48e",23,19,51,3.15686274509804,23,0,2,1
"8951","3e8fc15735ff4ba10099f5ff56ced189",27,27,0,27,27,0,1,2
"8952","3e949ce23cc8050f1cc4f7bf6b33c77b",8,8,0,8,8,0,1,2
"8953","3e9a235b75025542e58a771fa00dc0ab",129,58,49,18.4285714285714,129,0,3,3
"8954","3e9a4907dff052f7b527fac9ce3814f6",161,89,83,13.578313253012,128,33,3,3
"8955","3e9b4ebd4e9e9802ed4c40bc5fff506b",139,94,42,23.1666666666667,139,0,3,3
"8956","3e9eb71230a2c3ca5a87b312dd9f0026",21,21,0,21,21,0,1,2
"8957","3e9f4a457effdc0613da98ee623f4afb",53,29,72,5.15277777777778,53,0,2,1
"8958","3e9f88b15182f5a6bd5ec10621bbad76",89,56,66,9.43939393939394,71,18,2,1
"8959","3ea16ff790d6dd8addd3707bd4310ccf",58,38,42,9.66666666666667,41,17,2,1
"8960","3ea1923618906549441497b3027f47d3",23,23,0,23,23,0,1,2
"8961","3ea3a725aee13b2b8f315633f8d9daf3",62,33,55,7.89090909090909,62,0,2,1
"8962","3ea5ef6d33531131e5a68a56f3065258",42,42,0,42,42,0,1,2
"8963","3ea7f4be38b0d13586e66854a1b9c7ff",36,36,0,36,36,0,1,2
"8964","3eaa5d60b6bf092d5bdb66ce4514c8d0",225,109,70,22.5,186,39,3,3
"8965","3eaacbbb367cdc10c6bca2ca3ccf87b9",38,22,40,6.65,26,12,2,1
"8966","3eab043737890270a118f209b2c2408f",28,28,0,28,28,0,1,2
"8967","3eae0c4030e27460e83b3b4daf634cc2",33,33,0,33,33,0,1,2
"8968","3eb1c3cd88b5d1e9c496e26e944f3109",23,22,3,53.6666666666667,23,0,1,2
"8969","3eb3741d804883a660bf1dc8b26b13f2",200,107,80,17.5,200,0,3,3
"8970","3eb3b8fdfbc1324b6be69540a1176be4",26,26,0,26,26,0,1,2
"8971","3eb4ece42b9134ced1af7693a4b6484d",3,3,0,3,3,0,1,2
"8972","3eb5cede22ee5be514e66a9a5e6f96c7",1,1,0,1,1,0,1,2
"8973","3eb5d0a5ec9e8f5a27016596d3898bbd",57,39,41,9.73170731707317,57,0,2,1
"8974","3eb66fbb9281712b9178b1b8e635a99b",52,52,0,52,52,0,1,2
"8975","3eb915bbff0338a8413e947742bc34b5",112,77,66,11.8787878787879,80,32,3,3
"8976","3ebc65fd7e1e42fcea215dec9163542a",10,7,34,2.05882352941176,10,0,2,1
"8977","3ec0127fb00e9b0dd15076e242ab60fc",103,73,61,11.8196721311475,61,42,2,3
"8978","3ec447cc0a20d0ba7cd78919bb0083bb",113,85,62,12.758064516129,113,0,3,3
"8979","3ec4b35cb63d6871575c8d0aa052a6fd",95,83,62,10.7258064516129,47,48,2,3
"8980","3ec5b8e72bfcd1dcee2b2104729ccf00",31,13,65,3.33846153846154,31,0,2,1
"8981","3ec6b63aa0b3c44153262acaf652dcc5",49,39,33,10.3939393939394,49,0,2,1
"8982","3ec8706441ae5e6d6b653454d9cef08d",10,10,0,10,10,0,1,2
"8983","3ec8f0ed78d484200b827458ec947996",12,12,0,12,12,0,1,2
"8984","3ec9589a93647ef26b3c3a7eac8663a0",101,92,59,11.9830508474576,101,0,3,3
"8985","3ecd1f55cf13c586af8b6f10876040ed",94,66,34,19.3529411764706,94,0,2,3
"8986","3ece5da73173e2792739a43029f597f6",129,75,61,14.8032786885246,129,0,3,3
"8987","3ecea0812c358b49bd7b5c72f7b820f8",89,72,57,10.9298245614035,89,0,2,3
"8988","3ed04b4586f5fa3a5e6ca120ba6223f7",121,54,70,12.1,121,0,3,3
"8989","3ed2d8ef802f071c8d221f0f0f7a2eaf",3,3,0,3,3,0,1,2
"8990","3ed333caa17f46203f91f8caf6b7ecf3",113,64,26,30.4230769230769,113,0,3,3
"8991","3ed41734cb859670d770d67cbad86c3c",12,12,0,12,12,0,1,2
"8992","3ed74da0ffd5c78e0aecd556a50a60e6",48,48,0,48,0,48,1,2
"8993","3ed94e4412e866da90051c9fa8b545ba",24,24,0,24,24,0,1,2
"8994","3edbf9c9a11a543fa4c76e74a293ae27",16,12,61,1.83606557377049,16,0,2,1
"8995","3edfc5c924fff957dcd2e2e264c87cea",10,10,0,10,0,10,1,2
"8996","3ee01de6adb80e0500128231fb56d90b",81,53,50,11.34,81,0,2,3
"8997","3ee468078d88d605966241d22edc45d3",36,36,0,36,36,0,1,2
"8998","3ee4bff80f575fd10a28e85c23c152e5",19,19,0,19,0,19,1,2
"8999","3ee560a43875a470949f95951a69e94c",9,9,0,9,9,0,1,2
"9000","3ee838bd606a1fe38da13e77437e09e4",27,27,0,27,27,0,1,2
"9001","3ee9e06fb33930924df9a0631c362681",13,13,0,13,13,0,1,2
"9002","3eeaa38a29f2bb03e8b5cabf1ba0e11e",105,65,58,12.6724137931034,105,0,3,3
"9003","3eee431ff0bd63783b6221bdf6179372",156,99,74,14.7567567567568,123,33,3,3
"9004","3eef5bd2f37878654ab92958ecfaae3a",64,58,15,29.8666666666667,64,0,1,2
"9005","3ef1ddce4a941f5b1f8303e7f653cdc4",137,89,57,16.8245614035088,137,0,3,3
"9006","3ef2379173e654bbaa7374730f568485",37,34,54,4.7962962962963,37,0,2,1
"9007","3ef2a3dbe9c3d833e39cfcee920c13ba",16,16,0,16,16,0,1,2
"9008","3ef70ee02521f6c612c2b2fb7547b5e9",99,62,35,19.8,99,0,2,3
"9009","3ef7a6d94817edbe68ad96b8a3a00c24",30,30,0,30,30,0,1,2
"9010","3ef822762a668c45c2184d031d0b9da7",132,68,65,14.2153846153846,132,0,3,3
"9011","3ef97446bdacc3c2a9752cae69726964",151,127,45,23.4888888888889,125,26,3,3
"9012","3efa552e9303f05b77b5b17d8317009b",33,19,62,3.7258064516129,22,11,2,1
"9013","3efbe24ca6aea9b243116584895c0eed",49,45,22,15.5909090909091,49,0,2,1
"9014","3efebf714166bddec509d9cfa4316b25",2,2,0,2,2,0,1,2
"9015","3f01202dc7d63da73a00f806945f6e76",89,30,84,7.41666666666667,79,10,2,1
"9016","3f027854b6353772c02cdd86ac3d1140",6,6,8,5.25,6,0,1,2
"9017","3f053d789cfaa2268ed5316adb713ddf",20,20,0,20,0,20,1,2
"9018","3f078798558cdb62ed7a916bd1b96e7e",41,33,73,3.93150684931507,19,22,2,1
"9019","3f07b7dd8ccd607aabef0170c1f98523",30,27,68,3.08823529411765,19,11,2,1
"9020","3f08064c379830335c510e8156c04e3a",95,75,77,8.63636363636364,95,0,2,3
"9021","3f0808417efac5a4ed49741b976197d4",108,47,74,10.2162162162162,93,15,2,1
"9022","3f0925e7bdaaaeb9083816c1ce840952",47,45,60,5.48333333333333,5,42,2,1
"9023","3f09705cd765572f4799546efe725792",158,40,82,13.4878048780488,158,0,3,3
"9024","3f0b9b40d32d77163a1b8101e17a34d5",173,100,84,14.4166666666667,173,0,3,3
"9025","3f0def577969b731339b4c370b879052",57,52,35,11.4,57,0,2,1
"9026","3f0dfb5589a16162a84aef886f366422",38,32,35,7.6,38,0,2,1
"9027","3f0f6ca0112e0e8874a4a32c67e890b1",54,46,47,8.04255319148936,29,25,2,1
"9028","3f124c1ad266e2380eca1b4d8c021a5e",20,20,28,5,0,20,2,1
"9029","3f1311a4425f718a196159e6833d7d46",52,52,0,52,52,0,1,2
"9030","3f131e3981e14e709f4e1eeb65aff741",102,75,49,14.5714285714286,102,0,3,3
"9031","3f15132ff79232b86760de490a3f20ac",106,81,30,24.7333333333333,106,0,3,3
"9032","3f1587bc547da31857a4b9948e836f30",82,75,70,8.2,82,0,2,3
"9033","3f16e73f010fb93ba8cf0a0c14ff0fca",148,84,61,16.9836065573771,108,40,3,3
"9034","3f1ac32d5bb16c91b47a9d7eb1a8ea0a",94,81,66,9.96969696969697,94,0,3,3
"9035","3f1af1189fad9c6b8f0d59ab1f066055",21,21,0,21,21,0,1,2
"9036","3f1da58705a2c3eb0bf0a841a5caf758",193,77,79,17.1012658227848,165,28,3,3
"9037","3f1ef2db58ab8ea5e33c71ce0802fe28",196,77,74,18.5405405405405,178,18,3,3
"9038","3f1f137a9c3278a54a5ef14d612273fa",44,44,0,44,44,0,1,2
"9039","3f1ff7c5f76085116d0d16a5adfa2cc9",10,10,0,10,10,0,1,2
"9040","3f252d225e2563dbabe6d06b0c15d915",16,16,0,16,16,0,1,2
"9041","3f25419b6d7b1d7ae3b8e780a68b70bb",35,35,0,35,35,0,1,2
"9042","3f2982abd0815488eb6de5caf38e901b",22,20,12,12.8333333333333,3,19,1,1
"9043","3f30f7cd4e6def8b0f272b94620357dd",58,24,82,4.95121951219512,58,0,2,1
"9044","3f3201d3eb6e13da7b633e9eded1a70e",19,19,0,19,0,19,1,2
"9045","3f3316b65ac35b645b495c88abbe16bf",82,59,84,6.83333333333333,82,0,2,3
"9046","3f33218579892e7b6e47830d6bf53036",56,56,0,56,56,0,1,2
"9047","3f34573675cfcafdf243a5992db91b26",47,34,35,9.4,47,0,2,1
"9048","3f347f111fccdead37a790261ddf5fa6",69,50,70,6.9,69,0,2,3
"9049","3f37102d66a1fdd3eec2c0fdc84f4427",67,46,53,8.84905660377358,66,1,2,3
"9050","3f390227fffd3c86a5fbcaef12bed613",38,38,0,38,38,0,1,2
"9051","3f39637685aef5ab0d5ba104c8dc9866",116,76,28,29,74,42,3,3
"9052","3f3a128cac057e538f651eb61666f325",105,72,66,11.1363636363636,67,38,2,3
"9053","3f3ace4d43e4d34af2c8f0174e8bb63b",164,106,70,16.4,164,0,3,3
"9054","3f3c65bf9964b9145446cc1a7f977011",73,52,32,15.96875,73,0,2,1
"9055","3f40d1f6df625cc2de80728445165882",212,118,89,16.6741573033708,212,0,3,3
"9056","3f433b25d1ba0bc102667b817c1652be",34,26,23,10.3478260869565,34,0,2,1
"9057","3f43869050d252682167237b381e564f",51,40,35,10.2,51,0,2,1
"9058","3f43f41b6be7d91672c8a0008abe6b40",75,45,62,8.46774193548387,75,0,2,3
"9059","3f49f78d492dc7ea0bbba84f926f65fa",24,24,0,24,24,0,1,2
"9060","3f4ab2b4f78bf54771e6acb2b30f8b7a",40,23,63,4.44444444444444,40,0,2,1
"9061","3f4e4e3f4b7a8468af14cc97ae36430d",18,18,0,18,18,0,1,2
"9062","3f4ee63be7f65c4ba420dfbc3ced5203",27,27,0,27,27,0,1,2
"9063","3f5112ccfe2b6399f866e83a6463161c",78,63,50,10.92,41,37,2,1
"9064","3f55fae2b6d14fa573a59345b2b6f2f6",32,32,0,32,32,0,1,2
"9065","3f57dfa346332a1c513f419a10bbf412",10,7,64,1.09375,10,0,2,1
"9066","3f593babc87912fd32756735f23658ac",63,51,22,20.0454545454545,63,0,2,1
"9067","3f5b8ff02d83e0c11c6d2106da731fb6",85,40,58,10.2586206896552,85,0,2,3
"9068","3f5d009432bf89129614d71492058f4d",22,22,0,22,22,0,1,2
"9069","3f5f0e03d46dbc8ba8572c298dae7093",62,37,67,6.47761194029851,48,14,2,1
"9070","3f5f1fec1e79da116968a0b0efb9ff8d",55,55,0,55,55,0,1,2
"9071","3f5f7faed83e64d96d80597f4acd4939",26,26,0,26,26,0,1,2
"9072","3f60dfb5a80864c0a61bf69af026820e",36,36,0,36,36,0,1,2
"9073","3f6294d8eb4be313509bfa3cbcaaa015",20,20,0,20,20,0,1,2
"9074","3f6334252b4319848d0e2ea4c3c23746",10,10,0,10,10,0,1,2
"9075","3f647e4fbc6553dcdcb66bb73c7c507c",36,36,0,36,0,36,1,2
"9076","3f657304bc68d0d992dde21f8c04c48d",108,69,56,13.5,108,0,3,3
"9077","3f65eafae39767e523a448a1e1e403c3",41,41,0,41,41,0,1,2
"9078","3f66e95610cb5883ee07c7aee1993acd",15,15,0,15,15,0,1,2
"9079","3f6b3af41ebdfa4db90c4634472eefc2",27,15,21,9,0,27,1,1
"9080","3f6c2cf487d5a1ae630bd19b6a913e1e",39,39,0,39,0,39,1,2
"9081","3f7020d1b8a2c7bb533c4225f3e93ca8",13,13,0,13,13,0,1,2
"9082","3f70ba337ea1a737d76bcdfc8d06e9ee",55,55,0,55,55,0,1,2
"9083","3f71575d2f5b7ab30b9a78d097628af1",44,35,17,18.1176470588235,44,0,1,1
"9084","3f71fe617adad2b48ef2b074f9bb7ea2",19,19,0,19,19,0,1,2
"9085","3f7581f4034fedf50730c4ff75552834",113,83,29,27.2758620689655,113,0,3,3
"9086","3f78818b6c13e3d1915b0a644ec64596",34,34,0,34,0,34,1,2
"9087","3f793a9bc0468e9f71d2f7ad2bef04ce",72,54,53,9.50943396226415,35,37,2,1
"9088","3f798a193fd9475fb2608de851bac1d4",16,15,2,56,16,0,1,2
"9089","3f7a0f36718f2bc08521b1528fbbdf54",11,6,28,2.75,0,11,2,1
"9090","3f7c44209ef6c73b82a25246f68de95e",22,22,0,22,22,0,1,2
"9091","3f8141cbb6c52231b030d23463a80a70",27,27,0,27,27,0,1,2
"9092","3f8554bc273495c5246f5dd6eb8d6d21",28,20,60,3.26666666666667,21,7,2,1
"9093","3f8612c763dd3f3e5d4af0c48fcd3948",228,104,73,21.8630136986301,190,38,3,3
"9094","3f88282dab2367fc0e6900f4c60642ab",130,97,33,27.5757575757576,130,0,3,3
"9095","3f8c9a58f3c51599d41c6be4d08bbd20",20,20,0,20,20,0,1,2
"9096","3f9461aa47e5746f8ae6c3125aefb704",42,42,0,42,42,0,1,2
"9097","3f95276b49379d3c904dabc82ea2ac0a",100,85,67,10.4477611940299,100,0,3,3
"9098","3f9592c58ab2b1ce6757861793168135",26,26,0,26,0,26,1,2
"9099","3f96c1603640702737cf45f0bcff90a8",66,37,77,6,66,0,2,1
"9100","3f97237e94740eec66fd6310b44d1efb",86,68,38,15.8421052631579,86,0,2,3
"9101","3f9a00be70c0135e66e604e4c5ef5472",12,12,0,12,12,0,1,2
"9102","3f9a500d061df14f29acf62a75d407f9",23,23,0,23,23,0,1,2
"9103","3f9a681ee74d5ca4287777eed27c0b51",144,62,89,11.3258426966292,144,0,3,3
"9104","3f9a7404f5ba224ba25a161911da0942",174,50,85,14.3294117647059,174,0,3,3
"9105","3f9c42ec7a7228322d40d1915369834a",113,75,85,9.30588235294118,113,0,3,3
"9106","3f9d06acccee7c4808073818504fe84b",5,5,0,5,5,0,1,2
"9107","3f9de70f889b429f3f5c5b33951727f1",10,10,0,10,10,0,1,2
"9108","3f9fb8eac3a366e0e52d2ece57afa5b3",113,60,57,13.8771929824561,113,0,3,3
"9109","3f9fe4265ea52dee2d494aeee462349c",51,43,13,27.4615384615385,51,0,1,1
"9110","3fa001965419ea5b8a61f5d5eef81c06",40,40,0,40,40,0,1,2
"9111","3fa021d2cfc6c4473d51c26bb51952d1",13,13,0,13,13,0,1,2
"9112","3fa21b5b5343eeeabebdd5a82dc3640a",55,55,0,55,55,0,1,2
"9113","3fa30cc10ed26d92218a4ac196106d93",19,19,0,19,0,19,1,2
"9114","3fa52924bce021ed8e89509eeda81c94",169,104,80,14.7875,160,9,3,3
"9115","3fa7487c9343d7750c2f2c4c213b74ea",13,13,0,13,13,0,1,2
"9116","3fa7f49bb43f2cde9a35ff48a9322c53",133,96,70,13.3,133,0,3,3
"9117","3faa592e1a43543ec9f48a94496576af",156,112,82,13.3170731707317,156,0,3,3
"9118","3facce7e799a484cdf40337c4c207cfd",14,14,0,14,14,0,1,2
"9119","3fad7eeb9a88d72d1d1817a879b88c2a",18,18,0,18,18,0,1,2
"9120","3fb024beaa55e3ccafe9e14bac23aff7",104,47,56,13,67,37,2,1
"9121","3fb06b28830109ff262233feb1e104fa",36,34,42,6,36,0,2,1
"9122","3fb4777bf841b6033809f995e954f78f",18,7,80,1.575,14,4,2,1
"9123","3fb680b48437849aa4b50dc663478073",39,39,0,39,39,0,1,2
"9124","3fb86a72c0789883b42082e57d550804",31,31,0,31,31,0,1,2
"9125","3fb8949471f9d3978081b82f1d31d05b",35,35,0,35,35,0,1,2
"9126","3fba43650afd60db06f030c6b496a77a",33,33,0,33,33,0,1,2
"9127","3fbdeb2976200954601a892be47a8447",13,13,54,1.68518518518519,6,7,2,1
"9128","3fbf0427c6bdfce4bca8f6140126bd6a",16,16,0,16,16,0,1,2
"9129","3fbf85662f21bb1816c2492c1d45866d",27,27,0,27,0,27,1,2
"9130","3fbfcf8408cae65df86acc9c6a3adf21",1,1,0,1,1,0,1,2
"9131","3fbfe98d50e58c43dc6fb82bcfc6ae95",60,26,78,5.38461538461539,60,0,2,1
"9132","3fc073fd88e74d7099f7e94435d5f4d3",35,35,0,35,35,0,1,2
"9133","3fc27dfba3df838eb06b35745694ecd3",25,25,0,25,25,0,1,2
"9134","3fc39ba2b6d859e7b32d6ea7d6175439",61,51,33,12.9393939393939,61,0,2,1
"9135","3fc4fba4be37652ef447c802fd7ccd7e",133,92,65,14.3230769230769,133,0,3,3
"9136","3fc56e23c1871ac274bc10e7b996b8dd",123,62,78,11.0384615384615,90,33,3,1
"9137","3fc6cbdf1704f930a4f783ffbf6acee9",44,44,0,44,44,0,1,2
"9138","3fc75ef8e239c48f1144e8947360c865",84,67,83,7.08433734939759,84,0,2,3
"9139","3fc7a02db808f3cab10e6e14aaccea00",28,28,0,28,28,0,1,2
"9140","3fc7e01cf09f944f5ecc1eb56853cd97",19,19,0,19,19,0,1,2
"9141","3fcca640d1d378877a5c1c3e63aa0c24",30,30,0,30,0,30,1,2
"9142","3fccc924b215f5208960366b3ac03e64",78,62,53,10.3018867924528,59,19,2,1
"9143","3fcccbfef63bcae622b9e860a060afbb",233,87,82,19.890243902439,192,41,3,3
"9144","3fcf229b7b3218af547205c3368f88f2",186,101,79,16.4810126582278,137,49,3,3
"9145","3fd248e20d957fa69a99995ccc2d52c7",34,34,0,34,34,0,1,2
"9146","3fd6b1a2710ffbd8a179778daafe4751",193,98,55,24.5636363636364,193,0,3,3
"9147","3fd8913a13e36f4ba4ac4217c7b273aa",9,9,0,9,0,9,1,2
"9148","3fdac6e36b862b983e61c20457839c1d",30,30,0,30,30,0,1,2
"9149","3fe4978e59192d70d7fed01232a669d2",39,36,7,39,39,0,1,2
"9150","3fea903803948877cd86c1b5fdcf8cc8",161,104,75,15.0266666666667,123,38,3,3
"9151","3fee5c9ee32bf0d301331b7d715f767b",92,53,62,10.3870967741935,48,44,2,1
"9152","3feea50c54a02ea478c7b67111c4c675",14,9,84,1.16666666666667,14,0,2,1
"9153","3ff216509eb97be25d7e1aac96d48401",12,12,0,12,12,0,1,2
"9154","3ff243aa03082f229f9987799b9863ba",57,50,13,30.6923076923077,57,0,1,2
"9155","3ff3881d7929db026a5b672ad664883c",34,34,0,34,34,0,1,2
"9156","3ff4b41d2de25ace1dbd0ef45f240ef9",95,78,50,13.3,95,0,3,3
"9157","3ff56d380a83c126975c61d497a5866c",12,12,0,12,12,0,1,2
"9158","3ff5e96c3db2c20dd261bd122a6a2d9d",23,23,0,23,0,23,1,2
"9159","3ffa10dfbac80e454cf497d43e4bd64b",14,14,0,14,14,0,1,2
"9160","3ffba7d33d2ac37dc49117c9a12fddc6",149,101,50,20.86,149,0,3,3
"9161","3ffcb73812da04fd698bd9b2953d4204",34,34,7,34,0,34,1,2
"9162","3ffe4c725a6d9c78b3bb28bd223ac1d4",19,19,0,19,19,0,1,2
"9163","3ffe6552ccac47adf095908063a613ea",22,22,0,22,0,22,1,2
"9164","3fff025551cb55d9fe47079e77b61949",12,12,0,12,12,0,1,2
"9165","3fff8a2e708af619d630eb41f3296d56",57,43,81,4.92592592592593,57,0,2,1
"9166","400175af924a084abb1f2ba69ba71e16",116,75,61,13.3114754098361,75,41,3,3
"9167","40047054c83e593d49db94e03b12df5e",62,58,75,5.78666666666667,18,44,2,1
"9168","40049807a0c11f4d38249b97883b81de",52,52,0,52,0,52,1,2
"9169","400594750adec72eab4dd82d68ac81f5",71,41,50,9.94,48,23,2,1
"9170","4009f99c20f085edef746acbc2303339",13,13,0,13,13,0,1,2
"9171","400a632374784424bb153f5613493e6f",203,92,70,20.3,203,0,3,3
"9172","400b00a6063d89d2919b11546c7199ba",206,110,84,17.1666666666667,206,0,3,3
"9173","400e4e618bee728d4ae2b9115aa8a257",94,71,37,17.7837837837838,68,26,2,1
"9174","4011949511a6c4afda4a7042f39cadc8",99,78,50,13.86,99,0,3,3
"9175","4012e188bfc810b5e1090158ec57f625",85,69,21,28.3333333333333,85,0,2,3
"9176","401440041e68c44a3f7657ba4c71e2f9",12,12,0,12,12,0,1,2
"9177","40151884eff8187ea4cbbc96ead88d34",139,80,30,32.4333333333333,98,41,3,3
"9178","40158a4ac37a0799115f17c1a5dd6438",29,29,0,29,29,0,1,2
"9179","401610e6d2f2c551c8f0a9427e394e37",16,16,0,16,16,0,1,2
"9180","40174506203984d6fe3658d1c5f41d76",39,39,0,39,39,0,1,2
"9181","401cb70227a618dfedfc36f7f03dc9d6",23,23,0,23,0,23,1,2
"9182","401d1bb2564aa41e990496f3ea6387ea",40,36,48,5.83333333333333,40,0,2,1
"9183","401eddd1a973cc42aae3d8aedca3a39d",15,15,0,15,15,0,1,2
"9184","4020df8df028fb58167d5a7c4ca810cc",48,48,0,48,48,0,1,2
"9185","40234955992881d966a03e1a9b10ddcf",5,5,0,5,5,0,1,2
"9186","4024db092606c174267c3d62077d0c84",118,64,63,13.1111111111111,118,0,3,3
"9187","402663029a5bfe0878f1b55cbf5b8811",130,73,88,10.3409090909091,130,0,3,3
"9188","402763a070e2c675630a5c9fdb8767a8",124,76,71,12.2253521126761,124,0,3,3
"9189","4027682c2818f70182f19c311015233c",78,54,40,13.65,78,0,2,1
"9190","4027a4f138cbadfcadbcd63c3273c2e4",108,29,77,9.81818181818182,108,0,2,3
"9191","402d795649d0c7efbfb70c5fc98e8e9e",107,80,14,53.5,107,0,3,2
"9192","402e65c98b7c03ece4d98c3b0822f352",31,31,0,31,0,31,1,2
"9193","403012607e81199bb7fd99231c9125bf",8,7,4,14,8,0,1,2
"9194","40316821b00b84d26346b0de0b47f36e",48,48,0,48,48,0,1,2
"9195","403339760e296eb8d6c6b2309cbeb928",30,30,0,30,30,0,1,2
"9196","4035d20ef192f0dfb9f40639b99f84e8",14,14,0,14,14,0,1,2
"9197","403716c33af6f4c3790e6c5d46ea36a7",50,42,53,6.60377358490566,26,24,2,1
"9198","40386fb347b7fde6bc17a8aedae585b9",12,12,0,12,0,12,1,2
"9199","403a6422fd1054b86f1a8f3387e0fa08",23,23,0,23,23,0,1,2
"9200","403bb91a24022bc7b97a3c513b225595",71,47,70,7.1,47,24,2,1
"9201","403f73499b117daf5fa416142758c997",44,31,65,4.73846153846154,44,0,2,1
"9202","4040d3575057d1a77649e1dcab0cac91",52,45,59,6.16949152542373,52,0,2,1
"9203","40428e8cabebcdcc5ba7db4d7d87098b",64,51,57,7.85964912280702,64,0,2,1
"9204","4043611cbb4a48b832fb04cfcb8161c4",15,15,0,15,15,0,1,2
"9205","4047924c9fb6f62f9715885498fcfd19",26,26,0,26,26,0,1,2
"9206","404b64ae5a1a6ba72d911270ac960c78",56,51,7,56,56,0,1,2
"9207","404cd9fe08659a444eae102c53dc3df9",217,97,85,17.8705882352941,217,0,3,3
"9208","4050dd62f8b8c71395653f94641064ea",6,6,0,6,6,0,1,2
"9209","40522f0686728be38c2f7fce2bb65aed",98,86,73,9.3972602739726,76,22,3,1
"9210","40527531f54d7fd02bfd60aeffb49945",7,7,0,7,7,0,1,2
"9211","4053a74034aae6159e9d7caf207ec8da",15,15,0,15,15,0,1,2
"9212","40540dd446c33920aebda5309083b365",31,31,0,31,31,0,1,2
"9213","405614d83370d468ffb279465690e717",39,34,23,11.8695652173913,18,21,2,1
"9214","4057e22d2b845034700842e1e04f61e4",41,41,0,41,41,0,1,2
"9215","4058e3e894488177191f51f306732ede",65,52,44,10.3409090909091,65,0,2,3
"9216","40597216f778dd772ea519a09cbcf6cd",23,22,52,3.09615384615385,16,7,2,1
"9217","405d8e2274980946c366dcb63101ab5d",104,51,48,15.1666666666667,104,0,2,3
"9218","405e304d1baa4ff7a7196660e144f196",35,26,63,3.88888888888889,35,0,2,1
"9219","405f82d6e948b926257226cb2e8ed9a5",62,55,35,12.4,30,32,2,1
"9220","4060b11e04d7a6e5e7aee56f2af4b97b",55,55,0,55,55,0,1,2
"9221","4062e5211f5395aff1a037f735980638",41,41,0,41,41,0,1,2
"9222","406375aa7cb72333ff1630979eeaf856",22,14,40,3.85,22,0,2,1
"9223","4063e89cd009cf7c88895ebdae70c100",54,47,53,7.13207547169811,54,0,2,1
"9224","4066ab3c10471e75eb44c2d7887e6c32",23,18,34,4.73529411764706,23,0,2,1
"9225","40675f4b36057e804c601452f7a84eba",1,1,0,1,1,0,1,2
"9226","40694e5cf7b44ba23714f3fc14cab5e4",51,51,0,51,51,0,1,2
"9227","406997796ef027e60f0156427364bd4a",22,22,0,22,22,0,1,2
"9228","406c8bd73bbed6fe318891f49fa11718",182,88,58,21.9655172413793,134,48,3,3
"9229","406cd9b86d3131a9bd3f13ba7b964e85",20,20,0,20,20,0,1,2
"9230","406d41315689dcb063bc9f9e1acd5c7e",131,95,82,11.1829268292683,102,29,3,3
"9231","40765e34f88c87d8670e2aab12191ddf",17,17,0,17,17,0,1,2
"9232","4078ed26c917957e11034f4e8f8badf3",26,26,0,26,26,0,1,2
"9233","407c115b27ccf2f4f8e72ea644d2efff",13,13,0,13,0,13,1,2
"9234","407cbd0c57ec6a026256f9ad12564679",98,66,30,22.8666666666667,98,0,2,3
"9235","407ed140b352393d43ad8f03737c1a1f",139,94,77,12.6363636363636,139,0,3,3
"9236","407fd049edabd9ce8895f984ae2992db",100,46,75,9.33333333333333,80,20,2,1
"9237","408185358b982d6f88dc7892f535cb2e",90,60,51,12.3529411764706,90,0,2,3
"9238","4082217b9ec7cc61e9b7cd099d13319c",28,28,0,28,28,0,1,2
"9239","4083fcbcc1e693ed7808b4031a975f8a",32,32,0,32,32,0,1,2
"9240","4084788c80676c7c16b404254e2a1c11",6,5,3,14,6,0,1,2
"9241","4084c4e9df94d23f8942a0f64cf14a48",103,82,64,11.265625,60,43,3,3
"9242","40859308b0db585df9a2e6da434583e9",53,53,0,53,53,0,1,2
"9243","40860359038c8d60bd7a81f82c39bd23",46,33,35,9.2,46,0,2,1
"9244","408841d47a8d2de7a5cb64667c10abde",7,7,0,7,7,0,1,2
"9245","4088a8f0fa1f3ad778020098df12015f",36,36,0,36,36,0,1,2
"9246","4088ec2f5aedb1bca63e383e724117ec",44,44,0,44,0,44,1,2
"9247","408d82c122d10bf2a7f84e7404dd2669",21,21,0,21,0,21,1,2
"9248","4092abc675bad1db39d0fbfb49998c66",39,36,12,22.75,39,0,1,1
"9249","4093beb6d303216137c40738836f0ad1",39,39,0,39,39,0,1,2
"9250","409714c7bb3d7ca7259745947fa21a69",31,28,28,7.75,31,0,2,1
"9251","4097340f37e63b0a8eeea93dd3c4cf2e",92,67,35,18.4,92,0,2,3
"9252","409921296d73240d71dae42db5e904a8",210,76,84,17.5,182,28,3,3
"9253","409a1ffeb17ca726e90b666546bf110f",81,57,58,9.77586206896552,59,22,2,1
"9254","409a8e3ae6e965ba1c156b933d906c30",109,69,56,13.625,109,0,3,3
"9255","409fd4b5cc50aee2532eb6451cf0a7e7",5,5,0,5,5,0,1,2
"9256","40a54227efb13d5d602cb714a4917a63",58,49,46,8.82608695652174,58,0,2,1
"9257","40a6fddf6ab71dd5331f5b5fbfc1ebbd",190,107,63,21.1111111111111,190,0,3,3
"9258","40a8d093221a1fc5fdf427060bdb9983",42,42,0,42,42,0,1,2
"9259","40a8d54177092c3f2d275462669cefe2",185,101,73,17.7397260273973,185,0,3,3
"9260","40a9e39c1d44b8081c21776e5ace45e9",20,10,46,3.04347826086957,20,0,2,1
"9261","40aa2d5fbe29fde88cae85179b867de9",31,31,0,31,31,0,1,2
"9262","40aa351aa5ff31ec3414c86f47dcb077",98,60,17,40.3529411764706,98,0,1,2
"9263","40abc280e9325183eaceb6bc91aedb15",96,54,60,11.2,96,0,2,3
"9264","40ae79107b69d5b5d06840cd0b16b712",10,10,0,10,10,0,1,2
"9265","40b29006f1a3fd9a44766f68dd04860e",154,79,77,14,154,0,3,3
"9266","40b2c1d98c77ebcceb369baf4bbd0d0f",18,18,0,18,0,18,1,2
"9267","40b3e698458336e2c65b2e03c2cd98ac",45,45,0,45,45,0,1,2
"9268","40b4a9bb11f5f67c015b5e79e38921ec",1,1,0,1,1,0,1,2
"9269","40b5db8bb3f68fc3c8d33b871d2b7838",71,59,40,12.425,71,0,2,3
"9270","40b663eecc79c4f38fdf85e032af19a1",136,114,49,19.4285714285714,136,0,3,3
"9271","40b7b0541dbef51080bfbfe802bf2919",79,72,31,17.8387096774194,36,43,2,3
"9272","40b8c7e587fda4ca62aea0f3047e22ff",36,36,0,36,36,0,1,2
"9273","40b905ee99c08f89c67361b364e2714f",41,33,52,5.51923076923077,19,22,2,1
"9274","40b9d1182079cb4608087b236bb8fc9f",92,66,17,37.8823529411765,92,0,1,2
"9275","40bbbf73b2f530304dbdce3716b257aa",136,90,66,14.4242424242424,136,0,3,3
"9276","40bc3e82bd38327d844a4c59f49a388f",91,68,27,23.5925925925926,91,0,2,3
"9277","40be65599bdbd80d64aa2fc85d5cf888",32,32,0,32,32,0,1,2
"9278","40c2dc2199eba5fbb7df08c6b7357084",124,90,54,16.0740740740741,124,0,3,3
"9279","40c795894943c9ebe30d461a788ae05d",112,93,28,28,112,0,3,3
"9280","40d1005709ca2afd6b79750b1b693848",36,36,0,36,0,36,1,2
"9281","40d5ac5f90a654c2defee7a1ea977eb3",67,57,78,6.01282051282051,58,9,2,1
"9282","40d9034bfa844082d86f507845c32710",17,11,88,1.35227272727273,17,0,2,1
"9283","40d920c9975cf46f68f1f3b2a941cf25",56,38,44,8.90909090909091,38,18,2,1
"9284","40dc191b844c1a1beda5f31d0e273fd8",28,28,0,28,28,0,1,2
"9285","40de30d8c29e1293bfebe07561af6439",1,1,0,1,0,1,1,2
"9286","40df9f8bde7f24621261bab66fd06ffe",49,35,41,8.36585365853659,33,16,2,1
"9287","40e06cd87930bfdf7d3c695f25516db2",60,46,68,6.17647058823529,38,22,2,1
"9288","40e07132e8f3624b022e363aee696e17",21,21,0,21,0,21,1,2
"9289","40e1163d9143b005aea44b3978b7faad",36,36,0,36,36,0,1,2
"9290","40e18af24791a44763f32e859e1f1698",40,40,0,40,40,0,1,2
"9291","40e1a397c6ad2129a4eacb912059d27d",15,15,0,15,15,0,1,2
"9292","40e356fcfcaf3d12df44b31f4a3cbe58",10,10,0,10,10,0,1,2
"9293","40e8b0a6aefec475f03ccd14f7bb0dc5",70,60,30,16.3333333333333,31,39,2,1
"9294","40e99e8613cbe21116905f7f700772c3",122,80,34,25.1176470588235,122,0,3,3
"9295","40ec8986c6fd4aa823d5faea390c68f4",15,15,0,15,15,0,1,2
"9296","40ee9af6a51c4620a66d69c52e1564a1",2,1,32,0.4375,1,1,2,1
"9297","40ef3832caf233bd692b000dfb7f8359",36,28,79,3.18987341772152,36,0,2,1
"9298","40f43076c828c2ce404ffa517be5d9be",22,22,0,22,22,0,1,2
"9299","40f5c7f247846df68be5fc250bf1abf0",23,23,0,23,23,0,1,2
"9300","40f6904b73142314c5c7016429f24d77",132,73,61,15.1475409836066,132,0,3,3
"9301","40f73c9b23ffadcb7bc70ca2658aeb23",15,15,0,15,15,0,1,2
"9302","40fb1da8bb543dad6d420f9992e90b40",12,12,0,12,12,0,1,2
"9303","40fb4b45e457f43af7f159bb903a3d83",39,39,0,39,39,0,1,2
"9304","40fc34673abbc688bb0cf4dc5d035850",24,24,0,24,24,0,1,2
"9305","40fd95d8ca2750aaf0a58e97761574d7",30,30,0,30,30,0,1,2
"9306","41000278a01a6968875859122b23fdc8",30,26,63,3.33333333333333,0,30,2,1
"9307","4100db06ad01e6dfff653c0b8384e85f",4,4,0,4,4,0,1,2
"9308","4100f892b3342277f519e8b019d71e2a",98,69,84,8.16666666666667,98,0,2,3
"9309","41016ab945ff383fb07bbf1b5100532d",54,43,70,5.4,0,54,2,1
"9310","4101d18c3864c0866839743ca073112a",96,61,84,8,96,0,2,3
"9311","41022282a43c4d6abdd21cbf1955c703",45,39,64,4.921875,41,4,2,1
"9312","41034c0772eddc71b2645379b549d285",77,45,59,9.13559322033898,77,0,2,3
"9313","410569335905aa22e618af84bbb0e0e2",20,20,0,20,0,20,1,2
"9314","4105851773ee6fac86f356a1eda2fa8d",15,15,0,15,0,15,1,2
"9315","410880d04652727dad4127c6c5777d5c",61,55,80,5.3375,35,26,2,1
"9316","4109b0d0a3b8b6d56e84ad811a606738",7,7,0,7,7,0,1,2
"9317","410ae8c1ab8030eb90040732b7c15d25",12,12,0,12,12,0,1,2
"9318","410b66196408f6588bfb17543abebe20",61,46,83,5.14457831325301,61,0,2,1
"9319","410b9437c634c511ed23a8c9a04c23e1",34,34,0,34,34,0,1,2
"9320","4110155cc3d9a71862d3b0ba7e4fd899",47,47,0,47,47,0,1,2
"9321","41108bfc09eac88b2a95f2d0a1b32ff0",54,43,49,7.71428571428571,54,0,2,1
"9322","4110b466b66b8d8ad381678b830d3456",3,1,36,0.583333333333333,2,1,2,1
"9323","411285bb7ce80897739243b839c437b7",22,22,0,22,22,0,1,2
"9324","4115848ef9e14e8392fa08e3f6eebebd",57,48,25,15.96,57,0,2,1
"9325","4118451c9913ef35efc3d32a87ed53df",39,28,81,3.37037037037037,39,0,2,1
"9326","41184fc38e404b4cf8e4c2ed4c99d515",188,103,63,20.8888888888889,188,0,3,3
"9327","411aa5cc5779de260234cfa72792a25b",114,66,65,12.2769230769231,114,0,3,3
"9328","411c9453ac204123268612a1350d3173",41,37,11,26.0909090909091,41,0,1,1
"9329","411cca095168e51597b605908a1627e7",7,7,39,1.25641025641026,7,0,2,1
"9330","411f4532bc6b3a85842ebe596a83bb95",165,101,53,21.7924528301887,121,44,3,3
"9331","411f8e7d29418b31357c994c9295a20d",38,38,0,38,38,0,1,2
"9332","411fd92d0c31f346fedf9622a64565e8",13,13,0,13,13,0,1,2
"9333","41255706aa3b81da8d7eacd2a59b309e",24,21,33,5.09090909090909,24,0,2,1
"9334","4127cf24beabe3a82cf855f8a723b4b7",186,98,83,15.6867469879518,186,0,3,3
"9335","412aad77ea8c68109a1c3792ff2cb5d5",83,58,56,10.375,83,0,2,3
"9336","412bbde38056851428ebc95e7636d9c0",243,98,70,24.3,207,36,3,3
"9337","412de4563447e85e60ec4b04328faf6b",27,27,0,27,27,0,1,2
"9338","4131577cb5a5527847e9fbc4b9b3ad6d",131,89,44,20.8409090909091,80,51,3,3
"9339","413275182e3667b4b0f5dd0b60940c3b",29,29,0,29,29,0,1,2
"9340","4133cc97630a0de9f3770c73f0709ad5",54,51,60,6.3,54,0,2,1
"9341","413434aa22f75ed0b6bbee321ce8d02f",11,11,0,11,11,0,1,2
"9342","4134fac6e016ee022ec75ae566867c9f",69,55,77,6.27272727272727,69,0,2,3
"9343","41353255601ccf8d6576761a5fcdfaf0",11,11,0,11,11,0,1,2
"9344","41372ab568bb103e90b1407aa54e0352",75,53,63,8.33333333333333,75,0,2,3
"9345","4139b807b614c31fe972ad25883c1790",43,28,56,5.375,43,0,2,1
"9346","413ac1cd70b439dbb9d1287a43cd0587",22,22,0,22,0,22,1,2
"9347","413e60713de10cc797e996df8ac99568",72,55,45,11.2,72,0,2,3
"9348","41401f6712f8df7c0da79239e1c8ef9e",12,12,0,12,12,0,1,2
"9349","4141170fbeb32126ba725c8dd49d78ec",96,58,20,33.6,96,0,1,2
"9350","414694b75974f946d235dab11c885742",40,34,38,7.36842105263158,40,0,2,1
"9351","41497abab6ad21f8300816f52e6126d7",92,38,78,8.25641025641026,69,23,2,1
"9352","4149a56c6cf7be123de8994e09ae43d0",119,66,86,9.68604651162791,119,0,3,3
"9353","414b46435a10b88f0878121fa80be41b",180,65,84,15,161,19,3,3
"9354","414b4ea2a4702091fe545a0635487fbf",69,56,50,9.66,69,0,2,3
"9355","414b6dd9769c97d90c12b0d1748ff905",36,36,0,36,0,36,1,2
"9356","414ddd45f55e05d9a83a18201b31157e",41,35,31,9.25806451612903,28,13,2,1
"9357","415015385d89434f31b9bd9a4100defd",22,22,0,22,22,0,1,2
"9358","41525ffccc8f4d0bbcdf864f054a05a8",17,17,0,17,17,0,1,2
"9359","4152c5f4fb4a03e7e17981c18fbe6b52",21,16,86,1.7093023255814,5,16,2,1
"9360","4152f19b5099b15f1eae7f807d6f4354",14,14,0,14,14,0,1,2
"9361","41540816807c632e75c0a83ee2794878",48,42,53,6.33962264150943,48,0,2,1
"9362","4154e6f39a294b5972886e0c1f23b08a",48,36,48,7,48,0,2,1
"9363","415565b9c819f711e4711ec0b481af5e",32,29,21,10.6666666666667,32,0,1,1
"9364","4155e5d3123bb525288fae69bb80154e",89,56,82,7.59756097560976,55,34,2,3
"9365","41570eef9751303918fce0ffcee612d9",13,13,0,13,13,0,1,2
"9366","41582cbddd8f35f67a3f33ee321aaa1f",19,19,0,19,0,19,1,2
"9367","415c2ecf7862dcc6c017c96e581ac911",257,129,79,22.7721518987342,211,46,3,3
"9368","415c86e992b681337bedbecf54c9fef5",69,62,59,8.1864406779661,50,19,2,1
"9369","415e188bab5155241b99d78db2d19285",84,68,27,21.7777777777778,50,34,2,3
"9370","415fb1ad83aca3cc8a63c0684781d9aa",48,37,43,7.81395348837209,48,0,2,1
"9371","41605058bc4e6a250cf06a6721a0214b",22,22,0,22,22,0,1,2
"9372","4160bc56c67785784dd56400e9896358",30,30,0,30,0,30,1,2
"9373","4161e671480b44b18060c6ab0f268e44",25,25,0,25,25,0,1,2
"9374","4162242766998483149153b25de33a03",59,41,65,6.35384615384615,59,0,2,1
"9375","4164286df8e22134c488321142ba1063",63,39,62,7.11290322580645,63,0,2,1
"9376","41682ba2f47eb59b6162794fce8ea266",46,46,0,46,46,0,1,2
"9377","416946f3b89e6e36d78a45055dc58fcb",53,48,64,5.796875,53,0,2,1
"9378","4169cfebed9431428ef2b56e4e920a02",22,22,0,22,22,0,1,2
"9379","416b134e3d4028210a9ef5e30c8a0abd",28,28,0,28,28,0,1,2
"9380","416b29c4e87d3282378566c010b36806",38,31,19,14,38,0,1,1
"9381","416c18aca3ce6d30750d765a26c0590b",12,6,31,2.70967741935484,12,0,2,1
"9382","416c228f94f3dbac71cd93a698c65c6b",79,71,13,42.5384615384615,33,46,1,3
"9383","416d01152b8b7951bd0cebd81ab24f6d",10,10,0,10,10,0,1,2
"9384","416de072d2eddda5670b0cc852c95dac",65,41,78,5.83333333333333,51,14,2,1
"9385","4170253f471f8d7204a1ab30000ade13",15,15,0,15,15,0,1,2
"9386","41717eb4e01c5d93802d15472659ca01",15,15,0,15,15,0,1,2
"9387","4172ce7463e1d3b65f9be6e2604d728f",58,52,39,10.4102564102564,58,0,2,3
"9388","417416c4f6a59367b6564dbc07a46a80",117,92,76,10.7763157894737,117,0,3,3
"9389","4174d8e285e434d1be58cd739ff29164",1,1,0,1,1,0,1,2
"9390","41776b617136b8bff619424682613b0e",184,118,63,20.4444444444444,184,0,3,3
"9391","4177f39c1c45002cdf256cac433344c6",131,107,59,15.5423728813559,80,51,3,3
"9392","4179c5c1eb159642d832001741815dd2",18,18,0,18,18,0,1,2
"9393","417a662170825d8a8bf37f71e6033459",40,37,38,7.36842105263158,22,18,2,1
"9394","417be94ed335c9bec8726abd05326163",28,28,0,28,28,0,1,2
"9395","417e44429b98868619a3d7b0146be435",59,34,50,8.26,59,0,2,1
"9396","417e4690fd809165242a228687fc0f0c",32,29,74,3.02702702702703,32,0,2,1
"9397","417e5f9509fb5d081bd8e2f88ec0dbaf",80,64,42,13.3333333333333,80,0,2,3
"9398","417e7c6f4b7f77c966f83b525402524b",93,57,59,11.0338983050847,66,27,2,1
"9399","41845e76ac91d9a8eaf70e77df68b89f",7,7,0,7,7,0,1,2
"9400","4184ebea860129360aa04e3b22f4773d",17,17,0,17,17,0,1,2
"9401","41865b8abcd8ebc6694f71eb4c60bae5",46,39,59,5.45762711864407,46,0,2,1
"9402","418883a92b74c00cbc52007b4d060703",96,74,42,16,96,0,2,3
"9403","418bf57e4ec1624fe9456b065e3eb8b3",56,44,62,6.32258064516129,56,0,2,1
"9404","418c43064a7abb60d9a30c12ab3e5623",61,40,60,7.11666666666667,25,36,2,1
"9405","418cfa3be30cceca02afc964addad245",54,24,74,5.10810810810811,54,0,2,1
"9406","418db8ab884a4cac19d68176db11eff1",12,12,0,12,0,12,1,2
"9407","419128068903b01dcd9d7e080f472e4b",51,51,0,51,51,0,1,2
"9408","41924d35256572010fa58bfd74457fb9",27,27,0,27,27,0,1,2
"9409","41948f227c081f17fa6cb7a6734a839b",85,55,28,21.25,85,0,2,3
"9410","4196120fcc75cebf3316189b7819cc73",34,34,0,34,34,0,1,2
"9411","4196ed4d84240bf9d7b86fc33575cc19",216,119,67,22.5671641791045,216,0,3,3
"9412","419a20a1c6af587b9aff12ee61269b54",137,92,35,27.4,137,0,3,3
"9413","419eb6dba9007b0a84213b1be86666f0",51,51,0,51,51,0,1,2
"9414","41a02f025963b1296b71da9c34ff937b",78,65,61,8.95081967213115,42,36,2,1
"9415","41a5cf40222ffff6f5faed27c4c096cc",110,71,42,18.3333333333333,110,0,3,3
"9416","41a74d0d4b773ac173d5b91d887ca4a8",13,13,0,13,13,0,1,2
"9417","41aa3fb3a74d6f3be59d1a58166b7289",19,19,0,19,19,0,1,2
"9418","41abc0e4345e10f670381595aa0835d3",27,27,0,27,27,0,1,2
"9419","41b0767e912e83875ac7f0dae81ab6ba",67,62,30,15.6333333333333,67,0,2,1
"9420","41b07f6eb9f7e795a70bdc3510cc19fe",157,70,75,14.6533333333333,157,0,3,3
"9421","41b24f49424e3ec6d687fd653505376d",46,46,0,46,46,0,1,2
"9422","41b4ade40abbca84b0e20c145507a2cc",79,44,70,7.9,31,48,2,1
"9423","41b5704ce6efa641d6470544ddea0bed",140,105,63,15.5555555555556,140,0,3,3
"9424","41b68762d2f1110f90eb018012ae7b1a",13,13,0,13,13,0,1,2
"9425","41b6b23f66d7eeeee571fe5258b02f26",105,67,54,13.6111111111111,60,45,2,3
"9426","41b94b899736944726b53f50fe7505e7",9,9,0,9,9,0,1,2
"9427","41b9da47266461f2846e45d0187d4ae1",42,42,0,42,0,42,1,2
"9428","41ba13ae3919c15952c39b7134361c3c",73,42,63,8.11111111111111,24,49,2,1
"9429","41bd4802735863dcb0f3f0502204784b",38,36,18,14.7777777777778,20,18,1,1
"9430","41bdc5cb90c6f68c0213418f1b9e28c6",44,39,39,7.8974358974359,11,33,2,1
"9431","41c07f0b458b2e0979d65739ee41566d",123,81,79,10.8987341772152,123,0,3,3
"9432","41c0b956aa0b40ae03d6df425d31dbde",2,2,49,0.285714285714286,0,2,2,1
"9433","41c2a0661e2e83cc5c7eeb8150721db4",13,13,0,13,13,0,1,2
"9434","41c397cd5729e918f7dd267de7bdcee7",141,85,42,23.5,141,0,3,3
"9435","41c5d7191831339dad2bde6c762b7e51",41,41,0,41,41,0,1,2
"9436","41c947ac14cc024bd44112ab248cfff1",68,56,57,8.35087719298246,68,0,2,3
"9437","41c961a9dd62b954f38953a386c0c39b",47,35,41,8.02439024390244,47,0,2,1
"9438","41ca5423168a2c5b0261da177a30f90b",85,63,61,9.75409836065574,85,0,2,3
"9439","41cbde272fa79273ff11bca9dc11eaa1",127,70,61,14.5737704918033,96,31,3,1
"9440","41cc48e8981e17c62eb37c96a3457ccf",166,91,89,13.0561797752809,166,0,3,3
"9441","41d144f57ea76e0bfc7c269ed6403ec9",136,89,61,15.6065573770492,136,0,3,3
"9442","41d3033df7f93036d8f4a854965f1eed",16,16,0,16,16,0,1,2
"9443","41d40a12bdfc301382c9419761b31e97",32,32,0,32,32,0,1,2
"9444","41da58b452ab2cad4ad351e51d45a4a4",35,35,0,35,35,0,1,2
"9445","41dabb15696d18eaa8b466567b512cf3",13,12,47,1.93617021276596,13,0,2,1
"9446","41dbd233dbbf53c13b59af7ebfc30ad3",158,104,66,16.7575757575758,158,0,3,3
"9447","41df08412aa3aafca42086500850463e",122,85,35,24.4,122,0,3,3
"9448","41e482fe1beb0e586af5a9cbe47e57cb",213,119,85,17.5411764705882,188,25,3,3
"9449","41e793b95622a5f0f6ffa98790121e20",127,88,45,19.7555555555556,127,0,3,3
"9450","41eb38a6938e289a7d8c885d48647b8e",31,31,0,31,31,0,1,2
"9451","41eb5ff92ae1a1f766a20db791d56986",50,40,29,12.0689655172414,50,0,2,1
"9452","41ed6710372534020001ca0714846a63",86,70,14,43,86,0,1,2
"9453","41ee758e45723a04dfac511ddb47ab32",21,21,0,21,0,21,1,2
"9454","41f2bea0eba2c9f15b96fd765ea9f7b0",19,19,0,19,19,0,1,2
"9455","41f34801bd40642d6ff35cf8c2bbfd13",14,14,0,14,0,14,1,2
"9456","41f35eb977b1ff9b706806058b72ee35",88,66,52,11.8461538461538,88,0,2,3
"9457","41f38328f04893a08b714c1de4f7b9d9",51,40,38,9.39473684210526,51,0,2,1
"9458","41f66af04f87dfecf228793e48dfc145",58,53,30,13.5333333333333,58,0,2,1
"9459","41f69d85b184647e0c4f033a2be438c2",20,20,0,20,20,0,1,2
"9460","41f756c80a95369d82a5bbc8fbcc9001",44,36,26,11.8461538461538,44,0,2,1
"9461","41f99b3fec0dfe45d2a0c29f2fafbbbb",10,10,0,10,10,0,1,2
"9462","41fa6d5c98a231905e1fe29a119f9673",50,39,42,8.33333333333333,50,0,2,1
"9463","41fa6f77faeb6185fab5929548e23841",85,69,46,12.9347826086957,35,50,2,1
"9464","41fbdda8bbb6297edc614064911eeee3",49,31,64,5.359375,49,0,2,1
"9465","41fdc5d0186f9190c954d5712e2394b8",87,34,77,7.90909090909091,87,0,2,3
"9466","4202092db9fc76b49935b97499167893",54,54,0,54,54,0,1,2
"9467","4204a1c8c47b50a96816559816e96fd3",196,69,79,17.3670886075949,196,0,3,3
"9468","4204b1fe83aeea8b7bd2ba3cf2d5cd22",36,27,56,4.5,36,0,2,1
"9469","4204c63eb149e5541dbca5f3af67428b",48,48,0,48,48,0,1,2
"9470","420a131b4b3354a1978b1a271bc00475",49,49,0,49,49,0,1,2
"9471","420b3c58d43eec852fbe6f0dec8bb12c",47,38,43,7.65116279069767,47,0,2,1
"9472","420b829e334805e2747658bbfca0429a",1,1,0,1,1,0,1,2
"9473","420d719ef93f7ea8a3dc28c6f388ef14",115,87,59,13.6440677966102,115,0,3,3
"9474","421001441267263c496e26f6ad341eab",32,32,0,32,32,0,1,2
"9475","421152c55bb4058aed03268d13ae1559",121,83,88,9.625,121,0,3,3
"9476","42127eaa4fca3067ac965b7007a1432d",97,61,53,12.811320754717,66,31,2,1
"9477","4212871ba6302ca0b5844dd52228d4b9",16,16,0,16,0,16,1,2
"9478","4213719a7e34b732ba3d5d961fa60d12",106,60,63,11.7777777777778,106,0,2,3
"9479","4215a03a7fdbd3659bae585af3724f24",24,24,0,24,24,0,1,2
"9480","421654b7ce995a1984e5561505f8ec80",216,104,57,26.5263157894737,168,48,3,3
"9481","4216a777a9a0db0a1b2d57129adde40e",53,43,57,6.50877192982456,53,0,2,1
"9482","4218ceb746b195df597a43755502a4fe",15,15,0,15,15,0,1,2
"9483","421b75814ac29a6696d36715e668c4bd",89,63,61,10.2131147540984,59,30,2,1
"9484","4220eb72d854693b65ce7e6f3ea8b63b",9,9,0,9,9,0,1,2
"9485","42225441b85e19b62b4bea96831aaceb",11,11,0,11,11,0,1,2
"9486","4222e0f718088cf9fb7711089ddec1c2",31,31,0,31,31,0,1,2
"9487","4223dcfb580d5b890c00903950ff6694",18,18,0,18,18,0,1,2
"9488","42243cd35784bbb6609d835e18a6b42f",139,97,63,15.4444444444444,139,0,3,3
"9489","422450981795f33170366950c7cf309a",53,46,57,6.50877192982456,53,0,2,1
"9490","4225dac63d2f6d55ad9bfd7c06c117bb",23,23,12,13.4166666666667,23,0,1,1
"9491","4227a2aee1aa7014023e9ba38f656cd9",30,30,0,30,30,0,1,2
"9492","422b2cb48643dd37426200ffac6f9c1f",29,29,0,29,29,0,1,2
"9493","422b402ebf101f7796d2f9d19eadd7aa",169,110,56,21.125,169,0,3,3
"9494","422fc50a2304d27c9549988f32421293",86,60,31,19.4193548387097,86,0,2,3
"9495","4232bdf308c558cf518a1c94b4ef3e53",99,74,35,19.8,99,0,3,3
"9496","42355679b447bf30435c09c48d70b736",21,21,0,21,21,0,1,2
"9497","423ad29852950c117b9c180ad57cfa44",53,53,0,53,53,0,1,2
"9498","423c5e24f811c8cac1d8918e00d50de6",87,61,71,8.57746478873239,87,0,2,3
"9499","423ca9c93ef8f5332420c03a769c0ff0",11,11,0,11,11,0,1,2
"9500","423d16dd1897b8a5eaa25a9af105b8f4",120,76,57,14.7368421052632,93,27,3,1
"9501","423ffb50cd7593157b587aae786e4046",14,14,0,14,14,0,1,2
"9502","4241fc0385b775dd1bd9cd3ee4eb4670",96,67,30,22.4,96,0,2,3
"9503","42439be586eeaec69035811196fb6de5",170,81,81,14.6913580246914,170,0,3,3
"9504","4246ee8566531cd196e48ac650e0a5d9",28,28,0,28,0,28,1,2
"9505","4247d75fd29352fdfc69757e000d2784",38,22,34,7.82352941176471,38,0,2,1
"9506","424a64d15e17467e564c738cf639200e",44,44,0,44,44,0,1,2
"9507","424bdfe5ed51ec0779f5e27017ecd6d2",127,58,66,13.469696969697,78,49,3,3
"9508","424d6bd029dd639ee749b32afbd3f5aa",202,116,71,19.9154929577465,202,0,3,3
"9509","424fa9d2b7fa69daf5fb0d4c1a2f4a2a",49,49,0,49,49,0,1,2
"9510","424fac6bfaa16666b8e20f8e4731c457",45,45,0,45,0,45,1,2
"9511","42502dc11aa820653185636b6d50832a",61,53,30,14.2333333333333,61,0,2,1
"9512","42525b5c1b47442950fd3ab45edcd068",12,12,0,12,12,0,1,2
"9513","42568df2d654ef844c1d15d8c84abdf6",50,33,76,4.60526315789474,50,0,2,1
"9514","4257093a269b60ceea1c4a3c05c4a369",18,18,0,18,0,18,1,2
"9515","425871824eb6ff2e2c5c55afcfa3f41f",97,74,72,9.43055555555556,61,36,2,3
"9516","425916816daba97be776f64f1150f984",33,33,0,33,33,0,1,2
"9517","425f777a79db60d4647e4cdec079fddb",26,26,0,26,26,0,1,2
"9518","4260de43b5e3cd6b4eb1bffefc39960d",33,33,0,33,33,0,1,2
"9519","42630be0d70a923cb07595fa289ae853",18,18,0,18,18,0,1,2
"9520","4263405e1baaf6e8c4ba9e66495c64c6",27,27,0,27,27,0,1,2
"9521","42650ff29438dc6909ea54c3f05326a0",114,83,74,10.7837837837838,114,0,3,3
"9522","42651066c935f06cc61ff37dd7ab59ad",19,19,0,19,19,0,1,2
"9523","42660618eae88effac2bd076d14f01f0",48,48,0,48,0,48,1,2
"9524","42674d6ef073623e539a054564ec8e7d",98,76,43,15.953488372093,98,0,3,3
"9525","426e23e583edac761a3fe96ea3df89d3",139,92,50,19.46,107,32,3,3
"9526","4270800731a2751d0fe4db5cd06b2efc",45,35,34,9.26470588235294,45,0,2,1
"9527","427096362538a6007aed27f9518c6d2d",131,75,79,11.6075949367089,97,34,3,3
"9528","4271b2062ed37f754eabff853ccdac72",26,22,70,2.6,0,26,2,1
"9529","427420c073bdbbf87ac722c4c2101d56",153,97,63,17,153,0,3,3
"9530","4274541a42ab5a6f65e6d5fb74585881",40,40,0,40,40,0,1,2
"9531","4276e7abcaaa9035b62a3e590adf8ab6",42,28,43,6.83720930232558,42,0,2,1
"9532","4276f34cf237ef2c1d69a230ee637a18",20,20,0,20,20,0,1,2
"9533","4279b216ba2ada4abbd534d3812ba3e6",19,15,31,4.29032258064516,19,0,2,1
"9534","4279dbce4b221de2be27f11b75fbe4e3",130,66,74,12.2972972972973,103,27,3,3
"9535","427a9ed43754d8cf25f5b0cedbb30694",22,22,0,22,22,0,1,2
"9536","427ef6b6b870dc43e070e0736ae2e35f",41,36,25,11.48,41,0,2,1
"9537","427f1fab5f1b5a5b1cdfe39ab4901848",24,24,0,24,24,0,1,2
"9538","42800aad23c635c4e05a05102c69a549",86,60,70,8.6,86,0,2,3
"9539","42850838e39d7f1fc271b154a877d856",32,27,34,6.58823529411765,32,0,2,1
"9540","4285204d9db2cfa230fdeaa3a3c3b25b",22,22,0,22,22,0,1,2
"9541","42854132dd45df3feea559c561593e89",17,17,0,17,0,17,1,2
"9542","4285c79753e93e7ebfa56d3c83d6fa14",44,44,0,44,44,0,1,2
"9543","4286eaa69619baa52ff325c96524e5e0",70,51,59,8.30508474576271,70,0,2,3
"9544","428ccb4dc534113f1b1e0aafd2209eb3",11,11,0,11,11,0,1,2
"9545","42908c180df57183758bb98c87b5ece4",107,52,60,12.4833333333333,107,0,2,3
"9546","4290bd68d2a376b45e3b5c317237e1e6",61,40,60,7.11666666666667,61,0,2,1
"9547","4293d0b72180ee012930740dfb7253d8",80,63,17,32.9411764705882,38,42,1,1
"9548","42957f768fe240a53b7b585aa1961706",36,20,30,8.4,24,12,2,1
"9549","42970b7446af34a276c055f5e780feec",28,28,0,28,28,0,1,2
"9550","4298f35b855d80ab66813271a65d02dd",9,9,0,9,9,0,1,2
"9551","42996ac9ca65504872cc6e97140312bf",21,21,0,21,21,0,1,2
"9552","429c631a5a9735eadf5d255b5c3b0fa6",56,43,63,6.22222222222222,56,0,2,1
"9553","429f6a88b4621932a20ca4701812860e",38,38,0,38,38,0,1,2
"9554","42a0460c827917b807247f5f751fdf3f",91,64,38,16.7631578947368,91,0,2,3
"9555","42aa566e0dad230809d9526e4bb1a97f",80,66,66,8.48484848484848,80,0,2,3
"9556","42ab402b29f33cbae6b610fd81e449e9",31,31,0,31,31,0,1,2
"9557","42acaca897254c19d48f9f30ebcd7e9c",16,13,42,2.66666666666667,16,0,2,1
"9558","42ad202d5ab0b72d158839779433c211",28,20,63,3.11111111111111,28,0,2,1
"9559","42b0fffa2260691dff16f2369194de2d",20,20,0,20,0,20,1,2
"9560","42b36187524e59055d1542ac76a1a435",80,52,78,7.17948717948718,58,22,2,1
"9561","42b6b652eb6d387eb39b37ab57d47785",69,51,32,15.09375,38,31,2,1
"9562","42b9653c497c3f05d8cc802f4f6cae12",34,29,33,7.21212121212121,34,0,2,1
"9563","42ba1823b9519946e978357b564bc7de",21,21,0,21,0,21,1,2
"9564","42bac55675f880a5aa947f78c80bb678",97,78,42,16.1666666666667,97,0,3,3
"9565","42bbaad5b02ec751e681ae95fdd4142d",48,37,43,7.81395348837209,28,20,2,1
"9566","42c005db106794571fba1da010206553",137,76,47,20.4042553191489,114,23,3,1
"9567","42c04082296745ef36bbd0a2f4ee46f4",134,77,50,18.76,134,0,3,3
"9568","42c607559b94482c07a178837a91f00b",68,43,74,6.43243243243243,35,33,2,1
"9569","42c751aaff63c099a43d61e00a4fe610",12,12,0,12,12,0,1,2
"9570","42c9426c572c20659e4b6bfbadd0e392",131,67,50,18.34,103,28,3,1
"9571","42cb56b02f29d64a15dbb8adf1bdffee",204,150,60,23.8,204,0,3,3
"9572","42cbdc6504ace66c98a813008f5d0937",76,52,50,10.64,76,0,2,3
"9573","42cbdef67681a6c3371abaac9b6c2c10",22,22,0,22,22,0,1,2
"9574","42cecdb2c21d089c6b4f752515735448",173,93,84,14.4166666666667,173,0,3,3
"9575","42cfa6f98eb5352f0b10b8823600ea7c",33,33,0,33,33,0,1,2
"9576","42d04125fb83e42a3775266ffce1bbab",146,95,70,14.6,146,0,3,3
"9577","42d121242922761e6fb69b93299e9f70",28,26,12,16.3333333333333,4,24,1,1
"9578","42d22182e5260e9c0a37299286b5b79f",114,82,78,10.2307692307692,114,0,3,3
"9579","42d58613878b21bc824af4344cb95cde",145,97,81,12.5308641975309,145,0,3,3
"9580","42d69cc3f99098485fc18c1db1f27df8",48,48,0,48,48,0,1,2
"9581","42da9036afe5751164eb178b5a4b318e",30,30,0,30,30,0,1,2
"9582","42dac0405f952c128b71d83a16dd032d",43,43,0,43,43,0,1,2
"9583","42dd76cacdfe4c5228b75e550dc3c6f1",34,34,0,34,34,0,1,2
"9584","42df07b951ae5017dbd5771b91572268",6,6,0,6,0,6,1,2
"9585","42e2735c6848bf182124b0649ac40489",138,37,76,12.7105263157895,95,43,3,3
"9586","42e4872a39a935ca3bf5f154398e13af",33,25,49,4.71428571428571,33,0,2,1
"9587","42e54c945932194d93ad64f59dd0fa28",3,2,35,0.6,3,0,2,1
"9588","42e74736be5ff9482f753042f05dc740",50,50,0,50,50,0,1,2
"9589","42e853fa079c9864c69faaae35e5b84e",16,16,43,2.6046511627907,16,0,2,1
"9590","42eaafaded124f16684c69b24772bf22",21,21,0,21,0,21,1,2
"9591","42edbcca5ab869a1766abc5f291a099a",40,40,0,40,40,0,1,2
"9592","42f1fa5f5ff6298e95244a747ed42348",24,24,0,24,24,0,1,2
"9593","42f2ccefdc9cb0d1194224c4575dc4c9",68,54,77,6.18181818181818,68,0,2,3
"9594","42f3a8ad545ff266ee173d04f1610194",22,22,0,22,22,0,1,2
"9595","42f607f2bde3384bfb3302f973bee19b",24,24,0,24,24,0,1,2
"9596","42f7e2259c63cde860803dc350a6bfc5",34,34,0,34,34,0,1,2
"9597","42f8966c64d66f54a5aa2c15c8d42245",23,23,0,23,23,0,1,2
"9598","42f8ee289ace3643f0aa494af9d620f8",82,75,37,15.5135135135135,82,0,2,3
"9599","42fc00ca505b4964b73ba4a48d6fb60d",60,45,66,6.36363636363636,60,0,2,1
"9600","42fda2b1fd27c621f22499cf15cd3487",1,1,0,1,1,0,1,2
"9601","42fdd76b570eaf5808bb2670bfc9f5b9",20,20,0,20,20,0,1,2
"9602","42fe466a8c02bc82aac38b32562a356c",42,42,0,42,42,0,1,2
"9603","43012a63503e53eb9edd056abd108797",34,33,11,21.6363636363636,34,0,1,2
"9604","43015b5a5089cd605ff17c8b495a2e98",191,126,79,16.9240506329114,159,32,3,3
"9605","43016435bd7416785587f520bda989cc",64,50,23,19.4782608695652,64,0,2,1
"9606","43046245567a20aa3d8a9ac12b4d53a8",119,86,32,26.03125,119,0,3,3
"9607","430505442ed411c7ca06d9164a0d77fc",32,23,63,3.55555555555556,32,0,2,1
"9608","4308ace2c5d2c87df9606a050e3390e8",165,96,70,16.5,130,35,3,3
"9609","43090f22308e77a4f755181870f2a915",110,80,66,11.6666666666667,110,0,3,3
"9610","4309d3d5e39df52daca2ef2e1efdcba5",163,110,51,22.3725490196078,113,50,3,3
"9611","43118b6a3f1092ef7f1f812e69a246ce",94,84,54,12.1851851851852,94,0,3,3
"9612","4313b5ed454b748873b264e386dd6335",9,9,0,9,9,0,1,2
"9613","43159af7f1539618a316040f2902d2c8",136,93,60,15.8666666666667,136,0,3,3
"9614","43171ffc2fada02e5c0a42f93320a33d",21,21,0,21,21,0,1,2
"9615","4318d634af7d965c636cec6ac24da28d",47,38,68,4.83823529411765,47,0,2,1
"9616","4319c81039fc5053656b4d959241441f",39,39,0,39,39,0,1,2
"9617","431b02cc175392864ff4edfee2fbfa91",54,45,14,27,54,0,1,1
"9618","431ba62fe4ffa0f1a9f2f7616dff5589",32,32,0,32,32,0,1,2
"9619","431db2ac17dd61d33b1d965e20b48fa2",26,26,0,26,26,0,1,2
"9620","432228b8acd0e91e08e93e97b67b025b",23,23,0,23,23,0,1,2
"9621","43222e5e9e5f345b7cb2113d51a321c4",109,58,84,9.08333333333333,109,0,3,3
"9622","4322f9b094b8538a5c6401d9c7bc59eb",24,24,0,24,24,0,1,2
"9623","4324dd1e5a8a3318073d484c9a08a651",112,63,90,8.71111111111111,88,24,3,1
"9624","4325c4437acb20335ad5421e1ad2a775",7,7,0,7,7,0,1,2
"9625","432cfd8dd3d6da134e69f7bca07c787b",59,50,66,6.25757575757576,59,0,2,3
"9626","432fe44fb6d04dd468617e1b06aa56ed",28,28,0,28,28,0,1,2
"9627","4335eccc727946eebd876dc07258ec89",25,25,0,25,0,25,1,2
"9628","43363929355b8fe0a0394149589664ba",104,55,50,14.56,104,0,2,3
"9629","43394c3aeef8c79bf97507ecf4cc73e2",110,78,40,19.25,110,0,3,3
"9630","4339a86f8d3359f7ae4fb496a5ef9968",10,10,0,10,10,0,1,2
"9631","433c42a1f9f5475f94884ab2ce448dc4",45,29,73,4.31506849315068,45,0,2,1
"9632","4340f55dad48473a4af96e640dc8fa24",47,41,50,6.58,21,26,2,1
"9633","43455bae397876ceb565dfa5b96dc378",54,54,0,54,54,0,1,2
"9634","43472064ca25cd525036ac687ae469af",30,26,59,3.5593220338983,18,12,2,1
"9635","4347305b669ac2543ce13861c103cbe3",42,42,0,42,42,0,1,2
"9636","434846aa257b818a881705e9bc0af0c5",36,36,0,36,36,0,1,2
"9637","434dab817891f24a75b401b365d64171",84,63,50,11.76,43,41,2,1
"9638","434f8400b70e3e0527e9013f33270f22",1,1,0,1,1,0,1,2
"9639","434fb768b3e5b853d38efa1ffafff628",33,33,0,33,0,33,1,2
"9640","4350669fc9d1e3ee29a8940d75c2e246",4,4,67,0.417910447761194,4,0,2,1
"9641","43523299c1b63ececd7c0faa6cfc16f5",249,144,63,27.6666666666667,199,50,3,3
"9642","4352c963c8b2232ea0193102e96da9d9",16,16,0,16,16,0,1,2
"9643","43555f03284065c9b63240af234b26e9",18,17,59,2.13559322033898,10,8,2,1
"9644","435749dae608c2500b0ff92a1adb1567",80,50,51,10.9803921568627,80,0,2,3
"9645","43581b2363cc3968df328a8a37f10f22",64,54,23,19.4782608695652,64,0,2,1
"9646","435aea7b95aa270e3f803c9dee62fe93",25,25,0,25,25,0,1,2
"9647","435e6f761cd07b7722bac4ddd83fedf3",10,10,0,10,10,0,1,2
"9648","435f05ad2b462f8537fb5702db40fa96",68,46,49,9.71428571428571,68,0,2,3
"9649","436659f154322dd97f8a94f635d461c7",12,12,0,12,12,0,1,2
"9650","4368931659973bcc01129eb8129159c5",21,21,0,21,21,0,1,2
"9651","436969035db547625c5991f2cc5b8bc2",61,37,73,5.84931506849315,41,20,2,1
"9652","436b28e08703b744a88744a66123275f",33,28,33,7,10,23,2,1
"9653","436b60896dd21a70f2bb88a36befd3f8",214,112,67,22.3582089552239,214,0,3,3
"9654","436cd38a411b3bc98b4a1c3e28dde1ac",121,78,69,12.2753623188406,121,0,3,3
"9655","436d6bc8ac4c633095374a16889f0827",11,11,0,11,0,11,1,2
"9656","4373c023c94f30ca4a6061a34288bccc",47,47,0,47,47,0,1,2
"9657","43742c7751658d9d195883f11bd45e0c",27,27,0,27,27,0,1,2
"9658","437563c7e7886b3cc2689645723779bc",33,33,0,33,33,0,1,2
"9659","4375c9fbf24f97f6b209485addcd3e51",96,78,86,7.81395348837209,54,42,2,3
"9660","437a7cb00cfa86f73d85dc2985d64c6e",54,35,76,4.97368421052632,54,0,2,1
"9661","437b4c0e8da6ce94b21d51ebf02207d3",148,72,88,11.7727272727273,148,0,3,3
"9662","437c8496308e7271bf160f5dc1d71d67",33,33,0,33,33,0,1,2
"9663","437d7fe024111ba6d8bfa642328275a9",27,27,0,27,27,0,1,2
"9664","437ec047932aa4f410a8df18e6defa31",74,62,25,20.72,74,0,2,1
"9665","437ed252df4b9a928b98bdf957d038cc",42,34,33,8.90909090909091,11,31,2,1
"9666","43801344a721e5a3f9cbc3bcfcba8dec",34,27,28,8.5,34,0,2,1
"9667","438214ec7682ae4592a9a65a153a9668",20,20,0,20,0,20,1,2
"9668","4384c007aae7b3438895f79aca5447fc",16,16,0,16,0,16,1,2
"9669","43852d3ce9c4dd9edee5537ba8674a24",6,6,0,6,0,6,1,2
"9670","438602ab759ee26482080f66b5212e66",19,19,0,19,19,0,1,2
"9671","438931e463f094ef38ed9984db030d1d",15,15,0,15,15,0,1,2
"9672","438b8dfc9d21cc28c56ebc9f39c97443",14,14,0,14,14,0,1,2
"9673","438dc959d4878e8e6cc2b6228e65fc7f",54,37,32,11.8125,54,0,2,1
"9674","438f55d40361cf3e6e1585c7be07717e",69,60,64,7.546875,44,25,2,1
"9675","43903f8b8f2875b85871771ba17de055",40,40,0,40,0,40,1,2
"9676","439485cb74970140a6afb8338bf46bfc",28,28,0,28,28,0,1,2
"9677","4394ddbbd7c22dae4e0bff173dabde9a",69,51,66,7.31818181818182,69,0,2,3
"9678","43977489c75518747e615ffc26ef0d78",8,8,0,8,8,0,1,2
"9679","4398aaad6332c914b0a67eea427b2858",23,23,0,23,23,0,1,2
"9680","43991ce319470d2cc34b51183120a773",15,15,0,15,0,15,1,2
"9681","439d85388fa5623e16e59b357817927a",47,36,12,27.4166666666667,47,0,1,1
"9682","439e76a07dae1a82304ffc1fa3228c28",34,29,48,4.95833333333333,34,0,2,1
"9683","43a04142ae1e50b161ffe69e5863567c",10,10,0,10,10,0,1,2
"9684","43a0820a7f9ba6270ae9643fda995ce6",41,41,0,41,41,0,1,2
"9685","43a278b700db1b8fe26944afb1d79c4c",111,95,55,14.1272727272727,111,0,3,3
"9686","43a2983fef96c17b02c52b9f88de6182",21,21,0,21,21,0,1,2
"9687","43a3ef33d43891f89eeee7bc7f62c117",11,11,0,11,0,11,1,2
"9688","43a4513bb479ce33941b4fae2977b6dc",8,8,0,8,8,0,1,2
"9689","43a4fa08e4d66f55cd147e3a96198656",31,31,0,31,31,0,1,2
"9690","43a6b7949aa320957956e0cfd29d7d68",93,64,57,11.4210526315789,93,0,2,3
"9691","43aa9eeaa8d5fd594a9199a5d5a270ac",11,11,0,11,11,0,1,2
"9692","43ab1a3b83960c2536244b63378d44d8",168,151,49,24,168,0,3,3
"9693","43ab3b7157b81412c5c9872b70dd988d",1,1,0,1,1,0,1,2
"9694","43acb16947c2beb0f41476a5cb3ee523",157,82,67,16.4029850746269,120,37,3,3
"9695","43ae4287c6b4eaad4c42da0c9dca28a9",147,74,32,32.15625,92,55,3,3
"9696","43ae952d6169ba03c12ad52aa68873b8",45,45,0,45,0,45,1,2
"9697","43b2566c44e70f281d6449b031b2bed6",24,18,12,14,24,0,1,1
"9698","43b8672e5c028741d97a579d16ac9b55",81,50,34,16.6764705882353,81,0,2,1
"9699","43b8f1b718bec680dd5fc756e8cef507",22,19,34,4.52941176470588,22,0,2,1
"9700","43bab911b0455c3d41c3b6b18a5b2bbd",20,16,70,2,20,0,2,1
"9701","43bae4d968b9bf6287718006a90d1698",5,2,32,1.09375,5,0,2,1
"9702","43be2b70d561492ebc9c4de19adbf0af",37,31,30,8.63333333333333,37,0,2,1
"9703","43bf16a74fef361fd0a034ad6d965ed1",223,101,50,31.22,176,47,3,3
"9704","43c032c2a26e4c3782eee329e60f6fc4",132,82,42,22,104,28,3,3
"9705","43c966b428e6f0323af9f16477860fc3",87,63,54,11.2777777777778,87,0,2,3
"9706","43cae8dea54de24f0b2b7d6fc9957794",16,16,0,16,16,0,1,2
"9707","43cb514cdfeee9a679537508b63a71c8",12,12,0,12,12,0,1,2
"9708","43ccf45e5c8c59a44735e31049b5c6b6",25,25,0,25,25,0,1,2
"9709","43cf45232c1c7ad23339ae902850e97c",86,58,70,8.6,86,0,2,3
"9710","43d04ee6b5f829c1ed64f7c613d7252f",8,8,0,8,8,0,1,2
"9711","43d0a36902053e02ad05474904acc077",69,55,25,19.32,69,0,2,1
"9712","43d2a098f3971db87833cf7bd92582ce",45,45,0,45,0,45,1,2
"9713","43d2ba1b58a6336095f88a4a651b57c2",35,27,42,5.83333333333333,12,23,2,1
"9714","43d5306eda2b5795c7be547a891f9520",156,76,85,12.8470588235294,156,0,3,3
"9715","43d642af267d7d812074aa0de9851540",135,104,78,12.1153846153846,111,24,3,3
"9716","43d916d30f0be8bebb5c485f312f8f67",5,5,0,5,5,0,1,2
"9717","43df4cddb2f0e4cfafffecfc2f7876da",45,45,0,45,45,0,1,2
"9718","43df9740f179748c76921381cd90a6bc",29,29,0,29,29,0,1,2
"9719","43e145fcfb4b1eabfe4ebcad90a516e6",79,62,30,18.4333333333333,31,48,2,1
"9720","43e471882ce7fca87afb63ec6a8e8f32",10,6,65,1.07692307692308,10,0,2,1
"9721","43e47219b549652a5e1407fd618b89e2",79,52,86,6.43023255813953,61,18,2,1
"9722","43e560d4117aaa4084e8a116955cc298",158,50,63,17.5555555555556,158,0,3,3
"9723","43e6d19e9c0432c81caeec0adb9015d1",95,63,50,13.3,58,37,2,3
"9724","43e7cde8eb52640ef9d33184e28ae3c0",40,40,0,40,40,0,1,2
"9725","43e80c61bea67f29f448c41605d17dad",173,106,56,21.625,173,0,3,3
"9726","43e904d1a133cae4590b8f44bb389d42",33,33,0,33,33,0,1,2
"9727","43e9afe865336be4d020df8dfd37eab5",41,41,17,16.8823529411765,41,0,1,1
"9728","43ec641e4809c2c085fdeefc09da77d0",43,43,0,43,43,0,1,2
"9729","43ecf7ff36aa7d264e2fd17597c6f91f",22,22,0,22,0,22,1,2
"9730","43ed14a4a728e8d71744bfd18b6304ed",22,22,0,22,22,0,1,2
"9731","43ee3397d8cf113f8ba939dfb5f7686d",21,21,0,21,21,0,1,2
"9732","43ef0b3a299806b35d6f9acfec777842",45,45,0,45,0,45,1,2
"9733","43efafa4ac75a65a5cadfc5c8051921d",51,45,51,7,51,0,2,1
"9734","43f52c0f4fd4f52fa314b36e8351db99",53,46,66,5.62121212121212,32,21,2,1
"9735","43f6d323af9179f16595210fbbc236c6",41,33,76,3.77631578947368,41,0,2,1
"9736","43f9a15116a8c2be0369938c2cf987e8",11,11,0,11,11,0,1,2
"9737","43f9c6b4a74dce24ca454b8d523f9b02",40,34,9,31.1111111111111,12,28,1,2
"9738","44012633834d4d0ace0527a60d97faff",29,28,21,9.66666666666667,29,0,2,1
"9739","44028bee571f9fcfd38c079dd6512dc0",54,34,45,8.4,28,26,2,1
"9740","440351b57aeea2a79233a3622b1ebf16",35,30,47,5.21276595744681,26,9,2,1
"9741","4403d01a92653df5b14d66e9bdf79476",205,125,54,26.5740740740741,205,0,3,3
"9742","44053a948e4334387ab38308b9a0a8b8",80,64,13,43.0769230769231,28,52,1,3
"9743","4408edddae29da755b9d034b73cc3bde",97,45,66,10.2878787878788,82,15,2,1
"9744","4408fa1b5db436144fa25e437761fbff",57,49,47,8.48936170212766,57,0,2,1
"9745","440b05d05d26bf20f5c8059316034f43",48,48,0,48,48,0,1,2
"9746","440d022b3f25ed845d7acd90728450e3",160,112,56,20,160,0,3,3
"9747","440d504278161c6fb0fd42922b94ef07",204,68,84,17,204,0,3,3
"9748","440f05eb40d57fe84ce61b7e69d515aa",119,72,82,10.1585365853659,103,16,3,1
"9749","441237b7290ddab87ff8a4de614ee3e1",6,6,0,6,6,0,1,2
"9750","441278464656c1a8a8312de118189540",107,66,81,9.24691358024691,87,20,3,1
"9751","4412cd88295852633e75bb2d611e6362",189,113,63,21,189,0,3,3
"9752","44131d00e683772e4b0fed7eebfb026c",27,19,39,4.84615384615385,13,14,2,1
"9753","44177fad14d52e507c4a3ff618c5e2eb",31,31,0,31,31,0,1,2
"9754","441edf5c6254de0c9c87f663a23aaa3c",14,14,0,14,14,0,1,2
"9755","4420718255f01c7e548060fbca19c6db",159,79,82,13.5731707317073,159,0,3,3
"9756","44207d4f41009adbee797ffed433737a",41,41,0,41,41,0,1,2
"9757","4421253fb688d5587887cb77a2b70912",98,80,49,14,98,0,3,3
"9758","4424309a02bda4ddfd45934b444008b6",95,63,46,14.4565217391304,59,36,2,3
"9759","4424df57fd4a21b0c2d221a34a7352d2",21,21,0,21,21,0,1,2
"9760","44250c0a1f6adec65a98885be39d1a7d",37,37,0,37,37,0,1,2
"9761","44254f5f7d59c83b04e16ce50e6ef21d",9,9,0,9,9,0,1,2
"9762","4427c3a8008cd9957b5fc6748ad44bcf",9,9,0,9,9,0,1,2
"9763","442cb536d9bb91a12285591f0064fd33",18,18,0,18,0,18,1,2
"9764","4430ded7747c5a1940fbb460bca7db69",25,25,0,25,0,25,1,2
"9765","4431af759c9d18acb4b9d914d680415b",106,79,82,9.04878048780488,106,0,3,3
"9766","443404bd34873e760efead6b518aca5f",60,51,58,7.24137931034483,60,0,2,1
"9767","443525790ed23151e46c46532cd63d64",45,38,14,22.5,45,0,1,1
"9768","4436d317a74baced7917364714f4344b",3,3,0,3,3,0,1,2
"9769","44371a16c177dbf676b18ede98dc421d",44,39,45,6.84444444444444,44,0,2,1
"9770","443be43c4cea306a33d7104609d4a074",13,13,0,13,13,0,1,2
"9771","443dd4199a7b84403210e66132549474",119,86,54,15.4259259259259,105,14,3,1
"9772","443e594cb8e53ac6c1dac16594ff8e71",81,48,72,7.875,38,43,2,1
"9773","44438ef3108b82d8ba8de7b6141cdda4",32,31,42,5.33333333333333,32,0,2,1
"9774","44448278bf9ed17311bb3532034e289d",29,29,0,29,29,0,1,2
"9775","4448610978a686b6cb708de7de62b866",90,62,70,9,90,0,2,3
"9776","444da343e608a8dd73bd31515f4b448e",37,37,0,37,37,0,1,2
"9777","444ddbee4b47bd274fcae41106907035",129,84,22,41.0454545454545,129,0,3,3
"9778","4456f91208f6a8d36ab08f331d409820",41,41,0,41,41,0,1,2
"9779","4457115fec8e813c5ddfece9ec838ed3",16,16,0,16,0,16,1,2
"9780","445a5713d6114ceab9b7da54cba98493",12,12,0,12,12,0,1,2
"9781","445ab0649d9b14fd0771bfa6f7f63d1f",108,77,43,17.5813953488372,108,0,3,3
"9782","445e3f2cba58c84c945e43de20517503",34,34,0,34,34,0,1,2
"9783","445f77c429d9c4762baf67976d162d1a",39,39,30,9.1,39,0,2,1
"9784","446085e707ef314dd28ed8e94a53580b",26,23,20,9.1,26,0,1,1
"9785","44609c1cf998f436661f480c4526acb3",134,83,70,13.4,134,0,3,3
"9786","44624f6401c2fd64af8e6d9f0327b6d2",19,19,0,19,19,0,1,2
"9787","4465d58e4d6b08c948ac5e0407b653d4",13,13,0,13,13,0,1,2
"9788","44664017b36e7e7a8e0571f986099f2f",40,40,0,40,40,0,1,2
"9789","4468d72d2cc4e056b18eaf202b7f6d12",21,21,0,21,21,0,1,2
"9790","446a454f52a34488abf6db1f651d45d6",48,48,0,48,48,0,1,2
"9791","44730ed602f639e7c813d78ac10caa1d",65,61,53,8.58490566037736,28,37,2,1
"9792","44742098744673c2002f3f592558afba",9,9,0,9,9,0,1,2
"9793","4474a7738a6b1443656bdbfbbe996ef5",79,59,82,6.74390243902439,79,0,2,3
"9794","4475be8284f8e1d1120b11a8b8e6a80c",24,24,0,24,0,24,1,2
"9795","44762566640960542bde555179295670",162,97,69,16.4347826086957,162,0,3,3
"9796","447625c7b2e23ae3503e3338463a57ae",27,27,0,27,27,0,1,2
"9797","447894c5995f909b7f40085bfda37ce8",28,28,0,28,28,0,1,2
"9798","447ca45ee92bdf9a3a4cb25ae1dc7299",190,138,56,23.75,190,0,3,3
"9799","447cacaa5ee363fbe11cd92678f4ca65",7,7,0,7,7,0,1,2
"9800","447cf781c1b90282f40f4a89b4f9c58e",99,80,70,9.9,99,0,3,3
"9801","4483f71adcd74b516491837c0d21b092",79,48,66,8.37878787878788,52,27,2,1
"9802","44845d62566d02cbd259063a698a949f",11,10,0,11,11,0,1,2
"9803","448a736c684106b45fa465de25dc9a35",52,52,0,52,52,0,1,2
"9804","448a7b4688ff398b4a4c0a7dd6df2d87",7,7,0,7,7,0,1,2
"9805","448c8709b58f4c1dbb30e5afe6b7d211",31,31,0,31,31,0,1,2
"9806","4492f5092d242e3dcba7cf0d540d316f",127,87,88,10.1022727272727,127,0,3,3
"9807","4493616fb82800c68da940dc02ee9e97",23,22,3,53.6666666666667,23,0,1,2
"9808","4495e3f739691711922efdcafa1d583b",28,28,6,32.6666666666667,12,16,1,2
"9809","44968be4045a96612e241174715888b4",15,10,35,3,15,0,2,1
"9810","44990284cc074c7bb02eabaaef20e018",91,74,31,20.5483870967742,91,0,2,3
"9811","4499717fb4ecff6f1f36ff1af0354b5d",74,49,66,7.84848484848485,25,49,2,1
"9812","449b8ca59178750e87e66ea440f507ca",59,47,37,11.1621621621622,25,34,2,1
"9813","449ccb88dbea7e4ad5c1084246908d78",15,15,0,15,15,0,1,2
"9814","449db1aa2b9178c770b0122c71619f04",144,60,70,14.4,144,0,3,3
"9815","449edb411e4450a65f8efc55461983c7",199,108,74,18.8243243243243,199,0,3,3
"9816","44a0372834718ed7851d2d06ec5eaa52",13,13,0,13,13,0,1,2
"9817","44a4dd618f2c4c8ababafe87ce7cc1af",23,23,0,23,23,0,1,2
"9818","44a5cd9fff624ca494911a298135789d",77,38,63,8.55555555555556,77,0,2,3
"9819","44a6398abb3fe18f1b23553f239ba99d",10,10,0,10,10,0,1,2
"9820","44a841f156446939cd4ad67185c5cb7c",14,14,0,14,14,0,1,2
"9821","44abe590fa8b77ab04470a91b9d45f7c",39,39,0,39,39,0,1,2
"9822","44acbc6f50ef93581439f7a4e3bac8b1",10,10,0,10,0,10,1,2
"9823","44afbc2a265b7e940542a402842c99d2",18,18,0,18,18,0,1,2
"9824","44b06c635d9b0bde1922b3c06163d7dd",49,49,0,49,49,0,1,2
"9825","44b14e6523745dce6e0f02c24ed8b5f8",25,25,0,25,25,0,1,2
"9826","44b42ce9f64195d0d8ac30218cbbc660",46,37,36,8.94444444444444,46,0,2,1
"9827","44b4a18505ba2e20b91b9d80cebe9a04",22,22,0,22,22,0,1,2
"9828","44b5ac2cd0af93b5fc3e69436feea3cb",144,87,78,12.9230769230769,144,0,3,3
"9829","44b98a65258ecde5c28294cc54cbdf1e",20,13,76,1.84210526315789,20,0,2,1
"9830","44bbda412385dcd071c841be08798ffe",21,15,58,2.53448275862069,21,0,2,1
"9831","44bbf4e86432ea6125e2590d803ec688",66,57,36,12.8333333333333,66,0,2,3
"9832","44bc184282dc853cd6071a656c717adb",65,55,42,10.8333333333333,43,22,2,1
"9833","44bc289613718e5d6c2f00dd2fcfd81c",32,32,0,32,32,0,1,2
"9834","44be473b46a7fb9c64e1dc480b68ed5c",146,83,32,31.9375,146,0,3,3
"9835","44bfe30608868472df3b90ed64232894",14,10,53,1.84905660377358,11,3,2,1
"9836","44c536faec7c7c0c3e3d40122ff642df",45,37,70,4.5,45,0,2,1
"9837","44c5d1ec7c9ca507b11b2e1029ddb181",15,15,0,15,15,0,1,2
"9838","44c7a0f590589b9ca6fcb1942aaa67a4",12,9,35,2.4,0,12,2,1
"9839","44c7b5dc48f75e6aec9b2683afdffd94",39,39,0,39,39,0,1,2
"9840","44c86649c0c8e99461c800685f29a707",66,51,46,10.0434782608696,31,35,2,1
"9841","44cc5bdd675cf8cd6ad8551fcb1392d4",57,46,35,11.4,57,0,2,1
"9842","44d1e4b438682a4ddc85b819b836b277",117,78,55,14.8909090909091,117,0,3,3
"9843","44d29d8faf096ce770ff801f17b2afc8",92,56,62,10.3870967741935,92,0,2,3
"9844","44d442ec723f6c8a0c6f7f06b9fdf7b6",12,12,0,12,12,0,1,2
"9845","44d599daa427a4f9d856971517320aa2",60,41,35,12,60,0,2,1
"9846","44d664ef3f138fbfa3337ded183c47fa",40,40,0,40,40,0,1,2
"9847","44d856a97d2f9bd5f8b5aee9bcbd4185",21,21,0,21,21,0,1,2
"9848","44dbbcd4ce01ef3072cfce9740a9e4b6",34,22,11,21.6363636363636,34,0,1,2
"9849","44dd5cb56d7e6cf00cba86be82c6607f",21,21,0,21,21,0,1,2
"9850","44dda68f6243e17203cbf1a6bf999d42",14,14,0,14,14,0,1,2
"9851","44df4717632214fec4b1d7d217eca189",178,91,64,19.46875,133,45,3,3
"9852","44dfb3d75beeb8e7ce1aae0169d42743",35,35,0,35,35,0,1,2
"9853","44e1b5c0cd2ce8c1a54220f9c1b50b05",65,57,68,6.69117647058824,65,0,2,3
"9854","44e212a54335dc5ec08324ad068286ad",22,22,0,22,22,0,1,2
"9855","44e43690647809694c73285a52e69278",22,22,0,22,22,0,1,2
"9856","44e457c89f2bf12f09b3700a5ed77a55",50,29,70,5,50,0,2,1
"9857","44e6215d54d5b1707f3b12afd20843c1",16,15,11,10.1818181818182,16,0,1,1
"9858","44e840f72897d6f73ee1fd84f4e49915",23,23,0,23,0,23,1,2
"9859","44e86d302a6f2b2829cd8a35d4d46bce",31,31,0,31,31,0,1,2
"9860","44ea34cc96a28ef6c5a6fa83d8ef280c",93,83,80,8.1375,41,52,2,3
"9861","44eb396f0afae02353d865c3af9ef889",72,57,33,15.2727272727273,42,30,2,1
"9862","44ec79f3a2e6861e1ce4501c4b6d92cf",51,41,31,11.5161290322581,24,27,2,1
"9863","44ecdac5ead32c38f41475d346d3e32b",48,40,62,5.41935483870968,48,0,2,1
"9864","44ef4a40769aa4f712e841b61f097e52",18,18,0,18,18,0,1,2
"9865","44f14ad797ee54de1730bdcc8108ce62",94,61,21,31.3333333333333,94,0,1,2
"9866","44f3e75bf260b3e14237e3752fd37cda",182,111,64,19.90625,182,0,3,3
"9867","44ffee5ad0b3c5366db7d33d5ac208ed",50,40,22,15.9090909090909,50,0,2,1
"9868","45030e00139ee098b84ea761938fed57",18,18,0,18,0,18,1,2
"9869","45051495fad057cda86438c2d5f7f8c2",11,11,0,11,11,0,1,2
"9870","45053f73a93584fa8d96da68b6ee5667",235,102,83,19.8192771084337,205,30,3,3
"9871","4506d2547dc9dc29c30bfcf51a1ff0ac",37,31,49,5.28571428571429,37,0,2,1
"9872","4507707dd96ee2c19cdec42e5e72c91b",186,86,89,14.6292134831461,147,39,3,3
"9873","450e32bc274b248443c03d096f132f23",5,5,0,5,0,5,1,2
"9874","450e83fc78b5e7b547355f85ae7a0e97",77,67,69,7.81159420289855,77,0,2,3
"9875","450f489c05eebd2fc7c8b3fd48cbbe90",175,101,79,15.506329113924,175,0,3,3
"9876","450f5ffaa8daea975418603ea7302f6c",88,68,50,12.32,88,0,2,3
"9877","450fd9103319de935f299649128831f3",84,43,62,9.48387096774193,84,0,2,3
"9878","451041f2db8242a078e129271cbb0188",31,31,0,31,31,0,1,2
"9879","4510b3c7ef29524137a9f8b61669b1f0",128,81,63,14.2222222222222,128,0,3,3
"9880","451584ecd9cad0de44e9987b838acba7",49,45,14,24.5,49,0,1,1
"9881","4515d38ba9583d68b4339c14d8b01315",204,104,82,17.4146341463415,204,0,3,3
"9882","4516917c84e9e5d3405c7c1b0460d69f",23,23,0,23,23,0,1,2
"9883","4516efb256ace818cf9d44318062178c",20,20,0,20,20,0,1,2
"9884","45178e6c3c3f699fa017441483511199",29,29,0,29,29,0,1,2
"9885","4517bade9222a603c97b8c76d842130b",193,98,65,20.7846153846154,159,34,3,3
"9886","4518bd2b99e98e4c371b9c45a5f6da10",86,52,64,9.40625,49,37,2,1
"9887","451b898943c7ca9818fae05e689b4561",12,12,0,12,12,0,1,2
"9888","451d0a2414a2fe3f025b095f0806d88a",64,40,63,7.11111111111111,64,0,2,1
"9889","4524f1deac9338e1e69abad55b7d5ca0",55,47,52,7.40384615384615,55,0,2,1
"9890","45254c0477feeaa1b0be40413494f354",8,6,2,28,6,2,1,2
"9891","4525ae947824f8b051e9b861b5bc8915",65,47,44,10.3409090909091,65,0,2,1
"9892","4527e6a2be243c7aaa65f84ef98b85f3",132,38,83,11.1325301204819,132,0,3,3
"9893","452847e6da56be5d7012d7ad6e3db975",4,4,0,4,4,0,1,2
"9894","4528f7e1b8a31dd3b0b8f91c967ef3d8",40,31,14,20,0,40,1,1
"9895","4528fc83abe9929c204ae991a53ffcaf",87,73,55,11.0727272727273,87,0,2,3
"9896","4529612f1c621f907ccdaabe3da738c2",41,37,60,4.78333333333333,41,0,2,1
"9897","4529b853968851e894cc6df286fc54aa",25,25,0,25,25,0,1,2
"9898","4529bb3d589bd42fc54bef2817912c5e",56,50,26,15.0769230769231,56,0,2,1
"9899","452a483b4a06988995734855cddb1b58",64,50,38,11.7894736842105,64,0,2,3
"9900","452a4b4869dfb5158cbee23a161c1197",84,70,36,16.3333333333333,84,0,2,3
"9901","452b58a748699b97da13d248fb1e93ab",23,23,0,23,23,0,1,2
"9902","452faeb925881b1dd895345be0a4490a",161,121,62,18.1774193548387,161,0,3,3
"9903","4530ed5fcb2099fef91c935028b4a9d4",70,57,24,20.4166666666667,40,30,2,1
"9904","45313561e8168c18e0e3c7e3b0d878a0",62,47,56,7.75,62,0,2,1
"9905","45322f3cc32207b1b900bfe232d3a1f8",33,33,0,33,33,0,1,2
"9906","4534727dc53ba1683990a1472c60c728",109,80,19,40.1578947368421,109,0,3,3
"9907","45354a2f22d2664615b91b7b4d894be3",75,52,76,6.90789473684211,75,0,2,3
"9908","453b349ac117e87b77329d18892a2949",12,12,0,12,12,0,1,2
"9909","453b655302a6a80d7fca48d9fb8de44a",25,25,0,25,25,0,1,2
"9910","453c6eca240181efc43a28bdbf223993",19,19,0,19,19,0,1,2
"9911","45408b1afba9e248feca8654c3b9f52f",42,42,0,42,42,0,1,2
"9912","45421570844da12ded6c5d3b247e1b0a",144,73,79,12.7594936708861,128,16,3,3
"9913","45454ae67d0da0939b1e1547e34b1b41",37,30,26,9.96153846153846,13,24,2,1
"9914","454a0b2b56c4b67efebc6651dfcaa833",13,11,41,2.21951219512195,13,0,2,1
"9915","454b0b354bf1cef15649cbf3284c0bfb",86,56,30,20.0666666666667,86,0,2,3
"9916","454c788b7310aa6041c06591826b84d0",104,70,61,11.9344262295082,73,31,2,1
"9917","454c9d8224511bdb862e202bcdae6683",19,19,0,19,0,19,1,2
"9918","4550d11885967877d0efc87f27e0997f",35,28,41,5.97560975609756,35,0,2,1
"9919","4554a5c147aa2af749075cbad295cbb0",34,30,24,9.91666666666667,20,14,2,1
"9920","4554b3f2d96f0c770a1aedd7d182db82",3,3,0,3,3,0,1,2
"9921","455585d57d0110605f6bd836c37c0670",174,99,78,15.6153846153846,171,3,3,3
"9922","455724264b97690dcd55e7bc2a99b3cc",30,30,0,30,30,0,1,2
"9923","45588d219329a1c7aff47eac50013e34",20,18,7,20,20,0,1,2
"9924","4558b4df1542d0895cbd0ecb6018efaf",34,34,0,34,34,0,1,2
"9925","4559098cd6f0547da2cded7407c0243d",45,45,0,45,45,0,1,2
"9926","455ae5fdb9b7966fa698b482b3730246",18,18,0,18,18,0,1,2
"9927","455b157621b3e7ab97a8d865fa7cd9ce",213,96,71,21,213,0,3,3
"9928","455f4f163c40d5099548c29ab134826e",166,95,74,15.7027027027027,166,0,3,3
"9929","45621aefb1c8d2a562a292475f452e15",50,46,68,5.14705882352941,50,0,2,1
"9930","4562204abc80ca153cc46ad0fce425b1",13,13,0,13,13,0,1,2
"9931","45624e126fd682ea09d36b99b4f21daf",19,19,0,19,19,0,1,2
"9932","4564ebca2337e966b2a9ed19f3cbf697",5,5,0,5,5,0,1,2
"9933","4565bf7c18ac20bfc42bec7bece8bd65",23,23,0,23,0,23,1,2
"9934","4566ed2bd5ef4c06617345199f329da5",35,35,0,35,35,0,1,2
"9935","45677d695e40a20b54dd4285681815fc",68,37,71,6.70422535211268,68,0,2,1
"9936","4568ca9dd2d1f4c5928044bac5d3517c",128,67,57,15.719298245614,128,0,3,3
"9937","456ac9ecb033af009e5d36ad3bad7b93",16,16,0,16,16,0,1,2
"9938","456fc7b51270403947a18de7e98fee37",142,84,77,12.9090909090909,142,0,3,3
"9939","457120dc845b5e1b39b7382bf0b6b58c",69,50,48,10.0625,31,38,2,1
"9940","4573ac750a1fafb015df76ffb0234783",18,18,0,18,18,0,1,2
"9941","4573e9536d67af56d133bf6afa186ca9",106,85,23,32.2608695652174,60,46,3,3
"9942","45750a94019aa3b00f32b68454ee6cb4",84,60,63,9.33333333333333,84,0,2,3
"9943","4575e857778b0f13b349280e615c43b0",73,54,41,12.4634146341463,73,0,2,3
"9944","4576fbe83a3e97c998ebe20d763af752",49,46,69,4.97101449275362,49,0,2,1
"9945","4581381dc3d2e20527d9ba05e1f9c618",106,64,64,11.59375,106,0,3,3
"9946","45817a2499ba64a6c40ddbba52ea08d0",149,93,56,18.625,149,0,3,3
"9947","4584f537b63b5f66a5c4811f775db8d6",32,22,53,4.22641509433962,16,16,2,1
"9948","4584f5b852fd9530ea6400a35dff2f70",30,30,0,30,30,0,1,2
"9949","4589f5b68c39e0c701c46f029f506e67",47,47,0,47,47,0,1,2
"9950","458a6b2e66c3621a946460afd708b9bc",26,26,0,26,26,0,1,2
"9951","458af748745ba64cda31f3f98b4ec231",8,8,0,8,8,0,1,2
"9952","458d297a0a331eb5a9fc0d64466f3bec",18,18,0,18,18,0,1,2
"9953","458f3535c39ea78db870bae990205b17",53,53,0,53,53,0,1,2
"9954","458ff77e457c9f62cdb592349566f18c",37,28,70,3.7,37,0,2,1
"9955","45901420d745021a183b6fffbb551efc",69,56,68,7.10294117647059,69,0,2,3
"9956","4590d64a0e3386631894dd7663ffbc72",25,22,44,3.97727272727273,25,0,2,1
"9957","459226355963c18f10d599d0c57c78db",113,80,82,9.64634146341463,99,14,3,1
"9958","4592604669b712ba47da99b597e245e0",13,13,0,13,13,0,1,2
"9959","45946a7af3bfa641db0108e08229cf60",48,48,0,48,48,0,1,2
"9960","45948f12f48a7637ccd59247747a3054",58,44,29,14,22,36,2,1
"9961","4595ec8a6c1ffb951cc1adee1813f1ba",94,76,58,11.3448275862069,94,0,2,3
"9962","45961e42e6987c6046bfb02da55aad2c",4,4,0,4,4,0,1,2
"9963","4599ec0e9bcbb87396418a1eb336b800",81,57,67,8.46268656716418,81,0,2,3
"9964","459acca9e207b0fc70befb99228eab46",24,24,0,24,24,0,1,2
"9965","459d0afc7867592903b4a8da4104793e",228,122,74,21.5675675675676,184,44,3,3
"9966","459fe81626995a99211013bb52b40b3e",78,72,42,13,78,0,2,3
"9967","45a0b8178620c2bf2f49100523400d4d",17,12,77,1.54545454545455,17,0,2,1
"9968","45a2237db0a88a62b12311733c6c967b",49,49,0,49,49,0,1,2
"9969","45a2b7031bcce66b657db9315f5d2d1d",27,27,0,27,27,0,1,2
"9970","45a6906da1eec678d64b457c56f603ea",32,32,0,32,32,0,1,2
"9971","45a6d5546d439cf4e09d61551b1e8355",53,44,50,7.42,29,24,2,1
"9972","45a7303729891bbcb8104a7fb15aa393",31,31,0,31,31,0,1,2
"9973","45a7b2c5515326f88ebf90cf76f22039",75,54,50,10.5,75,0,2,3
"9974","45a7ca17d73553b2a3877b4347b0e2a8",45,45,0,45,45,0,1,2
"9975","45a90e7a5afc56384382ce841b0e93a7",123,82,55,15.6545454545455,123,0,3,3
"9976","45a953097e67c33afc28166e062d608f",19,8,59,2.25423728813559,12,7,2,1
"9977","45a98ea12af8bf7d1d7004b0808209f1",18,14,35,3.6,18,0,2,1
"9978","45aff750089aa17eb427ba491c64d4cf",91,70,39,16.3333333333333,52,39,2,3
"9979","45b323a4176bb80aac003acca0d0a996",33,33,0,33,33,0,1,2
"9980","45b4a12c11d074534811ebd602aac406",19,19,0,19,19,0,1,2
"9981","45b761d6fddb393032fb2de0c0dd7eda",45,45,0,45,45,0,1,2
"9982","45ba11e58ddaec43812a53afada64244",55,55,0,55,55,0,1,2
"9983","45bbed0b2e95a49197ef06ece70347cd",16,16,0,16,16,0,1,2
"9984","45bc664007045b0de4691dd65a5521e9",125,70,65,13.4615384615385,125,0,3,3
"9985","45bffb85bef8af207447055db4e4f6e1",4,4,0,4,4,0,1,2
"9986","45c01249bfe1da26e12b08215c9824cc",26,26,0,26,26,0,1,2
"9987","45c2d1034c2d48f47839585c6de71da0",101,84,42,16.8333333333333,101,0,3,3
"9988","45c5fa90ac31a3d2c6db433039f21060",95,53,53,12.5471698113208,67,28,2,1
"9989","45c9f9e5320f828d334bbe3fedb3dd35",163,99,89,12.8202247191011,137,26,3,3
"9990","45cbe68b1423874f74728a8ce7194376",22,22,0,22,0,22,1,2
"9991","45cd9ac4b4c8b0e4d5ac01546fbee1ee",161,105,66,17.0757575757576,124,37,3,3
"9992","45ce18f646ba1d0fd28e77ca951288eb",38,38,0,38,38,0,1,2
"9993","45d3795cf4bf2955c9a046d30f7c933f",18,18,0,18,18,0,1,2
"9994","45d406cec162c66d1027929bb5cd7e0a",60,54,49,8.57142857142857,60,0,2,3
"9995","45d44e4543c758a3157850ea9fe69b62",57,51,36,11.0833333333333,57,0,2,1
"9996","45d4c3ab16a8510216c51ac3df8d8083",77,60,29,18.5862068965517,59,18,2,1
"9997","45d4c5fb8c453c29282b657bab02d7d8",36,36,0,36,36,0,1,2
"9998","45d74b449045448b0e5f5c104e75e5f2",35,35,0,35,35,0,1,2
"9999","45dc9b8efac1764192696190d65a8cf3",30,24,53,3.9622641509434,13,17,2,1
"10000","45dced955e37af20236f46d253edf54a",154,77,90,11.9777777777778,154,0,3,3
"10001","45dceedf32248d4dafe16dce4b8396c3",42,42,0,42,42,0,1,2
"10002","45dd04bf83455bed2280e6ee2d894ad2",105,79,36,20.4166666666667,105,0,3,3
"10003","45dd57a6cf22159ea38d70b30e283e46",40,31,78,3.58974358974359,7,33,2,1
"10004","45dd5f0da817c1c2dcf2deecee9250dd",25,25,0,25,25,0,1,2
"10005","45dd6bdb74a5b936524012d8937404ca",40,40,0,40,0,40,1,2
"10006","45df1c16ec584bd6538745eceae203cc",54,35,48,7.875,28,26,2,1
"10007","45e0836b1dd61bc9d717908ee38986f7",19,19,0,19,19,0,1,2
"10008","45e0b06689daa2ec14714f716508071e",48,45,10,33.6,26,22,1,2
"10009","45e1cf2a4e39f656003a99a7f82b69e2",12,12,0,12,12,0,1,2
"10010","45e734e852c316879c709289fd082ae7",63,49,35,12.6,63,0,2,1
"10011","45ede3b906c56f7b0da2da5952d0be74",28,28,0,28,28,0,1,2
"10012","45eea1cad209657c69a10fcc153b4c50",180,104,65,19.3846153846154,180,0,3,3
"10013","45ef910bfec8b4d78c52bec6a79c768a",81,73,62,9.14516129032258,81,0,2,3
"10014","45f0a82e3adee13986f26550af4dd954",73,62,14,36.5,73,0,1,2
"10015","45f167949fdcec71f544fa53c4eed914",83,63,45,12.9111111111111,83,0,2,3
"10016","45f28861a5c85bd39ab71ab890d2334d",98,72,61,11.2459016393443,98,0,2,3
"10017","45f35a4be074ac5d6d534f47156dc91a",75,53,34,15.4411764705882,75,0,2,1
"10018","45f38fc5967be320d7670711def3ceb2",116,65,65,12.4923076923077,76,40,3,3
"10019","45f6a2b6aec64363045a792c71891979",32,32,0,32,32,0,1,2
"10020","45f755282107ae3cfd491aaf9409acdd",113,67,77,10.2727272727273,113,0,3,3
"10021","45f8dfe40c9a61737868eba066b49657",52,46,35,10.4,0,52,2,1
"10022","45fe324479b19f1449667dfe5c1b01ed",180,92,60,21,180,0,3,3
"10023","46009c416c432e34fcc69ff5d98fd886",49,49,0,49,49,0,1,2
"10024","4601130aed7dc2274d533f3b59f19381",36,36,0,36,0,36,1,2
"10025","460505b285cd19fe6fa79e489aab606a",18,18,0,18,18,0,1,2
"10026","4606c55e5e23e9be8a0e474bae32fbff",102,58,61,11.7049180327869,102,0,2,3
"10027","46091a5816f9baabc71d3ac8ad7be922",29,25,33,6.15151515151515,16,13,2,1
"10028","46094fed690404ccb44157008d0809a4",23,23,0,23,23,0,1,2
"10029","460bb991f7ee6e380711fd5519deb993",25,25,0,25,25,0,1,2
"10030","460bdb33bd3a8ce9b95aee3cc9c35f88",23,23,0,23,23,0,1,2
"10031","460d2cbfaa6f96481209ddc7922c13d8",57,43,77,5.18181818181818,57,0,2,1
"10032","460ed3ab78ccd02df6e150f01671958a",89,71,44,14.1590909090909,45,44,2,1
"10033","46120c5c7c8fa31656976791d33249fe",122,67,85,10.0470588235294,98,24,3,1
"10034","461275dea409c1fd7c37d753ffa009d6",21,6,70,2.1,18,3,2,1
"10035","461356843d2dcfbd822ef9fd1f2577f2",145,82,58,17.5,145,0,3,3
"10036","461adcde0de72c59afaf68521abc4585",210,109,75,19.6,210,0,3,3
"10037","461b7a486653669e8c331f516cb20fdb",140,73,67,14.6268656716418,127,13,3,3
"10038","461d2b791cbfc4d521e23e047bc3a5a0",75,61,19,27.6315789473684,75,0,1,2
"10039","461d4eb253baea02638e422aac049562",32,32,0,32,32,0,1,2
"10040","461d724fced80d1bca9053005fe5972d",4,3,43,0.651162790697674,4,0,2,1
"10041","461dc77e61a6fdf412a28d9cdccdb546",20,20,0,20,20,0,1,2
"10042","461f5ab32f2bc33c97daf75fdaf6b564",135,78,52,18.1730769230769,135,0,3,3
"10043","462122c58dbbc975ff97df2b473270d5",27,27,0,27,27,0,1,2
"10044","462283f6379c61feec8b5a2af2839b3a",71,64,38,13.0789473684211,71,0,2,3
"10045","462439eda486f5eb2b0eaef01eeaf194",124,93,29,29.9310344827586,124,0,3,3
"10046","46264d56f0ab3afc7e5efc5a7be8ce7f",16,14,36,3.11111111111111,11,5,2,1
"10047","462acfddef22a2a9400cf48173632078",131,84,63,14.5555555555556,131,0,3,3
"10048","462b88d72c8618d6cb039502cc8e9e20",53,41,19,19.5263157894737,53,0,1,1
"10049","462bedefdb07373d48035a64c2b89f1b",6,6,0,6,6,0,1,2
"10050","462cd638705affc4591caa383897c026",26,26,0,26,26,0,1,2
"10051","462cdd52cc0f42f68236076fc413bf38",66,38,64,7.21875,66,0,2,1
"10052","462d126fca52fe93429dbe1adcdd3332",7,7,0,7,7,0,1,2
"10053","462ee06a657778e7ec9de8dab1b6b600",47,47,0,47,47,0,1,2
"10054","46300a6df4c979644b8f6badf03e94a8",58,52,29,14,58,0,2,1
"10055","4630c9cf8a0d03874773ae08a5983037",31,31,0,31,31,0,1,2
"10056","4631bd906ed3e6efb7d04a8dcde7e9e6",39,39,0,39,39,0,1,2
"10057","463315b7ac4d8f3c9e60547ea0e45678",83,63,67,8.67164179104478,83,0,2,3
"10058","4635e8869ab0943fce6b2e184cce9d03",111,89,66,11.7727272727273,111,0,3,3
"10059","4636498a7c07c0389bb072a8df46a421",111,83,82,9.47560975609756,111,0,3,3
"10060","46395158d5280b6f78e0333fff84fe25",49,49,0,49,49,0,1,2
"10061","463a5b57e3b7fad327d17c46dc693053",42,26,57,5.15789473684211,42,0,2,1
"10062","463cd4fa4c0f96a2a1db96e59130a2b4",77,65,78,6.91025641025641,70,7,2,3
"10063","463e7a43a0fa0fbac005423bbc2e466c",74,59,74,7,42,32,2,1
"10064","4642e814a2af5adb9de76d1bd1b3726b",129,38,72,12.5416666666667,129,0,3,3
"10065","464381f8ff161e1cd74a5b65246addbb",43,38,29,10.3793103448276,43,0,2,1
"10066","464511f9019c8846ace24ae5b69fcb2d",53,38,32,11.59375,53,0,2,1
"10067","4647e930bb743cd308508a4f561f4dd8",10,10,0,10,0,10,1,2
"10068","4647ebed95cb478d0e10c701cda25854",14,11,15,6.53333333333333,14,0,1,1
"10069","464af38891eb271209fb1d47ae25a83a",165,91,71,16.2676056338028,135,30,3,3
"10070","464b63ef01f26f4b125abfb76071b9b2",39,14,83,3.28915662650602,39,0,2,1
"10071","464b953d10599764a6387afc0e3ea8b3",9,7,49,1.28571428571429,9,0,2,1
"10072","464ce3b5ad146a4128cee1c353143e56",24,24,0,24,0,24,1,2
"10073","4650d2325b678e8b48b4398708bd91ae",93,66,41,15.8780487804878,93,0,2,3
"10074","46527de36ff6c255667163cb6e928576",32,27,47,4.76595744680851,32,0,2,1
"10075","4656246df7aec3b1e5240e4b4a84eb64",24,24,0,24,24,0,1,2
"10076","46571ae1267f0f2df5f2149683249dad",22,22,0,22,22,0,1,2
"10077","465e066c640dd2fdbc2cad088a3f5fa0",96,53,57,11.7894736842105,45,51,2,1
"10078","465e5cb6c6861a88e5e5b079b31649e6",48,48,0,48,48,0,1,2
"10079","465f5345b4b4dbf84d7871e076674cb0",15,15,0,15,15,0,1,2
"10080","465f66d1be51df34dda4ee70b98651f9",167,103,35,33.4,167,0,3,3
"10081","465f97e438bf260dd62f87acac110e9e",160,98,85,13.1764705882353,134,26,3,3
"10082","46604c35c0082f1d0d4d7f41b6cacb1f",11,11,0,11,11,0,1,2
"10083","46624a4443b8ce3e8ab37c3b3ecd37c8",32,32,0,32,32,0,1,2
"10084","46655122b243a8b5e56bce80aeeaf10e",187,107,85,15.4,187,0,3,3
"10085","4666a108a6d7181bad0a356c7480b68e",25,25,0,25,0,25,1,2
"10086","4668e57eff3c42b082740bfb1c8b600b",25,25,18,9.72222222222222,25,0,1,1
"10087","466a1a1681a7893b9137af49026c2d36",157,102,67,16.4029850746269,128,29,3,3
"10088","466bacfa7f9967575d5769437d73dabe",102,66,49,14.5714285714286,102,0,2,3
"10089","466d99819ce786c30d1bbfd1095860b2",139,71,50,19.46,115,24,3,1
"10090","466f0d8a3ec00d27c7ecd49937dd08e1",31,31,0,31,31,0,1,2
"10091","466fa25f967464d428e84fe3f5fca382",34,27,30,7.93333333333333,17,17,2,1
"10092","4673d6eb976cd6d3da5ebccc9f24e1f8",146,94,25,40.88,146,0,3,3
"10093","467701b4f4378e38abb634be17a94f98",43,22,49,6.14285714285714,43,0,2,1
"10094","467836a969c96186ad6cffbe07c3b375",9,5,26,2.42307692307692,9,0,2,1
"10095","467ced2716705ad9f1dcd6e833f1560f",36,31,21,12,36,0,1,1
"10096","467d6119e609f1c948798625b173494d",2,2,0,2,2,0,1,2
"10097","467ef9a0b76d4d96001042830cefab74",22,22,0,22,22,0,1,2
"10098","46823b22847d2215b6d346e8a7b93bce",2,2,0,2,2,0,1,2
"10099","468283b3b277127cc3bf67ccce4e1161",15,14,7,15,15,0,1,2
"10100","468286ca3f3963e7e97acc46360034ef",186,79,84,15.5,186,0,3,3
"10101","46831543acaee0d7f97ad938ce6443b2",4,4,0,4,4,0,1,2
"10102","468324fa05f8e71d2e7d281285dbf0f2",30,30,0,30,0,30,1,2
"10103","46867d6386c11d0fa2809976f8c1abca",29,29,0,29,29,0,1,2
"10104","46878321b8e8989d32742fae7cf5ced7",46,39,65,4.95384615384615,46,0,2,1
"10105","4689ea44aded67d1093f3137f9e13d7f",143,83,70,14.3,103,40,3,3
"10106","468b6a1095d86898d648200bc61f9a67",189,89,68,19.4558823529412,189,0,3,3
"10107","468be62ce04784be86d713baeb81723b",35,35,0,35,0,35,1,2
"10108","468df0dd348703cb5bf32199d43b217a",15,15,0,15,15,0,1,2
"10109","468e25d3923c99d536b318a97235fe29",203,94,76,18.6973684210526,203,0,3,3
"10110","468e6f3a3b549d08ba5fe8257fc21794",46,41,25,12.88,46,0,2,1
"10111","469294727b67a0c1a38a267590f795f7",22,22,0,22,22,0,1,2
"10112","4693e9704811ddd680e30dbcfffbc638",140,95,62,15.8064516129032,99,41,3,3
"10113","46979fa4ceaaeb3c932a3520bec29fec",18,18,4,31.5,14,4,1,2
"10114","46999549d498b137fda4fc4b4b532d19",17,17,0,17,17,0,1,2
"10115","469a947eaf358f97c45061a80c6dbd8e",61,49,62,6.88709677419355,37,24,2,1
"10116","46a3c6c1611e3711602bd85327c109b5",84,67,51,11.5294117647059,54,30,2,1
"10117","46ab30c5d182ccd07e396a345ebe52da",35,26,36,6.80555555555556,35,0,2,1
"10118","46ac03a18be7d26e1a8a791bcf6c783d",130,106,49,18.5714285714286,130,0,3,3
"10119","46ac0ecd203ada56de17928f8384cec9",70,52,19,25.7894736842105,43,27,1,1
"10120","46acad10322c13df2c3b4ad7be100c6e",26,26,0,26,26,0,1,2
"10121","46b02f881ca68d3ea5294c0ce30fd62b",13,13,0,13,13,0,1,2
"10122","46b09184f4dd8a0afdb1f3d2f98a5310",112,70,56,14,112,0,3,3
"10123","46b33fe8eeb4058b67c39aa82f57059e",1,1,0,1,1,0,1,2
"10124","46b4de0665c57e2a3e11afefa7c48946",53,49,49,7.57142857142857,53,0,2,1
"10125","46b8d9395721888b27e496da7f09e76f",35,27,62,3.95161290322581,35,0,2,1
"10126","46ba36518dff39aea6ac6a4421a970cc",1,1,0,1,1,0,1,2
"10127","46bb465dc2da98df4feb63f0dce7038d",66,52,18,25.6666666666667,29,37,1,1
"10128","46bc6ca0d0183f24f2b078ee68000b64",20,20,0,20,0,20,1,2
"10129","46c0ded3a93549723807fa74a37e2b80",60,29,77,5.45454545454545,60,0,2,1
"10130","46c43ca0d9ad6ba03fd8eaa5c38a4318",87,65,49,12.4285714285714,78,9,2,1
"10131","46c766f026a0e111f100fe90c0dcddb6",32,32,0,32,32,0,1,2
"10132","46c7e9198926129f4b0174d528627e2e",202,91,57,24.8070175438597,157,45,3,3
"10133","46c9bc40306ec0c891e7568e26c4da88",58,48,37,10.972972972973,58,0,2,1
"10134","46c9f19a5a795d0df3a7defce4e25a9d",21,21,0,21,21,0,1,2
"10135","46ca79f1c13bcc608f0ca22447890dc3",28,28,0,28,28,0,1,2
"10136","46cc2fc15a3311b84cb1e6aca44f2918",33,33,0,33,33,0,1,2
"10137","46cdfbc705810278864ffa8f31679d1b",62,49,35,12.4,62,0,2,1
"10138","46d434858a1325c07a0503b50d0e6b78",75,69,26,20.1923076923077,44,31,2,3
"10139","46d45679c44bdbabc87e0a2d61b2557c",55,43,81,4.75308641975309,55,0,2,1
"10140","46d50283ab3617fbdb89184a1431f1d9",121,58,58,14.6034482758621,96,25,3,1
"10141","46d71677785f7eea02bb65ef7d7641a8",28,23,42,4.66666666666667,28,0,2,1
"10142","46d933e6293bc6c57539853abdcc9b68",28,28,0,28,28,0,1,2
"10143","46dc665b0666c4d7b979ec4a1955ab9a",40,40,0,40,40,0,1,2
"10144","46dd3a6b9e7467845da53024b57dbb8c",100,61,45,15.5555555555556,100,0,2,3
"10145","46de7af5cd7f453d8f53750fda5f8ba8",79,48,69,8.01449275362319,79,0,2,3
"10146","46df196dc70897c3f95e66505536d5c7",91,58,85,7.49411764705882,71,20,2,1
"10147","46df59e1225643b124199c136669209c",140,99,63,15.5555555555556,140,0,3,3
"10148","46dfc3f10a6ca3fd3df43a97a5b96090",173,102,68,17.8088235294118,173,0,3,3
"10149","46e4a62fd63fa9a48a79f858c150e335",170,83,64,18.59375,170,0,3,3
"10150","46e71f748d26cbf811918582cd9470e8",140,118,49,20,140,0,3,3
"10151","46ec2e0812d18fadd9057ba4d9ef28da",20,20,0,20,20,0,1,2
"10152","46ee598c410f4c8440732961376d8951",197,115,78,17.6794871794872,197,0,3,3
"10153","46ef812b4f21e85a21aba5beade5afac",16,16,0,16,16,0,1,2
"10154","46f2c2f45f99d557d4b81220b837b142",100,55,29,24.1379310344828,100,0,2,3
"10155","46f49ba8d13930ccc6bb004fd2e88473",11,11,0,11,11,0,1,2
"10156","46f4a34d1c6a87f1b0e81651b236edbd",128,96,77,11.6363636363636,128,0,3,3
"10157","46f655b92150d4d396fdbab9f5b6ab7c",13,13,0,13,13,0,1,2
"10158","46f76ca00720f0e7dff2dd33a031425e",36,28,32,7.875,36,0,2,1
"10159","46f7f455b05179fa35d227a2ebb61192",10,10,0,10,10,0,1,2
"10160","46f9164ae0064656d068141d0a00320d",18,18,0,18,18,0,1,2
"10161","46f9c64df359a70ce96175a48c0ff0e2",57,44,27,14.7777777777778,57,0,2,1
"10162","46fa27356c1fa39a64a138bfeaa831e1",66,55,68,6.79411764705882,30,36,2,1
"10163","46fa9c2ae0b9100ec979151d3ca84339",29,29,0,29,29,0,1,2
"10164","4703d0b2c7192c4800ba73fcd022dca9",28,17,50,3.92,28,0,2,1
"10165","4704c2a724ff9fbfbe970dc09200637f",20,20,0,20,0,20,1,2
"10166","470aa82e3b60809950c6edb3a9f22529",87,60,39,15.6153846153846,87,0,2,3
"10167","470c65e3241894b3689c758f7a3f34ed",38,38,0,38,38,0,1,2
"10168","470e86131e1e2cf8c1aacaad28d6ee02",32,32,0,32,32,0,1,2
"10169","470f2096267dd06f989ac37a617fac07",37,37,0,37,37,0,1,2
"10170","47169da22a8c9a1a88e6e4be10704559",160,84,69,16.231884057971,160,0,3,3
"10171","4718a48047eed5c36287e55bce1b7698",8,8,7,8,8,0,1,2
"10172","471c944325bd9331ebdb0627886f6797",17,17,0,17,17,0,1,2
"10173","471f4e5927cffba30ca50acfd30826e3",22,22,0,22,22,0,1,2
"10174","47202f0042e31e1783a31b15b11bbc92",29,29,0,29,29,0,1,2
"10175","47224476e0116305d8470c50cb209e05",59,52,82,5.03658536585366,59,0,2,3
"10176","4727b9d4fd9f131145613888c4fd7152",28,26,4,49,28,0,1,2
"10177","4727ffa1d1257f8c404977c848e0b4f8",26,26,0,26,26,0,1,2
"10178","4728a3963d8e634154a55a3ce1a3653c",238,92,88,18.9318181818182,201,37,3,3
"10179","472a568bb648878e77f95da40d965cd8",91,63,35,18.2,91,0,2,3
"10180","472f049ea9975d2c2d594848ca7dc19f",84,73,36,16.3333333333333,84,0,2,3
"10181","472f10e18e33f026d009de3f87c1d9c0",112,73,55,14.2545454545455,112,0,3,3
"10182","4730943f2f4fb7523bf732ed322d63f8",122,67,69,12.3768115942029,122,0,3,3
"10183","47312a82acfad2768f11f03e1d721ea2",87,75,48,12.6875,45,42,2,3
"10184","47325dde6fc6bbd2e30ed7bfb50aa512",38,38,0,38,38,0,1,2
"10185","4735b2dfd07cd2560395c97f568c9668",60,53,43,9.76744186046512,60,0,2,3
"10186","4739ce6f5fb88c16b839793863a77fa2",117,58,49,16.7142857142857,67,50,2,3
"10187","473ae746ce43aaf66b167fa06ab0fed3",33,33,0,33,33,0,1,2
"10188","473b97f900ec1efe38f19df34f8f8f81",45,45,0,45,45,0,1,2
"10189","473c3bb634579bc426aaec7fa7a8ba49",46,46,0,46,46,0,1,2
"10190","4740d9095667d91ca7ab280e4497ee8c",18,14,50,2.52,18,0,2,1
"10191","4740fa15cb93bf3678f699c08805b86a",168,116,62,18.9677419354839,134,34,3,3
"10192","4745a7826d79b73be887fd752c9593b0",89,74,12,51.9166666666667,49,40,1,2
"10193","474959a39d5d3012e8f064e8d50fc412",33,31,33,7,33,0,2,1
"10194","474a145a62eb25a09f2869d5f21856c9",42,42,0,42,42,0,1,2
"10195","474b03d774586968c146218233102c40",39,33,42,6.5,0,39,2,1
"10196","474b2800d73b957a3784f24890eeefbb",66,47,60,7.7,59,7,2,1
"10197","47519a5aa378eb982f78f6b5bbcb4edc",67,56,33,14.2121212121212,67,0,2,1
"10198","4753c2c38875b7ee073c10e931b2175e",219,123,63,24.3333333333333,219,0,3,3
"10199","4753f5ad2531526ea96104fb8b165cff",50,50,0,50,50,0,1,2
"10200","475479c7fa699b9dfd4f377ae1dc0c3b",30,30,0,30,30,0,1,2
"10201","4759a62ee48e0f31a455ea9d84271c7a",16,16,0,16,16,0,1,2
"10202","4759cbb62f54ec9b2edae761078c380d",89,65,65,9.58461538461538,89,0,2,3
"10203","475f4ce2f791f024a3c9cb245b12268d",67,60,61,7.68852459016393,53,14,2,1
"10204","4766b0ec2779030c9c40cdf85fd057ba",95,61,65,10.2307692307692,61,34,2,3
"10205","4768fa6d658ac6ca9fa7c3fee7a7a59b",91,48,21,30.3333333333333,91,0,1,2
"10206","476b69d7e9f2c5bec05a7b5f58568591",19,19,0,19,19,0,1,2
"10207","476d4c8e32527b414a84b3bec1d93a31",83,58,28,20.75,58,25,2,1
"10208","47702a41de3aaa7bc743121dc49e6eb3",30,30,0,30,30,0,1,2
"10209","47706b061da4beaa94f2de4d4929fd4d",90,63,54,11.6666666666667,63,27,2,1
"10210","4771fdb38edd7dc73175fccca8d87a30",59,50,27,15.2962962962963,59,0,2,1
"10211","47778fbe1c3d54294f584d816b1416fc",1,1,0,1,1,0,1,2
"10212","477948f9ad79dc2e4f1af11dc82f9e91",43,43,0,43,0,43,1,2
"10213","477ec985da2303a229a5665dc8b65bbf",34,34,0,34,34,0,1,2
"10214","477ef8626192404c525faa474b08261b",33,24,39,5.92307692307692,33,0,2,1
"10215","4780d9090208470b441fad198a60149e",176,95,56,22,176,0,3,3
"10216","4780d922b5f9bf2e079f41a640edc148",23,23,0,23,0,23,1,2
"10217","4781605930501837a461ef6390f8a7a9",21,21,0,21,21,0,1,2
"10218","4782500b529bd3b63f008b1842bb39a9",83,67,65,8.93846153846154,83,0,2,3
"10219","4783234c234225e489f61eccbf1e96f3",31,24,77,2.81818181818182,31,0,2,1
"10220","478d7494e3d026a3aaeeb8c039590388",64,56,60,7.46666666666667,39,25,2,1
"10221","478f4681c739d04cf7285acda458f796",90,57,53,11.8867924528302,90,0,2,3
"10222","478fdf94f071f85ec0e9175c13ac8dd1",22,22,0,22,0,22,1,2
"10223","479120591ef8ceb5af68746be685a926",41,34,60,4.78333333333333,41,0,2,1
"10224","4792417d05516a82dc43c2cbf40ee0de",36,36,0,36,36,0,1,2
"10225","479279f3f547aeac406e1e98b570056e",30,30,0,30,0,30,1,2
"10226","47956a37dbbf90accf54093fb6641606",129,78,57,15.8421052631579,108,21,3,1
"10227","47965f7ccb60ff1c7ea4efae74139fd8",74,70,38,13.6315789473684,74,0,2,3
"10228","479d84cacb5943442ff94c05ce4c4914",13,12,6,15.1666666666667,1,12,1,2
"10229","479faf71e50d9e5dbdade458cf18a34d",42,42,0,42,42,0,1,2
"10230","47a0190103624b01ff0bed85a254f52a",29,29,0,29,29,0,1,2
"10231","47a2c088c2c5620075a08b74af192884",19,19,0,19,19,0,1,2
"10232","47a9452be48fa43ce28a0603567faebb",24,24,0,24,24,0,1,2
"10233","47a9f933f3738791f5f8e4c6c92f16a6",75,63,34,15.4411764705882,75,0,2,3
"10234","47ab0faa55dd2850c8c77e51a51d1f6b",25,25,0,25,25,0,1,2
"10235","47ac23d37fa56203c0a8e88d80d92c3e",31,31,21,10.3333333333333,31,0,2,1
"10236","47ad7e13cc5ea15fbc0422066f1ec45d",98,88,66,10.3939393939394,98,0,3,3
"10237","47b0317f94f78882eeb5a14d1c2ba2e4",116,50,77,10.5454545454545,92,24,2,1
"10238","47bb6f750b5f7667fa7c62017abdb3e4",192,119,84,16,192,0,3,3
"10239","47c6e55c23434e6d588b71883d2a90dd",19,19,0,19,19,0,1,2
"10240","47c99ac30d94d93c0017b1d806e68194",25,25,0,25,25,0,1,2
"10241","47ca7b60fbd438f42c1040e55b3f0b9d",61,52,43,9.93023255813953,61,0,2,3
"10242","47ce7b13437d6c6c8a0f3772ad58af95",93,79,15,43.4,93,0,1,2
"10243","47d0d76c3539e5b74f31ec165eb32b8b",30,30,0,30,0,30,1,2
"10244","47d0e77dbda9fcd45da57a461be6f6b7",11,11,0,11,11,0,1,2
"10245","47d3bea8e765cbcaee2393e57b9d9e81",26,21,49,3.71428571428571,26,0,2,1
"10246","47d4cf75da69ec6b2d51975b0d05c40d",37,34,41,6.31707317073171,19,18,2,1
"10247","47d6bf0915c42e086d85019525da736c",138,109,61,15.8360655737705,138,0,3,3
"10248","47dd5e3e2e4d75142f27ff880fd7c601",10,10,0,10,10,0,1,2
"10249","47e1bd5c7ac57b44d4ab4ed0c4f934fd",29,29,0,29,29,0,1,2
"10250","47e2b3f9c59c680c90a1fc4352da8268",21,21,0,21,21,0,1,2
"10251","47e49f2d47d1c4ffaf62fd86f0e1378b",45,43,39,8.07692307692308,45,0,2,1
"10252","47e4a0f1051d73a22034ee6fbba0fd04",99,82,54,12.8333333333333,99,0,3,3
"10253","47e4ab3f01bf5338c2e1292d4c847746",63,51,41,10.7560975609756,36,27,2,1
"10254","47e6e3b5c82c4380a85b69f224f26574",46,40,37,8.7027027027027,46,0,2,1
"10255","47e7021b8990877234ffcc11e59341cd",85,54,21,28.3333333333333,85,0,1,2
"10256","47e83ee6c4cbe650db6e8f2232614621",114,57,70,11.4,89,25,2,1
"10257","47ee16595daa23f759275691ce7b88f1",2,1,2,7,2,0,1,2
"10258","47f230dc61142058a83249ab667a2626",23,13,75,2.14666666666667,23,0,2,1
"10259","47f3e242e6d04eb24234bd3f88f9a9d8",10,10,0,10,10,0,1,2
"10260","47f499055a4b6977f38d1dc0911e247a",88,80,21,29.3333333333333,88,0,3,3
"10261","47f921315b9a57f63c27f9c6d66caaef",101,61,63,11.2222222222222,83,18,2,1
"10262","47fb2209a8250b0105b0d994b4f363ab",140,91,86,11.3953488372093,115,25,3,3
"10263","47fca5686ac5b8cb75cdeff2dba9f8fc",40,34,50,5.6,40,0,2,1
"10264","47fd8e72a740d0f602681734929b4ff7",31,31,0,31,31,0,1,2
"10265","47fe4894bab840391a1fca9c143dfda6",11,11,0,11,0,11,1,2
"10266","47fe557ddaa3f2aa99b11bd7de7a7cf0",87,60,56,10.875,87,0,2,3
"10267","47ff518a10e91fb1db4094b76c2c34ce",38,20,48,5.54166666666667,38,0,2,1
"10268","4803993fd432c5e47db2bb355a3956ec",36,33,24,10.5,36,0,2,1
"10269","4807fcfb666828ae717cba3c2d2660a1",101,71,46,15.3695652173913,73,28,2,1
"10270","480a276fa7927edd1a5065fa0b882251",149,76,32,32.59375,110,39,3,3
"10271","480a35779de1be2e5fd371a9fe9a87a5",195,85,84,16.25,142,53,3,3
"10272","480b39f4927a1e66fe2d7eb307c37538",129,87,72,12.5416666666667,129,0,3,3
"10273","480cdca91be12d861d298bd94782306b",148,107,69,15.0144927536232,148,0,3,3
"10274","4810d30a8b7d333c1624c6dc85561509",23,23,0,23,23,0,1,2
"10275","4811871a97c79a83c490d8879d5006ae",51,44,12,29.75,21,30,1,1
"10276","48120108f18a374922d7af1a32e01cde",32,32,0,32,32,0,1,2
"10277","48120e9107b375b3184f6f66f4040284",191,85,77,17.3636363636364,139,52,3,3
"10278","4812cb752d4961595850280a1984e1e3",182,125,78,16.3333333333333,182,0,3,3
"10279","4812f246b0b2ce8ea2b286417a2b6369",49,49,0,49,49,0,1,2
"10280","481663a859d79088524300be9d95205e",43,43,0,43,43,0,1,2
"10281","481736c61b14a9f1044b64f19755988c",26,26,0,26,0,26,1,2
"10282","481861c808dcd633202226ae238f1188",10,10,0,10,0,10,1,2
"10283","481b434ef68f644639a87c3feacb4f38",21,21,0,21,21,0,1,2
"10284","481e39024843f693dc3577fb77471076",41,26,11,26.0909090909091,41,0,1,2
"10285","4820d72fbed6341e20c0dfd9efd05223",180,154,31,40.6451612903226,180,0,3,3
"10286","482308083310961627aac57b20f9e33d",95,84,39,17.0512820512821,52,43,2,3
"10287","482625b3c7a41d985820209c257d488a",47,47,0,47,47,0,1,2
"10288","48272baa9652ce2371dc291902711479",92,67,83,7.75903614457831,92,0,2,3
"10289","48283f5545857aa038d4e5a1bae3d37f",129,94,30,30.1,129,0,3,3
"10290","48285e076bc2fa932d6feb6f10210bfb",141,91,76,12.9868421052632,141,0,3,3
"10291","482d64284f4a026ec5337c7d62861f20",49,35,35,9.8,49,0,2,1
"10292","482e97604d0b171342ae074c9508545e",122,75,82,10.4146341463415,122,0,3,3
"10293","48303250fb839e4b451093f8bab216fc",53,46,66,5.62121212121212,53,0,2,1
"10294","4831b4e1841be6f0cacc4b49ed2c8717",1,1,0,1,0,1,1,2
"10295","48326017d96343d268da74424ec5d973",29,29,0,29,0,29,1,2
"10296","483306b06d73be73fdec5fa68a51fb03",28,18,64,3.0625,28,0,2,1
"10297","4838d959d5d56ef0a9883cf3eee352fa",23,23,0,23,23,0,1,2
"10298","4838e2acecdc052b35f63dcebf497150",73,65,59,8.66101694915254,73,0,2,3
"10299","4839fe7c7b7129456051163a0b535277",37,32,26,9.96153846153846,23,14,2,1
"10300","483bb34fa22b5a5fde2954ccaf36f2f5",201,93,71,19.8169014084507,201,0,3,3
"10301","483cfee324d6b056bae79f13f07b89e7",25,20,28,6.25,25,0,2,1
"10302","483d7bfd990ba11b433a7f77cbae7e4a",82,74,50,11.48,82,0,2,3
"10303","4840109dc1f6bd4f6034915b168abff2",46,32,6,53.6666666666667,46,0,1,2
"10304","48424958b56f888f4eb32c3ec3f4db60",9,9,0,9,9,0,1,2
"10305","4845740dd2d4d6f6a331ec65cb8a5e42",2,2,0,2,2,0,1,2
"10306","48464df4757535d5a5f350c8a4f2515d",22,22,0,22,22,0,1,2
"10307","4846c99c12efe388316583fc0470958d",48,26,65,5.16923076923077,48,0,2,1
"10308","484c1d64500d186ae39067e0dd426c58",38,38,0,38,38,0,1,2
"10309","484c3ed3f124374e834213a1f939e2c7",3,3,0,3,3,0,1,2
"10310","484e1711d72fc6c1de00e8dd1cdcc2ff",31,28,32,6.78125,31,0,2,1
"10311","4851103cb8286d8dc144859e13a97e04",33,24,42,5.5,33,0,2,1
"10312","4851a4da05a6c0da440e48efdc9d391d",10,10,0,10,10,0,1,2
"10313","4854c57bcbf41670610be405ff08e946",24,24,0,24,24,0,1,2
"10314","4855776d2cd3379295282ce637ef1788",100,61,57,12.280701754386,100,0,2,3
"10315","4856d82d4a9ac1c18d218f273359014a",7,7,0,7,7,0,1,2
"10316","4859864d705579fec21b8fdf8ed0b9c4",89,51,66,9.43939393939394,89,0,2,3
"10317","485aad362def2f5776eef7330f5f15e4",20,2,47,2.97872340425532,15,5,2,1
"10318","485da13a025333a736998f8c26ded6f0",18,18,0,18,18,0,1,2
"10319","485e1c6afd8adb8d07faea705cab244e",20,20,0,20,20,0,1,2
"10320","485e30637dd013770d7de5b60651f090",1,1,0,1,1,0,1,2
"10321","486420ff6cd7a69099f1f8b630521b21",11,11,0,11,11,0,1,2
"10322","486528e8f2f671f1041255f9a95c0805",68,45,32,14.875,67,1,2,1
"10323","48655e1631ccfa4b3b7f4e2f62b59156",37,37,0,37,37,0,1,2
"10324","4865b72bfd9fe4fab819517e8621010c",100,87,58,12.0689655172414,58,42,3,3
"10325","4867575f9e3ca90e93caec8709696cfc",54,35,40,9.45,33,21,2,1
"10326","486918db0d4afec02d7846c41ec93be7",81,70,38,14.9210526315789,47,34,2,3
"10327","486b0b431562a6b1f8b5286cd02b8a55",35,35,0,35,35,0,1,2
"10328","486c34c11817bb06ef09ef439063e496",67,50,48,9.77083333333333,67,0,2,3
"10329","486e6eda717d9368e2254154ef2b0b46",18,18,0,18,0,18,1,2
"10330","4871112d49aa5613bae53c688820e302",22,22,0,22,22,0,1,2
"10331","4873e0fa3e2663f796ca08dbd5268f06",36,34,83,3.03614457831325,36,0,2,1
"10332","48765983390a3e50740679f016eb8c62",52,35,28,13,31,21,2,1
"10333","4878e49102e1a02f61433059907381f9",19,19,79,1.68354430379747,19,0,2,1
"10334","48796451d7c67d112c5efa4ab487196c",4,4,0,4,4,0,1,2
"10335","4879bbd13c556137b57b9d3250f8ed71",89,70,60,10.3833333333333,89,0,2,3
"10336","487c1c9c3bf25e9795053cd5a46ce936",12,12,0,12,12,0,1,2
"10337","487cca323e55b58e5dcb5c27c8ed8426",40,40,0,40,40,0,1,2
"10338","48819fc148aacaae1f34d913515b1869",22,22,0,22,22,0,1,2
"10339","4881b4af9ab6be385c9dbf3f672f6b77",26,26,0,26,26,0,1,2
"10340","488425950830b5d4e803d5860abba764",70,52,85,5.76470588235294,44,26,2,1
"10341","4887a3948370ee3505a42f4e66b8a87d",26,26,0,26,26,0,1,2
"10342","488b293ab7f29c648f68ee9b59fc90f0",29,12,66,3.07575757575758,29,0,2,1
"10343","488d3e3e8981f80b1a5f86069ddd3dd2",22,22,0,22,22,0,1,2
"10344","488e154528e6476c1a928f5ae9428f17",4,4,0,4,4,0,1,2
"10345","488e9ef21173468b3dec05e49b4eadd4",31,30,7,31,31,0,1,2
"10346","488f4a9c9a24ce39bb26fc1c1a11fe21",46,46,0,46,46,0,1,2
"10347","4892213ee91bd2aacd16f76f64126ad9",150,92,61,17.2131147540984,150,0,3,3
"10348","48925d6e1bb4d1ad5bd10f45e56c91e4",175,109,84,14.5833333333333,160,15,3,3
"10349","48948c40e31c744e2831ac37221fd5cd",30,30,0,30,30,0,1,2
"10350","48965349bcd0e9a841833cb98674f89c",24,24,0,24,24,0,1,2
"10351","4896ddfcea8482cceeb1b8db123ca7bd",13,13,0,13,0,13,1,2
"10352","48992c8d18bb942d87e42ed53887b1a8",17,7,67,1.77611940298507,17,0,2,1
"10353","4899de260a364200af3a35412d94a782",10,10,0,10,10,0,1,2
"10354","489ae374e3494ff347ffc4782b659466",122,86,41,20.8292682926829,90,32,3,3
"10355","48a0f24403c739d074df830ecc22575c",136,91,71,13.4084507042254,98,38,3,3
"10356","48a1e2a383cc29e39e0b0035880b3d86",35,35,0,35,35,0,1,2
"10357","48a1eee3ed8e1d9236a0e04301d83e10",34,34,0,34,34,0,1,2
"10358","48b2c5a1bdf55cd685879107029bb012",23,23,0,23,23,0,1,2
"10359","48b3a5b667e263254aa724b9b3b4b0b8",26,26,0,26,26,0,1,2
"10360","48b3a7c23648d822597a7c2126af50e4",102,83,37,19.2972972972973,102,0,3,3
"10361","48b3d41ec499a93a914913fec47198de",169,94,64,18.484375,169,0,3,3
"10362","48b42d4ddb3a41c2d330610e7ba07187",13,13,0,13,13,0,1,2
"10363","48b4b9eddbe327aad39efb4b78a1a830",31,31,0,31,31,0,1,2
"10364","48b4f0bb4eefd7473fef366de7a12163",27,27,0,27,27,0,1,2
"10365","48b62c6c90485b567e73ce0b0de563fb",160,100,54,20.7407407407407,106,54,3,3
"10366","48b6b11beece3fbbf38e915d0cb5fcce",123,56,64,13.453125,101,22,3,1
"10367","48b7023b913a36b51aba7110d262d785",46,46,0,46,46,0,1,2
"10368","48bb101274572bd2d2601bf5e88234c7",96,65,54,12.4444444444444,63,33,2,1
"10369","48bce330a80b39c5dc7be854d9ecad2d",14,14,0,14,0,14,1,2
"10370","48c44d8ad39e747d7bb69d3d68f55862",7,7,0,7,0,7,1,2
"10371","48c48699430a80b6323abe8393660a60",83,64,36,16.1388888888889,83,0,2,3
"10372","48c60358563cc6435035f8e6f006155c",47,33,33,9.96969696969697,47,0,2,1
"10373","48c6085cf5fe16e3b715dcf80726ab94",36,36,0,36,36,0,1,2
"10374","48c8f5e06306ffde52c210f7e37d984d",28,18,23,8.52173913043478,28,0,2,1
"10375","48cbb39f6b4b4024b9ff6a2f5ee144dd",71,43,55,9.03636363636364,44,27,2,1
"10376","48cc498b386d3453822bc84c50548e5f",67,51,21,22.3333333333333,67,0,1,1
"10377","48d17d03af2b03c995eddf8d8414696d",16,16,14,8,16,0,1,1
"10378","48d221c2d2c2cced7474b1b161f3e403",2,2,0,2,2,0,1,2
"10379","48d4517b56eb7679854d9428f96f93e2",7,7,0,7,7,0,1,2
"10380","48d5ee8302cef2db491100c3c33f6c4f",43,35,42,7.16666666666667,43,0,2,1
"10381","48d5f9cb4103bc43cf088dcd86393040",100,63,71,9.85915492957747,53,47,2,3
"10382","48d824c39f911ffd87cf5abbb6039833",50,35,47,7.4468085106383,50,0,2,1
"10383","48d8ee562a603374ffb410b2c09ff732",109,87,29,26.3103448275862,109,0,3,3
"10384","48dbce4dfdb81c578bb1fe484490bbaa",195,127,63,21.6666666666667,195,0,3,3
"10385","48dca3db49b0ecfc870ebe4626cee060",132,77,25,36.96,132,0,3,3
"10386","48dcfdb1a6d5b35769327798796f281a",3,3,0,3,3,0,1,2
"10387","48ddf07736f9bf408f93f99c63d14dcf",37,37,0,37,37,0,1,2
"10388","48df6dbe70832e4159875238099c4d29",20,19,4,35,20,0,1,2
"10389","48e0476466357c400f89917ba41bff1e",2,2,4,3.5,1,1,1,1
"10390","48e3606f556e2c036caf72a52aab8da5",180,122,61,20.655737704918,180,0,3,3
"10391","48e44860f8f8beca3334b6a07c6d555a",95,70,32,20.78125,52,43,2,3
"10392","48e563da51005bb6ba6c60140fd7ae9b",53,33,37,10.027027027027,53,0,2,1
"10393","48e59195c14982c9e3f7e6cf18f652af",10,4,55,1.27272727272727,7,3,2,1
"10394","48e74e75065d0eb0b792d9809d4e3b3c",127,100,78,11.3974358974359,127,0,3,3
"10395","48e9d73133873d39dd5c5ebe455c8454",33,33,54,4.27777777777778,33,0,2,1
"10396","48eb07a2db7c52de9e36f727d251978f",82,50,75,7.65333333333333,82,0,2,3
"10397","48ebf44c09909bfdbb32a74d62a05736",175,96,69,17.7536231884058,175,0,3,3
"10398","48ec9ce4f9482a83cd6d5f2ed85d9e93",47,47,0,47,47,0,1,2
"10399","48ecca1627dcd09b70dfe1879d4124c8",19,19,0,19,19,0,1,2
"10400","48ecfd6d1c6ff91541f6033c64399021",23,23,0,23,23,0,1,2
"10401","48ee154063ac71fca757d19f89aa8f8f",19,19,0,19,19,0,1,2
"10402","48f6c54eebc1f70e4496d7169d18902f",33,33,0,33,33,0,1,2
"10403","48fcab0ba1af45cfe9f86aa2cf3b5c62",96,55,83,8.09638554216867,78,18,2,1
"10404","48fcdfdf13036a6f760026c1fe04641b",76,59,61,8.72131147540984,76,0,2,3
"10405","48fe379fc39a04fb9ccf466dc758ef22",50,42,65,5.38461538461538,20,30,2,1
"10406","48fedab86488f638dff96bed7fa3893d",18,18,0,18,18,0,1,2
"10407","4900df952ab2c7f21c76dc670f913a78",115,98,35,23,115,0,3,3
"10408","49010aec2b841125c38f059e39f27ec0",133,103,75,12.4133333333333,112,21,3,3
"10409","4904f3425f50d7381b8d74099f772adf",23,23,0,23,23,0,1,2
"10410","49072b0f03e64a7eb9fff4c5cb70b3ce",126,79,60,14.7,126,0,3,3
"10411","49098a73e9f2b1ff01bbb7e91a81ba03",6,6,0,6,6,0,1,2
"10412","490a609bc7972f515fee4d0f629ddb57",61,52,22,19.4090909090909,61,0,2,1
"10413","490a65924b1004e4db08a21ef8987fa8",25,25,0,25,25,0,1,2
"10414","490ad10602588bded3738d715d708f3d",19,19,0,19,19,0,1,2
"10415","490bcdfcd791169a159ad293f661550a",30,27,9,23.3333333333333,17,13,1,1
"10416","490c3ded534a94b503fcf6ccb4b0c4fb",31,31,0,31,31,0,1,2
"10417","490f3c8a555eba0c3bc81b5aa6f94c3c",128,83,65,13.7846153846154,128,0,3,3
"10418","490fa35a0657cb46e5329acf4049bb08",25,25,0,25,25,0,1,2
"10419","4918a9ce7c3802b7437c842d0acb953a",71,49,45,11.0444444444444,71,0,2,3
"10420","491a216d2eb40b57defa21858fbc7508",166,115,76,15.2894736842105,166,0,3,3
"10421","491a5c077db94b81f51fb79070c2fd6e",52,46,15,24.2666666666667,52,0,1,1
"10422","491d21e1bac3c02664dbb7f10e863476",2,2,0,2,0,2,1,2
"10423","491ddb7fd580e1c33d93c5505721b766",9,9,0,9,9,0,1,2
"10424","491ed4fb0a26f1825694daa36c5b8a2a",1,1,0,1,1,0,1,2
"10425","491f1b6f8e41dcf80d6e4d56a4ce2bd7",22,22,0,22,0,22,1,2
"10426","4922d7a77f59dee054b5ecf02a8d51e2",30,15,53,3.9622641509434,21,9,2,1
"10427","4923eb0392e9b3ae692a32b5baae4b1c",11,11,0,11,11,0,1,2
"10428","4923fc5e16e4567d3084e47dab1ad9f5",27,27,0,27,27,0,1,2
"10429","4924cd7502f5d82214b870a09479b71c",27,27,0,27,27,0,1,2
"10430","49298b0ec911bd4c46a51de49f5d2a18",71,66,20,24.85,71,0,2,2
"10431","492a60df81fceebc796593481845ea78",29,29,0,29,29,0,1,2
"10432","492b3376786297355d954aa40ceb5b65",80,74,15,37.3333333333333,80,0,1,2
"10433","492d80a94161ed2fadcf5a1e1d947585",30,25,44,4.77272727272727,16,14,2,1
"10434","492e333b51bf970da3b12b490ada46de",45,45,0,45,45,0,1,2
"10435","492e67b4d7a29ac56c33d73bee8c23a1",76,69,20,26.6,76,0,1,2
"10436","492e774c3f6027ad41ff6fcdef9379c0",146,106,66,15.4848484848485,146,0,3,3
"10437","493113526fd4b5aec7707e42d18ddafc",20,20,0,20,0,20,1,2
"10438","4934abdc0179538684d72c126117d3fd",24,24,0,24,0,24,1,2
"10439","4934f0ab50e015462c70916d23ac52fb",26,26,0,26,26,0,1,2
"10440","493796298fb6ddcfd42a3140a32dabb2",122,80,69,12.3768115942029,122,0,3,3
"10441","493b089359ea63b6ae124338e2082f3c",9,9,0,9,9,0,1,2
"10442","493b9a2e0a3eb2047b9b04cfd3c6eab8",116,84,70,11.6,116,0,3,3
"10443","493e6561b5eb04bf4840aba66464b01e",72,63,12,42,72,0,1,2
"10444","493f2aea0433ce37146042a8f61f40a9",24,24,0,24,24,0,1,2
"10445","49430d8d1a1f05d105219f4057378936",60,50,37,11.3513513513514,60,0,2,1
"10446","4943598cdcfcba2c6c714cabcf3574bd",9,9,0,9,9,0,1,2
"10447","494477141e3a4bbf08e7826995c518ac",41,41,0,41,41,0,1,2
"10448","49456691a86b39349d448ffa85fda573",49,49,0,49,0,49,1,2
"10449","49466df1be5b43fcb502a6aef0444b0f",41,41,0,41,41,0,1,2
"10450","49473cde98653c04703942b8f7c202e1",21,21,0,21,21,0,1,2
"10451","49479acb24e30049c5d1828bc1722e14",16,16,0,16,16,0,1,2
"10452","494bf3c6739b549aaa894fd056a78e21",13,13,0,13,13,0,1,2
"10453","494ca9c6dcac2263cb402a30670ee2f9",106,74,46,16.1304347826087,106,0,3,3
"10454","494ef29da9a51df03154c0c4a020ba3e",48,40,14,24,48,0,1,1
"10455","4952fea983a060b2293bddd5c152e7ad",93,75,57,11.4210526315789,61,32,2,3
"10456","4954accfc3ca266b5d8a5799e4fef6a5",44,44,0,44,0,44,1,2
"10457","49555234af3a341a3840c418018a0079",258,125,74,24.4054054054054,209,49,3,3
"10458","49579ed7ca9a5a139e9d5071347afb2a",201,141,48,29.3125,201,0,3,3
"10459","495b0068f9366b20c7c8afff398236ce",21,21,0,21,0,21,1,2
"10460","495b6313f36d969c1ac464d3625f22cd",69,59,9,53.6666666666667,69,0,1,2
"10461","495d3c33bf500b16a06d4efbf49d8cd2",169,101,80,14.7875,146,23,3,3
"10462","495dee3e70e9e1bcef1eaab5d290315a",47,47,0,47,47,0,1,2
"10463","49606d99477ecc371054eb522cfada2e",3,3,0,3,3,0,1,2
"10464","49658d43a292ba65a907ed32bbc0f771",97,80,42,16.1666666666667,97,0,3,3
"10465","4966055fc6a5d5a097544315b4d5f416",64,52,42,10.6666666666667,64,0,2,3
"10466","496676dbd41e6236408c995cb0909f38",52,52,0,52,52,0,1,2
"10467","4967e97b25336946b9381932348f4ae4",127,52,84,10.5833333333333,127,0,3,3
"10468","49685013864e8e10dcb335087232122d",59,52,65,6.35384615384615,59,0,2,3
"10469","496ab853cf4b541646a4d5b558b22a40",36,28,18,14,36,0,1,1
"10470","496b4f94082b8d31e4fd026fa41fb0e8",61,41,54,7.90740740740741,18,43,2,1
"10471","496c4d69f05d3dc401db13310d8f6512",5,5,0,5,5,0,1,2
"10472","496d8de13f8a8abdbeb6c4ed059d5ca3",43,43,0,43,43,0,1,2
"10473","496e84b2b6f65675bd946b317472e4fb",31,31,0,31,31,0,1,2
"10474","4970be6dc29beeafc808bf62b450f36e",30,30,0,30,30,0,1,2
"10475","49719cf0f50e0fb70406128ea095b3d1",141,81,78,12.6538461538462,141,0,3,3
"10476","49750099ec6ddf02f88fe9611b84b0a2",46,46,0,46,46,0,1,2
"10477","49753689f1a36f01a18fd6f440c61204",35,35,0,35,35,0,1,2
"10478","49776479fab0ef8d21aacec40afd6ddb",103,63,56,12.875,103,0,2,3
"10479","497913677fa32d7f2f41c50b6d7d7558",2,2,0,2,2,0,1,2
"10480","4979b6dacc37a7aa92e2d21335d9e776",25,25,0,25,25,0,1,2
"10481","497d81a213266a7248bd612ed1ce7aaa",54,33,76,4.97368421052632,54,0,2,1
"10482","498145137e2ab913de1f7318d9b3b432",10,4,34,2.05882352941176,10,0,2,1
"10483","49834eb0c81079ed281157c251f26c52",177,91,48,25.8125,122,55,3,3
"10484","4985794b69190a3f460fee0e164c8eb4",48,40,45,7.46666666666667,29,19,2,1
"10485","49862c8de6e6f9f9f58b5d3b1cbc5007",223,119,75,20.8133333333333,193,30,3,3
"10486","4986a3bbebf9369b46625324a56b9d1d",88,62,58,10.6206896551724,50,38,2,1
"10487","4987bd0c48eb1b901fd1592f2d98b9fe",64,56,51,8.7843137254902,64,0,2,3
"10488","498852750213175567bec8f9bdbad6e3",134,80,76,12.3421052631579,134,0,3,3
"10489","498dbd64e253fefeefe20d55135cbe31",70,57,62,7.90322580645161,70,0,2,3
"10490","498fc3c22739346db91dbd27f9755614",4,4,0,4,4,0,1,2
"10491","49919d993be012a83c75f87951e906b8",27,19,75,2.52,9,18,2,1
"10492","499388526e11e9e9ce75faa7d30adab6",121,63,78,10.8589743589744,121,0,3,3
"10493","499a147af1051b1b0382d17f9686d7b7",34,31,57,4.17543859649123,34,0,2,1
"10494","499aecef0fcfd2b59f780299fe1eb78f",147,73,69,14.9130434782609,147,0,3,3
"10495","499b4de755e676aed2c6cfbe4aeb7819",17,17,0,17,17,0,1,2
"10496","499bd1ae30f57a1512cfe9d1dfe56864",72,58,21,24,72,0,2,2
"10497","499c0297c6367266320b54bd60e2efa5",119,89,50,16.66,119,0,3,3
"10498","499f9b5866bc96d1cea9b6fc5bc19d94",74,61,40,12.95,74,0,2,3
"10499","49a030d3725e5341e764a878612d0331",17,13,63,1.88888888888889,17,0,2,1
"10500","49a223c3fef1fe6893fe01965435a212",95,76,17,39.1176470588235,95,0,3,2
"10501","49a43d137f718854312696dbe2e88b2e",137,97,72,13.3194444444444,120,17,3,3
"10502","49a497ae9c1aa6181c7f1e376cfc7b3f",45,45,0,45,45,0,1,2
"10503","49a7547475002682359323ce5cf2b6e3",136,101,68,14,136,0,3,3
"10504","49ad945d543bddef58f1087b9c8d4201",12,12,0,12,0,12,1,2
"10505","49b19a783073f75034378f26a0a1f1c1",21,21,0,21,21,0,1,2
"10506","49b22ffd36f91ca82c71d10bacbf69f9",96,77,28,24,96,0,3,3
"10507","49b35644fdf30a3a3f3cbd031a68470c",40,40,0,40,40,0,1,2
"10508","49b45847421c01232e54e4eb418e72d1",60,35,49,8.57142857142857,60,0,2,1
"10509","49b55eee33503d1ad862978ade2fa15c",63,17,80,5.5125,49,14,2,1
"10510","49b5dcf5e56f5065caff6ea013e9f520",26,26,0,26,26,0,1,2
"10511","49b6640482e3fe4dee283db856ddbab6",9,7,42,1.5,9,0,2,1
"10512","49bc13fade45a48b1bbc375849e5ee49",33,16,73,3.16438356164384,15,18,2,1
"10513","49bf969da9b75a7b04c291fd41194ad0",46,41,36,8.94444444444444,46,0,2,1
"10514","49c004628d40d1b2de9b40f2baab2122",149,103,67,15.5671641791045,149,0,3,3
"10515","49c1fb4723b46bffa5ede89f7b6c3133",225,108,77,20.4545454545455,199,26,3,3
"10516","49c26332497022775bdca488f3c9f06f",18,18,0,18,18,0,1,2
"10517","49c348db2f690e9a1def313021172c02",216,135,78,19.3846153846154,216,0,3,3
"10518","49c42093e785fc581773dcb5667ec4ed",112,54,66,11.8787878787879,58,54,2,3
"10519","49c69aae9a30e616bca34381f77fc32d",8,8,0,8,8,0,1,2
"10520","49c7320d4b1764ac115966a1356bf062",129,75,75,12.04,102,27,3,3
"10521","49c8963354141f836b17778b8d51fa7d",172,103,82,14.6829268292683,172,0,3,3
"10522","49cb613f30693175f788eb51857f41b5",44,44,0,44,44,0,1,2
"10523","49ce1a3d2675b9decb779d6a3a23e318",29,29,0,29,29,0,1,2
"10524","49ceecf8ee6b83b05f5f007e2fa60df4",31,31,0,31,31,0,1,2
"10525","49cf3732a3a8924849a5d10041f03dc6",16,16,0,16,16,0,1,2
"10526","49cf402617351fdf5903a3f5183fda63",20,20,0,20,20,0,1,2
"10527","49cf570a6b386f0e90f75c555db1f271",23,23,0,23,23,0,1,2
"10528","49d181be15f26c882ac28e5aadf01f22",46,38,26,12.3846153846154,46,0,2,1
"10529","49d634c2a499dced7c2f615131423fbf",14,14,0,14,14,0,1,2
"10530","49d6365f4f07faf1aa026d138bfed91a",174,102,70,17.4,174,0,3,3
"10531","49d6a46a7f9e9c73a9a161350cdcc41c",51,39,50,7.14,51,0,2,1
"10532","49d890a730a723968ef199329c58d193",63,55,39,11.3076923076923,14,49,2,1
"10533","49e071c53f9194b7b60cdfc565d6f067",26,24,29,6.27586206896552,26,0,2,1
"10534","49e35d8e9e5f68e7511adfe057a09e93",109,49,72,10.5972222222222,109,0,2,3
"10535","49e7a9b67fbefcba0644397a15cca9f1",32,32,0,32,32,0,1,2
"10536","49e89dec0f6633891c70473290853502",90,64,81,7.77777777777778,63,27,2,1
"10537","49e9929c3daf6d36b83988816870ebfa",36,33,66,3.81818181818182,36,0,2,1
"10538","49eae07bf4c37ef3adafbc524bbd2904",58,53,17,23.8823529411765,58,0,1,1
"10539","49ef2907fe96131dd2d1d9526f879539",103,91,46,15.6739130434783,52,51,3,3
"10540","49ef5b6a0e42a2673373e32f8e1aa254",35,35,0,35,35,0,1,2
"10541","49f2e2e66eadf9390280625a223ef311",39,22,70,3.9,39,0,2,1
"10542","49f32bec84fd7e50a53657e64a7390ee",22,22,0,22,22,0,1,2
"10543","49f67dbda9cfb1d645e69bc644b8adf9",121,95,59,14.3559322033898,121,0,3,3
"10544","49f6de77958a7dadb7f7504cd808ceab",182,80,82,15.5365853658537,135,47,3,3
"10545","49f6eeb55458d01df5f13eafa8518248",29,29,0,29,29,0,1,2
"10546","49f88bd2af4e132f1bab764c66ef14bc",141,90,53,18.622641509434,141,0,3,3
"10547","49fce9604cd2e09370432539815d02c6",88,48,66,9.33333333333333,39,49,2,1
"10548","49fe17c3e5e87647b5dd0b54984a46ce",27,20,83,2.27710843373494,26,1,2,1
"10549","49ff030b0bdafdae919626c14623a68b",16,16,0,16,16,0,1,2
"10550","4a017daec32a2f8adfc25b658829b32a",145,100,56,18.125,145,0,3,3
"10551","4a0273a27326f22b4814dd56de714177",136,74,39,24.4102564102564,136,0,3,3
"10552","4a073b10c633f5aa55421b0960b71f98",25,22,54,3.24074074074074,14,11,2,1
"10553","4a08872816095774228a492f1fb64b1c",1,1,0,1,1,0,1,2
"10554","4a0f04e6b2ffee4062898cd3943fb834",20,20,0,20,0,20,1,2
"10555","4a102a270b82021af0676627e7a9eb0d",191,95,90,14.8555555555556,191,0,3,3
"10556","4a11100e10258d700d8081dbb3fb1221",13,13,0,13,13,0,1,2
"10557","4a138b6d194ab6ffa6d01447d8a0cad6",46,46,0,46,46,0,1,2
"10558","4a146fd0c1378b3ec38a2c4b52f7412b",74,57,82,6.31707317073171,74,0,2,3
"10559","4a17613a599dfc0f26d084ea2244d066",157,117,67,16.4029850746269,157,0,3,3
"10560","4a17956c8f0af6973b87c5beee3ca732",38,28,13,20.4615384615385,38,0,1,1
"10561","4a17fba22fd71a0283cd79a64e60be4c",68,64,45,10.5777777777778,68,0,2,3
"10562","4a18b9b64ac708a480a8b705141bc6e3",30,26,40,5.25,30,0,2,1
"10563","4a193ca0d3e8da629950adb9a357de39",2,2,0,2,2,0,1,2
"10564","4a197a3ceb63b02342717376e435b7e2",105,58,66,11.1363636363636,105,0,2,3
"10565","4a1a6a4ace640162056d207d5dad1832",15,15,0,15,15,0,1,2
"10566","4a203b3e37b54f3cb37e2e8ae771c79c",87,68,45,13.5333333333333,87,0,2,3
"10567","4a2049e9b7c00fd19ae1496ec9059ec4",28,22,42,4.66666666666667,28,0,2,1
"10568","4a22eaef0fcc601ae5cee443a3ea9195",14,14,0,14,14,0,1,2
"10569","4a294392c16a491d5ef065ebd4b720f1",56,47,21,18.6666666666667,56,0,2,1
"10570","4a29879267f289fff9b42b67f872a76d",27,27,0,27,27,0,1,2
"10571","4a2a44a33c4efe9b85e20990bc9ccd93",182,73,85,14.9882352941176,182,0,3,3
"10572","4a31ed253fd06f4e1c32479c66538c62",253,152,83,21.3373493975904,212,41,3,3
"10573","4a34cd9efe276eb829265236b69c742e",75,67,14,37.5,75,0,1,2
"10574","4a3509fcb96e5b5e2ab37aeee54fe9fc",15,15,0,15,15,0,1,2
"10575","4a3592ce663bfcd623b22d46cf418fa2",85,71,60,9.91666666666667,85,0,2,3
"10576","4a35fc8d73b61e5d2344fb2eb94e9992",37,37,0,37,37,0,1,2
"10577","4a39557dd623f10ce78c34b6d18e61a2",49,49,0,49,49,0,1,2
"10578","4a3c27d858440f6607a9a98ce75c3367",29,29,0,29,29,0,1,2
"10579","4a3c27f1d1a7595afedd8cee3b619ee7",54,33,50,7.56,54,0,2,1
"10580","4a3c762f5a7869c82bbc5cc661034851",14,14,0,14,14,0,1,2
"10581","4a3ca00c353540dee974fbd1221f510f",97,51,71,9.56338028169014,97,0,2,3
"10582","4a3e349727ae0d0382a1c911a0c4dfa5",52,37,37,9.83783783783784,52,0,2,1
"10583","4a3f06cb966bd970323bd6527ac51a83",23,23,0,23,23,0,1,2
"10584","4a3fb6ba8eaa328db3e28c7ee0e29769",35,29,26,9.42307692307692,35,0,2,1
"10585","4a3ff2804b43e255fd5217634c361cde",145,99,74,13.7162162162162,117,28,3,3
"10586","4a405f8dccfcd43bbedabaaadfba553b",90,70,63,10,90,0,2,3
"10587","4a4171b3a62c431fa7db7503ca04e891",31,31,0,31,31,0,1,2
"10588","4a4350bb91d0b507ea77d76e571c0888",35,35,0,35,35,0,1,2
"10589","4a4456dc0e8a0d21c978afa1073ae817",143,127,44,22.75,143,0,3,3
"10590","4a45c65a614f71c7cae6b5e1f69454ae",79,52,49,11.2857142857143,79,0,2,3
"10591","4a483f56a937c4a14e7371e15f58a5cf",15,15,0,15,15,0,1,2
"10592","4a507a3f1b3b81d5d0d7e60d71a734a4",126,91,63,14,126,0,3,3
"10593","4a517dba8ea0d058b71e943cc6eabfb3",57,38,49,8.14285714285714,57,0,2,1
"10594","4a51c9aad8b0dadcd70a3508739a3272",9,9,0,9,9,0,1,2
"10595","4a54bde8c297a280b2198d6ca97b84c5",69,58,45,10.7333333333333,69,0,2,3
"10596","4a5522d49425da073715633fb30a3279",32,26,64,3.5,32,0,2,1
"10597","4a55cbaaf3425fed87d48f87ed51da9e",80,66,69,8.11594202898551,80,0,2,3
"10598","4a56f06310b18396a760a8f7a143cf7c",100,74,28,25,100,0,3,3
"10599","4a574fde977ac5183b68568fa751911f",21,21,0,21,21,0,1,2
"10600","4a61fab38be3542db7c124b00bd9ac2c",32,32,0,32,32,0,1,2
"10601","4a658d0751525ecd87375194b7fd0634",206,97,84,17.1666666666667,206,0,3,3
"10602","4a66cd4abf167b80518e3ddb932c963c",76,62,27,19.7037037037037,34,42,2,1
"10603","4a670b8dbd465e64e9c64ecb913260ec",226,92,72,21.9722222222222,190,36,3,3
"10604","4a6bfe69e1d97fa78cfca058bfba593d",15,15,0,15,0,15,1,2
"10605","4a71f632f948a16262c687c4ed1c0516",23,23,0,23,23,0,1,2
"10606","4a7241fe2844e6d3c391e3e0a026e6d9",177,78,80,15.4875,149,28,3,3
"10607","4a72a5a226613c7e8c8a0a1d56af548d",25,22,51,3.43137254901961,25,0,2,1
"10608","4a739708bf595b432744af11dee26316",59,29,50,8.26,59,0,2,1
"10609","4a74b8d0d9aea097995dfd6832c0ddb8",237,113,79,21,182,55,3,3
"10610","4a74ca65ba873e9bfc9786664bdfa492",1,1,0,1,1,0,1,2
"10611","4a751593c3aafb1aba66c0c8f0cc5fb4",15,9,32,3.28125,15,0,2,1
"10612","4a759474084ee57c248626633d2f0ff6",100,68,62,11.2903225806452,81,19,2,1
"10613","4a78233d42855f13a0555b44c8efa17e",36,36,0,36,36,0,1,2
"10614","4a7a67ae63154b81a4a2f628485fb43a",46,36,58,5.55172413793103,46,0,2,1
"10615","4a7a8d40d8fd8dd6cd8699e92ce25aff",136,102,62,15.3548387096774,136,0,3,3
"10616","4a7af196a771c5ce98a8f3d6d2c3ba35",146,52,70,14.6,122,24,3,3
"10617","4a7b84d81208593350886838eb645231",103,69,63,11.4444444444444,103,0,3,3
"10618","4a7f23293d33ab43bca83a205173b487",50,38,21,16.6666666666667,50,0,1,1
"10619","4a816fb52135dd6f3d03c22ecaa00d51",51,51,0,51,0,51,1,2
"10620","4a82835bea8df2eb82c4294ca1688b48",71,64,41,12.1219512195122,71,0,2,3
"10621","4a894bf665b3228c2e5d0199b8574b85",56,56,0,56,56,0,1,2
"10622","4a8a43ed775dd0b4dc2c26df9e79ee1b",31,21,35,6.2,31,0,2,1
"10623","4a8ed1f89fe696af4db1d98c13efbd90",27,27,0,27,27,0,1,2
"10624","4a90a09cc78dd84d314e0b1f7ca6308f",113,65,81,9.76543209876543,113,0,3,3
"10625","4a92aa1b28a70d61140a834a582b4eb5",59,51,27,15.2962962962963,33,26,2,1
"10626","4a942ea4106beec2244025f1d64df4f6",11,11,49,1.57142857142857,11,0,2,1
"10627","4a98bc172c8266b09407748c0dd70985",46,46,0,46,46,0,1,2
"10628","4a9c8cb53c200dc262fe7cbe6da159d2",192,44,77,17.4545454545455,192,0,3,3
"10629","4a9f2f21aa291d6d02e6b1332ab3a10a",169,114,68,17.3970588235294,137,32,3,3
"10630","4aa1d2758dfc4189f65b94cb7ae07d25",106,53,46,16.1304347826087,68,38,2,3
"10631","4aa33d183134b27163235053579a3cb6",101,71,36,19.6388888888889,64,37,2,3
"10632","4aa5b35173ba7280f41e2ba9cbeae8e0",116,92,61,13.3114754098361,83,33,3,3
"10633","4aa7b600d30fe99b8f92a95c2b425681",73,62,65,7.86153846153846,47,26,2,1
"10634","4aa9e5d6b5e3ecb0593cf078a78a10e6",48,48,0,48,48,0,1,2
"10635","4aadb458293fc164b699e11e23591ac7",10,10,0,10,10,0,1,2
"10636","4aafc17919153441a08a0a9750efa895",33,17,47,4.91489361702128,33,0,2,1
"10637","4ab20f7202720efddda3bb531be5e665",211,91,74,19.9594594594595,211,0,3,3
"10638","4ab32152657687462aa1913c4a4ae803",76,57,46,11.5652173913043,36,40,2,1
"10639","4ab8c0e6191c3d3a64a314c48b4a9215",22,22,0,22,0,22,1,2
"10640","4ab8e3cf02892e33fc0fc221e5d4a920",44,40,53,5.81132075471698,44,0,2,1
"10641","4ab8f422f76ff6b457b5f80183916a05",31,31,0,31,31,0,1,2
"10642","4ab90e68a784b3237b26d8eaa9587174",28,28,0,28,28,0,1,2
"10643","4abb55ff020c096f5b656bfb29c8d108",195,91,82,16.6463414634146,195,0,3,3
"10644","4abb66392ee598e74d821ed47ee49b58",23,23,0,23,23,0,1,2
"10645","4abba0e5d6c4744425d98b37c1e1ae99",79,60,77,7.18181818181818,79,0,2,3
"10646","4abbc7906560bb378a9a18461af75837",50,42,56,6.25,0,50,2,1
"10647","4abeb5e4a6753c4ae7928ec0088ec3b4",188,105,86,15.3023255813953,188,0,3,3
"10648","4ac14f649135da02eeda55f51f0a4c04",42,34,42,7,42,0,2,1
"10649","4ac4e67094e0a99979d2bb95e016bce8",83,46,61,9.52459016393443,83,0,2,3
"10650","4ac50e0a57857650c7e1d04b07e48d75",45,45,0,45,45,0,1,2
"10651","4ac5db67d3f724da635ede6aa0e563e7",69,54,34,14.2058823529412,69,0,2,1
"10652","4ac70aed605d5d6a401c7c774cc9ccc4",19,19,0,19,19,0,1,2
"10653","4ac76a6f501fda9843d08e9f8b3b974b",48,48,0,48,48,0,1,2
"10654","4ac9352e8ac3c7b48b23529ebb15ad42",21,20,42,3.5,21,0,2,1
"10655","4ac99a24d9e8b2c9b8e2f1260dfa83c1",94,53,58,11.3448275862069,94,0,2,3
"10656","4acbea7b9391b080b353244ecf4cc56d",122,70,45,18.9777777777778,71,51,3,3
"10657","4acd46331a1df4c405505ba753e3f5e7",11,11,0,11,11,0,1,2
"10658","4aced993dcc528202392fad1f5188632",34,34,0,34,34,0,1,2
"10659","4ad0523a82e899fb5b3c06ed990a4ee1",19,19,0,19,0,19,1,2
"10660","4ad0ae1f695c582480cec58f6f646bc5",181,112,70,18.1,155,26,3,3
"10661","4ad2a23c0a4d8d951674240ba5970e64",37,36,15,17.2666666666667,37,0,1,1
"10662","4ad38a978534a375a47cbb94d0742434",9,9,0,9,9,0,1,2
"10663","4ad48836b733e2849407848ef4ec2999",61,42,50,8.54,61,0,2,1
"10664","4ad5e3ae49275da8787d5478f76983df",131,105,46,19.9347826086957,120,11,3,3
"10665","4adc260efeb1c01dc41aef93fa49dd28",12,12,0,12,0,12,1,2
"10666","4adcca0ad440f7826cb86619456eca21",84,77,22,26.7272727272727,84,0,2,3
"10667","4add7ea2fa4e8e548cb70e1775aad1cf",39,34,63,4.33333333333333,39,0,2,1
"10668","4addba2838e6ca0448b5842194e6925c",132,97,50,18.48,132,0,3,3
"10669","4addff3ae464d0306f7fb14aec72b1c4",32,32,0,32,32,0,1,2
"10670","4ade17e6dc4dd65551b75e6a655f1cc4",82,67,76,7.55263157894737,58,24,2,1
"10671","4adf2e5191760c3f5fb10b19f3ecba49",20,20,0,20,20,0,1,2
"10672","4ae139eb53f8b2dfaad4048f4d574ba5",101,79,42,16.8333333333333,101,0,3,3
"10673","4ae1cd18ab66a4353ef96de622b28b78",114,81,63,12.6666666666667,114,0,3,3
"10674","4ae3d7a9cf88f3ea162044199393c581",18,18,0,18,18,0,1,2
"10675","4ae46b5ab920fbc8ec347d02858ae877",16,14,5,22.4,16,0,1,2
"10676","4ae6806f82c078cf0f0425c90137cdba",41,41,0,41,41,0,1,2
"10677","4ae989c3dafd8eb7d2b3d6dce342da84",86,53,64,9.40625,86,0,2,3
"10678","4aec0ae6b321225fa3a2b9148777a201",33,33,0,33,33,0,1,2
"10679","4aec636901e1b77afba16d5a8874e851",5,5,0,5,0,5,1,2
"10680","4aeec1411d5bd2300cb2e13cc249e55b",13,12,6,15.1666666666667,13,0,1,2
"10681","4af16b2045b8ad2b590ce553e219e34a",14,14,0,14,14,0,1,2
"10682","4af47b65c95b22d924f61c20e6c2941c",5,5,0,5,5,0,1,2
"10683","4af4e1ca8064e12205fef36796251f12",177,74,36,34.4166666666667,177,0,3,3
"10684","4af939cdbd103b2532df3fdf4872d584",42,40,38,7.73684210526316,16,26,2,1
"10685","4afa47d72a104f622e095031f5798229",80,67,52,10.7692307692308,56,24,2,1
"10686","4afda60da927e184a0948b538d483400",71,61,16,31.0625,71,0,1,2
"10687","4afe40fdc06ae9f09316646749410b28",76,64,38,14,76,0,2,3
"10688","4afe8ae779a1960682d93d1062094652",24,17,35,4.8,24,0,2,1
"10689","4aff7af3abf1ee4eabd793aa5a8332a2",20,20,0,20,0,20,1,2
"10690","4b066faf58f3beb3e54fb86cba00f2b8",130,65,73,12.4657534246575,130,0,3,3
"10691","4b0700cf5a5ff2ad0c4a705b0e0cc19b",36,33,29,8.68965517241379,36,0,2,1
"10692","4b087c842a854ffc471c9954d281b2ce",111,79,67,11.5970149253731,111,0,3,3
"10693","4b096fdd8fff3c1b85db84d7d15b648a",58,37,33,12.3030303030303,15,43,2,1
"10694","4b0ad9f7e87a16e178448e25faedfa1a",99,63,84,8.25,99,0,2,3
"10695","4b0b7a1e23672ed340623813de07246e",20,20,0,20,20,0,1,2
"10696","4b0d66939b3d358835e922adae1f35dc",27,26,63,3,27,0,2,1
"10697","4b12429e97e26f5b25dccfbc47a9b538",26,26,20,9.1,26,0,1,1
"10698","4b12ec274d90e2264163ee6792953602",15,15,0,15,15,0,1,2
"10699","4b1554eb1f6dad09afab644d045b3481",160,90,84,13.3333333333333,131,29,3,3
"10700","4b15f88e522a93a73864cef50b55539f",24,24,0,24,24,0,1,2
"10701","4b18ffca897f39f854dfc0b1346f9ae9",191,112,83,16.1084337349398,149,42,3,3
"10702","4b19db1c930c016960c24e0d96aab704",40,34,15,18.6666666666667,40,0,1,1
"10703","4b1bacfc45a3c96b10593fb96a0d6701",127,79,50,17.78,84,43,3,3
"10704","4b1bf24045a829b8fa2a919bb281d763",33,33,0,33,33,0,1,2
"10705","4b1c77f357ce4200ef2b789b87afce29",40,40,0,40,40,0,1,2
"10706","4b1cae0aa6789595d3caf91382bab86e",29,29,0,29,29,0,1,2
"10707","4b1d02bdb66d4cb34bd38b016c919042",114,93,48,16.625,114,0,3,3
"10708","4b1ff1431ef3260d1d18a7a697c81aaa",132,99,67,13.7910447761194,132,0,3,3
"10709","4b217513af7501a3b95c6704d0ce7bc0",28,28,0,28,28,0,1,2
"10710","4b22c48a0214f28f3289085b6116ef2e",22,22,0,22,22,0,1,2
"10711","4b24ac6681d085cec6ee3beeb8f033dd",12,12,0,12,0,12,1,2
"10712","4b288f2cb9ea45baf4e886c5ef29b3eb",76,66,45,11.8222222222222,76,0,2,3
"10713","4b29dcaea5c6fc0841ffe9e3dbae3baa",15,13,52,2.01923076923077,15,0,2,1
"10714","4b2af69d7e61dec79c0b59fbac7aa6ed",19,19,0,19,19,0,1,2
"10715","4b2ba734c8b7977228f37242c66e407c",11,11,0,11,11,0,1,2
"10716","4b2cddf96b5d9f5b455db342890811e8",30,21,59,3.5593220338983,30,0,2,1
"10717","4b2e0cef83ae58408c3efdfc61651ec2",194,109,75,18.1066666666667,194,0,3,3
"10718","4b30378d13c871cda956119eae474ddd",166,102,42,27.6666666666667,128,38,3,3
"10719","4b323aa0375041caffa99c8a9532be0f",129,91,19,47.5263157894737,129,0,3,3
"10720","4b32b1b56b6f334d75bf69895c92329b",53,40,21,17.6666666666667,53,0,1,1
"10721","4b34f5b73912c2b31e5bb9fd05bd476e",33,33,0,33,33,0,1,2
"10722","4b3d81cb56a9cf264d03e5805be394dc",177,74,79,15.6835443037975,177,0,3,3
"10723","4b406662c3754fc1eae6694953fec483",20,16,60,2.33333333333333,20,0,2,1
"10724","4b40e1e068c0e93b90b362430cc00e14",79,60,67,8.25373134328358,79,0,2,3
"10725","4b42099703db892cd77bbdc0d55effcb",88,72,79,7.79746835443038,68,20,2,1
"10726","4b424978f3ba61f5934fb50cc914e7d3",112,67,46,17.0434782608696,74,38,3,3
"10727","4b44f0ab995b794e93500e1b9bf57493",29,29,0,29,29,0,1,2
"10728","4b45796167cc2af9779d51a58b631eea",113,62,63,12.5555555555556,113,0,3,3
"10729","4b4a4c7143e4056a7b3a1c0f92e015d5",34,34,0,34,0,34,1,2
"10730","4b4d1312cf86fd0ca60dc3093449b5ab",110,71,82,9.39024390243902,78,32,3,3
"10731","4b4da5ef92846f6ca83af41fe2e2ed49",83,59,68,8.54411764705882,83,0,2,3
"10732","4b4e7bcbea3cfd106ff5b6be3fab0c58",37,37,0,37,37,0,1,2
"10733","4b50ca19c7d6cf1d7f81382205364da9",78,59,43,12.6976744186047,78,0,2,3
"10734","4b56bdade5712509f493acd20ac75bf7",40,40,0,40,40,0,1,2
"10735","4b582e25e67857fae7692c6f76b53613",14,11,71,1.38028169014085,14,0,2,1
"10736","4b5ba0378372f8173afc8a40939433d0",15,15,0,15,15,0,1,2
"10737","4b5c691bc5ad52f23cdc5f62d698e109",114,78,74,10.7837837837838,83,31,3,1
"10738","4b5cdf34537fbbfa71ecbe69dbb79617",120,74,56,15,120,0,3,3
"10739","4b5d13c9d8faf5447f3003e4e3fbd9fc",27,27,0,27,27,0,1,2
"10740","4b5d31f8e40b122767f42141c8d0e41a",22,22,0,22,22,0,1,2
"10741","4b5d525a86ff89400b0b7e3ece202204",135,85,43,21.9767441860465,135,0,3,3
"10742","4b6074ede80512103e3d5ebebbcc6bed",19,19,0,19,0,19,1,2
"10743","4b6498728622d27c0ff3dabfcbe6ffef",53,53,0,53,0,53,1,2
"10744","4b66adeae1abd47040e8b1d3ed60ca8d",47,47,0,47,47,0,1,2
"10745","4b6833ebefd84ee8f834e6f7edf62bb8",13,11,12,7.58333333333333,11,2,1,1
"10746","4b699319e2c6177e720d466f23668e8e",21,21,0,21,21,0,1,2
"10747","4b6be273351cdda9c94179434781530b",36,23,46,5.47826086956522,36,0,2,1
"10748","4b6c26e077101ac856cc9429a547c93a",105,83,31,23.7096774193548,105,0,3,3
"10749","4b6c9beb5934ab696f9cf19598f3a2a2",56,37,62,6.32258064516129,39,17,2,1
"10750","4b6d1fc8e71455eb52c82ef7d8278074",25,25,0,25,25,0,1,2
"10751","4b6d7a1f870c4fac5eb672e21bd45205",22,22,0,22,22,0,1,2
"10752","4b6fd2b7e90d2d720fcb265c58d7d527",36,36,0,36,36,0,1,2
"10753","4b70a6ca7ad5864c8b577fbc101c2e5a",151,51,57,18.5438596491228,151,0,3,3
"10754","4b717c72bd956ea7d805c738d116e02a",159,130,41,27.1463414634146,159,0,3,3
"10755","4b71940c087f91d76a59359db9c2fe80",43,39,77,3.90909090909091,43,0,2,1
"10756","4b75dc5a04778a393d9b002925a16051",31,31,0,31,31,0,1,2
"10757","4b773b7698be29026cfe152c1d3498ab",10,10,0,10,10,0,1,2
"10758","4b7898f8ad674b00966d89b3bbdad282",205,100,73,19.6575342465753,205,0,3,3
"10759","4b789a02bd21888af94c73401378227d",34,34,0,34,34,0,1,2
"10760","4b78dd3a36efe9eba198625fca7127a6",116,98,81,10.0246913580247,116,0,3,3
"10761","4b7ad984b07c359e228dd35974d50bc0",6,6,0,6,6,0,1,2
"10762","4b7c01d4229d4d85ab4ceed3c68530db",46,46,0,46,46,0,1,2
"10763","4b81cdb5afb6234fe344580a07462585",83,64,21,27.6666666666667,83,0,1,2
"10764","4b8386510b80b6eb671d015becd2a82b",13,13,0,13,13,0,1,2
"10765","4b898cb9344983953e202a56b4caccba",180,101,62,20.3225806451613,180,0,3,3
"10766","4b8d9146a2112175416fa632df5cddb2",7,6,30,1.63333333333333,7,0,2,1
"10767","4b91a3caaf5c13db2ee740d0ac502e49",34,34,0,34,34,0,1,2
"10768","4b91a61753aa539ea1c52df38e75b343",213,120,73,20.4246575342466,169,44,3,3
"10769","4b938a3fe5c2831d824c2e49cdbe3883",3,3,0,3,3,0,1,2
"10770","4b972d668822869638c4e8006ed6bc76",170,112,49,24.2857142857143,115,55,3,3
"10771","4b98cc817d293f899621b2ec65f2a9ae",138,74,74,13.0540540540541,103,35,3,3
"10772","4b99762825092b6c2bbe2b10d6a33a4b",97,82,19,35.7368421052632,97,0,3,3
"10773","4b9a3660094ffd718908596f5eaf0d0a",85,54,28,21.25,85,0,2,3
"10774","4b9d85bd48f236189f201990740dc20c",36,34,41,6.14634146341463,36,0,2,1
"10775","4b9e959fd844a18e5eb39b96fa6488dc",68,55,38,12.5263157894737,30,38,2,1
"10776","4ba0b45a4fdaee585589fce0772a35b4",26,26,0,26,26,0,1,2
"10777","4ba20e1056f73b72748e79ea9b44951b",70,50,59,8.30508474576271,70,0,2,3
"10778","4ba24a6835d0e55cf2e457a5e55c83ad",11,9,22,3.5,11,0,1,1
"10779","4ba68326b2120ea68b4275306a27c33a",4,4,0,4,4,0,1,2
"10780","4ba75902780d7ce03f3c49e4d5c4d0c9",19,19,0,19,19,0,1,2
"10781","4ba871e77e6ce7908994d5dcdabb4808",37,37,0,37,37,0,1,2
"10782","4ba9dfcb7bdb73c3646428cf5b4f0035",30,24,35,6,30,0,2,1
"10783","4bab90c47bd9ae1c328921372ac678b7",179,119,59,21.2372881355932,179,0,3,3
"10784","4bad1b1950d0000264ac7d0bb7ac1915",27,27,0,27,0,27,1,2
"10785","4baf7f8259ca401a13a8b4c5005655d7",80,64,46,12.1739130434783,55,25,2,1
"10786","4bb0f4a290dbc26df36de5cf15b61ca6",10,10,0,10,10,0,1,2
"10787","4bb1ab00bac00a178fa16a37d1d34c4c",55,37,21,18.3333333333333,55,0,1,1
"10788","4bb33476150760960fe543422594127e",74,61,31,16.7096774193548,74,0,2,1
"10789","4bb44e27cb584fb7f3cd4be7341a1132",56,23,51,7.68627450980392,56,0,2,1
"10790","4bb466ce55ecf0b4ea15ba32adb68de1",136,91,34,28,136,0,3,3
"10791","4bb4c9875bf41c0f164dcfda15f4ba96",2,2,0,2,2,0,1,2
"10792","4bb620ecf8a880b7fb6814e3ab5f5ce0",93,61,34,19.1470588235294,70,23,2,1
"10793","4bb8affe5ffb0075b92106252ae43ffd",20,20,0,20,20,0,1,2
"10794","4bb9516e950c6d34b645e0a96e46e7a5",22,22,0,22,22,0,1,2
"10795","4bbd2d2d75e056c22b8e67b79588fa84",15,15,0,15,15,0,1,2
"10796","4bbe95c12f8c914b492d099344336821",39,31,21,13,0,39,2,1
"10797","4bbfdc58eba52d4f3faa90890e8fee94",124,65,68,12.7647058823529,124,0,3,3
"10798","4bc00186c9bfb36a00724c891cd897a8",90,63,84,7.5,90,0,2,3
"10799","4bc34428ead5426406f50a034f8428ed",26,26,0,26,26,0,1,2
"10800","4bc5cdb7d06bb0601481c4020f560953",18,18,0,18,0,18,1,2
"10801","4bc66251af77594d478e854cbfcf36b4",16,16,0,16,16,0,1,2
"10802","4bc9c51ced720fbe53000e59172e283b",74,66,79,6.55696202531646,43,31,2,1
"10803","4bc9e76cac5ef4503ee917d092279179",27,26,7,27,27,0,1,2
"10804","4bcc4ca4de076fc695d031d7d955b609",38,34,50,5.32,38,0,2,1
"10805","4bcdefa59f51c2d8909592ceefb74d90",77,62,37,14.5675675675676,53,24,2,1
"10806","4bce1aa3c1e096578b7ce54da797c499",17,17,0,17,17,0,1,2
"10807","4bcf61c953d19543e111c588f7bcd202",6,6,0,6,6,0,1,2
"10808","4bcf9cb401edae625ff11c4fa334602f",14,14,0,14,14,0,1,2
"10809","4bd026bbe5f918ce4906f3d02375a5c8",82,51,67,8.56716417910448,68,14,2,1
"10810","4bd400c603ca7fa2423a2c019e3b49ab",36,36,0,36,0,36,1,2
"10811","4bd4b2378e8cd559abfa88d6a3595f18",23,23,0,23,23,0,1,2
"10812","4bd60b93080a9530326dbd3aebe296f2",81,52,36,15.75,81,0,2,1
"10813","4bd7695dd9c9dea7cbd745a72d7db85a",21,21,0,21,21,0,1,2
"10814","4bdafbb451e21d5fec3e1fbaf3858cfa",25,25,0,25,25,0,1,2
"10815","4bdb3844e9493b3a37db9b828d593d2a",145,118,64,15.859375,116,29,3,3
"10816","4bdc56b50532b805ce1c636455287855",57,47,32,12.46875,57,0,2,1
"10817","4bdf4c915d75e6c3637baa35e0bdded1",53,46,38,9.76315789473684,53,0,2,1
"10818","4be0a23ae46aaf3428deb6d2f1d61d94",41,41,0,41,41,0,1,2
"10819","4be4f8b1485e8f4c5cf0365f3246bfba",128,74,55,16.2909090909091,99,29,3,1
"10820","4be8fd9d55d7ca2599f1881aca6a94de",54,39,74,5.10810810810811,54,0,2,1
"10821","4be9cae344b61b0bf8c0b3dc1caad011",49,40,39,8.7948717948718,49,0,2,1
"10822","4beab02f80d29b40d5224f95bb99116c",51,51,0,51,0,51,1,2
"10823","4bebd7e12e089d73e70444ba7b33d653",201,125,57,24.6842105263158,149,52,3,3
"10824","4bee9476265394e0e864143aa2ac21d7",60,51,66,6.36363636363636,60,0,2,3
"10825","4beff6ded68370721d90cb4550ac0729",44,44,28,11,44,0,2,1
"10826","4bf03d84725d5dee2bbbd5c8a67312c9",65,58,50,9.1,26,39,2,1
"10827","4bfc002f9b41f57d4e7a99f68395e149",122,79,65,13.1384615384615,82,40,3,3
"10828","4c02e492dff94ec39a13ffce92d7480f",86,54,41,14.6829268292683,86,0,2,3
"10829","4c03881f8ee6e42c6bb9d2983f63b74e",27,27,0,27,0,27,1,2
"10830","4c06b79c626f97208b4ce60d51c9a515",114,91,29,27.5172413793103,68,46,3,3
"10831","4c09e4b85c7d8252ebc46ae6df7b5842",73,60,76,6.72368421052632,73,0,2,3
"10832","4c0b6542e2be401f21f9f5d801c50a84",181,128,70,18.1,181,0,3,3
"10833","4c0c506f93810ad504359bf51533f7cb",15,15,0,15,15,0,1,2
"10834","4c0dd383b2cec5bf7f5054650527486b",16,16,0,16,16,0,1,2
"10835","4c0e883defc9dd694d7156cf6e88087f",67,41,43,10.906976744186,21,46,2,1
"10836","4c12b95736a2ac3924d907c2eea915f1",144,62,52,19.3846153846154,104,40,3,3
"10837","4c12d1e8122f47805bb54921405c5b6c",37,27,43,6.02325581395349,37,0,2,1
"10838","4c144d0089bfa76c6a5a1659d1fc8626",22,22,0,22,22,0,1,2
"10839","4c15fcd9912d48024dac83e7b63ff172",24,24,0,24,0,24,1,2
"10840","4c16ad42762dbad028a28a5a3cbb14bc",139,86,58,16.7758620689655,103,36,3,3
"10841","4c179e7048a2e576a6a9e7926d193ae7",91,74,67,9.50746268656716,91,0,2,3
"10842","4c17bf81e02753b5041d1a8f2422d732",43,29,71,4.23943661971831,26,17,2,1
"10843","4c17c747c22264ad03f153955f407aee",20,20,0,20,20,0,1,2
"10844","4c19db4dd2d623252e83dc91dea226a6",88,74,36,17.1111111111111,88,0,2,3
"10845","4c1cea166c84ca532d82601bee97fff0",79,56,55,10.0545454545455,79,0,2,3
"10846","4c1e5cdb35b09f1745b3a0c45bd94f3d",34,34,0,34,34,0,1,2
"10847","4c1f07cc035fd2486f649a49f15e0007",28,22,16,12.25,28,0,1,1
"10848","4c20a8b71de2f2687e6470502434c4df",33,33,0,33,0,33,1,2
"10849","4c21207bb13f8252f94d34e727ac309a",77,58,66,8.16666666666667,77,0,2,3
"10850","4c217f568816c0696a9fc9e1685c383d",85,72,31,19.1935483870968,30,55,2,1
"10851","4c225bbe871d50ae3e888346caead2fd",158,93,62,17.8387096774194,158,0,3,3
"10852","4c22cadb6135b170bee9516352277f6b",41,41,0,41,41,0,1,2
"10853","4c24ead46719617bd7bfe6117510ed16",52,52,0,52,52,0,1,2
"10854","4c2521d1e3d49f9ece76e16879ae4ccd",196,110,73,18.7945205479452,196,0,3,3
"10855","4c259896198724a7568b756e45dec9d4",220,123,90,17.1111111111111,172,48,3,3
"10856","4c26f9498e2ded1f416ccacea44977da",46,36,33,9.75757575757576,46,0,2,1
"10857","4c27e204421f9ca702b260ee69bce720",33,33,0,33,0,33,1,2
"10858","4c2fcce3da9802d924481ea25d9f55cf",50,34,13,26.9230769230769,26,24,1,2
"10859","4c3068ed383d3b5cc84e58f6ec490fa3",114,91,38,21,68,46,3,3
"10860","4c31b214a1c11c1b5854002cf5405c23",42,42,0,42,42,0,1,2
"10861","4c324f2d8187351d4a24283ef38f450d",29,29,0,29,29,0,1,2
"10862","4c3393c0cb129268d48e96b8d46a650f",12,12,0,12,12,0,1,2
"10863","4c33a7bf30da79c06dbacf0c32b74f90",55,50,30,12.8333333333333,55,0,2,1
"10864","4c3405980e94e315cf021fbbba12a4f0",52,52,0,52,52,0,1,2
"10865","4c346e36e6c570e97602f84a624c52cb",83,47,67,8.67164179104478,83,0,2,3
"10866","4c36abb6c45411fb0f55b0bb95be767c",75,56,45,11.6666666666667,39,36,2,1
"10867","4c387db109f2064822a678c468abb1a1",11,11,0,11,11,0,1,2
"10868","4c393e59e21c34312cc2fbb41ee13317",10,9,63,1.11111111111111,10,0,2,1
"10869","4c396cc8cf0dd007b25c718b37228ee6",15,15,0,15,15,0,1,2
"10870","4c3bd42a44f2e737750454114e92a2d2",19,19,0,19,19,0,1,2
"10871","4c3c06716eaba34700a8eeedc6e81944",39,39,0,39,0,39,1,2
"10872","4c3feded919d1aa244b0cabb201e8fa8",73,53,69,7.40579710144928,41,32,2,1
"10873","4c40fcf3a5e42b1a2ec58adbcc0fdac4",253,74,78,22.7051282051282,209,44,3,3
"10874","4c421df3bec141115063456b8c0741ea",150,100,63,16.6666666666667,150,0,3,3
"10875","4c428df1f8122c8dc7bb47a506a3dadd",44,33,69,4.46376811594203,27,17,2,1
"10876","4c43c1836bbab078c83631e782aba520",12,12,0,12,0,12,1,2
"10877","4c44ce6d8f2867df0185441a86d8e6ec",92,50,63,10.2222222222222,67,25,2,1
"10878","4c45b3248a72bf193663d79daaf7e0ea",81,56,43,13.1860465116279,53,28,2,1
"10879","4c471f342c2e13698379341c29b5fea4",22,22,0,22,22,0,1,2
"10880","4c4764451fb4990b6d260179fb1e66e3",36,35,23,10.9565217391304,12,24,2,1
"10881","4c47ac75d5d59171e47eb248aedf76b8",71,35,69,7.20289855072464,41,30,2,1
"10882","4c47e244d72b3541b4a0d4cfb965275a",36,36,0,36,0,36,1,2
"10883","4c4ad317638616ba393c62af67794728",153,79,63,17,113,40,3,3
"10884","4c50a909e33d286e2d65305a6ba1ef27",15,15,0,15,15,0,1,2
"10885","4c55117c1e93e95e188e6ec4bb2e85f6",35,35,0,35,35,0,1,2
"10886","4c5580549bf72789cf864694fd40481a",29,29,0,29,29,0,1,2
"10887","4c569db56ab4deec3d161fbd77fcc119",40,40,0,40,40,0,1,2
"10888","4c56febd29a8c0127f5e40d54ac58bbd",144,106,84,12,106,38,3,3
"10889","4c57a556925be399ad3f17a19fb62f40",70,36,70,7,70,0,2,1
"10890","4c58b369564a59972a2329cc0f47db03",77,57,28,19.25,77,0,2,1
"10891","4c59429a2269ab6b63b706e99142af50",45,45,0,45,0,45,1,2
"10892","4c5a344c7bdf710da8623a9e1a68bbb0",174,94,68,17.9117647058824,122,52,3,3
"10893","4c5bc8374dc55d56746fa341f65928f1",13,13,0,13,13,0,1,2
"10894","4c5d4fb476b97957a88b5b61213905fe",9,9,0,9,9,0,1,2
"10895","4c5ddcb8f5593704e25a1d58df83b6b2",41,31,45,6.37777777777778,37,4,2,1
"10896","4c5ea71a3860db7abf44c2159bc8908c",19,19,0,19,19,0,1,2
"10897","4c5f9c90aa13ef0144e9be25425089da",34,26,26,9.15384615384615,18,16,2,1
"10898","4c6109ebd2531815e253a7b600a2997c",44,34,26,11.8461538461538,30,14,2,1
"10899","4c61ec6736ba31603782c48ba7a330b9",73,54,28,18.25,73,0,2,1
"10900","4c61fe0b08dc78674bcf2de9a92070cb",6,6,0,6,0,6,1,2
"10901","4c622aa8611e6714d201f2ed27dbc421",53,46,72,5.15277777777778,23,30,2,1
"10902","4c63e6b20260491fa55fed1153959af2",34,34,0,34,34,0,1,2
"10903","4c677e07761f32a3ce91a55cc9c0f20e",29,25,83,2.44578313253012,29,0,2,1
"10904","4c695d8b13e1352cf21987b616a5ab38",17,17,0,17,17,0,1,2
"10905","4c6b14bf3886f29b4215987b559aa389",42,42,0,42,42,0,1,2
"10906","4c6b4726d2bc1eb0c43d80f76be8baa3",249,131,75,23.24,213,36,3,3
"10907","4c6b566f79b5041e44115837985cb200",68,46,42,11.3333333333333,68,0,2,3
"10908","4c6d991876b94df2a44d5e24e07a52de",118,81,63,13.1111111111111,118,0,3,3
"10909","4c6dc22347c95566b1d9cf3db662b403",16,16,0,16,16,0,1,2
"10910","4c6e7dd982eeb6d5d29745b52d3e5063",10,10,0,10,0,10,1,2
"10911","4c6fb71841c4397cb2de57a795e6059a",21,21,0,21,21,0,1,2
"10912","4c7224d5a2c591fcdd3e4c7577cecd17",37,37,0,37,37,0,1,2
"10913","4c727aa3eada529d40e59835876c78c9",30,30,0,30,30,0,1,2
"10914","4c778f7a6ab33b8d5686ab43939afa62",58,22,54,7.51851851851852,37,21,2,1
"10915","4c7842ae0badb594da47d1f0f00d5d30",112,64,56,14,60,52,2,3
"10916","4c794825a184686f08a57b95fe6cc080",84,59,46,12.7826086956522,55,29,2,1
"10917","4c7d4cde82215a240febfdb41adb3539",18,18,16,7.875,18,0,1,1
"10918","4c7dc317176771d1a26096a4effe3af7",13,13,0,13,13,0,1,2
"10919","4c7e8e6c47665c4ae1db655e5f858588",11,10,6,12.8333333333333,1,10,1,2
"10920","4c810ba14a8418efa5745965907b71ef",90,53,69,9.1304347826087,90,0,2,3
"10921","4c81e25defba55faf96c591aeb49cd9c",54,38,58,6.51724137931034,54,0,2,1
"10922","4c84382167bff329068631fe134a9dad",107,87,43,17.4186046511628,55,52,3,3
"10923","4c849c1f88c834370d3f747a1a87a78d",25,17,63,2.77777777777778,25,0,2,1
"10924","4c857b94ef9f3ad4bd005afb88fb2136",86,49,64,9.40625,86,0,2,3
"10925","4c8dfc3bf176a726a444f12c09fd41b2",50,50,24,14.5833333333333,14,36,2,1
"10926","4c8eb71b647b3ad61e009f4d046edda9",20,20,0,20,20,0,1,2
"10927","4c8f50335e0a4dac4dc29e79fdbe7f9d",41,41,0,41,41,0,1,2
"10928","4c91d5f0183bcb0251ba1bcd3b9b6294",41,41,0,41,41,0,1,2
"10929","4c9248f8c5dc95aaa97c23872f91cf50",17,17,0,17,17,0,1,2
"10930","4c92be976a0d19607254714d0eb32094",134,93,34,27.5882352941176,134,0,3,3
"10931","4c92f5ece7e1545bb4b3d6805dd8c8b0",117,59,70,11.7,117,0,3,3
"10932","4c93267dc9fe9b63d75c8057d8a8cf0c",26,26,0,26,26,0,1,2
"10933","4c9543bef4f558880edad47560aaa9a6",23,23,0,23,23,0,1,2
"10934","4c97a0d9b23e810cce1cbfafce0ce1fd",27,27,0,27,27,0,1,2
"10935","4c981b471b11095c4d3ef4b7519136b0",18,18,0,18,18,0,1,2
"10936","4c9c572100f44b1bb0eb288d00979ce3",18,18,0,18,18,0,1,2
"10937","4c9eb1e25d401f5d5a74a4f7a53a13fb",67,39,33,14.2121212121212,67,0,2,1
"10938","4c9f327aa1d619848e745a3952462b5f",26,26,0,26,0,26,1,2
"10939","4ca0e92fc34a58e91eead00ce6632799",30,30,0,30,30,0,1,2
"10940","4ca2a14a1febcc000414ae2bb42e3e56",20,20,0,20,20,0,1,2
"10941","4ca2f8a6917d57e13b5fe8096be5e95f",25,25,0,25,25,0,1,2
"10942","4ca503e3902d6f2c5242b5ab8a43bfd8",36,36,0,36,36,0,1,2
"10943","4ca8446dec0ea4d46987ac3fee9e232f",197,97,75,18.3866666666667,173,24,3,3
"10944","4cac71999995374bd1ef67c3d37493c9",189,120,44,30.0681818181818,189,0,3,3
"10945","4cace95090fd20d129640169c0be1303",127,53,64,13.890625,127,0,3,3
"10946","4cacfd351f7d7a303171b5e7dab4ecb3",41,41,0,41,41,0,1,2
"10947","4caf8d76157ca8638d094154dde480fe",187,112,64,20.453125,187,0,3,3
"10948","4cb2f3c51643e75a05cf033634144ab0",27,26,7,27,27,0,1,2
"10949","4cb6669166c7c93df6092421d40d38cb",28,28,0,28,28,0,1,2
"10950","4cb73c9d5e7eb0585144605c465c631a",36,33,14,18,36,0,1,1
"10951","4cb7ccfeeb3710b9bc5b9c2c2a2f4e70",66,40,66,7,66,0,2,1
"10952","4cb8fa8f961bbf01e0f336bc946f1d98",197,111,57,24.1929824561404,197,0,3,3
"10953","4cb91367eeb672ba89834eedb0b485e1",20,20,0,20,20,0,1,2
"10954","4cb962781ebb464ec17c10e873f6668c",27,25,61,3.09836065573771,27,0,2,1
"10955","4cb9f66b86e8fa43ac89fb13a78af098",10,10,0,10,10,0,1,2
"10956","4cbc59386b8edcccb66567f04448e4cb",182,100,63,20.2222222222222,182,0,3,3
"10957","4cbc5cb08e176df51e1fe32758a32c42",39,39,0,39,0,39,1,2
"10958","4cbc788bbaf55825a8198692180d0f15",18,18,0,18,18,0,1,2
"10959","4cbd29e8d1f0f02e6aa5026d72677c9c",31,23,42,5.16666666666667,31,0,2,1
"10960","4cbe542282e962ebc7e82d4b8c4332d8",95,58,14,47.5,95,0,1,2
"10961","4cbe7653f16e05461cd263c5a9eea5a3",21,21,0,21,21,0,1,2
"10962","4cc23717752f53092ae1cd8b61eb2d92",70,56,33,14.8484848484848,36,34,2,1
"10963","4cc2b1fc11ff492499836c1f903e4ef1",39,39,0,39,39,0,1,2
"10964","4cc57a00c97571f6028d236d4686b8d4",17,17,0,17,17,0,1,2
"10965","4cc691099f5e2948e62d49ca29657728",185,88,76,17.0394736842105,160,25,3,3
"10966","4cc6d11ad5a47c9d7bbe18a67145a7e5",33,33,0,33,0,33,1,2
"10967","4cc996e21d739a9879827f20f9b54a15",21,21,0,21,0,21,1,2
"10968","4cca0c6b7d52e577619d7fc1045a4a21",175,119,81,15.1234567901235,127,48,3,3
"10969","4cca7bbe8ca24f94d51f7fd424405f76",78,40,47,11.6170212765957,62,16,2,1
"10970","4ccac87759ff6b293b9b49462c3c56f7",29,29,0,29,29,0,1,2
"10971","4cce08a2ae2956bd3ce48bbc60d30ea0",20,20,0,20,0,20,1,2
"10972","4ccede8729e85fc5230fe023e3619c85",127,106,27,32.9259259259259,86,41,3,3
"10973","4cd296952000ea232f244a5d610caea0",109,47,81,9.41975308641975,109,0,2,3
"10974","4cd462431b42476f018e14fad4617483",29,29,0,29,29,0,1,2
"10975","4cd6c9a70943400bf08b1a8bb93445ae",41,32,38,7.55263157894737,29,12,2,1
"10976","4cdeae45b3fbd22c6bf07034e0b84133",97,56,48,14.1458333333333,97,0,2,3
"10977","4cdf28c326bf5a2dba3439f56c274181",1,1,0,1,1,0,1,2
"10978","4ce2b957e48dea757393f821c55509dd",13,13,0,13,0,13,1,2
"10979","4ce2d22f61b98cba866ec33f776a5ad1",213,114,78,19.1153846153846,213,0,3,3
"10980","4ce516aaf891b72a165c857fd904654a",24,24,0,24,24,0,1,2
"10981","4ce5dfbb803597cd432d42a2ad33e799",15,15,0,15,15,0,1,2
"10982","4ce7e10e7a4c3aab178dfd8aba0a5759",24,24,0,24,0,24,1,2
"10983","4ce8aa6fba2533f70186b3e5deb2d773",24,24,0,24,24,0,1,2
"10984","4cea1b2392cc032e7068e4a0ef15f279",211,100,63,23.4444444444444,211,0,3,3
"10985","4cee80be9b979357f65921a9a62dd1b8",43,39,51,5.90196078431373,43,0,2,1
"10986","4cee87e1baeda728778238b71e91a76c",23,23,0,23,23,0,1,2
"10987","4cef6662d169a45e33f10c913f309b12",115,71,66,12.1969696969697,76,39,3,3
"10988","4cefafe2bc6ba4cd47ddc3a06d86c11d",112,74,35,22.4,112,0,3,3
"10989","4cf57d9db365ea3785693d3f1cb52d1e",1,1,0,1,1,0,1,2
"10990","4cf825b8521799a3195a06e27f3f2a37",80,63,40,14,80,0,2,3
"10991","4cf89ed8984e2d37fd21fa5e194ac0a0",84,59,39,15.0769230769231,84,0,2,3
"10992","4cf94ee9cdc6fadd5217f4e8a44e26a3",142,100,85,11.6941176470588,142,0,3,3
"10993","4cfc92db0c6e1df7f0ef4d71ffaccfce",40,40,0,40,0,40,1,2
"10994","4cfd1636934fa3a2c54301575b88d33d",53,42,34,10.9117647058824,53,0,2,1
"10995","4cfd6620c856b9a14c33527c6d71ca1c",30,27,6,35,16,14,1,2
"10996","4cfd848631735a2ab6a19376026fb5d7",47,43,53,6.20754716981132,47,0,2,1
"10997","4cfd9b2a53fa746d4f32725fcaf08e26",120,79,44,19.0909090909091,120,0,3,3
"10998","4cfe22cf21e4f3bff09e5f29b028776d",34,24,50,4.76,34,0,2,1
"10999","4cfeb5599a342a2ff82fa48b9673fc30",72,67,29,17.3793103448276,72,0,2,1
"11000","4cffc97c384178177bd58bb73fbd141f",30,30,0,30,30,0,1,2
"11001","4d00da7f735ed83d8fceb29028b0dd02",17,17,0,17,0,17,1,2
"11002","4d06a39a88ebbab99a6e379a2c9dc272",189,105,58,22.8103448275862,189,0,3,3
"11003","4d09f802e3d5325001beccd4c57f4ee9",177,96,60,20.65,177,0,3,3
"11004","4d0a2707000679beed229ee7e214c768",41,41,0,41,41,0,1,2
"11005","4d133a97025100a708af0b4a43dee406",136,82,43,22.1395348837209,136,0,3,3
"11006","4d13ed14f0354d2a4fec30a1140a4238",8,8,0,8,8,0,1,2
"11007","4d16408c646e465cbd5be9c49e531c9f",18,8,76,1.65789473684211,18,0,2,1
"11008","4d1a13b95a2262f54c12bb8297e776cf",100,58,71,9.85915492957747,100,0,2,3
"11009","4d1a4d224ef71347f1dc0c5b88491b75",28,28,0,28,28,0,1,2
"11010","4d1cf906a68305a1933c1e89c7a99404",36,36,0,36,0,36,1,2
"11011","4d1e3ed4ff9ede18c36e7df4a5fed27e",24,24,19,8.84210526315789,2,22,1,1
"11012","4d236d6cf4917c2d062539ca88e58569",55,39,45,8.55555555555556,55,0,2,1
"11013","4d23df278aa36a284dd37819bea04821",37,37,0,37,37,0,1,2
"11014","4d24fd0f7530550a092d3f33cc3daabf",37,37,0,37,37,0,1,2
"11015","4d265546d119fa3f5eca4ced5bf408e2",38,38,0,38,38,0,1,2
"11016","4d28e4d435a6a4c1fab2e6af931a926c",20,18,42,3.33333333333333,0,20,2,1
"11017","4d296a78f5b581d461f17e271dcc0a71",151,96,64,16.515625,132,19,3,3
"11018","4d29c0349ce45b1c7a64f8155b8244bc",116,76,56,14.5,77,39,3,3
"11019","4d2a1f9803ac41e38c884a04e0a8179b",11,11,0,11,11,0,1,2
"11020","4d2ba1f6282bbc86671c004eecce916c",16,10,65,1.72307692307692,16,0,2,1
"11021","4d2d95bc90595416b8898ed8560fe5ce",54,37,49,7.71428571428571,0,54,2,1
"11022","4d2dc35d0f3561f14efdfa337d1ba0ce",29,29,0,29,29,0,1,2
"11023","4d2f24527ccf82c23c22e75bf49b14d6",47,47,0,47,47,0,1,2
"11024","4d30b476b42fb1181dde4978b8b254d3",104,79,30,24.2666666666667,104,0,3,3
"11025","4d3677e7c640847ed4553026dc13ccb1",163,99,57,20.0175438596491,118,45,3,3
"11026","4d39550ccf5f0e8057384349aa607628",136,86,77,12.3636363636364,136,0,3,3
"11027","4d3a26b35b2f982313e1b6b897d50619",146,99,61,16.7540983606557,103,43,3,3
"11028","4d3a592d5f16fe534c69461abacdb647",22,22,0,22,0,22,1,2
"11029","4d3a68100c418373ccf76223ec35c52d",19,18,26,5.11538461538461,19,0,2,1
"11030","4d3aa7560eb422bdd8e64eba394ecc56",58,49,28,14.5,58,0,2,1
"11031","4d3c42b9e5f9989d6c957e5a70a284c9",46,34,28,11.5,46,0,2,1
"11032","4d3cca0ac766755245a28637873aba9b",94,77,20,32.9,94,0,3,3
"11033","4d3cdb8401e820a2c909c7fb36f7f252",29,29,0,29,29,0,1,2
"11034","4d3d81822faf8f612856d50c47ba4740",67,45,30,15.6333333333333,67,0,2,1
"11035","4d428e857e75ceb4bda7e9b6ce32b9fd",21,21,0,21,21,0,1,2
"11036","4d42aedce96bfe2692d3a77d76f6fd80",32,32,0,32,32,0,1,2
"11037","4d4368d3fd9c668d989c0f716a3a23a1",109,69,61,12.5081967213115,109,0,3,3
"11038","4d464491e7b37eafde94a1df03834e72",28,28,0,28,28,0,1,2
"11039","4d48451368fc37ce96986ba8a31ad8ce",84,67,52,11.3076923076923,58,26,2,1
"11040","4d4aef85e57ad8b644e37cc3b265a025",34,25,47,5.06382978723404,34,0,2,1
"11041","4d4c21f9a58f06a88c8eb398cf9e12c8",87,59,56,10.875,87,0,2,3
"11042","4d4c7f692b2a854fe1cc3a837844b957",8,8,0,8,0,8,1,2
"11043","4d4f1aa2ac515218339b7c9be747c665",151,71,82,12.890243902439,151,0,3,3
"11044","4d505eb55d958f2eac7b669183fc473e",10,9,26,2.69230769230769,10,0,2,1
"11045","4d5263f85a6e7160eaec0094cdc19536",57,48,28,14.25,57,0,2,1
"11046","4d530b7a4e3264c75d7252113a4d87dd",3,2,45,0.466666666666667,2,1,2,1
"11047","4d563f3c3408f91d453825ecbbad317d",46,46,0,46,46,0,1,2
"11048","4d5777ae0f5039eb129932b41cb35426",4,4,0,4,4,0,1,2
"11049","4d5cbb11e265bbfbe7d4a0f68d70d59e",118,75,57,14.4912280701754,81,37,3,3
"11050","4d5e1824b8f04f567afb2a54175a84b7",51,51,0,51,51,0,1,2
"11051","4d60f6aebf4f93adfcd4a39e08edacf4",141,105,50,19.74,141,0,3,3
"11052","4d61ec095ab3dc1fea3f050d9fcb22f0",184,68,80,16.1,184,0,3,3
"11053","4d6274b05a87639a75e15ee52a4e547c",164,99,61,18.8196721311475,164,0,3,3
"11054","4d63020b0a1a5f596ff68f4fde98a63b",47,33,50,6.58,35,12,2,1
"11055","4d64e4a14291e5adeb29e9b6731be94b",198,139,51,27.1764705882353,179,19,3,3
"11056","4d64e6153d2096d1501ba3b80ace3f9c",15,15,0,15,15,0,1,2
"11057","4d6592c5d50cc48d23dd4582e2ac9325",62,46,56,7.75,62,0,2,1
"11058","4d65f34355bcadb128bb6e29b3d39ce4",150,114,56,18.75,138,12,3,3
"11059","4d667a0a97b2fdc076ca8ebe46ec0d4b",112,68,67,11.7014925373134,112,0,3,3
"11060","4d6b1dfa438030b83b61ee17e1ff6134",31,31,0,31,31,0,1,2
"11061","4d74e3e92a6de171bdb2df4437162875",31,31,0,31,31,0,1,2
"11062","4d7772219bed96b2e03ec436122d389b",38,38,0,38,0,38,1,2
"11063","4d789633cbaf8e01121e812a067b7c9a",36,27,35,7.2,0,36,2,1
"11064","4d78e301a4a2575e6a5fc8a18eb21c9b",39,39,0,39,39,0,1,2
"11065","4d7ad9ae3d87035f99c3ef8ebaf08a36",37,37,0,37,37,0,1,2
"11066","4d7bb29d8aa7a3f3e004de01b33183e1",36,36,0,36,36,0,1,2
"11067","4d7cc74e62a5dfe47e49c14a5030b1f1",14,14,0,14,0,14,1,2
"11068","4d81ae6b0f5451ec82fd94308370c101",67,53,29,16.1724137931034,67,0,2,1
"11069","4d824b9f792b9ca43143bbcd5b777d20",55,44,14,27.5,55,0,1,1
"11070","4d83705c40b7b8f1db7a1521a161251a",104,75,69,10.5507246376812,70,34,3,1
"11071","4d839f6a1e8a2070fa299a796d284517",164,102,70,16.4,164,0,3,3
"11072","4d86343c13c09460a8accd2b6fac65d7",72,56,26,19.3846153846154,72,0,2,1
"11073","4d86b7fc375d23e1e7f894b4d7c4961c",28,21,48,4.08333333333333,28,0,2,1
"11074","4d88f23062ab5f6a0b8a82cceaf31359",26,26,0,26,26,0,1,2
"11075","4d8904727b1be8feafed660e944979af",22,18,51,3.01960784313725,22,0,2,1
"11076","4d8a0f4741c340307df9f2f6d5197415",117,88,25,32.76,85,32,3,3
"11077","4d8c3b4b512eb600a66e6fdd545ad6d5",29,18,65,3.12307692307692,29,0,2,1
"11078","4d8c9145bee8c85be1b865e1890c4af5",215,119,75,20.0666666666667,215,0,3,3
"11079","4d8c9de2b193a9e8a3693dade9d7c847",42,42,0,42,42,0,1,2
"11080","4d8cd2c1371aef6c4f2f6c50bacfce9a",40,34,56,5,40,0,2,1
"11081","4d8e1d57535b7754386761c466c22927",63,58,59,7.47457627118644,28,35,2,1
"11082","4d8eb9a1b0a4becdb473e4ed1319f440",168,115,55,21.3818181818182,121,47,3,3
"11083","4d8fe56145e8a262373075f3e6c3194b",184,70,64,20.125,184,0,3,3
"11084","4d940894ade0dd4ab0809c7a6b7bda91",217,99,76,19.9868421052632,191,26,3,3
"11085","4d97989111a16fdf5a526fcc2cce6ab7",47,47,0,47,47,0,1,2
"11086","4d97db975a1940007a5cdd0c55cba816",42,36,30,9.8,42,0,2,1
"11087","4d9b9dd19c38837ba5b678e619c4043e",38,38,0,38,38,0,1,2
"11088","4d9bffaf86d389c0e79e8205c35c3d82",31,31,8,27.125,31,0,1,2
"11089","4d9f6fed61e1b61d4be90b1587079e91",60,45,79,5.31645569620253,60,0,2,1
"11090","4da3266e9059f80dfcfeeee3fad22f02",15,15,0,15,15,0,1,2
"11091","4da412b1e2a41cbac6b466c3e7953186",179,95,77,16.2727272727273,143,36,3,3
"11092","4da64588c03a1fba40b7049e9b353012",61,47,75,5.69333333333333,26,35,2,1
"11093","4da8059717b60d3037e9ce27a01534b5",20,20,0,20,20,0,1,2
"11094","4da8b89279725fcabb4fdfc9e485d50f",38,29,51,5.2156862745098,19,19,2,1
"11095","4dac7fe5c943616c82aa89d04e3516bd",182,115,49,26,182,0,3,3
"11096","4dade66d072a9c8d7c4cdeb0b90daf8f",10,10,0,10,0,10,1,2
"11097","4db07fb70ecc620a3a66ea635e631de1",63,53,45,9.8,30,33,2,1
"11098","4db13a18249d4fccf7cc749c76808bae",30,30,0,30,30,0,1,2
"11099","4db1c97732446a082fc21613854ce978",15,15,0,15,15,0,1,2
"11100","4db4390f0c22915439a5cd4129bb9306",22,21,22,7,22,0,2,1
"11101","4db51e55f40d8d215e7631f8699ff762",23,23,0,23,23,0,1,2
"11102","4db88bfc2f46afc223493dc060509f33",48,35,71,4.73239436619718,48,0,2,1
"11103","4db93c9524fe1f6de9b4b8327497915e",15,15,0,15,15,0,1,2
"11104","4dbfd3c91ede49679efe818726a9bcfe",53,45,19,19.5263157894737,25,28,1,1
"11105","4dc378ce0d12878b77d49104ab8f5745",113,83,37,21.3783783783784,113,0,3,3
"11106","4dc54c82231d3d7a717be2370f12004c",96,84,60,11.2,45,51,2,3
"11107","4dc69d2811d57a4e34eeb3660aa333be",76,62,36,14.7777777777778,36,40,2,1
"11108","4dc6aaf9674e531dbd1fbb14a83dce73",69,54,42,11.5,69,0,2,3
"11109","4dc71a02a64d9a99da59d5f0b8286ddb",82,70,19,30.2105263157895,82,0,1,3
"11110","4dc73d93e1d91abfc909a8001bf0eb56",27,27,0,27,27,0,1,2
"11111","4dc776a396311fe65990fc693a760774",26,26,0,26,26,0,1,2
"11112","4dc84e2ed8af1778e4998264d5a4581f",39,39,0,39,39,0,1,2
"11113","4dca47afe03b2706026a699441aea567",3,3,0,3,3,0,1,2
"11114","4dcb310aaf39b5f41d806ef5d2e27309",92,67,76,8.47368421052632,92,0,2,3
"11115","4dcdf129b28f28f891b60cb8ed23ee2b",49,49,0,49,49,0,1,2
"11116","4dce86a9cdd5d7bf60a4c5ac58c9963e",25,25,0,25,0,25,1,2
"11117","4dcf740ad7762c1a29a34b7cd976ac78",102,70,46,15.5217391304348,68,34,2,3
"11118","4dd6b3142432ec8b3040a519275eba08",8,8,0,8,0,8,1,2
"11119","4dd9e79c2a66cf851d15c405ae4afb5d",204,109,67,21.3134328358209,204,0,3,3
"11120","4dda64770857b109f9fd6a6b88450846",37,37,0,37,37,0,1,2
"11121","4dde42e99818e84ac2c40e5a47daa665",8,8,0,8,8,0,1,2
"11122","4dde9adae2cd529c8396eea4d0976e7d",33,33,0,33,33,0,1,2
"11123","4ddf1027f2b12e218a437f8ad44a7d0d",145,69,60,16.9166666666667,145,0,3,3
"11124","4de1762d5bc767e33a466b63583c5afa",39,39,0,39,39,0,1,2
"11125","4de181753c7c5199c7a4e24b4cecfb02",50,50,0,50,50,0,1,2
"11126","4de3ab88ee6362f03f1f4e4f22679e98",78,56,42,13,78,0,2,3
"11127","4de5fe82fb801aff99fec46b0d085904",29,26,49,4.14285714285714,29,0,2,1
"11128","4de6da93a8e5cc839777e507ca728739",11,11,0,11,11,0,1,2
"11129","4de910e61bd01482c784f4bbf4a128f7",51,43,44,8.11363636363636,51,0,2,1
"11130","4de9e6182df2b7ffa9eeee5d453daecd",17,17,0,17,17,0,1,2
"11131","4deb7e429724d8c3f03ef17d6e5f8ec7",136,67,78,12.2051282051282,136,0,3,3
"11132","4dee804aef94e0e1ea53e04dc2378437",73,55,54,9.46296296296296,73,0,2,3
"11133","4dee92451393ce429e3f4030f91cdc3d",25,25,0,25,25,0,1,2
"11134","4df155c47f03614097927d77b111719f",87,67,56,10.875,87,0,2,3
"11135","4df15b3ee6314477f5b060eacf9b824a",120,93,37,22.7027027027027,120,0,3,3
"11136","4df24fe8873b40ca9459841c652798bf",114,89,56,14.25,76,38,3,3
"11137","4df346378b9ea1dc53ecc8340763a5fb",21,21,0,21,21,0,1,2
"11138","4df5899c21e305b5843c7cb7c524abda",105,81,52,14.1346153846154,92,13,3,1
"11139","4df614dd17aece5c7ed7446b6b6c9e9d",55,55,0,55,0,55,1,2
"11140","4df86c6fc1c2f1a3e0e7306816d494d5",62,49,51,8.50980392156863,35,27,2,1
"11141","4dfdbd6da52bca73165cfa25fe7b7476",106,73,70,10.6,106,0,3,3
"11142","4dff8ed3cc278605739ba23accbb3a53",6,6,0,6,6,0,1,2
"11143","4e00399f482c8f20e230aa2ce4af8b8e",106,72,56,13.25,106,0,3,3
"11144","4e019d8c93ac6332f132e292580a52fe",82,45,79,7.26582278481013,62,20,2,1
"11145","4e01e2efba4637bf74869433056fc089",189,88,82,16.1341463414634,134,55,3,3
"11146","4e04b824db13fe9a9b2f758ed2439f25",58,44,73,5.56164383561644,57,1,2,1
"11147","4e05d263aa0fc297ea8b4ca32a90d55e",140,73,75,13.0666666666667,140,0,3,3
"11148","4e066f783b837789c5b82750ff5be254",195,107,65,21,159,36,3,3
"11149","4e06890d3c9acbce0b8858d6a6cd14e8",31,31,0,31,31,0,1,2
"11150","4e0a7241223deec8a1821b4ac7292113",15,15,0,15,15,0,1,2
"11151","4e0b1e89411a8b0e0eeef65535217772",188,107,32,41.125,136,52,3,3
"11152","4e0ca742afd72fbad381fff69082e9e4",64,20,83,5.39759036144578,64,0,2,1
"11153","4e0f3dbe06dc79b99e9b4213ca405561",31,31,0,31,31,0,1,2
"11154","4e103afac3cfb94f802b059d6e595d99",132,65,61,15.1475409836066,92,40,3,3
"11155","4e11c15a449967a5a1a4de4c5a4e9c70",174,153,41,29.7073170731707,174,0,3,3
"11156","4e126a1e8187772f561d7c5e911ad209",26,26,0,26,26,0,1,2
"11157","4e1367bd09807c4cedec6476e6b860df",95,80,23,28.9130434782609,58,37,3,3
"11158","4e13c4aeeef4bb47c5306bb9be8ac03a",101,42,89,7.9438202247191,75,26,2,1
"11159","4e14547163706524dbad996abe46212f",29,8,75,2.70666666666667,29,0,2,1
"11160","4e15aa50d280afd52aec20c153aed330",94,63,41,16.0487804878049,94,0,2,3
"11161","4e15d87467e25533512153556289a8e3",1,1,0,1,1,0,1,2
"11162","4e1653aff076dae30432000daee82d5c",57,41,47,8.48936170212766,31,26,2,1
"11163","4e17211e26faafe40034fa36a31479f5",7,4,56,0.875,7,0,2,1
"11164","4e183c112a35b5ecaeeeb2e5cb22b69b",38,35,36,7.38888888888889,38,0,2,1
"11165","4e1cc5e7b7cf1cfc4a5370c610fefdee",56,44,20,19.6,56,0,1,1
"11166","4e1d13a9fd62208e2f9d46d5e1760483",1,1,0,1,1,0,1,2
"11167","4e1da503ac9a6cbbd3eb57d9297ad525",35,26,27,9.07407407407407,35,0,2,1
"11168","4e203b79ec8e12a79c436645eef2b79e",75,58,21,25,75,0,1,2
"11169","4e234db0e18c221be766f5a2dec93022",115,92,54,14.9074074074074,86,29,3,3
"11170","4e2356a1a380e76b7ae38dd4dddc61de",17,17,0,17,17,0,1,2
"11171","4e25dc1d0787ba7f8c3e2e8d48c07c1c",70,51,63,7.77777777777778,70,0,2,3
"11172","4e27aa9097985cc43d8fcf8381af849c",43,43,0,43,43,0,1,2
"11173","4e2a902fd65af1f4c93418bfde77d7b3",58,44,42,9.66666666666667,58,0,2,1
"11174","4e2ba7ead5744bc1ddc94037616c3180",67,44,49,9.57142857142857,67,0,2,3
"11175","4e2c6e663d60417650515972b7489160",43,43,0,43,43,0,1,2
"11176","4e2d448909c6fa72fe36585759b26585",153,89,65,16.4769230769231,153,0,3,3
"11177","4e2fda3035ef1b4155bace87fb4dfd42",31,26,68,3.19117647058824,31,0,2,1
"11178","4e37edb3e76377a314981f3cdef04709",78,46,61,8.95081967213115,78,0,2,3
"11179","4e37fc58db7a51649fc77e6f4b38d5a2",15,12,19,5.52631578947368,15,0,1,1
"11180","4e3dd671b284bc235b18b8089d2b722f",226,41,84,18.8333333333333,207,19,3,3
"11181","4e3f38fc1fbda6ff608652dd9fc3fdf2",85,67,46,12.9347826086957,85,0,2,3
"11182","4e41433934d5fa6016bbbb08c9e6c412",24,24,0,24,24,0,1,2
"11183","4e4249a35551a83ffb5db890601a7b80",42,42,0,42,42,0,1,2
"11184","4e44eb4a66f6fa38d5f1cd4a124d2cdc",52,41,34,10.7058823529412,52,0,2,1
"11185","4e45d9aa0ba1e8f1194e5e3183f65fa2",79,59,31,17.8387096774194,79,0,2,1
"11186","4e4744e4186b9c7b1e078123e91cf2ab",13,13,0,13,0,13,1,2
"11187","4e4c46b69b57d3ca192f15d6013b6301",161,102,63,17.8888888888889,161,0,3,3
"11188","4e4cb6c0ddf0e1ab9d8288dd58aa796d",23,21,45,3.57777777777778,23,0,2,1
"11189","4e4d72ad6c0f6eac92f13f807b8f0799",53,43,34,10.9117647058824,53,0,2,1
"11190","4e4d83273955309ceca80d7904a4d9be",54,46,23,16.4347826086957,54,0,2,1
"11191","4e4df85af950425df04b463406bb6e8d",50,45,40,8.75,50,0,2,1
"11192","4e50a5cbb94083112478fb463da5d45e",23,23,0,23,23,0,1,2
"11193","4e50df31e574377f4675b653208fd696",43,35,35,8.6,0,43,2,1
"11194","4e52f87060410c7ba322ba1e69a392eb",80,70,17,32.9411764705882,37,43,1,1
"11195","4e54d9d94b563ebc861ea00599c8eada",7,7,27,1.81481481481481,7,0,2,1
"11196","4e580c31e588f16f236c8d43ac66e5fc",32,32,0,32,32,0,1,2
"11197","4e5a5d2c609a3b213e3944bb2621c0fa",187,87,76,17.2236842105263,187,0,3,3
"11198","4e5ec1875f9a5f529708b38982b00e45",32,32,0,32,32,0,1,2
"11199","4e611cb599ae5c9752e8714f0ed8f286",107,75,82,9.13414634146342,107,0,3,3
"11200","4e6b524c1d939d833dc08ec519efd38d",182,71,84,15.1666666666667,140,42,3,3
"11201","4e6bf86aaaacbcfe62c68d909c2bfd9b",156,108,57,19.1578947368421,156,0,3,3
"11202","4e6d186722d2dfe2e703d90f09ab407a",114,65,47,16.9787234042553,114,0,3,3
"11203","4e6d417353f69a5d7ff352a51f99d623",85,46,52,11.4423076923077,85,0,2,3
"11204","4e6deea666878a547d270a9cac7d2afd",141,77,53,18.622641509434,141,0,3,3
"11205","4e7006db9af4a329cbb0dbcc47b17cfd",44,44,0,44,44,0,1,2
"11206","4e70b2fd32e6b4a5a635dd67aba51453",88,57,83,7.42168674698795,60,28,2,1
"11207","4e76c56093b68021281ac88688dfa83f",45,45,0,45,45,0,1,2
"11208","4e77cce480b7f06281d55292b9510580",111,63,51,15.2352941176471,74,37,2,3
"11209","4e78ff9d002a142a1db044cd76dabb8f",30,30,0,30,30,0,1,2
"11210","4e7a9cf03c2df3b8d70f45e06a46c5d4",33,26,59,3.91525423728814,16,17,2,1
"11211","4e7ab3db7d7fbaa12ae7d95e0362f27f",197,92,67,20.5820895522388,169,28,3,3
"11212","4e7d2db446ba3478c5612884634a98a4",22,22,0,22,22,0,1,2
"11213","4e7ece91d0e8efd3a3a27080ab55d859",141,90,76,12.9868421052632,141,0,3,3
"11214","4e7fb14e327ca391508ca858b32e6810",64,31,60,7.46666666666667,64,0,2,1
"11215","4e8026be58c331504afc4bbca5f1a678",213,110,55,27.1090909090909,165,48,3,3
"11216","4e8051be17202e32959cac3f793550c2",36,36,0,36,36,0,1,2
"11217","4e80cc8afd006c4990a1b447f328dd6d",31,31,0,31,31,0,1,2
"11218","4e8277b8568aa186f0b406bb70875baf",17,17,0,17,17,0,1,2
"11219","4e840f5c68d4a46e32283f3024e4a2de",52,36,61,5.9672131147541,40,12,2,1
"11220","4e85d4ed59d0e7e8323fcf4084526b21",77,65,53,10.1698113207547,63,14,2,1
"11221","4e862dd588a71d5564a51ee25076b252",199,91,84,16.5833333333333,182,17,3,3
"11222","4e8b70f23c3c8c47fb694199895445d1",25,22,29,6.03448275862069,10,15,2,1
"11223","4e8c89669019f9808a39039dc3375165",44,38,18,17.1111111111111,44,0,1,1
"11224","4e8cffed7b64ebce4b661dffc67b79d4",64,42,19,23.5789473684211,64,0,1,1
"11225","4e8d21dda1027e5e71a637e172dd2e30",50,35,62,5.64516129032258,35,15,2,1
"11226","4e8e1c347095f2b43e4b480181fab6a6",51,40,28,12.75,51,0,2,1
"11227","4e8f4ded17629a40d851e09318456658",13,13,0,13,0,13,1,2
"11228","4e90e8fb5ec998d92483b0736d0fde01",108,84,64,11.8125,108,0,3,3
"11229","4e938cbf1cea3a1a253a886cdd84c3c5",21,21,0,21,21,0,1,2
"11230","4e998b780f6a19703a4a8240a8b68338",76,55,84,6.33333333333333,28,48,2,3
"11231","4e99beb822fc28d5a5ab724026426548",138,75,74,13.0540540540541,138,0,3,3
"11232","4e9b1db76b8d1f7419da530a14b63e46",187,96,82,15.9634146341463,187,0,3,3
"11233","4e9b65f8308db75b6ce4e91b36cf2982",6,6,0,6,6,0,1,2
"11234","4e9d2eb26839fdb993ee29c67ee6c94c",113,76,81,9.76543209876543,69,44,3,3
"11235","4e9e5d60bc97d4622d9137d4a9e0fd8e",44,44,0,44,44,0,1,2
"11236","4ea0508532fd20acf5b139012cdf2f65",25,19,78,2.24358974358974,14,11,2,1
"11237","4ea662719956c1176d21093261f96501",28,28,0,28,28,0,1,2
"11238","4ea6c2adbc524bbfc427546255a2bf08",191,108,78,17.1410256410256,154,37,3,3
"11239","4ea7c41e56c236b5bdf0b8c6f4452683",47,47,0,47,47,0,1,2
"11240","4eaa8098902e1f55d312bac6e7dfbaa2",15,15,0,15,15,0,1,2
"11241","4eae400f8934f0d3f50454e91a588620",18,18,0,18,18,0,1,2
"11242","4eb040dc397fa7c50235ba517b4240f7",138,91,41,23.5609756097561,138,0,3,3
"11243","4eb0ce3e4c51d65cfdffbbc7cdaeb708",26,26,0,26,0,26,1,2
"11244","4eb141a145d95b9a1eaa8aa98d2fe7a0",67,41,36,13.0277777777778,67,0,2,1
"11245","4eb16d3a388910e9f306a80efacc11c3",82,54,62,9.25806451612903,82,0,2,3
"11246","4eb2fb7bfd424e83be37987eddc7d96f",133,102,75,12.4133333333333,133,0,3,3
"11247","4eb47de83a9d52929ff2c823f3e366de",200,128,79,17.7215189873418,155,45,3,3
"11248","4eb4c6e05379d6c2ac504a93c683b3de",214,134,73,20.5205479452055,214,0,3,3
"11249","4eb4eaf6f57bef05669577772ae7a26e",18,18,0,18,18,0,1,2
"11250","4eb5b6fa8597d88d15e128c257bf7220",172,99,80,15.05,172,0,3,3
"11251","4eb81aca8c39418906a4141c25b4956f",54,44,15,25.2,54,0,1,1
"11252","4eb95bc0fc9281601d6613625046601a",182,78,59,21.5932203389831,182,0,3,3
"11253","4ebbba705b800d6140ac902c7a1c4026",172,109,63,19.1111111111111,172,0,3,3
"11254","4ec5aa1c53dc491ba007104d8121a5de",40,35,66,4.24242424242424,40,0,2,1
"11255","4ec69f7a94b414aa28e0eca5871f2833",3,3,0,3,3,0,1,2
"11256","4ec791f6397e7a658d7d4affec08fdd9",103,64,55,13.1090909090909,103,0,2,3
"11257","4ec91259355f71b4ea6c64bb01e92157",119,73,27,30.8518518518519,119,0,3,3
"11258","4eca7f057ef8fc9cc989a19a749719cb",38,38,0,38,38,0,1,2
"11259","4ecacd60029fbc49759d437e5e53a56a",87,50,65,9.36923076923077,87,0,2,3
"11260","4ece50e7ba19c74d79c46d1fe53808ec",52,42,33,11.030303030303,31,21,2,1
"11261","4ece9b754d23f35773d6e9994a60a8cc",37,37,0,37,0,37,1,2
"11262","4eceef30b9889c42c34877089d15e2e2",32,32,0,32,0,32,1,2
"11263","4ed3e17215b242fb50bcf70c712345b8",70,54,63,7.77777777777778,70,0,2,3
"11264","4ed43d781a57bca3b94bb2fea5ce005b",68,50,89,5.34831460674157,68,0,2,3
"11265","4ed4da20df0be457875848230ac0761f",174,50,76,16.0263157894737,174,0,3,3
"11266","4ed50085f3839474e44f3aba209d1f1b",32,32,0,32,0,32,1,2
"11267","4ed7131a2c97a88a195703d9851d012e",71,61,17,29.2352941176471,37,34,1,1
"11268","4edb5b462c66bb1d45a60ec05641a3f5",78,57,84,6.5,78,0,2,3
"11269","4edc57bc8b9d0eb1ecb60e9071b62b53",19,19,0,19,0,19,1,2
"11270","4edcdf385603d48fbe586b4bac067a76",37,37,0,37,37,0,1,2
"11271","4edecf902b7582a856bd8faf124ab81d",45,45,0,45,45,0,1,2
"11272","4ee12d2853ea4bcbc4909327958d340a",66,60,10,46.2,66,0,1,2
"11273","4ee3c716386fa3b9469569b0dfae4515",62,44,30,14.4666666666667,62,0,2,1
"11274","4ee430b36554d4b0b484d1546dad5e0b",52,34,36,10.1111111111111,52,0,2,1
"11275","4ee98fcf9ba1e2b3759b9dd0d5f1c6f7",19,19,0,19,19,0,1,2
"11276","4ef1bbcb6fea66b66b8eb54acd8ff46c",41,41,0,41,41,0,1,2
"11277","4ef1cb5f3bd50a8da74a5fdd0e15af08",34,34,0,34,34,0,1,2
"11278","4ef1d5eec73a1e6e8dab2cf453c930be",56,53,66,5.93939393939394,56,0,2,3
"11279","4ef3241dbee9b168fe5bb8657d59b9d8",51,17,84,4.25,42,9,2,1
"11280","4ef916a7c0fb740a198299fe258f5035",61,25,88,4.85227272727273,61,0,2,1
"11281","4efd41f6174a560d3656c56673ae6d60",32,30,38,5.89473684210526,32,0,2,1
"11282","4f00997c3ae9bedf52e9ef1fee282a11",48,39,21,16,48,0,1,1
"11283","4f0653ecc12d95d586dd5e54ef67aad7",191,83,80,16.7125,158,33,3,3
"11284","4f06aeff465061d67e47e58b8ca79140",17,17,0,17,17,0,1,2
"11285","4f09943b656722ac1da9a1d0226acdf2",13,13,0,13,0,13,1,2
"11286","4f09997d8e9bf993d62fa85dc2fb61b2",193,129,60,22.5166666666667,193,0,3,3
"11287","4f0b60b6ec33ffa116fef815c74d9b36",11,11,0,11,11,0,1,2
"11288","4f0c2fb3b2373c0febe7938e3dd25362",90,82,56,11.25,35,55,2,3
"11289","4f0cc3c35790118738b0b5bd111570f0",55,42,39,9.87179487179487,55,0,2,1
"11290","4f0e58ff6c96538e170ff7b59b72c1b0",28,28,0,28,28,0,1,2
"11291","4f0eb15d7986e8d6ee537dc29230ac6b",32,32,0,32,0,32,1,2
"11292","4f0ebe2f9d35f4069c6ef15727650ff6",113,68,42,18.8333333333333,113,0,3,3
"11293","4f103ed2801bb64fd31b5359be23d54a",63,44,52,8.48076923076923,63,0,2,1
"11294","4f1370dc64b77939b3995b6dbcd956e8",15,15,0,15,15,0,1,2
"11295","4f141ab11356bac75367af739d30500a",4,4,0,4,4,0,1,2
"11296","4f14483d20a9681dd2f6a16a6761df30",36,36,0,36,36,0,1,2
"11297","4f15718700c208c6fb1c113c5b8116f7",19,9,86,1.54651162790698,19,0,2,1
"11298","4f15b0327d292a82a5efe194973ab131",21,21,0,21,0,21,1,2
"11299","4f16ef0eb0cee790b632110e4dc4c7ae",7,7,0,7,7,0,1,2
"11300","4f170b6199fa2927e51688e2f72b0416",184,144,58,22.2068965517241,184,0,3,3
"11301","4f1823e041e84dd6235d45e6ab1b138a",115,66,37,21.7567567567568,64,51,3,3
"11302","4f189c867cd1076d6259f8e56bcf2c98",8,8,0,8,8,0,1,2
"11303","4f190b32d0f57100b6124294397ad71a",21,20,10,14.7,21,0,1,1
"11304","4f199aff32187771e633daa7fbced2f7",22,22,0,22,22,0,1,2
"11305","4f1a4fd378ba489fc3f11c4283837abb",127,97,39,22.7948717948718,127,0,3,3
"11306","4f1c8dfbbbe588e8da425845a9812ce1",75,57,30,17.5,75,0,2,1
"11307","4f2184806e738ad67a13d242c66165c3",1,1,0,1,1,0,1,2
"11308","4f2407416099016a55eb58cdee378d89",14,12,41,2.39024390243902,14,0,2,1
"11309","4f240cd90bba9b72e9b15c307bb16e0b",4,4,0,4,4,0,1,2
"11310","4f25b1433818b27a319fb6aa279cd6ba",53,53,0,53,53,0,1,2
"11311","4f26493e1ee9857b61bdba3c7938eb9b",42,42,0,42,0,42,1,2
"11312","4f2777709cf1e64ab45f5b7d7d6bcdee",52,43,35,10.4,52,0,2,1
"11313","4f27e92b0d527f999a17bdc8dc0bdc51",33,33,0,33,33,0,1,2
"11314","4f281369d7cfc10b49c7d5dfaf306927",1,1,0,1,0,1,1,2
"11315","4f283958cf4b29e485f2c6eccd769cbe",81,64,18,31.5,43,38,1,1
"11316","4f2a0cd5014af84e01557198d9cee5e9",133,95,74,12.5810810810811,96,37,3,3
"11317","4f2abcbdced561fa12d33acbe9c1653f",19,19,0,19,19,0,1,2
"11318","4f2b813bdc976b12614d3e792ebaa166",117,84,58,14.1206896551724,117,0,3,3
"11319","4f3013b99288d31adb071524f653b315",49,37,84,4.08333333333333,49,0,2,1
"11320","4f30fb598a481d3cb60f9c437412cf31",57,40,42,9.5,57,0,2,1
"11321","4f3370e96a5c592047fdb1e6b3a71d87",12,12,0,12,12,0,1,2
"11322","4f34fd0f72bdc3757937889ba6025489",63,46,62,7.11290322580645,63,0,2,3
"11323","4f3647fd6c8bbc0a4e4b206a655b03b2",11,11,0,11,11,0,1,2
"11324","4f368c269d108bc0db22f77c165ef81a",92,56,16,40.25,92,0,1,2
"11325","4f371ba19b65e9fe8318ac1c7f631490",107,78,87,8.60919540229885,67,40,3,3
"11326","4f39e4fb2a27514ac8fc0b5223b17b62",44,39,27,11.4074074074074,44,0,2,1
"11327","4f3b2a4eb3727d1cf5e6d09afa9e5e7b",24,21,41,4.09756097560976,14,10,2,1
"11328","4f3c7c28e3fd8abd3a2a9fbd28403b4d",68,60,12,39.6666666666667,68,0,1,2
"11329","4f4830dff58773c3e203d7f2cea16baf",12,12,0,12,12,0,1,2
"11330","4f49a4f973fde84e9ec4006962015922",106,67,55,13.4909090909091,106,0,3,3
"11331","4f4cf380cf01f9c33fb088346af0acfd",65,50,42,10.8333333333333,65,0,2,3
"11332","4f4d359226fac264e0244314d422f6d9",24,24,0,24,24,0,1,2
"11333","4f4eb5b81c5c9c00a108d8ca16a7d85b",19,19,0,19,19,0,1,2
"11334","4f4ee26738cd3898c9212f842f1a1832",20,20,0,20,20,0,1,2
"11335","4f4f0082f20b1fe06f75956685954a0a",13,13,0,13,0,13,1,2
"11336","4f5212f9e223bf6ec64e156596752f92",33,33,0,33,33,0,1,2
"11337","4f5397e62c0beafea1f518e25e9a8720",31,29,53,4.09433962264151,31,0,2,1
"11338","4f5661e44b1721cfd7012c8f6706b28a",6,6,0,6,6,0,1,2
"11339","4f5692ad6bc37a4f726efcbdca30b2fc",49,44,29,11.8275862068965,49,0,2,1
"11340","4f58c83c254309e9f6b33e405191efe5",9,9,0,9,9,0,1,2
"11341","4f59a03e3edf85b2dd7cdd98e5cefbc2",80,57,40,14,80,0,2,3
"11342","4f59aa80d7d683377a9e6f7038eadfa1",33,33,0,33,33,0,1,2
"11343","4f5c79d964268ba284352328ab4059b3",10,10,0,10,10,0,1,2
"11344","4f5d06c5da735251494f60cfeb59cad5",56,56,0,56,56,0,1,2
"11345","4f5daadfd3688cef1bd862d3cb7506d8",197,109,70,19.7,156,41,3,3
"11346","4f5eae6a9b97b0feed061b934ccfaa3e",6,5,7,6,6,0,1,2
"11347","4f62e9ea485e23100ddc9ff7096fa670",37,37,0,37,37,0,1,2
"11348","4f62f9dbf8bb2af0746098244da55718",108,93,14,54,108,0,3,2
"11349","4f64637154c8d6b3a59fcacec3c4b086",142,79,63,15.7777777777778,142,0,3,3
"11350","4f65e40bbf0942736d9dd4ace67acd19",80,56,75,7.46666666666667,80,0,2,3
"11351","4f66341155ae7ef1b0321a92e297d9fd",23,23,0,23,0,23,1,2
"11352","4f69a9ab4037adebed7f14a6599f79d5",15,15,0,15,15,0,1,2
"11353","4f69b171864f4c34c90ffe2f503dbd1b",35,35,0,35,35,0,1,2
"11354","4f6bd86bc7f00b00c0f1770c80dff64a",35,35,0,35,35,0,1,2
"11355","4f6ca107f6a36a018dd1074a6f6b3c67",18,18,0,18,18,0,1,2
"11356","4f6d14a74ef3196f0ddee5ddaa61ab21",43,33,43,7,43,0,2,1
"11357","4f6e9f93595209d57245c93722ba1788",190,81,88,15.1136363636364,190,0,3,3
"11358","4f7226a7fc9091db133ba9ab34dfed05",79,74,49,11.2857142857143,79,0,2,3
"11359","4f730887904b54b4f56012be3d0650d2",36,36,0,36,36,0,1,2
"11360","4f75b73927342002493d32ea46f0b356",8,6,58,0.96551724137931,8,0,2,1
"11361","4f75ba2e21fd6d43cb4aaffc96bf4828",16,16,0,16,16,0,1,2
"11362","4f78271923cd5fb3506af36db7f3cbec",74,62,57,9.08771929824561,74,0,2,3
"11363","4f7845f0e17d6532985352388473866e",72,69,10,50.4,72,0,1,2
"11364","4f7bff546c884d8f378424a434d8743b",27,27,0,27,27,0,1,2
"11365","4f7ca026d6ab3ef7004b6a1f2cc8ce9e",35,35,0,35,0,35,1,2
"11366","4f7ca1964e270b121bd7cd82ba59c146",32,32,0,32,0,32,1,2
"11367","4f7d233947eb4e4575d95333f421692a",67,64,59,7.94915254237288,67,0,2,3
"11368","4f7d39b1c8255eeb095f6a7f328bea4d",31,31,0,31,31,0,1,2
"11369","4f7d63d90ccf7d3956099b188f640314",16,16,0,16,16,0,1,2
"11370","4f80223c2d3b3cf31b3422220fc14636",8,8,0,8,0,8,1,2
"11371","4f82db26b0dc11421b4903c3e4b275d1",19,19,0,19,19,0,1,2
"11372","4f82e30cee95f2d49d13531f4556f5a0",233,121,66,24.7121212121212,185,48,3,3
"11373","4f8565a0b699c056955ef380aa323382",43,34,28,10.75,0,43,2,1
"11374","4f8576d73787afa2b45ce144e01dfa9a",29,21,38,5.34210526315789,29,0,2,1
"11375","4f86dac1322b170ee322273f2f7c655e",18,10,45,2.8,18,0,2,1
"11376","4f8976e88758dab870135e9974cd2b70",108,62,75,10.08,84,24,2,1
"11377","4f8c6233832af043b944cff275fdaac3",64,61,30,14.9333333333333,64,0,2,1
"11378","4f8dd965903ccc01e15f1dd7b5fc363d",39,31,11,24.8181818181818,18,21,1,2
"11379","4f8fed19fedc55568ca07114cc319a40",30,30,0,30,30,0,1,2
"11380","4f9047e7b090007e882cfce74ec5184d",25,25,0,25,25,0,1,2
"11381","4f92aed6650eab7d1b8648bc9bde623d",70,47,38,12.8947368421053,70,0,2,1
"11382","4f937e12eaa5828712d25dd3152c7c64",17,17,28,4.25,17,0,2,1
"11383","4f95196ccaa1650f8b286a014c336b4a",11,11,0,11,11,0,1,2
"11384","4f95767879d014eea02d2e6a9f711558",22,22,0,22,22,0,1,2
"11385","4f9578a14201daa8a056f25c0de5e9f6",25,25,0,25,25,0,1,2
"11386","4f96a728b0d2add81743846087bf60dd",15,8,82,1.28048780487805,15,0,2,1
"11387","4f979963118c1cfb02d4c4cba5032222",213,137,57,26.1578947368421,213,0,3,3
"11388","4f99c2be0e963c68eb55186b1cd2c591",29,29,0,29,29,0,1,2
"11389","4f9b15dea1739dcc554b793dddea4f68",149,92,71,14.6901408450704,149,0,3,3
"11390","4f9eb7df53fe254b75d096143998d034",82,61,45,12.7555555555556,82,0,2,3
"11391","4f9eff9161a8ea52cac14a14c9dfc111",123,77,56,15.375,74,49,3,3
"11392","4f9fd3a71db48f2b0d756695998bb796",14,14,0,14,14,0,1,2
"11393","4fa1c87334aafbf171bc74a313996539",57,40,33,12.0909090909091,57,0,2,1
"11394","4fa40db958c000a9d624eb129505992b",193,84,68,19.8676470588235,157,36,3,3
"11395","4fa6312b2982424402fea6372e0c56c3",30,30,0,30,30,0,1,2
"11396","4fa9d58e18b604bc8eb0fb4ecf88cf6e",60,51,39,10.7692307692308,60,0,2,3
"11397","4fad1a03a3a600bb53447571c63a21be",28,28,0,28,28,0,1,2
"11398","4faf1cd379122ad7f4485ccb616cd3b9",29,29,0,29,29,0,1,2
"11399","4fb33f98eb387ded1d806e830765fa69",6,6,0,6,0,6,1,2
"11400","4fb3efc1c23b74041c2942455d1cd99e",53,43,63,5.88888888888889,0,53,2,1
"11401","4fb41dbb034ae82f81a5a915a1781064",38,38,0,38,38,0,1,2
"11402","4fb61b0fd6fb1e0d852e2574985bd847",142,76,53,18.7547169811321,109,33,3,3
"11403","4fb66d9559ba24eefe0edb49ead38705",79,56,37,14.9459459459459,51,28,2,1
"11404","4fb8d08a528059391f5ca22650759afb",14,14,0,14,14,0,1,2
"11405","4fc2faa892d0e5dd00414aa09cf8890e",8,7,12,4.66666666666667,8,0,1,1
"11406","4fc2fe59847e059d592f7674e480b9f0",178,89,53,23.5094339622642,178,0,3,3
"11407","4fc32d82ea94d3a6cf70f1e7589a6b95",42,28,78,3.76923076923077,42,0,2,1
"11408","4fc347bfd2261010012b37015b8eb883",31,31,0,31,0,31,1,2
"11409","4fc52edf495a35a592894861702feafd",1,1,0,1,0,1,1,2
"11410","4fcd7a3784f1cd52472c573be189371b",206,85,84,17.1666666666667,206,0,3,3
"11411","4fcea5e0cc2e3df65950d34b1b2502b9",87,66,29,21,87,0,2,3
"11412","4fd341d42d83347dbcd67bdf49f68979",175,84,59,20.7627118644068,126,49,3,3
"11413","4fd38f397c0dfdc30c81ef935ca60fbb",192,86,67,20.0597014925373,146,46,3,3
"11414","4fd42f6601f8de8bc5060ef2ed6eedc8",100,88,31,22.5806451612903,100,0,3,3
"11415","4fd45e31035ac0d4f253e80f09712b0d",47,47,0,47,47,0,1,2
"11416","4fd603c0b9e9d63d924362badc158a7b",25,24,52,3.36538461538462,25,0,2,1
"11417","4fd611eecabfcad33f956df631283efe",36,36,0,36,0,36,1,2
"11418","4fd648656d9d4d07c0453c10c706bd40",228,121,53,30.1132075471698,205,23,3,3
"11419","4fd84b070e29781708a73702e541b455",17,16,20,5.95,17,0,1,1
"11420","4fd92bad92725419c4e83c83b056a41a",72,59,40,12.6,72,0,2,3
"11421","4fda1b54f94db5ad6ad2143ef115869f",33,30,36,6.41666666666667,33,0,2,1
"11422","4fdb191528bdfa27283824597069004b",23,23,0,23,23,0,1,2
"11423","4fdbaf6e92bd0cd3efa56a618a7ef73a",23,23,0,23,23,0,1,2
"11424","4fdf16afada4c8af470b879667f482c1",137,95,30,31.9666666666667,137,0,3,3
"11425","4fdf91424ee717fa79acb8b6748b3cb8",132,83,80,11.55,132,0,3,3
"11426","4fe017fe8a9d6418abf185b322f87622",25,25,0,25,25,0,1,2
"11427","4fe2242116aa763c302b294bc1b1da96",3,3,0,3,3,0,1,2
"11428","4fe2c701923d24dfe83a2561f862248e",49,49,0,49,49,0,1,2
"11429","4fe611717ac0eb821cc4030a24584c23",65,49,48,9.47916666666667,65,0,2,3
"11430","4fe79b0b26750158b8dc10c1f769dc0e",197,105,71,19.4225352112676,197,0,3,3
"11431","4fea19046fdeb65764e7cea17ed5275b",36,30,52,4.84615384615385,36,0,2,1
"11432","4fefcdf0fdfbea32fd0ef46f84f390c3",36,36,0,36,36,0,1,2
"11433","4ff021a9939f3aa6a64fa331cbe1bfd6",22,22,0,22,0,22,1,2
"11434","4ff031f60d3b7cb70aa576925f80fd87",178,123,24,51.9166666666667,178,0,3,3
"11435","4ff13ae695f1b6706e72f54900341c9c",129,77,59,15.3050847457627,102,27,3,1
"11436","4ff32f1036db90039f66f5c893c7d39f",90,69,77,8.18181818181818,90,0,2,3
"11437","4ff623865c16777dd07fa42e66b7dd37",71,38,60,8.28333333333333,71,0,2,1
"11438","4ff7bf617b6768d921ab1fde97bc7047",141,68,63,15.6666666666667,141,0,3,3
"11439","4ff9c4fe2db4bd2ffaf488f131d89d53",38,38,0,38,38,0,1,2
"11440","4ffcf3a0c3ef72d55b81701bdf36405e",66,57,30,15.4,66,0,2,1
"11441","4fff7d092eb3cfcac8217d8d4436d4c6",58,39,21,19.3333333333333,58,0,1,1
"11442","5001707d67701fa6fe1cb1c14d9cfb24",29,29,0,29,29,0,1,2
"11443","5001f17fe28fdeabb9fc40581b985378",101,67,59,11.9830508474576,48,53,2,3
"11444","50038fe5cb777c716afd97cc6b748b63",69,53,37,13.0540540540541,69,0,2,1
"11445","500500618d9d8a3aef76fc13a8408cfc",82,64,22,26.0909090909091,82,0,2,2
"11446","5005d1e7505fb39c4e7429de01fb98ce",42,42,0,42,42,0,1,2
"11447","50065ecdebee5c202a64c6117e20cbce",79,67,38,14.5526315789474,56,23,2,1
"11448","5006c1e303584913c73bef9bbaa15988",27,23,53,3.56603773584906,11,16,2,1
"11449","5006e850432b0588d6af92e113d6f443",82,51,68,8.44117647058824,51,31,2,1
"11450","5006f11937643cacdffc196376023f7d",64,52,70,6.4,19,45,2,1
"11451","5007ec7b66e0e949950b5b0db91ef4d4",155,92,57,19.0350877192982,155,0,3,3
"11452","500a2ecf07b2df7178d171245916e8f0",7,7,0,7,7,0,1,2
"11453","500aba8a332f93b6dfb1bf3d72a51739",59,48,57,7.24561403508772,59,0,2,1
"11454","500c6aafa9a0fc5effbafab748f969f8",11,11,0,11,11,0,1,2
"11455","500eb248d3de7dc3a50ef9364aaecdca",122,82,66,12.9393939393939,94,28,3,1
"11456","500ff3acdf2a3607a78c39290c4fa53a",23,23,0,23,23,0,1,2
"11457","501401a4d67fc709c05161d4c192aef6",84,57,64,9.1875,84,0,2,3
"11458","5014555842f1b1f8536308dd3d416177",12,12,0,12,12,0,1,2
"11459","5018a47c66570ac0d56e27ea3a1dcd51",143,79,52,19.25,120,23,3,1
"11460","5018e5f069d5bf2fcebbdd6c2dcb916c",57,43,32,12.46875,30,27,2,1
"11461","5019e4b6310a076019a189bcd9655d36",11,11,0,11,11,0,1,2
"11462","501ac3009cbc17e3f322ca1cc5c31100",29,27,23,8.82608695652174,29,0,2,1
"11463","501b2f658243c2adadd68085cfd8972a",186,108,77,16.9090909090909,186,0,3,3
"11464","501d8e5f2bc365687e8b9a7d6ddc9014",7,7,0,7,7,0,1,2
"11465","5020deefbb73217d3e73868421f849c5",152,86,56,19,152,0,3,3
"11466","50225a5539c09bcbab2f9ff9f0518ea5",116,67,83,9.78313253012048,90,26,3,1
"11467","5023aa8b2d618ebce3c36a18b3079f57",35,29,37,6.62162162162162,35,0,2,1
"11468","50249c59dacdfa0b0c95194605e75ba8",9,9,0,9,9,0,1,2
"11469","5025814aace55c7b6b592e92e5564ce1",56,47,10,39.2,56,0,1,2
"11470","5027ae823588fa8588046245e4edbbe6",34,34,0,34,0,34,1,2
"11471","502a1a5bcff3b3e7a43da4552ffcc5f5",113,68,62,12.758064516129,113,0,3,3
"11472","502bbe25727aa55f18cb6a8b3cbb4809",64,48,17,26.3529411764706,64,0,1,1
"11473","502fdbec56fd5a9480299a877dd8a66d",35,33,25,9.8,22,13,2,1
"11474","5030e3e09c9435be5a382826afa6ec04",34,34,0,34,34,0,1,2
"11475","503125171c8899e78f66f98fcfc8bed3",6,6,0,6,6,0,1,2
"11476","50318b96630caac52b5610ec88257a6e",12,12,0,12,12,0,1,2
"11477","5031f92b678a16c704084f1d3dc72382",29,29,0,29,29,0,1,2
"11478","5033a2bd8dc1f5a92fc179d6bb390803",5,5,0,5,5,0,1,2
"11479","503a6539df48964124fe026b9deb5d13",88,60,21,29.3333333333333,88,0,1,2
"11480","503b59ca661d3664fbf2071dac43276b",54,52,9,42,54,0,1,2
"11481","503fe2e8e76fc16b4f303e8a66d3fca4",70,42,60,8.16666666666667,30,40,2,1
"11482","503fedf6534a946441f525c8c817943e",35,32,14,17.5,35,0,1,1
"11483","503ffd2f182cb25875637a6b8990992a",31,19,47,4.61702127659574,23,8,2,1
"11484","50414d3bca00d3d6274e1d8816b8552e",31,31,0,31,31,0,1,2
"11485","5045894d9b42fb6aa55895d7515063d7",236,100,74,22.3243243243243,217,19,3,3
"11486","504d17def6edc33b45eb5fff0ad5641f",146,91,89,11.4831460674157,146,0,3,3
"11487","504e4cf6079bba81e37ec6684fe2a6bf",167,106,77,15.1818181818182,133,34,3,3
"11488","50545a8f92937ef1a99fd60369af2171",171,134,47,25.468085106383,118,53,3,3
"11489","5054766cc462550c8344df73fa4c346e",50,50,0,50,50,0,1,2
"11490","5055ed7fa5b134448320812bc99bee8e",54,44,56,6.75,54,0,2,1
"11491","5056081ed2a8c740284e4ca8a94b554f",151,89,60,17.6166666666667,151,0,3,3
"11492","5056c83f86a9c2fb38353b077f309174",6,4,31,1.35483870967742,6,0,2,1
"11493","5057e9b2164890e00d899a13adf7991f",228,140,72,22.1666666666667,179,49,3,3
"11494","505a4c7572a517d8a63a09ac8460b386",188,130,34,38.7058823529412,188,0,3,3
"11495","505b103f7d77259d10c14f42dd76317a",145,79,74,13.7162162162162,145,0,3,3
"11496","505b66384840108c0613abc994eb9d88",39,39,0,39,39,0,1,2
"11497","505badd6b749724006e883d0b6e1d31a",19,19,0,19,19,0,1,2
"11498","505defd754efb4ee32f370e3309f4cbd",119,92,69,12.0724637681159,101,18,3,3
"11499","505f97a0a42a10056cfc491308875751",225,80,84,18.75,208,17,3,3
"11500","505ff2e59518789d8b46f2901bf5e4d1",20,20,0,20,20,0,1,2
"11501","5061eb351cc94c0ec34b6f0986081dea",28,28,0,28,28,0,1,2
"11502","5061f20087ab9aebb8d64d781b154662",76,67,18,29.5555555555556,27,49,1,3
"11503","50638687ef07953456dd48d4e6491a9d",22,17,44,3.5,22,0,2,1
"11504","5063caa33d8919e96cddefc61f3a0e88",18,18,0,18,18,0,1,2
"11505","5067221157c948942ca2c085b73f3130",73,55,57,8.96491228070176,73,0,2,3
"11506","506983daec48699f6bfb16eb83e8f07d",61,42,64,6.671875,61,0,2,1
"11507","506bccb34965595dcc192d3a94b8f831",16,16,0,16,16,0,1,2
"11508","506d7d0e9cae2060b175ac237e92d005",62,55,68,6.38235294117647,40,22,2,1
"11509","506dc00779d6669969f2ff59f6e9b60c",212,118,84,17.6666666666667,212,0,3,3
"11510","506e2212edc67630c043706e61d91c56",92,67,64,10.0625,92,0,2,3
"11511","506f324c2d01d94b7d8125dd0aaa849c",50,38,27,12.962962962963,50,0,2,1
"11512","506fd8f856304b4e9ad0f4f587d6c450",23,13,63,2.55555555555556,9,14,2,1
"11513","507129bce23bee2e4b523ddd320c1053",51,51,0,51,51,0,1,2
"11514","507379e3887c53fb08c65350d4a62419",15,13,45,2.33333333333333,15,0,2,1
"11515","507465e592418365322f3a73faa60740",52,52,0,52,0,52,1,2
"11516","50773d5c2eb1767f666543319d673397",110,73,73,10.5479452054795,75,35,3,1
"11517","5077f5e819b5251d80f4f4b01150c726",28,28,0,28,28,0,1,2
"11518","5078ff6f16d7cf2e7c5784eaae26698a",56,46,60,6.53333333333333,56,0,2,1
"11519","507a18c33e8316852816daad97f645e6",54,45,31,12.1935483870968,25,29,2,1
"11520","507d396881dcbbb9c3dbe5593bf74f02",92,59,79,8.15189873417721,92,0,2,3
"11521","5082c6d897ef343654df4a3e982e7183",29,29,23,8.82608695652174,29,0,2,1
"11522","5084e8ba86870c791e0d2d1803cd93fe",82,64,33,17.3939393939394,82,0,2,3
"11523","5088253094526304c1cd01bb0b6a69d5",185,82,79,16.3924050632911,185,0,3,3
"11524","5088f7de9113f9e883db75889035a92d",159,94,49,22.7142857142857,113,46,3,3
"11525","50896dafa05f31b291e15a003ad5fe44",35,23,11,22.2727272727273,35,0,1,2
"11526","508aa127d55202077a45db6466e9f116",32,29,35,6.4,0,32,2,1
"11527","508b7f3b04f520167f76b76219dd149c",19,15,71,1.87323943661972,19,0,2,1
"11528","508e9ea17b4557795a4659d3a596c8b8",8,5,57,0.982456140350877,8,0,2,1
"11529","5092e5a74eb85ace07cd172c2f84c4ac",56,45,37,10.5945945945946,56,0,2,1
"11530","509337c1494bd42392301934b96c474e",111,84,39,19.9230769230769,76,35,3,3
"11531","5095d8276fa3acefa9e3e11821106d69",45,36,33,9.54545454545454,45,0,2,1
"11532","509a8056a7d99241782bc2a82e7a1ea7",16,16,0,16,16,0,1,2
"11533","509c99a5f1d82acedfe08d950bf17eed",130,58,78,11.6666666666667,130,0,3,3
"11534","509dd2c6f08c7573a86d82e393309193",6,6,0,6,0,6,1,2
"11535","509eb28eaf2539f5068ee004a9b0b7c1",48,47,34,9.88235294117647,21,27,2,1
"11536","509f89af2e75944319a0e6d0a39bec8f",27,27,0,27,0,27,1,2
"11537","509fcdab683bda0a12a7b1212637a337",28,26,24,8.16666666666667,28,0,2,1
"11538","50a1488b05fe3f59b999fb1a2d5f72b4",179,113,74,16.9324324324324,161,18,3,3
"11539","50a57889d43ff5c420f05c1b0edb63b3",38,38,0,38,38,0,1,2
"11540","50a732c04166eba0069815774127757c",32,28,19,11.7894736842105,17,15,1,1
"11541","50aa48e76495852b2fcda516b56f4cbc",68,58,26,18.3076923076923,68,0,2,1
"11542","50aa66f37eac165dc81ba50b39328b4d",43,43,0,43,0,43,1,2
"11543","50aea3e24a34e609260fa8a0cbab4572",41,41,0,41,41,0,1,2
"11544","50b797ec28ab68270314f0f3ba77be26",135,53,85,11.1176470588235,135,0,3,3
"11545","50ba5756fd1b84f52340e6154d8fc0df",2,2,0,2,2,0,1,2
"11546","50ba5ea04132ef50c790e988b715268c",10,10,0,10,10,0,1,2
"11547","50baf4a4561516a231d398f24dda4501",79,56,56,9.875,79,0,2,3
"11548","50bb7edcaf81230b0c6f9ba7d67d98b2",256,145,73,24.5479452054795,211,45,3,3
"11549","50bbdd998e165af55be25cc9cbdcaed7",29,29,0,29,29,0,1,2
"11550","50bc825b9ad9fa74a6c601d05a895833",170,129,32,37.1875,170,0,3,3
"11551","50c57460c60e7fcaf680f245bab1158a",113,77,46,17.195652173913,113,0,3,3
"11552","50c5e59f113488d3de6f332e768204ec",36,36,0,36,36,0,1,2
"11553","50ca03a82a97b2d55ac6f2f86e1b6f12",20,20,0,20,20,0,1,2
"11554","50ca706c51a2df26f073b06a6a261a4d",11,11,0,11,11,0,1,2
"11555","50cb3e3b9e025857c4ffe2e4dfdf9c1b",28,27,18,10.8888888888889,2,26,1,1
"11556","50cc79b06acc94f9fc3baf99de23d36d",109,54,80,9.5375,109,0,2,3
"11557","50cea174af14e68b1169e36fd7564a1f",45,43,6,52.5,45,0,1,2
"11558","50da00b60fb1974d7fef2fae17ade325",24,24,0,24,24,0,1,2
"11559","50da90f5fd090d238207b210b437535c",102,56,71,10.056338028169,77,25,2,1
"11560","50dae311d826fb312e66d74df8b56de0",96,24,84,8,96,0,2,1
"11561","50dbbf1a1a7f41dbde2e13510df84f27",16,16,0,16,16,0,1,2
"11562","50dc48b3a4ecfec54e0d75c007762d9b",28,28,0,28,28,0,1,2
"11563","50dc4ed738dd56a2ad112b62b6d630ea",23,23,0,23,0,23,1,2
"11564","50dd729269785898a02e5ad4e48528fa",98,81,50,13.72,50,48,2,3
"11565","50de0bbccf3787234b8ba125bf350b0b",115,75,67,12.0149253731343,115,0,3,3
"11566","50dfc95471adcaa808797e316442c825",45,45,0,45,0,45,1,2
"11567","50e06b6558e16f4acf0e8ddd339548ff",76,71,27,19.7037037037037,76,0,2,1
"11568","50e146a0a626b6682c19aed3235e8047",158,72,63,17.5555555555556,158,0,3,3
"11569","50e1864c55e2311a0d16cd9fee94695e",45,45,0,45,45,0,1,2
"11570","50e1f139da62183f22b8d33c8e861ff9",77,63,55,9.8,77,0,2,3
"11571","50e2a725e8987349eee6806961accb83",125,89,65,13.4615384615385,125,0,3,3
"11572","50e33e22f151d74490f560374ee7e2cc",5,5,0,5,5,0,1,2
"11573","50e7da5d35aabd32bcb51913b4cf54b4",108,93,73,10.3561643835616,70,38,3,3
"11574","50e887e917e7f2a78213caba1dfd2256",46,46,0,46,0,46,1,2
"11575","50e8fbd55d32eaeb995092d88f708647",5,5,0,5,5,0,1,2
"11576","50eaffeba782d9117bdb08a86fccbe0e",124,93,60,14.4666666666667,124,0,3,3
"11577","50eb03ea9b9ed27edbd7562aa4874627",51,38,61,5.85245901639344,51,0,2,1
"11578","50eb3c367555706b97829fe21a82e5da",21,21,0,21,0,21,1,2
"11579","50eb563547283386c88190c21d06f694",38,38,0,38,38,0,1,2
"11580","50ed62cffcb7a431dcfb5a0ae282909d",33,14,64,3.609375,33,0,2,1
"11581","50ee89054377648425ee3d59eab08529",26,26,0,26,26,0,1,2
"11582","50eec983778055408a40dc6b978d80b8",140,110,66,14.8484848484848,140,0,3,3
"11583","50ef751c35e20c08b5bea31e0267a75d",84,46,38,15.4736842105263,52,32,2,1
"11584","50f127125e6f5805aeb372e5eaba9451",92,55,56,11.5,92,0,2,3
"11585","50f443616e3f4254a966e65f90532cf0",69,60,16,30.1875,32,37,1,1
"11586","50f4bab1569ebe94601cc59298ca3e6e",29,29,0,29,29,0,1,2
"11587","50f724970f13eeb928da148674cc6e09",57,48,15,26.6,24,33,1,1
"11588","50f746b57273bff1c2838e4f5c01587d",56,56,0,56,56,0,1,2
"11589","50f895548d7cec22167ef4d53ee0c377",10,8,63,1.11111111111111,6,4,2,1
"11590","50fadb984b350cdeddd287743b361063",102,58,42,17,102,0,2,3
"11591","5103ebd14c6cf2eb29feca8fd0db29e9",112,79,71,11.0422535211268,112,0,3,3
"11592","5104b9459d490e10e78104a62cfde784",47,42,51,6.45098039215686,47,0,2,1
"11593","5104c79227568e2fdcb45661739f3891",36,25,56,4.5,36,0,2,1
"11594","51053c1b3010eae59272d0081e78b802",212,105,50,29.68,212,0,3,3
"11595","510657e8048dfcafe3f72118bec68510",217,80,79,19.2278481012658,217,0,3,3
"11596","51069f18ca17d05963f385c117a58909",27,27,0,27,27,0,1,2
"11597","5106ba8762ba2f8024d6f705455f3cc3",132,75,78,11.8461538461538,132,0,3,3
"11598","510ddbe03c42d7da2058c1a0314bdecb",46,38,11,29.2727272727273,46,0,1,1
"11599","510f40b5b7e81d3c85156c84745e5e81",43,43,0,43,0,43,1,2
"11600","5110007cfd5238fbf50c1c09e2602ae2",18,18,0,18,0,18,1,2
"11601","511172b6aa478216d55b92901e01eb67",133,103,68,13.6911764705882,93,40,3,3
"11602","5111a742d2edaca54aa3a599690acf1f",72,57,67,7.52238805970149,72,0,2,3
"11603","51123488a7ebdcb8a080c77933b1c95a",25,25,0,25,25,0,1,2
"11604","51127d2c736c14f667fde78e72a61e04",50,41,57,6.14035087719298,50,0,2,1
"11605","511490c840ec61367b5d08eb54701d1f",90,70,43,14.6511627906977,90,0,2,3
"11606","51160e66e2cfea8c7b5a67ccb7c1cc53",28,21,26,7.53846153846154,28,0,2,1
"11607","51190d59fd191096b4850dba27b9a784",1,1,0,1,1,0,1,2
"11608","511cf0b0c3817babc29967fbf076933d",76,54,46,11.5652173913043,76,0,2,3
"11609","511dcb72057c8d52fbc2d678ec6139c2",130,75,62,14.6774193548387,130,0,3,3
"11610","511f1df5f18cd50ba42a33b5ac73d024",70,53,14,35,70,0,1,2
"11611","511fb81548d6d5812f45214812b271bf",26,22,40,4.55,26,0,2,1
"11612","51210da0ad234031c37e5aef7fa89081",185,59,55,23.5454545454545,185,0,3,3
"11613","5128883caad26c2ad025f575129ea139",46,41,59,5.45762711864407,45,1,2,1
"11614","5129b0a02f06921c338bc19245c31bdd",74,56,69,7.50724637681159,36,38,2,1
"11615","512a1084863d33710b472a054a8bd81f",34,31,56,4.25,24,10,2,1
"11616","512ae64b4f6543da2795245dccc7f7b3",156,85,75,14.56,156,0,3,3
"11617","512bb6d3a7055b6989b3e2e648c3115c",196,110,62,22.1290322580645,196,0,3,3
"11618","512dc1769d853e919da3af25d309159f",3,3,0,3,3,0,1,2
"11619","512edf46652990f802839a03e96f8766",19,19,0,19,19,0,1,2
"11620","512fa3dd31cdafc5f29dd87648560c09",65,56,43,10.5813953488372,65,0,2,3
"11621","51325e51904b0b66ab2f948e76ac648a",35,35,0,35,35,0,1,2
"11622","5136c8b919498aaaef2c9975e3eaa329",54,38,52,7.26923076923077,54,0,2,1
"11623","513720136a4ea83d4e9e1a4fe43587ed",47,44,19,17.3157894736842,32,15,1,1
"11624","5138a8891fb7f179996941d42b2f5b51",73,49,30,17.0333333333333,73,0,2,1
"11625","51398e67242594cc24fc990461a972e8",86,63,58,10.3793103448276,86,0,2,3
"11626","513ab45a26876e16b419da291d249ca1",27,27,0,27,27,0,1,2
"11627","513ce71ceaf1d59a89f9200d539d5194",51,51,0,51,51,0,1,2
"11628","513cf2a4b1bcb92f32f59234868e2696",137,86,32,29.96875,102,35,3,3
"11629","513d089510e6713d07e9ef012f6220a8",44,14,80,3.85,44,0,2,1
"11630","5140e2284141bdc5f23d7ee7692c0102",4,4,0,4,0,4,1,2
"11631","5140e7a923621a3058063f5881a77a62",23,23,0,23,23,0,1,2
"11632","514496a7b72b2c68f5f922a55935b9eb",175,75,78,15.7051282051282,175,0,3,3
"11633","5148df433cc892a76587530149a15198",24,24,0,24,24,0,1,2
"11634","514b682cfe5486402d651c225771b086",23,22,11,14.6363636363636,22,1,1,1
"11635","514c3dcdac8b485c614ccf09e539da28",21,21,0,21,21,0,1,2
"11636","514c82227442fbc610a0d4110144c0d6",24,24,0,24,0,24,1,2
"11637","514c8cb3a1bed5be880525f772887712",66,46,75,6.16,40,26,2,1
"11638","514f5c7af2a521292e7b32ec99fb5cfb",43,43,0,43,43,0,1,2
"11639","51518bb6e59b4dadd6d2edd57e8f616e",15,6,73,1.43835616438356,15,0,2,1
"11640","5154e0de1b38374f4f94a6d7b98133f5",28,28,0,28,28,0,1,2
"11641","515504bcded34bbf2a2a775c7a15d276",93,67,37,17.5945945945946,57,36,2,3
"11642","5156824b9e17f88de922bd1dccb3ae32",16,16,0,16,16,0,1,2
"11643","51575e784ddf6b2601b5eed28c105f51",7,7,0,7,7,0,1,2
"11644","51586a8fc81cfea56ae5bdb35075cf09",62,39,39,11.1282051282051,62,0,2,1
"11645","515a0670e018311cd0260d1f159f879a",176,94,67,18.3880597014925,176,0,3,3
"11646","515a6f19aced5c9a3f1380755e3b50df",17,17,0,17,17,0,1,2
"11647","515c2390b24adc8de3a06180e0b8b08c",22,22,0,22,22,0,1,2
"11648","515c4e8243cef9090b7eee2f08e40a40",76,57,33,16.1212121212121,55,21,2,1
"11649","5162a580dcd839dd925d7ff849b6ef41",65,56,37,12.2972972972973,65,0,2,3
"11650","5165df41f1390a3b521dbc812f119058",60,52,36,11.6666666666667,42,18,2,1
"11651","516a61735233aae4f5439061e17fedd8",8,5,11,5.09090909090909,5,3,1,1
"11652","516c1e7194722b69f7e87624110654c6",31,31,0,31,31,0,1,2
"11653","516d0b4772c0cec695bf475053810094",53,46,28,13.25,53,0,2,1
"11654","516ebad5a8d077c5e1155bd179558247",68,56,14,34,68,0,1,2
"11655","5171cf880b2bed1998a8740f25256b97",69,54,57,8.47368421052632,46,23,2,1
"11656","517285ce8b817aba183d2e9acf7ae110",4,4,0,4,4,0,1,2
"11657","5173753fd98e7c754d205706da8a4780",35,35,0,35,35,0,1,2
"11658","5174cdc944544e4c62a8271ef46832d8",52,45,31,11.741935483871,27,25,2,1
"11659","5176a780b2742ee46ae1f36ae2b74b7b",56,48,33,11.8787878787879,56,0,2,1
"11660","5177f59a3a46f132265997bbdf8bcdfa",34,34,0,34,34,0,1,2
"11661","517e676099a3a78f764eb1076a42d5d7",16,16,0,16,16,0,1,2
"11662","5181713f257bce7e355335c9b1b7882e",69,59,56,8.625,69,0,2,3
"11663","5182e1693cb4adbd52da6701acf684f2",126,91,81,10.8888888888889,126,0,3,3
"11664","5183e6d45af16c67683dc40e3743a2a2",75,58,82,6.40243902439024,38,37,2,1
"11665","518578806ae2a5e921ea10c009cae185",133,95,79,11.7848101265823,133,0,3,3
"11666","518610f6405299373428a2e896c39dbe",88,61,57,10.8070175438596,57,31,2,1
"11667","51875b3f9b93a7bca559eeb452a1a2fc",76,56,77,6.90909090909091,76,0,2,3
"11668","5188db123e6188c01bd789ef105a36e2",27,27,0,27,27,0,1,2
"11669","518b3a867b3e246a5d05aa07dcd3b954",15,15,0,15,15,0,1,2
"11670","518f75e2b2b5770c4cdfcce1ed49db93",45,45,0,45,45,0,1,2
"11671","5194c67d57c726f207bdac4768a58896",59,50,15,27.5333333333333,21,38,1,1
"11672","51958b1cde5f62efb5cb9731929f54f9",122,57,68,12.5588235294118,93,29,3,1
"11673","5197177cee3a2e6e6eec591b3afbe08e",102,73,57,12.5263157894737,80,22,2,1
"11674","519956cd97eefb6dca9a812b748da3f6",45,37,33,9.54545454545454,45,0,2,1
"11675","519ae923fce66c02bf4bd7d10bbfa5d2",42,37,54,5.44444444444444,21,21,2,1
"11676","519aed94f135ab76c2d64e5ec6cbf1bb",136,94,44,21.6363636363636,136,0,3,3
"11677","519d58a5acf6f033aa33abfbfb319506",97,77,83,8.18072289156627,97,0,3,3
"11678","51a211daa2add9d733879b921cb13283",33,33,0,33,33,0,1,2
"11679","51a576423a1c29399a3831bd6657a4a5",36,26,21,12,36,0,1,1
"11680","51a74d93ec1720a2fe64a68eba761953",70,61,10,49,48,22,1,2
"11681","51ac2cb1be23c5a9fc1de452f088d824",5,5,0,5,5,0,1,2
"11682","51acce1c3d11c516a3a079db31feee44",67,59,51,9.19607843137255,30,37,2,1
"11683","51af1f22345a50cf1db557dd6e7c44dd",25,25,0,25,25,0,1,2
"11684","51afaecf9100bc144f8bbd2fd7e75d17",17,17,0,17,17,0,1,2
"11685","51b3b119fccbe14e6c4b564a851dc9b6",31,30,5,43.4,31,0,1,2
"11686","51b5ca8d51542299945825bad3c97926",89,60,47,13.2553191489362,89,0,2,3
"11687","51b6ea8cfc42eb4983eeebe3997238ee",45,45,0,45,45,0,1,2
"11688","51b732da193db7bd0460f2cfc6cf06a5",46,39,29,11.1034482758621,46,0,2,1
"11689","51b8e82390c0074dd1e87ba397f4db72",31,22,50,4.34,31,0,2,1
"11690","51bba507d128973189a51cf9906b4845",10,10,0,10,10,0,1,2
"11691","51beb93be80b5efa51a7bef4235b5709",70,54,81,6.04938271604938,70,0,2,3
"11692","51c1904543c8d06213f16ae621f09f43",46,20,55,5.85454545454545,33,13,2,1
"11693","51c3fc6fb36c8e8be911c970174074ae",17,17,0,17,17,0,1,2
"11694","51c7727c36e5256a7a6f83aee0d61af9",120,64,46,18.2608695652174,120,0,3,3
"11695","51cbc29a12ffaea07f06f072852b6d2d",41,32,39,7.35897435897436,23,18,2,1
"11696","51cbdbe24d0c729460c3c5b32c1ff997",108,74,23,32.8695652173913,108,0,3,3
"11697","51cc602efc3ae0677076b0c6c7bb7863",19,19,0,19,0,19,1,2
"11698","51cca737094900d59a58078caf7ab78f",73,64,75,6.81333333333333,25,48,2,3
"11699","51cd82b7721ba3b0f0a1b53bb6ffcfc1",68,61,54,8.81481481481481,43,25,2,1
"11700","51ced59961e4a00e9dfff36445981448",83,54,14,41.5,83,0,1,2
"11701","51d1655fa7a255733ced010117ce574e",28,26,63,3.11111111111111,0,28,2,1
"11702","51d3d105d26b9f1767a968597788babd",67,52,38,12.3421052631579,67,0,2,3
"11703","51d509ce241147ba3adcbf857ca9ae24",29,29,0,29,29,0,1,2
"11704","51d8058dfac6b95378a577d250104a0a",84,64,70,8.4,67,17,2,1
"11705","51d85ebc2731a988d661aeefe9da84f1",86,56,44,13.6818181818182,86,0,2,3
"11706","51d8ba4321ecec82f1b20f324bb06682",29,29,0,29,0,29,1,2
"11707","51dc3ab3264a913223f7a0dfe81e3d58",156,62,60,18.2,156,0,3,3
"11708","51dc5e814466752f7ae5bdc69a26310e",3,2,43,0.488372093023256,3,0,2,1
"11709","51e258bf5b6e58eb76cea47a12ba1eab",27,27,0,27,0,27,1,2
"11710","51e3697621b05b01ff1a24ae69d4f458",26,26,0,26,26,0,1,2
"11711","51e402d34f7cdf1fd13c3ceff117f822",68,60,34,14,68,0,2,3
"11712","51e5eb0fa49fc4ff9cbaeaa2f51ca0cd",29,29,0,29,29,0,1,2
"11713","51e818ab882851a2c56d8feb71e06878",118,76,45,18.3555555555556,81,37,3,3
"11714","51ee113a47303f1e940c417b286ed119",56,38,73,5.36986301369863,25,31,2,1
"11715","51ee7fe7e68bd0961875fa90c715fb42",99,48,70,9.9,65,34,2,1
"11716","51f54e5eaefa3584c8f5d5be0b7fd9ee",29,29,0,29,29,0,1,2
"11717","51f7fd4197923fcb97b2e7dc36338ac4",7,7,0,7,7,0,1,2
"11718","51f9f8b68e0bfd6bfd7b4e8c4dd20fa8",50,50,0,50,50,0,1,2
"11719","51fa96422ccde0dfcee37e487aa0b8df",31,31,0,31,31,0,1,2
"11720","51fb63a5a2c2f8f10f005199c5c2930c",91,78,68,9.36764705882353,69,22,2,1
"11721","51fbc1dd2748a5cd8c2dd8370f4aa417",40,35,73,3.83561643835616,40,0,2,1
"11722","51fd119929e0280dbda715fbbe29edff",61,51,26,16.4230769230769,41,20,2,1
"11723","51fea56e09faaf37f51cc0fd369ade6c",129,62,49,18.4285714285714,129,0,3,3
"11724","5200aba89184ed8f343592e543173e0d",65,55,12,37.9166666666667,44,21,1,2
"11725","5202b55015448998138a9839d836dd18",39,39,0,39,39,0,1,2
"11726","5203b529ad305ae03e9af11d79e3194e",77,69,19,28.3684210526316,77,0,1,2
"11727","5203e783e7d04b1380a6cf8b7ad18231",106,71,43,17.2558139534884,106,0,3,3
"11728","52051623c15ec885c5c29b7cee8c0d62",208,100,72,20.2222222222222,179,29,3,3
"11729","520610a7fbfebad600718f7f17b4a8fc",50,37,48,7.29166666666667,50,0,2,1
"11730","5206e5485085b2c4fe7b578879d7c24e",196,99,65,21.1076923076923,196,0,3,3
"11731","520869f4e6259a1cd4d78046f04fbff6",106,81,54,13.7407407407407,106,0,3,3
"11732","520ad6c3171cbdca447c83bb68706de9",46,41,34,9.47058823529412,46,0,2,1
"11733","520b680e176869e5f53c65e0e95b34b8",81,59,49,11.5714285714286,33,48,2,1
"11734","520c72480b57c26c20587e2e16bd60ac",91,74,29,21.9655172413793,91,0,2,3
"11735","520cf72bb5a7b3ba46852661d7fe0612",39,39,0,39,39,0,1,2
"11736","520db667217d96feb03255f635f07f5a",163,89,84,13.5833333333333,163,0,3,3
"11737","52162923b7223ed08d0da8a5c8f75bf2",21,14,83,1.7710843373494,21,0,2,1
"11738","52187a3c61258b0096a4d6a01e33d6d1",58,54,24,16.9166666666667,58,0,2,1
"11739","5219c865cbe1c348982d72bfeb6fdee8",18,13,58,2.17241379310345,18,0,2,1
"11740","521c3579c08ca671dee7355d0e97bfbd",2,2,0,2,2,0,1,2
"11741","521d24b9101f75c379ee185a1a29e7bc",50,50,0,50,50,0,1,2
"11742","521e2d234e2fd5f7f86e0ecc11464c13",45,33,25,12.6,45,0,2,1
"11743","521eb87b75b31b0320e4eeb68a01e069",98,72,19,36.1052631578947,50,48,3,3
"11744","521ed4492da2e560ef1b2d4c81e0779d",22,22,0,22,22,0,1,2
"11745","521f1c631a592157f000911d9cd05505",53,53,0,53,53,0,1,2
"11746","521fb88df2a1c41c5fcc95b11dbf3bc6",118,97,42,19.6666666666667,118,0,3,3
"11747","5224bbaaee02d8fcd95b786c01056428",106,53,59,12.5762711864407,106,0,2,3
"11748","522b29f5a62283ddfe77905f6318b5b3",32,32,0,32,32,0,1,2
"11749","522b3e3a6548b0074b1bec4b41097137",114,85,42,19,114,0,3,3
"11750","522d610373c6a11fed2be3c4cd633ccd",32,32,0,32,32,0,1,2
"11751","522dc1eabf85ca03effa9ab37a399235",9,9,0,9,9,0,1,2
"11752","522df79a798e5fceac5de2ad2a0e9e45",45,33,70,4.5,45,0,2,1
"11753","522f5e3a5aeb91f3d4b4f968df1b5d70",26,24,76,2.39473684210526,26,0,2,1
"11754","523648b6ca5b421d5bbe761ed1338267",13,9,60,1.51666666666667,13,0,2,1
"11755","523784d7dae5c14418dbc253bd4b77ea",11,11,0,11,11,0,1,2
"11756","523929318604682a01120f1a8b522c7a",40,40,0,40,0,40,1,2
"11757","523c0742ef46c7b8291554316c3884b5",60,54,30,14,60,0,2,1
"11758","523c0c4752c1f9fc6bcae1c3034a8699",16,16,0,16,16,0,1,2
"11759","523c770c145191d6873cfb674ecd9685",6,6,0,6,6,0,1,2
"11760","523fc4d92849f0657a9c42c564c73406",40,36,22,12.7272727272727,40,0,2,1
"11761","524017e27a9a7f4955caf5c24ee11d73",12,12,0,12,12,0,1,2
"11762","52408c8b40c54884107b497f9cb3a24d",53,45,31,11.9677419354839,53,0,2,1
"11763","5242b3a04d4c731a7068d6d768222dd9",54,54,0,54,54,0,1,2
"11764","52430c7284d9afab8670818a25ce6223",37,37,0,37,37,0,1,2
"11765","524579ce94824da0e3356525d08ffc6a",127,82,64,13.890625,127,0,3,3
"11766","52467b2b29da5c6bc5a8d5e8371e6d94",33,33,0,33,33,0,1,2
"11767","524701bf43cd45bff7638e4effb57ab5",40,34,21,13.3333333333333,40,0,1,1
"11768","5248bc49ea865c10bcebbd6aff166836",22,22,0,22,22,0,1,2
"11769","5248bd3d9a1c35f73c446dc8cfea0491",49,40,27,12.7037037037037,49,0,2,1
"11770","5249718217e6c9d0e4471f305d947f11",70,50,52,9.42307692307692,70,0,2,3
"11771","524a0d9907377647ae694a0432966572",30,30,0,30,30,0,1,2
"11772","524b3df204c0a8403404f556c37547f3",34,34,0,34,34,0,1,2
"11773","524b4491e314d73fb07f960a060b683c",32,32,0,32,32,0,1,2
"11774","524f0d3d3d9e9c7015ca0fc025668806",20,20,0,20,20,0,1,2
"11775","525254677a262621f138e884ab80bc53",17,14,45,2.64444444444444,17,0,2,1
"11776","5252e0e1b599a1a0ca52189b65ce7705",46,46,0,46,46,0,1,2
"11777","52541132115c11590eae900be59b963d",102,75,56,12.75,102,0,3,3
"11778","52549f2696b5616ac0205af62bc01741",10,10,0,10,10,0,1,2
"11779","525606239fc7452cfe5cd5b1fb1e427f",158,86,68,16.2647058823529,158,0,3,3
"11780","525682bd0a464810651907ffc37dd9c6",35,35,0,35,0,35,1,2
"11781","52573a847c630b2765d5f5475acd0290",33,33,0,33,33,0,1,2
"11782","5258f9048292295db44601b5992bfa5c",83,67,21,27.6666666666667,83,0,2,2
"11783","525a0e6d15521228ec427102f86a3060",33,24,56,4.125,33,0,2,1
"11784","525ad0ce6ff0aad715006b8ff295f019",69,61,34,14.2058823529412,37,32,2,1
"11785","525ae6018a72503fc87fced6eacdff19",68,48,18,26.4444444444444,45,23,1,1
"11786","525c1a3ad4c6a4716b0d32d09a4f3a8d",140,54,76,12.8947368421053,140,0,3,3
"11787","525ddfa9d46fe68ae459cdc0ede49561",23,23,0,23,23,0,1,2
"11788","525e769ea3acca0b1d25ccf25b5f92e0",79,59,34,16.2647058823529,79,0,2,1
"11789","525f1c36b2dccaa464c8d27e19b19c18",33,33,0,33,33,0,1,2
"11790","525f505104f04b499e648c90e3450919",183,105,72,17.7916666666667,145,38,3,3
"11791","525ffd6e742c83e337adc5277b83a8f9",10,10,0,10,10,0,1,2
"11792","5260baa246ad4c137abd692d57c361db",117,71,58,14.1206896551724,75,42,3,3
"11793","5261924d0ef40d19338ad438374f5a2d",70,55,20,24.5,70,0,1,1
"11794","5262de0fd5cd6b889186b6fc5189516c",23,23,0,23,23,0,1,2
"11795","5263bf7e88a4dcb1ea24b8dbaccaf3ff",17,16,29,4.10344827586207,17,0,2,1
"11796","5264229c3e6b540bb45f899a8887f841",25,25,0,25,25,0,1,2
"11797","526478a3eb79c07c826959c7005ea6aa",130,43,72,12.6388888888889,85,45,3,3
"11798","5264cb4cb47644ca28c90123965af1be",33,33,0,33,33,0,1,2
"11799","5268017c31efb88b831d950eedd87e4a",67,60,25,18.76,67,0,2,1
"11800","52687eda0e18579ba5452fe62f3541aa",2,2,0,2,2,0,1,2
"11801","52690c461b0a83a61f9bf1358780a294",3,3,0,3,0,3,1,2
"11802","526b66438ac70b55e2626eb83c5ac715",35,35,0,35,35,0,1,2
"11803","526bb9ccd34f6d421886d476f9ebfd43",35,35,0,35,0,35,1,2
"11804","526d10de23c1da9c081c947ea21e3785",12,12,0,12,12,0,1,2
"11805","5271c6a4a0b9a9c2762b84a0eaf4e4f8",44,44,0,44,44,0,1,2
"11806","527336f3a32a45d1292f66bf18caadbd",61,38,60,7.11666666666667,45,16,2,1
"11807","52762385824994338bc6d81ef18d500b",24,24,0,24,0,24,1,2
"11808","52789d0057991411a2cad9a46fa99fd6",45,34,77,4.09090909090909,28,17,2,1
"11809","5280205bcc542fa57d63443f72866eaf",76,65,27,19.7037037037037,36,40,2,1
"11810","52805c9fbe8c364dbe05088d3a1ba19d",26,26,0,26,0,26,1,2
"11811","5282c45360336ef061cb137b85746e57",90,66,70,9,90,0,2,3
"11812","52838bbbfc8ba3c5821a3a35cd7f8a81",142,89,54,18.4074074074074,95,47,3,3
"11813","528435b91691a75f5a60c6ccf4c6294c",83,62,39,14.8974358974359,46,37,2,1
"11814","5286c73da08bc30453a493d1cbca1038",27,27,0,27,27,0,1,2
"11815","5288e00ecef3b5bf9f4abe79001b1104",39,39,0,39,39,0,1,2
"11816","528a84de07ec2fe57e5d8dc4805c7d02",15,15,0,15,15,0,1,2
"11817","528be4dadfc6e77bda9273aa6e226151",14,14,0,14,14,0,1,2
"11818","5291ce9113945668d80c43e32834d317",212,110,89,16.6741573033708,212,0,3,3
"11819","5295cf19720ca5f41236fb61e747b205",25,25,0,25,0,25,1,2
"11820","529646ebf5944d097339f0395e39ce39",164,101,49,23.4285714285714,136,28,3,3
"11821","5297323955c8b915f9028fc8890b8f64",42,42,0,42,0,42,1,2
"11822","5298169475262f5edbb8b124b68fdd07",26,26,0,26,26,0,1,2
"11823","529969ac8454a05bdc8cad01128fae7f",192,139,80,16.8,150,42,3,3
"11824","529ae2f47c1d6219d0548ca6d50dfc4a",62,43,62,7,62,0,2,1
"11825","529d6d2ab0bb06386c156a760fa75cf4",85,76,69,8.6231884057971,85,0,2,3
"11826","52a12faa10fe68b9c73179f1a9e46f9c",67,54,38,12.3421052631579,32,35,2,1
"11827","52a24253ebd7f3fa1980ebfa1a99e8cc",10,8,25,2.8,6,4,2,1
"11828","52a636a8849058ace0618e41fafae7a8",187,117,45,29.0888888888889,187,0,3,3
"11829","52a797a0b282ebcc78a0a1c5c2f18cb4",87,73,61,9.98360655737705,87,0,2,3
"11830","52aa4e37a67a6b7bfc7c215e995dd3c8",43,43,0,43,43,0,1,2
"11831","52ac333682864267a5c789287e67ee48",137,67,62,15.4677419354839,137,0,3,3
"11832","52afed5dbcfd38ff6c8e14dcc0c3d12d",12,12,0,12,12,0,1,2
"11833","52b01687da7451b866667f376e11031f",143,114,71,14.0985915492958,90,53,3,3
"11834","52b03b64173e0e0cc9ddc00a291f0a4f",22,22,0,22,22,0,1,2
"11835","52b1464659354ee00ee0cea0f70ef88a",30,30,0,30,30,0,1,2
"11836","52b6525c3e705c416fa42c6aca4dc1d3",21,21,30,4.9,11,10,2,1
"11837","52b9d77adde315f40ebd15ef0098fce2",88,68,65,9.47692307692308,88,0,2,3
"11838","52bebae26a9ee0a23506f7cb31ad0460",24,24,0,24,0,24,1,2
"11839","52bf3a34af34a13bfb1f824a83a2709c",33,33,0,33,33,0,1,2
"11840","52bfa918e65d806dd3fb58e345ff32fc",52,52,0,52,52,0,1,2
"11841","52c03f02cc387e9ad778c3542a876cf1",155,66,69,15.7246376811594,155,0,3,3
"11842","52c0b82f5f6b4f18936e1b2088bc2746",68,49,54,8.81481481481481,39,29,2,1
"11843","52c0d09ae4fe235ddb952d00c9ad98e5",24,24,0,24,0,24,1,2
"11844","52c15d595d961e26ba45e739e932b338",145,74,35,29,145,0,3,3
"11845","52c31e4a06dcb21beffadbec336527e1",38,38,0,38,38,0,1,2
"11846","52c4bd96626119101b9e5e8dfd05b72b",31,23,48,4.52083333333333,31,0,2,1
"11847","52c4c1aa1d794cc07c1f08c4ce569981",18,18,0,18,0,18,1,2
"11848","52c5be0fb92b585b43eda5d0da5282b1",39,38,9,30.3333333333333,39,0,1,1
"11849","52c5e58ff3eb06b2298cec2e8f191b8f",34,32,45,5.28888888888889,34,0,2,1
"11850","52c6cf0c521c9a8c0a75c88c6c1e2404",31,31,0,31,31,0,1,2
"11851","52c9254c85604ca2799679470bfc7a3f",71,52,35,14.2,71,0,2,1
"11852","52cd54ddeb8188b34526f576f756206d",26,26,0,26,26,0,1,2
"11853","52cfbefd79c07db22cfde54dfd2e2f05",94,59,49,13.4285714285714,94,0,2,3
"11854","52d0067da5b2d80bd5052388a819ef4e",24,18,57,2.94736842105263,24,0,2,1
"11855","52d0547f0111fd3c2b7133e4da7d4379",12,12,0,12,12,0,1,2
"11856","52d092c419fe312a4d0b3c28b9691ad9",158,81,30,36.8666666666667,158,0,3,3
"11857","52d0cfcb1835e724a32919de8d8c9331",31,28,24,9.04166666666667,31,0,2,1
"11858","52d2dcb36faf94b5555701b1f57f10a4",54,43,31,12.1935483870968,54,0,2,1
"11859","52d450da91546c92ef95c14470b9bc54",27,27,0,27,27,0,1,2
"11860","52d7108427275832a6935f064a4de1f5",58,43,37,10.972972972973,58,0,2,1
"11861","52d8afd18540e16f0021c45b43dad4a0",20,20,0,20,20,0,1,2
"11862","52d8f785dbaef1305a6fd7e786c61ef2",97,77,77,8.81818181818182,97,0,3,3
"11863","52db919ab7032405522797f395c62f94",6,5,67,0.626865671641791,4,2,2,1
"11864","52dbd6bf32a9f1041b4cf071a22d0d5a",15,15,0,15,0,15,1,2
"11865","52dd50f738fafe5c239bfe3ad4854162",30,30,0,30,30,0,1,2
"11866","52dd73ddb95ea1d23f3e529ab6fb3199",20,20,0,20,20,0,1,2
"11867","52dd8c1beab297196f47527af092e9df",88,55,66,9.33333333333333,88,0,2,3
"11868","52de0655168d7786016886f82314f5af",22,22,0,22,0,22,1,2
"11869","52ded42cc223f67b820c935cb77aed2c",85,66,23,25.8695652173913,85,0,2,2
"11870","52df321a2cba257ba043b51952eab7ef",101,85,49,14.4285714285714,101,0,3,3
"11871","52e0bc71d58be7059a8740464eed5b03",93,79,42,15.5,93,0,2,3
"11872","52e112fc5ef2f14c8455b66109f22ab5",35,35,0,35,35,0,1,2
"11873","52e19c5b247a728a0d6f3bb07ee70a7a",15,15,0,15,15,0,1,2
"11874","52e1f0982578f0c99ba29e5a5749b711",94,47,67,9.82089552238806,64,30,2,1
"11875","52e40a04e16d59148818220cff16a3f0",167,91,53,22.0566037735849,120,47,3,3
"11876","52e434fc9ec4d3e46174231fc59f468c",47,40,60,5.48333333333333,47,0,2,1
"11877","52e51071d4e38e062ee986aa261706f6",171,107,90,13.3,171,0,3,3
"11878","52e5f211b332c2028702522e9a57619f",22,22,0,22,0,22,1,2
"11879","52e7e16e1d7681deebba1c3b3d58c1d2",111,65,71,10.943661971831,111,0,3,3
"11880","52ea8957089435ad3f2124268cf4c7e5",92,60,43,14.9767441860465,92,0,2,3
"11881","52eb1dfb79e67fe7ca4490842d5942af",65,51,22,20.6818181818182,65,0,2,1
"11882","52eb65852f9c9b580150f9e6f2cd654e",127,98,41,21.6829268292683,86,41,3,3
"11883","52eb97f1ace4204cbfb904c391cb95b7",21,21,0,21,21,0,1,2
"11884","52ee3823b8eec359476ab6e221a0a000",34,30,23,10.3478260869565,17,17,2,1
"11885","52f0213ded38ed01f7c4386a1203b73b",30,30,0,30,0,30,1,2
"11886","52f2609640fc7a55783c3c33991ac39e",135,91,77,12.2727272727273,104,31,3,3
"11887","52f674ba0029436b2f49b552917a2638",127,92,64,13.890625,80,47,3,3
"11888","52f9b74e53829fe92ee6eb6c5f5c4034",25,25,0,25,25,0,1,2
"11889","52fa5eaa12297850d9d4918740fbf2bf",45,37,32,9.84375,45,0,2,1
"11890","52fdadca6c121c460083d503c8834bf3",30,30,34,6.17647058823529,30,0,2,1
"11891","52fedad679880cc5191d367323566b17",147,65,63,16.3333333333333,147,0,3,3
"11892","5300e8a847005059e5665b34cb604870",126,70,65,13.5692307692308,126,0,3,3
"11893","5303b5f7cf581cb3ab06fb315c4da0fd",109,69,82,9.30487804878049,96,13,3,1
"11894","530aa92e67daaad2c897ddc73cf4d8f3",10,10,0,10,10,0,1,2
"11895","530d891a03a9dc41801bdca3389d3b84",125,96,49,17.8571428571429,125,0,3,3
"11896","530db3e7107892b92b19a568ae5456ea",44,44,0,44,44,0,1,2
"11897","530dc26b3739c8fdecda12780deeca72",40,40,0,40,40,0,1,2
"11898","530e6cacb32a5f136eb5d7559b832d86",34,34,0,34,34,0,1,2
"11899","5313817d325297cae14d57a21c5b4e0f",27,27,0,27,27,0,1,2
"11900","5315c9fbcf80eeebde9761b0c183d0fa",19,19,0,19,19,0,1,2
"11901","5317566b75ab016340dab04c1501a785",1,1,0,1,1,0,1,2
"11902","531bbfc33b52c748553d290968f235ff",91,62,65,9.8,91,0,2,3
"11903","531bc22c1344b0e39a11b880bf568c28",12,9,42,2,0,12,2,1
"11904","531e2022f6fd98b019084b14e9f83650",51,51,0,51,51,0,1,2
"11905","531efd8b2a17fcbd8b75c688272baa4b",47,47,0,47,47,0,1,2
"11906","532277ce40f974ac2c4393ae02d43890",127,84,52,17.0961538461538,127,0,3,3
"11907","532860664bfe99252d7783af6aeb4c02",72,57,68,7.41176470588235,72,0,2,3
"11908","53313e1921097f0729a3fc3e4352e431",55,44,40,9.625,55,0,2,1
"11909","5331ca0d85a87db19076dd9097de61bb",10,10,0,10,10,0,1,2
"11910","53327ff96a308765fecb205658e30ff2",21,19,39,3.76923076923077,21,0,2,1
"11911","5333375ead697d2cce0413fa129d6d0d",37,37,0,37,37,0,1,2
"11912","5334884356b81f25a08157b6b77656f7",20,20,0,20,20,0,1,2
"11913","5334b762d2239700a8b0e8a42d35cd97",81,58,46,12.3260869565217,56,25,2,1
"11914","53358f2ee8b45642ef788507ae80cd50",19,19,0,19,19,0,1,2
"11915","533747582372ba479c4f0ccade01ebc0",12,12,0,12,12,0,1,2
"11916","53389f51dc9f3977ca99f9c09f25ac3b",21,21,0,21,21,0,1,2
"11917","533c04a8fb9ba8d1155f4774439db4bf",35,35,0,35,35,0,1,2
"11918","533e1b170262c315789e8a6f8a8b9217",27,23,16,11.8125,27,0,1,1
"11919","534056521c63792928895e3548f447bb",65,54,71,6.40845070422535,65,0,2,3
"11920","5340f9630a2cc063b9f3ab2775f4ed6f",79,66,30,18.4333333333333,38,41,2,3
"11921","5342f00e7e4cc6969b89f98feddc6d46",7,7,0,7,7,0,1,2
"11922","53444ca6e3cbc9ba84fb69df8c22a047",35,35,0,35,35,0,1,2
"11923","53445eece442821b0db1e6e8ddbe2966",19,19,0,19,19,0,1,2
"11924","5346b606cf58342a4f176a49057d5998",54,45,63,6,54,0,2,1
"11925","534aa6cca96ee3d4bc2f4a84d34abd32",86,61,11,54.7272727272727,86,0,1,2
"11926","534b18c4cf537999a04c9fecb9538a4d",78,71,36,15.1666666666667,66,12,2,1
"11927","534d9e1c2cd787ccb77e4b0c4ad8df3f",12,12,0,12,12,0,1,2
"11928","5350c5ac1abd109644fa60c6770e1fb3",129,79,68,13.2794117647059,86,43,3,3
"11929","53528a72de81a731199d27bf0fdcc600",88,44,68,9.05882352941177,88,0,2,3
"11930","535888c116929a2e8df076fb49b47c75",213,135,70,21.3,158,55,3,3
"11931","5361e235a3298102582aa767d8562b7f",66,52,44,10.5,66,0,2,3
"11932","536214a9c77efef484bf808db3d334c5",145,75,72,14.0972222222222,145,0,3,3
"11933","5364843d619ac4abfbfa769938c5387f",223,110,89,17.5393258426966,202,21,3,3
"11934","536a5b0d9cfb7cc214e8c173b1fc2652",63,40,42,10.5,34,29,2,1
"11935","536aeb1cb9fda32650dc4fd975c661ee",137,87,55,17.4363636363636,137,0,3,3
"11936","536bf70bc4837a982dec027e46768b6a",26,26,0,26,0,26,1,2
"11937","536f87f94f04feb350be8743c54b8325",223,123,84,18.5833333333333,171,52,3,3
"11938","5371a429dc0a05bc4956cd0034de41de",36,35,7,36,0,36,1,2
"11939","5373a63576d5bc1a071abdc6ff4be4fa",67,53,58,8.08620689655172,14,53,2,1
"11940","5373a8a838a82ff236e5a4a3912fa1ef",100,73,49,14.2857142857143,100,0,3,3
"11941","5373aa889bccaf95b5b72b12d6532fec",112,63,65,12.0615384615385,112,0,3,3
"11942","5374f908d2139a8443d9959a01edcb6d",30,30,0,30,30,0,1,2
"11943","53768f3557bc158c25ae5006665a5817",60,12,88,4.77272727272727,60,0,2,1
"11944","5376fce48396cf58b0d796396ff64b09",23,23,0,23,23,0,1,2
"11945","5378cf977426014dd5dc434d21b4940c",19,19,0,19,19,0,1,2
"11946","5379611937673409abbbc23a0e43f979",3,2,8,2.625,1,2,1,1
"11947","5379e709f14a2f4688ea3a8641e6e392",99,63,69,10.0434782608696,64,35,2,3
"11948","537dd402da12faa891fb0403c931c7e0",40,40,0,40,40,0,1,2
"11949","537e8e798637dba47dde070bb5d99f37",46,39,59,5.45762711864407,22,24,2,1
"11950","537f5f5f2ea4425dc9092034b6b92521",158,90,40,27.65,158,0,3,3
"11951","538149a4e1da48053e138cbaee1dce9c",17,17,0,17,17,0,1,2
"11952","5381f60c7a192fb2933f2c1ad12c48bc",111,41,31,25.0645161290323,92,19,2,1
"11953","5382f17ce67de0327ba042a053e6ed58",126,85,77,11.4545454545455,126,0,3,3
"11954","53844068acc6285f711b92c8f07e6863",38,30,60,4.43333333333333,19,19,2,1
"11955","53846dc7c1996ec5a6cbcef399c36436",54,40,21,18,54,0,1,1
"11956","53862e53a0ec790cab882a6bcf3a13c9",162,112,67,16.9253731343284,107,55,3,3
"11957","53865632706a9a845fa70473ca72a5ee",187,72,71,18.4366197183099,187,0,3,3
"11958","53873659da160f61569b45d92f64cd7f",70,55,28,17.5,70,0,2,1
"11959","538b3e40200d673cfe751772a87f5787",153,96,75,14.28,123,30,3,3
"11960","53916473f89cec363ac2fdf9cc16ddb6",57,40,51,7.82352941176471,57,0,2,1
"11961","5392af5c0c4978c3d0acc6db9349142c",24,17,56,3,24,0,2,1
"11962","5394a0855ed00b75d0f1a47506cd9236",41,28,25,11.48,41,0,2,1
"11963","539647a74685fd55a5b9359fb401c920",29,29,0,29,29,0,1,2
"11964","5396aabbb93f6517e0bc6567654c57c3",21,21,0,21,21,0,1,2
"11965","53981a938dedaca7dd79dbd5b3b4024c",15,15,0,15,0,15,1,2
"11966","5398a2e73b12204fd6b24d172f3e04c2",9,8,7,9,9,0,1,2
"11967","539b7236c1a2cf5983bc29fc4bf80f2d",3,3,0,3,3,0,1,2
"11968","539ba56747fed7f65c4c0fdf7094b10b",73,68,35,14.6,73,0,2,3
"11969","539d71823f2926cc77aab9375e3fe7c4",101,72,35,20.2,101,0,3,3
"11970","539ff216896eb8d689bd04d2d50c0d6b",157,92,61,18.016393442623,111,46,3,3
"11971","53a0a8efcf136017afcf24f3ec9d6ac0",92,47,47,13.7021276595745,92,0,2,3
"11972","53a38e23a983c911c2e2a473ad5df783",37,37,0,37,0,37,1,2
"11973","53a49143ed4fe45b58d6b6f37eff9344",44,44,0,44,44,0,1,2
"11974","53a90a8dd194d7fcfc51e6ffab58fae6",27,23,49,3.85714285714286,0,27,2,1
"11975","53aa4186e5c15c2c51e48eb5a402a95a",180,90,76,16.5789473684211,148,32,3,3
"11976","53aaa4e4c906e13bd57ca48ceb6001e7",101,81,57,12.4035087719298,101,0,3,3
"11977","53ab75242751b3a128e112d569b9200c",74,49,61,8.49180327868853,74,0,2,3
"11978","53ac305d47a8fc28fe8944ead73b7d6d",7,7,0,7,7,0,1,2
"11979","53af369e1367c08334c556224698fd8d",13,1,83,1.09638554216867,12,1,2,1
"11980","53b71b7fb3fd7d267257247f2a16ce47",29,29,0,29,29,0,1,2
"11981","53b720dfdb669d4a54024ddaf2e69fa9",41,41,0,41,0,41,1,2
"11982","53b99f29c39beefaf3222f8ff8579644",10,10,0,10,10,0,1,2
"11983","53b9f8d0a4440ae9157139432fc43e9a",117,77,70,11.7,86,31,3,1
"11984","53bc139874300c741bdeaf512746476c",20,20,0,20,20,0,1,2
"11985","53c25da34be16116b8e7502f2342ee47",84,63,48,12.25,84,0,2,3
"11986","53c4fa596e60194234d9fc56eaf4af9b",6,6,0,6,6,0,1,2
"11987","53c6aaec60af7a94503f511e9693d45b",53,53,0,53,53,0,1,2
"11988","53c767c35fb3f83fe4d6f3f4c44cec7d",37,34,43,6.02325581395349,37,0,2,1
"11989","53c779b9b7d8e4b374cadda3920e5231",155,74,71,15.2816901408451,155,0,3,3
"11990","53c96fa8b1592b96821ed03fc40c5f25",8,8,0,8,8,0,1,2
"11991","53ca0f5007f7e3e5c01c3bb1c7cb98c1",45,45,0,45,45,0,1,2
"11992","53cc4ee5dec9df620f457f3ea7cf6a97",212,92,70,21.2,212,0,3,3
"11993","53cd5d3f0318307d8652467419973345",64,54,9,49.7777777777778,64,0,1,2
"11994","53d18300412cf32240ee392490c21198",47,41,33,9.96969696969697,47,0,2,1
"11995","53d1f7b3f50d849b4a90bfff97ac855e",149,86,64,16.296875,149,0,3,3
"11996","53d9df5364ae43bab789f824c7bff7b6",72,60,55,9.16363636363636,72,0,2,3
"11997","53da3c0229cc941769d6719b668cc48b",26,26,0,26,26,0,1,2
"11998","53daedfc998131848831419fa2c0bd90",170,128,60,19.8333333333333,170,0,3,3
"11999","53de5388b2fb8351b420f45c76f1c68c",58,44,42,9.66666666666667,58,0,2,1
"12000","53df9f7706134ae07abc25ae42cdb418",126,75,68,12.9705882352941,95,31,3,1
"12001","53e07a5a16d3d38c5925c3b0aa19e674",136,69,58,16.4137931034483,98,38,3,3
"12002","53e2b5f7686a2021257bb5431f741cf9",8,6,2,28,8,0,1,2
"12003","53e56751dcfd1a96354e34af72e243be",21,21,0,21,21,0,1,2
"12004","53eb1b3ae6964f20bd27666db1447560",108,79,32,23.625,108,0,3,3
"12005","53ecac8a497cff1729e35f1555d8a96f",13,13,0,13,13,0,1,2
"12006","53ed5511e20554a54da8a45aeb28c3e5",121,80,56,15.125,121,0,3,3
"12007","53ed6dfc5f3f7e57d1325dce984f7492",19,19,0,19,19,0,1,2
"12008","53edd0404c56c3c07ec861c3fa64acb6",32,32,0,32,32,0,1,2
"12009","53eed604b387ec378e684887a12f1875",103,64,66,10.9242424242424,73,30,2,1
"12010","53f47867f1f8717041a5ae3ed34f12d1",142,62,84,11.8333333333333,142,0,3,3
"12011","53f5815939ecc77a97f9dbed7b1ae58b",110,81,60,12.8333333333333,110,0,3,3
"12012","53f7194e8a37556e605220cf14074acc",6,6,0,6,0,6,1,2
"12013","53f7de2266168a56cd15bd5ba8961b7c",54,36,37,10.2162162162162,54,0,2,1
"12014","53f8341b3f5ab6d9fe1f5b8d763b2834",20,14,69,2.02898550724638,20,0,2,1
"12015","53f8618dbaf4e2c38bb872c6d1c89e11",121,99,36,23.5277777777778,121,0,3,3
"12016","53f8a486ec50cbf941866e28a473c49a",54,40,64,5.90625,41,13,2,1
"12017","53fa7f78310fdb08e53f4c4e1188c784",133,99,42,22.1666666666667,116,17,3,3
"12018","53fe6443f0199cc498bec4f7bfd7035c",5,4,7,5,0,5,1,1
"12019","53feb65523c9b286b18623abb96c1aa3",43,43,0,43,43,0,1,2
"12020","53ff09990da7dc4b2a2340473d333e17",40,28,15,18.6666666666667,40,0,1,1
"12021","53ff77cdeea47ffbbe21d1f1eaee3c73",25,25,0,25,0,25,1,2
"12022","53ffb83e85fd51cf1ec2fdef3c78b4fd",95,68,58,11.4655172413793,67,28,2,1
"12023","54006020f36851cb36016979ebff0e2b",9,9,0,9,9,0,1,2
"12024","540279b6e66bba7a4033955d8995dc62",61,46,66,6.46969696969697,41,20,2,1
"12025","54030a93b2209a23c9dda4a7c53f2450",13,13,0,13,13,0,1,2
"12026","5405e1d1c832b0294c3d11530f4798d0",139,84,63,15.4444444444444,139,0,3,3
"12027","5406826b7ee87db82f95584377e5fab8",89,64,69,9.02898550724638,64,25,2,1
"12028","5406aa674925042d7a0bec4d1c6deff1",26,26,0,26,26,0,1,2
"12029","540734cb35dee14b73683e2f62434fde",116,71,85,9.55294117647059,77,39,3,3
"12030","540a97088201658e08c938d11b94fae4",116,74,52,15.6153846153846,74,42,3,3
"12031","540de465aaff43045679f964b8d1ffb6",34,34,0,34,0,34,1,2
"12032","54102b6e59744ac0e0228a1f77a01991",159,74,84,13.25,159,0,3,3
"12033","5410c14ba66956b4378d354c5cd030c2",11,11,0,11,11,0,1,2
"12034","5412f9abbb6ef3d0d949dea5f1a1c633",29,29,0,29,29,0,1,2
"12035","54131231189ff1c2b4889ccbbd3c346b",76,37,71,7.49295774647887,45,31,2,1
"12036","5413c3bd810cd6afe3c53a469d9ead5e",42,41,50,5.88,42,0,2,1
"12037","54141b326381208f21336024dab8bb44",8,8,0,8,8,0,1,2
"12038","5419344cf838a9781bf075ed23c1da94",88,59,32,19.25,88,0,2,3
"12039","541a361c4220e40c49d400a856bda3d1",112,88,69,11.3623188405797,112,0,3,3
"12040","541bd295389baed123f0b7afc57488ad",30,30,0,30,30,0,1,2
"12041","541bfe2adfa42a28d6dc75eb14420c64",21,16,42,3.5,21,0,2,1
"12042","541d6ed078ffa184b747abcf939af70e",40,40,0,40,40,0,1,2
"12043","5423c5c32e78dcc26a0cdf483a5ca2d3",86,68,31,19.4193548387097,86,0,2,3
"12044","54267d29f984e257d4d65b65c561875d",53,53,0,53,53,0,1,2
"12045","5426891cd8787223dca061f14e20fd56",128,69,67,13.3731343283582,128,0,3,3
"12046","542e58469b4a7993db6a0ff62c1620eb",28,28,0,28,28,0,1,2
"12047","543087cc04b7f8a72372e82c157b0c7d",33,25,36,6.41666666666667,33,0,2,1
"12048","5430f1527c68d4c3823bae95ac5980d8",34,34,0,34,34,0,1,2
"12049","5435e7c559c1611a6c24f619de1d2acd",18,18,0,18,18,0,1,2
"12050","5437f629d5c208a74f25b5b7d25181cf",31,31,0,31,31,0,1,2
"12051","5438c6e29894f7be5cf4c999850c3a64",58,42,52,7.80769230769231,36,22,2,1
"12052","543dce4972e0c207c2453c89cd0812a0",182,49,85,14.9882352941176,182,0,3,3
"12053","54419fb25b1a929a732b1175849d37bf",56,45,75,5.22666666666667,43,13,2,1
"12054","54478c2dc25d2f1bf791d223b3d5ac62",42,42,0,42,42,0,1,2
"12055","5449015569b5c427c1574d4175c770c7",92,78,49,13.1428571428571,92,0,2,3
"12056","5449e57336ac6fbe6de39105944cff3d",25,25,0,25,25,0,1,2
"12057","5449f1e3a30c8586b68a6e2568529a99",129,53,71,12.7183098591549,83,46,3,3
"12058","5449fae8d709b213d8c0e90a8976090b",80,68,29,19.3103448275862,80,0,2,3
"12059","544a2c8a79903e619f37bab1a0531e06",31,31,0,31,31,0,1,2
"12060","5450658d2cc850792bfee5228b227cae",29,29,0,29,29,0,1,2
"12061","545126f192ad318aca5980c726789cee",31,31,0,31,0,31,1,2
"12062","5452cbf15b65b1eb84e61ea0c116c054",33,33,0,33,0,33,1,2
"12063","545335c9ba9f75d350e4ad57cc1c9b35",21,21,0,21,21,0,1,2
"12064","54546f5ef294bd99d22b1b60a02d2538",109,86,80,9.5375,61,48,3,3
"12065","5458af657b69bbbb8c15ede3a24e8afb",16,16,0,16,0,16,1,2
"12066","545c4204b154339b2956ff0edfc5fc13",174,104,50,24.36,138,36,3,3
"12067","545f4f3b4a74aa9d276f52c8413a2e71",161,113,61,18.4754098360656,161,0,3,3
"12068","54614ed21ca36e8bac9f587dd17ab6b0",102,85,30,23.8,52,50,3,3
"12069","5461906650a950b27892ad7ea5f6e142",56,43,65,6.03076923076923,56,0,2,1
"12070","5465f26150db0117439b19aed37114f9",70,51,59,8.30508474576271,59,11,2,1
"12071","54670edf32dc93db97629b7fd23dfb6d",3,3,0,3,3,0,1,2
"12072","546b564539565657c449ad35fdf2ee33",60,43,44,9.54545454545454,60,0,2,1
"12073","546b7fc68c1b4045e96ab4195cb6f427",180,102,49,25.7142857142857,180,0,3,3
"12074","5472480646d517ab75ad21b960cacf03",91,48,63,10.1111111111111,51,40,2,1
"12075","54753e1abbcd85942004724feddb2606",16,16,0,16,0,16,1,2
"12076","5477033de98c0b1c3b5cb45303993b4a",75,53,35,15,75,0,2,1
"12077","547861dc3b9aff207385dea3b1c6ed42",25,25,0,25,25,0,1,2
"12078","547a19c294588985a3e670e94f9c1f71",18,18,0,18,18,0,1,2
"12079","547ed8ffe3b6f399dc5d2f69827c0a3d",137,49,77,12.4545454545455,137,0,3,3
"12080","547f919f2b5741b506c5a8782f523f77",49,49,0,49,0,49,1,2
"12081","5480b6b6906238d212d7d6878711fce3",48,41,28,12,0,48,2,1
"12082","548224b373556ea84679972966b960b7",126,83,89,9.91011235955056,90,36,3,3
"12083","54831059780c82ed3c24102a0e731d75",127,72,70,12.7,127,0,3,3
"12084","5484f5119dc5dc60823042c6ee0d1b43",136,88,63,15.1111111111111,110,26,3,3
"12085","5485cf25981ad1f5a4776c75afc2c8cd",24,24,0,24,24,0,1,2
"12086","5486869409a87bf51c69810db6fd11c9",82,46,58,9.89655172413793,52,30,2,1
"12087","5487fc6bbf24177298d6f1e6cd3144ae",79,50,57,9.70175438596491,79,0,2,3
"12088","548960c6550321f9e8b4810cdef22c19",159,87,61,18.2459016393443,159,0,3,3
"12089","5489fa483ab78ae67bb800137781f381",163,133,42,27.1666666666667,163,0,3,3
"12090","548a39457b9fd7e00f823bedd1f1d251",120,85,72,11.6666666666667,120,0,3,3
"12091","54901f6048ae2397d1578c55704e1c94",17,17,0,17,17,0,1,2
"12092","54916a541e248f07b27ae4049315da18",76,57,57,9.33333333333333,31,45,2,1
"12093","5491b0dc77ce9cd6be1e78f51ec78ba8",29,26,7,29,29,0,1,2
"12094","5493d1353cabb0ac3d34708a86e217fb",27,27,0,27,27,0,1,2
"12095","54959c4186d9b4028bed1eecaa6f1451",20,20,0,20,20,0,1,2
"12096","54969def3e2f98092018299ad72f249d",36,29,66,3.81818181818182,36,0,2,1
"12097","5497973ecfe3643387f8de3be8c9dd37",40,37,11,25.4545454545455,17,23,1,2
"12098","549984b5f6cb7dc8f7354935458a5583",18,18,0,18,18,0,1,2
"12099","549db0d882d8b0ee47efdaa4bd10e57b",132,62,78,11.8461538461538,79,53,3,3
"12100","549dd39a9cef340cabccca622faf1e2d",124,33,84,10.3333333333333,114,10,2,1
"12101","549e2c6bdcdfd3e86d7236fba3fc5105",11,11,0,11,11,0,1,2
"12102","54a1abbb808ea322add4b3da07c2d0a0",16,16,0,16,16,0,1,2
"12103","54a3c7a27db9f3331764dd97ec57925e",152,69,77,13.8181818181818,130,22,3,3
"12104","54a4acbf1b5ec15ecc6e9b36a2e11c50",206,125,71,20.3098591549296,156,50,3,3
"12105","54a4f1b555291691c0b5428b2b496e23",85,35,66,9.01515151515152,85,0,2,3
"12106","54a5e8555047f425f8da887210cafd7d",60,43,23,18.2608695652174,24,36,2,1
"12107","54ac1e3e2e74e3e3958c36f12641fcba",50,44,54,6.48148148148148,50,0,2,1
"12108","54aca8f4d0056fa3917871a96a58719c",103,71,73,9.87671232876712,103,0,3,3
"12109","54ad4b8ee51762bd90b2aad459349848",111,91,40,19.425,111,0,3,3
"12110","54af11d3847bdf0a349c6b8ef6698bf8",112,58,88,8.90909090909091,82,30,2,1
"12111","54af36089a5e505e168a6fa1c65326f5",38,38,0,38,38,0,1,2
"12112","54b034f2e31f8c3d9c1d8b30e7b0f81c",39,34,13,21,39,0,1,1
"12113","54b1e0e0a8d455ba26a2bcc133df2043",100,68,70,10,100,0,2,3
"12114","54b45bc127afc009733a37dedec83b28",44,44,0,44,44,0,1,2
"12115","54b7a2648b055ef813ba2b97c48ddc81",25,25,0,25,25,0,1,2
"12116","54b88fe7dd854567b01073a4ca078346",39,39,0,39,39,0,1,2
"12117","54bc6281eac21eb8e74f0e5a94acefdc",75,69,36,14.5833333333333,75,0,2,3
"12118","54bccc6b552584ec00b962551114ba81",4,4,0,4,4,0,1,2
"12119","54bfdbad8a300fe4c09c80e998a354c5",15,15,0,15,0,15,1,2
"12120","54c04adfca6699898a23fb18959a1dc7",28,28,0,28,28,0,1,2
"12121","54c2dcb87d9ac4d9c28ba1837d6187cc",49,49,0,49,49,0,1,2
"12122","54c5b85c9f5f64c3a035fd2d2a81ef97",39,31,9,30.3333333333333,39,0,1,1
"12123","54c6b8a27cd2ef9ecf141665efc3f962",129,86,57,15.8421052631579,129,0,3,3
"12124","54c772158fa03f3579a3ff1bc52e2bfe",31,31,0,31,0,31,1,2
"12125","54c77fee26efe4302d33b7ff828972ca",3,2,1,21,3,0,1,2
"12126","54c79c302c8184de966ee8ad1be39f22",22,22,0,22,22,0,1,2
"12127","54c7cc01342dff244f084a99ac50a960",40,31,7,40,40,0,1,2
"12128","54c80c9a1c94b20398d1814577a712a8",83,73,15,38.7333333333333,83,0,1,2
"12129","54c8614927cbf74ca5ecd0cb0d7c8678",36,32,44,5.72727272727273,36,0,2,1
"12130","54cf8219dc47b2fe2b910ab7f515d02f",32,32,0,32,32,0,1,2
"12131","54d386a2571b61d237059ec2324250d6",25,25,0,25,25,0,1,2
"12132","54d4df9a9c187f7a7540ac48f7ad88df",112,70,62,12.6451612903226,112,0,3,3
"12133","54db14b64a7e440a8fca38f256b8c4aa",41,41,0,41,0,41,1,2
"12134","54db709f23d177ac5980a4ccf8009c2d",129,61,79,11.4303797468354,129,0,3,3
"12135","54dc7843515a05b63bd153de0f4db242",167,67,82,14.2560975609756,167,0,3,3
"12136","54e0dda689f010390eea43593295c8f9",3,3,0,3,3,0,1,2
"12137","54e10730d9f1bc10ee6d8f5b435c2dc8",81,69,47,12.063829787234,81,0,2,3
"12138","54e18983d1fe1c5b1787b1d945e1af57",39,39,0,39,39,0,1,2
"12139","54e24643cd1a56401d93ccceeeb50112",107,74,62,12.0806451612903,71,36,3,3
"12140","54e46bcdfd24e8838b507d7e18e21db5",41,29,57,5.03508771929825,41,0,2,1
"12141","54e674c6235200f5842898f9be0ab37e",26,25,36,5.05555555555556,26,0,2,1
"12142","54e73abd31bc23eda8b9bdf5fbebdc98",150,96,89,11.7977528089888,113,37,3,3
"12143","54e8d014ea8515ac6122d1e240e37f31",14,14,0,14,14,0,1,2
"12144","54e96f7b5a6a439f07cc7c88b3dd0465",47,38,58,5.67241379310345,1,46,2,1
"12145","54ea0f97f488750d1edd59908dd41d86",39,30,29,9.41379310344828,39,0,2,1
"12146","54ea9962e79b1d0ed482c6c62b28847e",30,30,19,11.0526315789474,30,0,1,1
"12147","54ec7fe4bc15bde548f39db031c88b63",35,35,0,35,35,0,1,2
"12148","54ed8f115012ddb0a41661bdd8345404",22,22,0,22,22,0,1,2
"12149","54eec3b04d86bdf3b2b4b1879c6103db",26,26,0,26,26,0,1,2
"12150","54ef72eee6e159cca3ebc5617bd8973c",66,47,62,7.45161290322581,66,0,2,3
"12151","54f38da50432cdcd8681e38079159910",53,47,27,13.7407407407407,53,0,2,1
"12152","54f48850a8e27f98232054ae9ec14659",36,32,14,18,36,0,1,1
"12153","54f4a4f921751a5b2fbab32a4c60ef15",32,32,0,32,32,0,1,2
"12154","54f6712ac6a2d20b1821ec43a6bf1da4",32,32,0,32,32,0,1,2
"12155","54f6e9bdf76af2de9f3c31db6f6b3d3c",94,36,70,9.4,76,18,2,1
"12156","54f70f23dfcf787db86253cbd0bf1361",15,15,0,15,15,0,1,2
"12157","54f97521e52d0701edf1ddbc41e5334f",143,103,77,13,143,0,3,3
"12158","54f993b67b7f16330a71c96a5fa5cc05",109,75,58,13.1551724137931,109,0,3,3
"12159","54faa3491f479498a1d5c7a390966b50",20,20,0,20,20,0,1,2
"12160","54fb4db9fce5bff2b14396feabfd6826",49,42,47,7.29787234042553,27,22,2,1
"12161","54fee37f5bf444f0707230c14546d745",14,14,0,14,0,14,1,2
"12162","5503cf7e7c2477adca1523387b48cfb3",113,74,51,15.5098039215686,113,0,3,3
"12163","550427346f46e99f82edeff129333647",51,51,0,51,51,0,1,2
"12164","5505b5726dc522459bd94e502b6d461a",36,36,0,36,0,36,1,2
"12165","55070ed1fc4febddad7e6dc50a0fea7d",42,18,69,4.26086956521739,36,6,2,1
"12166","5507861fb39664ea4705167b8babbe34",93,69,53,12.2830188679245,71,22,2,1
"12167","550968fc6c4adc42189f24172be6affa",27,27,0,27,0,27,1,2
"12168","550b40c884615fb51c8ebe003f86c2c5",3,3,0,3,3,0,1,2
"12169","550b9fed87a0ff60bd4bbd309b202ec1",48,48,0,48,48,0,1,2
"12170","550bdee6df01dbd34af12eab73caf16c",5,5,0,5,5,0,1,2
"12171","550d92cabe9a9f178f882c77f5b7c3ab",5,5,0,5,5,0,1,2
"12172","551257404f3075ca0835ae5a7344c646",61,35,85,5.02352941176471,38,23,2,1
"12173","551510b2505eb3f3d94076173997b13b",7,7,0,7,7,0,1,2
"12174","5517370ed7a3915b3ad561ad14908d06",34,34,0,34,34,0,1,2
"12175","551b07a72dc3f1530a29975e1debbbfd",20,20,0,20,0,20,1,2
"12176","551df3c62d7713f01a8b32d912e9ca2c",23,23,0,23,23,0,1,2
"12177","551e73c2c52da085759597d1049e5263",97,54,61,11.1311475409836,97,0,2,3
"12178","5520c44ffb4e887254f96ac6ad62c6c9",12,12,0,12,12,0,1,2
"12179","5520de0f09126ae5921d02852049f730",48,40,70,4.8,48,0,2,1
"12180","5521871eec5cbde4f46b61517d1e031a",18,18,0,18,0,18,1,2
"12181","5523372411b6e315e0001504bfb93d8d",108,67,73,10.3561643835616,108,0,3,3
"12182","5523e773ced2f370213ca4932dd12989",8,8,0,8,8,0,1,2
"12183","5524b5ca79e4969ee87da70ab2cf338d",90,72,67,9.40298507462687,70,20,2,1
"12184","5524ffd9346745e4838b5b3268f70138",34,33,54,4.40740740740741,34,0,2,1
"12185","55278a5626299162d1bfc7e6a2470326",71,67,32,15.53125,71,0,2,1
"12186","55281ad4bfb09efc696dfde10fd57786",114,49,57,14,114,0,2,3
"12187","552874ccf124f45bca65c22cd8427576",67,52,48,9.77083333333333,67,0,2,3
"12188","552b05bb7cc4f4cb5db33b274f3868e3",37,34,54,4.7962962962963,37,0,2,1
"12189","552b29d51200edbb29d5cebd7d36db04",31,31,0,31,31,0,1,2
"12190","552d04c18f6155df33d8bbfe7649d07e",44,25,72,4.27777777777778,44,0,2,1
"12191","552f349ebf251ab7368cd754e6915b4f",92,40,57,11.2982456140351,92,0,2,3
"12192","552f8097527a1de0972a4d8eaf9bf265",10,8,56,1.25,10,0,2,1
"12193","553198f5a29f05a89d1e9faa6f1d26ad",42,42,0,42,42,0,1,2
"12194","55337a5fd78436d33b3629f01b4a8912",4,4,0,4,4,0,1,2
"12195","55339cb4a14243da266f8f5d17707b23",150,95,63,16.6666666666667,150,0,3,3
"12196","5535034ed99df7ed9485da12698741db",55,45,31,12.4193548387097,55,0,2,1
"12197","5535e2a643f0d8ee6e720cb111bf8923",52,52,0,52,52,0,1,2
"12198","5535e8995348d4330e9007d90b818c3c",208,103,81,17.9753086419753,208,0,3,3
"12199","5539bb41dad59530224598c57dd5a1b2",48,31,77,4.36363636363636,48,0,2,1
"12200","553a5877ee1f9efb96307b4cb96739da",184,52,82,15.7073170731707,153,31,3,3
"12201","553aee3d86e190a3ad7fbad21296e036",134,64,82,11.4390243902439,113,21,3,3
"12202","553cf74236eb8e6e6cd2c2ef9aaa5858",6,6,29,1.44827586206897,5,1,2,1
"12203","553de94b7f89a86862b20512be6499ab",141,117,63,15.6666666666667,141,0,3,3
"12204","553ed5285fe52b7ef5276e1ad261938f",14,14,0,14,14,0,1,2
"12205","553ef4022f268e94e58c0315e6a55111",55,35,58,6.63793103448276,55,0,2,1
"12206","5545761e46e5e5e7058fcdb4aad32a20",55,49,45,8.55555555555556,55,0,2,1
"12207","554a31706452eb91b394599fa7938f8e",31,31,0,31,0,31,1,2
"12208","554a75a56408617a3cfd8c9b7a679d8d",32,32,0,32,32,0,1,2
"12209","554acc64359711fe5e517f95cee46d74",114,81,61,13.0819672131148,75,39,3,3
"12210","554d248d73ecef6ba7991996dd8a0ea0",53,44,26,14.2692307692308,53,0,2,1
"12211","554e2cf65dc8e99ed1ad4929757ec0fe",20,20,0,20,20,0,1,2
"12212","554e60a810972aeaa0f56b4c64be2031",9,9,0,9,9,0,1,2
"12213","55500fd11189008641d9b6955ebab525",99,69,54,12.8333333333333,99,0,2,3
"12214","5550bdfda761eaa65f9568b1633c65d3",70,60,37,13.2432432432432,31,39,2,1
"12215","5552a9eff725155423c96c8b4845cde7",42,42,0,42,0,42,1,2
"12216","5552cce32127f5a60e4afffefd494504",34,34,0,34,34,0,1,2
"12217","5553f92db7022ac9dc5c3e9810bd52e2",19,19,0,19,19,0,1,2
"12218","5557138ee14fba82d75d896324de628d",26,26,0,26,0,26,1,2
"12219","5557307e6821716efd55a191a09c81e4",17,17,0,17,17,0,1,2
"12220","5558211956cc352c96f02273082f29b6",49,49,0,49,49,0,1,2
"12221","555c7692236aff37d76d088e1c3ad5a7",42,31,58,5.06896551724138,29,13,2,1
"12222","55626b18560dce7cf33f50029c50afa6",24,24,0,24,24,0,1,2
"12223","55651d3a18479bd14b76d4f06f72e21a",10,10,0,10,10,0,1,2
"12224","5568287398bcfaa2b3abe1defdf28792",9,8,32,1.96875,5,4,2,1
"12225","556ee268d1b0bc24b2dfdb18252b7e9c",46,39,31,10.3870967741935,24,22,2,1
"12226","557072c52d9434a0c157c2b542f334c4",86,51,59,10.2033898305085,67,19,2,1
"12227","55737429be83f03f50da12d708020974",66,50,51,9.05882352941176,66,0,2,3
"12228","5573a951c4b752dda155ab72bb1cacd0",63,48,19,23.2105263157895,63,0,1,1
"12229","557498b17f2732b9cdaf7e0f6174f902",14,14,0,14,14,0,1,2
"12230","557621974c82738149eb02a64cb559c3",26,26,0,26,26,0,1,2
"12231","5576b92008dbd12466c4a12ea7386c00",53,48,48,7.72916666666667,53,0,2,1
"12232","5577a072b2c931208b181153f58498b2",22,22,0,22,22,0,1,2
"12233","5578cde9b6838af3df872f4e99899cd1",40,40,0,40,40,0,1,2
"12234","5579a129dd48c677ac690d7723bc5618",31,31,0,31,0,31,1,2
"12235","557ebbd49db4820bf346851ef8ea216c",35,35,0,35,35,0,1,2
"12236","557ef1216b56c946c49d1bd59e4d2310",25,25,0,25,25,0,1,2
"12237","5580493da3cbdb330735af38321608c5",148,94,63,16.4444444444444,148,0,3,3
"12238","5581a10b8aa89907d89fe8f2bdc4a4b3",34,34,0,34,34,0,1,2
"12239","5583beab0fb55dbe35976369344e94c7",36,36,0,36,36,0,1,2
"12240","55861a04a21ace9f5a06728ec9587975",142,66,77,12.9090909090909,142,0,3,3
"12241","5587f828f90a524ebee687b1d99fe7ba",13,13,0,13,0,13,1,2
"12242","5588a0439f9d9bd8cc1cc50de072d3fc",103,66,70,10.3,103,0,2,3
"12243","558b02f698ee3bb0b6e297b8b8e24e08",27,27,0,27,27,0,1,2
"12244","558c70fc667e69aa052149024b607f59",129,73,57,15.8421052631579,129,0,3,3
"12245","558d5470626704bfd4ef8fa27424ae71",31,31,0,31,0,31,1,2
"12246","55902400623d15bdb20289ddda5e36ba",36,36,0,36,36,0,1,2
"12247","5591d803ebdd5a716c6c5e988c361051",1,1,0,1,1,0,1,2
"12248","55987bcae0862ad63af2887745895750",236,131,86,19.2093023255814,205,31,3,3
"12249","559a00249816b63409db556bc33b592b",5,4,50,0.7,5,0,2,1
"12250","559a39ad36d842926e54d9f2851853d3",134,103,48,19.5416666666667,134,0,3,3
"12251","559babe64aa1146d20174d89f3702654",7,7,0,7,7,0,1,2
"12252","559dff5af12b80d3ec7ed20d6d4eccad",129,78,66,13.6818181818182,129,0,3,3
"12253","559fd07048fc12f47c498098d4030547",9,9,0,9,0,9,1,2
"12254","55a000efa98264f45bbe87606754b155",98,65,49,14,70,28,2,1
"12255","55a180d693d2ba10bdd260b5689facec",180,75,65,19.3846153846154,180,0,3,3
"12256","55a26280560343b12905c6904a6031c6",34,28,28,8.5,34,0,2,1
"12257","55a3bdb4c2d84adf259ee70ad63b3a0f",15,15,0,15,0,15,1,2
"12258","55a3c22cdaf30bb050f4c98a5d1aeff6",72,61,42,12,72,0,2,3
"12259","55aa2522e8ac08d64d8b8abdefef39b8",154,111,49,22,102,52,3,3
"12260","55aa2e62815fe271ce512bfc8469f7bc",12,7,35,2.4,12,0,2,1
"12261","55aa69cf6da5fde86407e3f29c1c8fe5",4,4,0,4,4,0,1,2
"12262","55ac037370c31c56eae89b06eabb54b2",19,19,0,19,19,0,1,2
"12263","55acd59cf44d4682750cffdf61d4b898",11,10,37,2.08108108108108,9,2,2,1
"12264","55ad2705d60fbc39762ddd9986164530",39,39,0,39,39,0,1,2
"12265","55ad62df3b0067e485fc00729c33ca73",151,91,59,17.9152542372881,151,0,3,3
"12266","55ad6b53d6ad724809f83cfbfe32e8b5",15,15,0,15,15,0,1,2
"12267","55b5bf2aaec81b9827c93513f7bcb1bc",128,90,64,14,128,0,3,3
"12268","55b718e58456c3a51269ac772fe0bad3",24,24,0,24,24,0,1,2
"12269","55b8a5e8996f4b2268494db64845f6ee",83,73,33,17.6060606060606,83,0,2,3
"12270","55b94b41e31d99a15ae938b05d9dde3d",65,57,39,11.6666666666667,27,38,2,1
"12271","55bd5eb47cd4956bc54c5ad8a6e93727",110,64,29,26.551724137931,110,0,3,3
"12272","55bdb1d4e5cc6bc5285e70011675ef8b",106,90,26,28.5384615384615,106,0,3,3
"12273","55c0f01ec4b262717e3ea946635f4920",14,14,0,14,14,0,1,2
"12274","55c107bb34132b6722151e361ffaa8e4",63,48,23,19.1739130434783,30,33,2,1
"12275","55c122e78c097df65e799cc9f5f3c8ba",149,97,65,16.0461538461538,129,20,3,3
"12276","55c1b79c0128498d80e5335fa5c381f0",36,36,0,36,36,0,1,2
"12277","55c375e722a1a9c061683a33e3b6972f",128,75,61,14.6885245901639,128,0,3,3
"12278","55c37f92fc2069762ab06d8a224be8d3",38,38,0,38,38,0,1,2
"12279","55c3cc8bf89aaedd77df16a7b89ef4c6",55,45,48,8.02083333333333,55,0,2,1
"12280","55c5cd058c7132c2e9818afca6be3493",48,40,28,12,0,48,2,1
"12281","55c6749fd3852c03624f869a7d530f49",46,29,30,10.7333333333333,46,0,2,1
"12282","55c871d876cf6a73f984540b51602dd9",118,86,66,12.5151515151515,118,0,3,3
"12283","55cc8e1934b01e08d4ecfbf3e8f2edd3",1,1,0,1,1,0,1,2
"12284","55ceba82395c681427f2ff50a208bb72",48,30,19,17.6842105263158,48,0,1,1
"12285","55cf45eff3f4b5d9581d14016c7125c0",77,50,62,8.69354838709677,77,0,2,3
"12286","55d314c22d94b2c97eb563b68bc0f164",187,115,89,14.7078651685393,187,0,3,3
"12287","55d3b9b4287a51e324791f4d26590f0e",19,19,0,19,19,0,1,2
"12288","55d3c21cfbd46efe09708d3f3fc05147",8,5,22,2.54545454545455,8,0,1,1
"12289","55e4470cec6d3ca5091078782b6619c2",32,32,0,32,32,0,1,2
"12290","55e460ad1726cc1fae084cbf084d2329",27,27,0,27,0,27,1,2
"12291","55e47c78630095bafcd2793856ee28d4",197,133,72,19.1527777777778,197,0,3,3
"12292","55e47e68d00580e3bd2215da50f7395c",3,3,0,3,3,0,1,2
"12293","55e75cc06e412ebaba2d8719e3b7e7b7",101,84,75,9.42666666666667,76,25,3,1
"12294","55e9405f774d2ebd7fe82fd46ecba169",59,55,28,14.75,59,0,2,1
"12295","55e96be4e32a4c3c5a8adfa88e2fa21c",16,16,0,16,16,0,1,2
"12296","55ecab5e61cba35dd544866436ada823",64,52,49,9.14285714285714,64,0,2,3
"12297","55ef66624174101d2eae1079a58838c3",34,34,0,34,34,0,1,2
"12298","55f34b88ce92caeff5445f2825110967",22,18,41,3.75609756097561,22,0,2,1
"12299","55f42f277656f83edf697f8a11c4196d",18,18,0,18,0,18,1,2
"12300","55f4b5d1ffc865c8ea566cdc2e26be84",54,54,0,54,54,0,1,2
"12301","55fa1428615c04059a298bae0d03a185",200,81,70,20,200,0,3,3
"12302","55fe05f042ef8906a7f49c3ca234c459",112,77,69,11.3623188405797,112,0,3,3
"12303","560201373b45cfaf4e32c43a7bae63aa",61,50,37,11.5405405405405,61,0,2,1
"12304","5603986c65e4174dd5e7f3d2ec8c71bf",24,24,0,24,0,24,1,2
"12305","5603b4cfcb36b3e65826012ea3f60193",88,63,40,15.4,88,0,2,3
"12306","5603eb18538ff0f499df784dfa5a9dee",35,35,0,35,35,0,1,2
"12307","560459bad1c722a0ee8cfae56ea79c2d",22,13,63,2.44444444444444,22,0,2,1
"12308","5606128dcb935e646873a0bdcf3f2837",97,57,35,19.4,97,0,2,3
"12309","5607f8eeee5dc0fe7a9e85890bc08f72",25,25,0,25,25,0,1,2
"12310","560931b96c242b5705e70d4366dcdd17",150,66,61,17.2131147540984,150,0,3,3
"12311","5609fe3331c970dfdda0e301eae7752b",38,34,64,4.15625,38,0,2,1
"12312","560f4c7731e121e7ffb7796232c7e1c8",6,6,0,6,6,0,1,2
"12313","560f5770d0bcc0e37416b4025d71c7b0",121,51,83,10.2048192771084,104,17,3,1
"12314","5611d64dbbd5ab42e59b28cc91df7779",20,18,50,2.8,20,0,2,1
"12315","5612a22f23d1d00213669a0d7c11b748",49,44,47,7.29787234042553,49,0,2,1
"12316","56157235928efed1d6aff14fc5bdc423",28,28,0,28,0,28,1,2
"12317","561610d0f31af58a7d47dafa05254233",29,28,6,33.8333333333333,29,0,1,2
"12318","5617d06aa398fe6c74cb8334d61561a6",195,149,39,35,195,0,3,3
"12319","5617fa919d3b8cd3d118bf540d9c8425",37,37,0,37,37,0,1,2
"12320","561ba4fcfd1779c279adfe594e5f142a",60,56,19,22.1052631578947,60,0,1,1
"12321","561bcdcac5e3158376e136dee83d9ef1",1,1,0,1,1,0,1,2
"12322","561c71d33086018e2ddb764232bbd7a2",7,7,0,7,7,0,1,2
"12323","561dad92216987f38337019bf8b32575",95,57,22,30.2272727272727,95,0,1,2
"12324","561fc1e11110fee3b27f719e595348e0",15,15,0,15,15,0,1,2
"12325","5623d492d8894dfa6def9e681d9da6fa",48,44,17,19.7647058823529,25,23,1,1
"12326","5623d8ee2b1f61ca802c54f4f7ff26e0",5,5,0,5,5,0,1,2
"12327","56280555bc4a2bcbc2683d518b5e5019",22,22,0,22,22,0,1,2
"12328","562903a8bc3b09210589c2dab8a339a3",60,50,21,20,60,0,2,1
"12329","562acad068bdda606f1d4f6c9e5b907a",14,14,0,14,14,0,1,2
"12330","562f6d0650039794fbb499c9c5d512af",23,23,0,23,23,0,1,2
"12331","562fd2ebaf7cd02b0d1e3bae0ea45875",110,45,63,12.2222222222222,56,54,2,3
"12332","5631a25ce7ddca6e36fa0567521cc53e",177,89,72,17.2083333333333,177,0,3,3
"12333","5632bb8dcf631ab59376a574e84084ef",131,70,76,12.0657894736842,131,0,3,3
"12334","5633d7aa8eeffa1b0883e56bbf4e7009",7,7,0,7,7,0,1,2
"12335","56341b212715444edf35891c073b918c",167,108,78,14.9871794871795,132,35,3,3
"12336","563655ee1203faac79256da3faa1cfe7",51,51,0,51,51,0,1,2
"12337","5636c2c20ecabff52904db100dfb0d20",40,40,0,40,40,0,1,2
"12338","563d2c0f804d0193790c2cb101e5136a",85,61,58,10.2586206896552,85,0,2,3
"12339","563de343535178de02d810d6d76ac121",131,66,65,14.1076923076923,131,0,3,3
"12340","563e94bfab15296cea5e433997594104",184,89,43,29.953488372093,184,0,3,3
"12341","5642b460817b1e02f7e0486f028bdcea",98,77,22,31.1818181818182,54,44,3,3
"12342","564bc7a1ef8ec28de4d156a1b9c418c3",96,66,82,8.19512195121951,96,0,2,3
"12343","564e82d5e9f633556ffd5f33fac24894",64,52,28,16,64,0,2,1
"12344","56508b03250e578b5482d8706e915e54",48,34,51,6.58823529411765,20,28,2,1
"12345","5650b3a01998e2b7d0f60251f8e2ac2c",170,118,74,16.0810810810811,170,0,3,3
"12346","5650fd7f0c65d9bc0109ba176e34b40e",124,72,61,14.2295081967213,124,0,3,3
"12347","565132ee3988a26cdb54f6dffe18aeab",26,26,0,26,0,26,1,2
"12348","5651768d10f1677c5f7614dfb782a3e5",28,28,0,28,28,0,1,2
"12349","5651b45a7660a39c51bc863b6e544788",95,75,14,47.5,95,0,1,2
"12350","5657eaffde9252769ed0c21d3af2a94c",60,35,66,6.36363636363636,40,20,2,1
"12351","565a71c1a8f5dda4d60e928a1d1eeb87",5,5,0,5,5,0,1,2
"12352","565a7ef5b6c874890ce59bb8e0253446",222,103,68,22.8529411764706,191,31,3,3
"12353","565e843c38caa85276454ac7a90c46fc",20,20,0,20,20,0,1,2
"12354","566192b73556f59737eb769e015b4dd1",22,22,0,22,22,0,1,2
"12355","566194806a261835391f373ae88d4f80",31,28,31,7,31,0,2,1
"12356","5663c98242c476a0f1f2aab9b5bf069c",57,34,58,6.87931034482759,57,0,2,1
"12357","5664b61cbf083e3aa5fd12a8dc5d412b",109,56,57,13.3859649122807,109,0,2,3
"12358","56657b1e323596c2afa91760feee06a9",82,50,72,7.97222222222222,67,15,2,1
"12359","56669bace33086db022c4be3aee833f2",30,30,0,30,30,0,1,2
"12360","566bb462a97905c4a92f9dfcf7e29992",166,126,23,50.5217391304348,166,0,3,3
"12361","566bdc295d2973ec6530763f085c7abb",47,47,0,47,47,0,1,2
"12362","566c48e3485af1acba4f650e2e2f0daf",2,1,50,0.28,2,0,2,1
"12363","566e23b8ea972a39499a84319b985eaa",69,61,42,11.5,69,0,2,3
"12364","566e3b69b8438312886b6cd900f7da94",6,6,0,6,6,0,1,2
"12365","5671c6c7bfe0b43692083cd5c8995fe6",97,79,40,16.975,97,0,3,3
"12366","5671cf474efa7c4b4acc0c88c196b072",22,22,0,22,22,0,1,2
"12367","5673e2613a7468df39d3eb29a1d37e76",122,96,24,35.5833333333333,81,41,3,3
"12368","5679d16c7e8a6ff8b6bca9db5d5f6247",172,121,44,27.3636363636364,140,32,3,3
"12369","567b3cd03cbfb57ea4ed09ab117a5c98",34,24,43,5.53488372093023,34,0,2,1
"12370","567d5838230529845a391556af4438a7",28,14,59,3.32203389830508,14,14,2,1
"12371","56803a8bf18c3347eaf11094ad951201",16,16,0,16,16,0,1,2
"12372","5680c671e5ca803fa948ab8bf47cd2fd",5,2,78,0.448717948717949,5,0,2,1
"12373","5680d6eb47d95143d1fcf6787f3e48bc",20,20,0,20,20,0,1,2
"12374","5683bdc381e6333717c3896526d75158",93,67,21,31,93,0,1,3
"12375","5684b08c79c4c34800faf2419665b402",6,6,0,6,6,0,1,2
"12376","568563fa356f3818f3beac79d9d50c6d",107,58,63,11.8888888888889,76,31,2,1
"12377","56863305c9b6a6c11a43107b4854103c",49,49,0,49,49,0,1,2
"12378","568a9cbb5094d9221b01915f160b4a0a",8,8,0,8,8,0,1,2
"12379","5690329d095096273fbd083c908c6f95",45,39,17,18.5294117647059,45,0,1,1
"12380","5695d5f23221438719667ca389ce6287",63,52,65,6.78461538461538,42,21,2,1
"12381","5696d2a4e4dcb76cfbcefecc67c0eddc",208,107,63,23.1111111111111,208,0,3,3
"12382","569ce4d371ab90e5c4bcf6893838b53d",81,47,55,10.3090909090909,81,0,2,3
"12383","569ea8465cbca677b84b26e7388c8757",35,35,0,35,0,35,1,2
"12384","56a00d87953a28fffcf27f0f8ab32968",28,28,0,28,28,0,1,2
"12385","56a274d4ff5e6413abb09b86bc8a82a7",78,58,71,7.69014084507042,78,0,2,3
"12386","56a4095489d0df1ab6ec7e2cd2343263",2,2,0,2,2,0,1,2
"12387","56a42ed058fd9fd8d58342c72618959a",19,13,67,1.98507462686567,19,0,2,1
"12388","56a613d1aed65cd6b59cd7644b12490d",67,51,33,14.2121212121212,34,33,2,1
"12389","56a7d48b132db897fb96367c4db03d56",9,9,0,9,9,0,1,2
"12390","56a90b60b67f7d703cc786518834d23d",49,36,17,20.1764705882353,25,24,1,1
"12391","56a9f5d1656e73b5a7a43227ae9873da",54,43,43,8.7906976744186,29,25,2,1
"12392","56aaeeb91e221d3c655a7961a4eced87",16,16,0,16,16,0,1,2
"12393","56abda617c87c78238d0818c8398fcce",39,39,0,39,39,0,1,2
"12394","56ad80cbb798a9f1cb467aad0392d0ae",21,21,38,3.86842105263158,10,11,2,1
"12395","56af8c081ad7160798d12a1a84e00840",20,20,0,20,0,20,1,2
"12396","56b24b6d73530583b98e01db8ac3873a",21,21,0,21,0,21,1,2
"12397","56b3446570ee5e5904a3133cc2987621",27,27,0,27,27,0,1,2
"12398","56b53d4c7c20737a1bcec9550a42344e",78,54,80,6.825,78,0,2,3
"12399","56b7f7f0c6ab1035a9605cbb4ce230d8",33,33,0,33,0,33,1,2
"12400","56b9199731a77a484e2a915e71d15b98",186,121,56,23.25,186,0,3,3
"12401","56bb744989560446238971a01218854c",3,3,0,3,3,0,1,2
"12402","56bbdd941466cc56c03a07507c1b7314",55,55,0,55,55,0,1,2
"12403","56becd0bc4a6fd66cc60cdede5523978",64,60,59,7.59322033898305,64,0,2,3
"12404","56bfde2f032d2fad48be04fa24aad032",47,38,64,5.140625,47,0,2,1
"12405","56c340421b986f3191015ffd1f65d5ad",4,4,0,4,4,0,1,2
"12406","56c3918f82f7cab1131d8a11667fa1ed",122,74,84,10.1666666666667,90,32,3,3
"12407","56c3bed6e7d7afae51f63d6fb635dfb5",42,23,63,4.66666666666667,42,0,2,1
"12408","56c626adbde7cae620913ea0b8a62b01",32,32,0,32,32,0,1,2
"12409","56c65a6bd4c8449d84493e604d754442",35,35,0,35,35,0,1,2
"12410","56c95e90b82ef12c5fed085910d6b0c8",27,27,0,27,0,27,1,2
"12411","56ca66f0e5c34fa4a35f8c90a9fb7606",35,35,0,35,0,35,1,2
"12412","56d12f4c0e03d8e4f76055e49342e4f0",113,76,72,10.9861111111111,113,0,3,3
"12413","56d19e6da22eba68f54654c06925127d",32,32,0,32,32,0,1,2
"12414","56d371358d7404b1b9bb49751ef00afd",218,106,78,19.5641025641026,218,0,3,3
"12415","56d7141dda9cdf19187d14a90e292ed9",161,81,50,22.54,161,0,3,3
"12416","56d81451d59a011e35cd9181139c6c02",5,5,0,5,5,0,1,2
"12417","56d8d66b8f05db5a60c3c3e193067724",7,7,0,7,0,7,1,2
"12418","56daaa8b0a5e7005c515e83c4595b4a8",9,9,0,9,9,0,1,2
"12419","56db3f9f6e63d7ef414f602cce5d9f41",91,71,42,15.1666666666667,91,0,2,3
"12420","56dbca6a6ae1da5872584784343081a8",35,35,0,35,0,35,1,2
"12421","56dc8c6d81f96858dec7986c94cd1d41",25,25,0,25,25,0,1,2
"12422","56dcd538845c2ff7ef687f3c8c245066",14,14,0,14,14,0,1,2
"12423","56deb140c7da31a5b56a6cd4c1d67f16",37,37,0,37,37,0,1,2
"12424","56e1ec4f774a516ade79718ab6fde472",41,40,19,15.1052631578947,1,40,2,1
"12425","56e2bd9df2cd73a6c3535bc22cbee9dc",22,21,6,25.6666666666667,22,0,1,2
"12426","56e4f90d4eac8ba2fd691de8eddee903",54,47,47,8.04255319148936,25,29,2,1
"12427","56e539b23ed27322cae07d0f9160d1bd",36,36,0,36,0,36,1,2
"12428","56e73244ea79740ce3db54a8384f3dab",34,34,0,34,34,0,1,2
"12429","56f12996ef773800e2e68e55e5d66640",59,42,31,13.3225806451613,59,0,2,1
"12430","56f96b96e7138389c5a4774a9892be59",6,6,0,6,6,0,1,2
"12431","56f9a65263f9c07a313f34a3dd559224",125,61,73,11.986301369863,125,0,3,3
"12432","56fcdedbe844e9d7c105e3f8bc8c9b77",63,37,63,7,63,0,2,1
"12433","5701a1849f82d676bd99a0af52607bfa",160,72,77,14.5454545454545,108,52,3,3
"12434","5701e8ddac3568b46a40feb786ff4073",29,29,0,29,29,0,1,2
"12435","5710b5278bd63b61b13673aeef7038d5",30,30,0,30,30,0,1,2
"12436","5717a1c57086152682d0caebc2439ab1",19,9,85,1.56470588235294,14,5,2,1
"12437","57181e8cde60ada432cbd4e8b8b242d0",14,14,0,14,14,0,1,2
"12438","571ba8aa00e1575471cc501d82c9005f",18,13,64,1.96875,11,7,2,1
"12439","571ea50a005526f4cad0f0a613954a37",72,72,11,45.8181818181818,72,0,1,2
"12440","57202f300ec95a8a4c766bab53beb7c8",73,61,32,15.96875,73,0,2,1
"12441","57214d03a81c71dc8c733f5243d42bd4",18,18,0,18,18,0,1,2
"12442","5721fb5c998410e28f674b8046968a14",71,42,58,8.56896551724138,50,21,2,1
"12443","572376c9b7c8b8787c271c0a8503d2d0",186,94,85,15.3176470588235,186,0,3,3
"12444","5723d04d33006f199594f208534c3c21",13,13,0,13,0,13,1,2
"12445","5727214e5862187ece31ac2e33c50300",90,80,49,12.8571428571429,90,0,2,3
"12446","5727217e2583cd5ab6319f7c82c9bdbc",34,34,0,34,34,0,1,2
"12447","572793597c5f9aad3a653f1e2d3f73a0",28,28,0,28,28,0,1,2
"12448","5729d58264d1070a4d8bfb9ed01c9e9e",29,25,49,4.14285714285714,29,0,2,1
"12449","572ce14dd68b0cf8531896c60672b6af",31,31,0,31,31,0,1,2
"12450","572d0d81d4dfefd3ba864d0c28e79c0d",38,38,0,38,38,0,1,2
"12451","572d87ac4518f117176fedc54c713764",25,25,0,25,25,0,1,2
"12452","57304965a0d56b2a64744de30361a7f6",30,30,0,30,0,30,1,2
"12453","57308a1426e1254a48093c52aa4eb6b7",42,42,0,42,42,0,1,2
"12454","57339e38d827a524b0d31eca9509bef8",20,20,0,20,20,0,1,2
"12455","5734035041e44ac892cdb941c8cef221",29,29,0,29,29,0,1,2
"12456","57357849317b9f9ac873f4885e9c3ab1",8,8,0,8,0,8,1,2
"12457","57388ecbbb865d0dee9c33e6097953be",84,67,14,42,84,0,1,2
"12458","573ad75d03e3822fb10b7ce863dfef27",160,124,42,26.6666666666667,160,0,3,3
"12459","573cb68543a51df7014043d2ff5cb241",63,60,10,44.1,63,0,1,2
"12460","573cbc8ddab0289ea907319f73fa0159",35,33,5,49,35,0,1,2
"12461","573e049e6d82ac3269dfc1100a4b2853",32,26,73,3.06849315068493,23,9,2,1
"12462","5741a1975a88d6391991d8ce503e8597",110,63,76,10.1315789473684,85,25,3,1
"12463","5741ec113d5ea8b2d83fb970c12d5a5f",19,19,0,19,19,0,1,2
"12464","574256a1295cec41e0d478e522fc01a7",30,28,37,5.67567567567568,30,0,2,1
"12465","574285b8bd7a42bf687dee7dd311ec36",37,37,0,37,0,37,1,2
"12466","5742ab623b5fe13f022589287d756b47",226,105,71,22.2816901408451,190,36,3,3
"12467","57495471afd6d126858c5537e3cf5016",103,65,80,9.0125,103,0,2,3
"12468","574d3bb656e83efdb2466deca201493a",50,42,46,7.60869565217391,31,19,2,1
"12469","5750b8632cab1101c977b4b5b4a2bc19",58,50,32,12.6875,58,0,2,1
"12470","575498f7207b7d4d216a3611db799624",7,7,0,7,7,0,1,2
"12471","5755b028301b006231a0f01665e56368",14,14,0,14,14,0,1,2
"12472","5755f0318ea154c3b120f3d6dd853f42",84,61,45,13.0666666666667,58,26,2,1
"12473","575b1b1c3969b8962b1ffb599128dba9",51,51,0,51,51,0,1,2
"12474","575b50016aff95e66f6be5c1630f96a9",24,24,0,24,24,0,1,2
"12475","575bcfd62664ea0480a3ae079cc1c0de",47,45,22,14.9545454545455,37,10,2,1
"12476","575c0b0db1000721be3a8eb393cc920f",35,23,14,17.5,35,0,1,1
"12477","57611dcc3ffdda4f4fe50734864b672f",164,106,71,16.169014084507,164,0,3,3
"12478","57647db9815417345e9b24488daf62bd",14,14,0,14,14,0,1,2
"12479","5765a72f5877d4e12217fb44b1e261d7",51,51,0,51,51,0,1,2
"12480","5765e371070b4ff8edce7b73d610d1c2",15,15,0,15,15,0,1,2
"12481","576645043c5f230a68d5a8cdb456d49d",93,65,46,14.1521739130435,72,21,2,1
"12482","5766b277588056e472f2a479a622c4d8",125,78,68,12.8676470588235,125,0,3,3
"12483","576854458a128482813bede19303a196",64,49,59,7.59322033898305,64,0,2,1
"12484","5769e1f847bc78eb72b3caad5a2aee00",19,19,0,19,19,0,1,2
"12485","576a2d07538937a73127609bd8003d7d",98,74,56,12.25,98,0,2,3
"12486","576a33dcdfe6567f1ba0b922c17f452f",40,31,31,9.03225806451613,7,33,2,1
"12487","576b2902d98b6a63e52b488ed7738fce",101,83,32,22.09375,56,45,3,3
"12488","576ef8f988594761f455bb977a988a7f",157,46,76,14.4605263157895,157,0,3,3
"12489","57733a10e3dc28f326b86c2449642d4c",71,52,40,12.425,38,33,2,1
"12490","57735068917ab8c9ddd000eb8c1fdbd6",88,66,41,15.0243902439024,88,0,2,3
"12491","5773a551cd6f1561359656eed3fab8a6",19,19,0,19,19,0,1,2
"12492","57745f44958dcc21a0e62445255072dc",137,83,84,11.4166666666667,120,17,3,3
"12493","57748d75728472a1d774981dfeea2c17",46,40,41,7.85365853658537,22,24,2,1
"12494","5776674d5525c7075420b24929bda2d3",88,71,33,18.6666666666667,43,45,2,3
"12495","5776b88199f24e9233e5b4786633814a",27,27,0,27,27,0,1,2
"12496","57776d286c08945f55ef554408265228",44,41,42,7.33333333333333,44,0,2,1
"12497","5778a68a39020b708adfe596232ee3d6",10,10,0,10,0,10,1,2
"12498","577a1cce6f8e185762ed46936242134f",32,32,0,32,32,0,1,2
"12499","577a8f63b8d1158bedebb67b17766d66",31,31,0,31,31,0,1,2
"12500","577aa4477dd89362dd8e848fde7d0b62",68,51,54,8.81481481481481,68,0,2,1
"12501","577e7bf5760fdf12c0ba9d995487be22",13,13,0,13,13,0,1,2
"12502","5781c2e3eb271863103c8fb6653436c5",201,105,84,16.75,201,0,3,3
"12503","578227dcf8873280cfaac0d0e0252150",66,54,53,8.71698113207547,32,34,2,1
"12504","578637edccdc60652a2211d80cb86ac2",43,43,0,43,43,0,1,2
"12505","5787811662d9c5142df31bd30586be0a",3,3,0,3,3,0,1,2
"12506","57878f261f505dd1015071b54cb38c02",44,44,0,44,44,0,1,2
"12507","5788b7d628a8c36520da295230691c4d",171,83,71,16.8591549295775,171,0,3,3
"12508","57895f998b16640be4fdb126176fc1f9",55,55,0,55,55,0,1,2
"12509","578a270b9f5ecbec4e862d8610bc1d69",72,21,72,7,63,9,2,1
"12510","57920a10fc03a72275f8f8f7e6412476",233,144,59,27.6440677966102,197,36,3,3
"12511","579442daa009dce31cff06a150768e4f",44,40,70,4.4,44,0,2,1
"12512","5794a6dbd918116fefe2815c1b4dee3b",7,4,33,1.48484848484848,7,0,2,1
"12513","5795d06e533da0d3465ee4ace786445c",136,103,84,11.3333333333333,136,0,3,3
"12514","5796949bc48ae25e2f5a0ecf507b578b",30,30,0,30,30,0,1,2
"12515","5797691d993b6d1fa447b6235297a713",144,101,89,11.3258426966292,144,0,3,3
"12516","5797e723d4d839175cf24510cedfd8f1",192,84,85,15.8117647058824,192,0,3,3
"12517","579adf7960d860117c7857fbaa9e4f4a",145,95,63,16.1111111111111,145,0,3,3
"12518","57a331877d9092927ce6184a874cffbd",45,45,0,45,0,45,1,2
"12519","57a39f32f9cb66fee4a0526b60de3b80",186,88,78,16.6923076923077,141,45,3,3
"12520","57a4b8441456f1785e6bfa247d7a8018",145,76,59,17.2033898305085,145,0,3,3
"12521","57a66f54ebdd4969f8ae55a7fe18d44e",12,12,0,12,0,12,1,2
"12522","57aa33822012863d91c5c2d6ca7c8c52",34,34,0,34,34,0,1,2
"12523","57aa89b1397dbbc271116f9a0e21f4b3",36,36,0,36,36,0,1,2
"12524","57aacf673072a2eacaa6229e8e0c02b2",54,48,30,12.6,23,31,2,1
"12525","57abf0765161404ab053ee0c0fc74c12",129,72,69,13.0869565217391,107,22,3,1
"12526","57ace0dfa5bb1ff6e6b8b9996fac40e9",31,31,0,31,0,31,1,2
"12527","57aeed7daa9f72a91ad539fea0d14c89",64,48,21,21.3333333333333,64,0,1,1
"12528","57b1bb3e004759095a6a5e02af67c3d6",5,5,0,5,0,5,1,2
"12529","57b27219d46bf2f913cbb5656a039886",1,1,0,1,1,0,1,2
"12530","57b52448edd19bc44592794265b322e6",80,23,84,6.66666666666667,63,17,2,1
"12531","57b70f4b0b4daffad1fd55c115f30bb6",99,54,64,10.828125,99,0,2,3
"12532","57b72073b1c9968870c00f27b5794a6f",39,38,23,11.8695652173913,39,0,2,1
"12533","57b773f369bac36a6b608f7ecd9c5c9a",10,10,0,10,10,0,1,2
"12534","57b79a4a13c208570811706eab2d1d01",24,24,0,24,24,0,1,2
"12535","57b8087c40adc79eb45018865be83b10",46,46,0,46,46,0,1,2
"12536","57b8106796a3d088bdda97bc0721bcca",48,48,0,48,48,0,1,2
"12537","57ba445ae5445a05195fad1267e38cc0",87,43,54,11.2777777777778,58,29,2,1
"12538","57ba8221d2601c03517339f19a24dbb4",23,23,0,23,23,0,1,2
"12539","57bc64fc9af92a7f1a832abdff7ca0cc",24,12,78,2.15384615384615,24,0,2,1
"12540","57bc65547ebe76a946c18b227cf1c833",15,15,0,15,15,0,1,2
"12541","57bcc6a26d3d007a0522daec47078e57",84,58,59,9.96610169491525,84,0,2,3
"12542","57bd067708ce47ff16f9dcfd80453a73",48,48,0,48,48,0,1,2
"12543","57bebcd0ee00d54b07c48ec082e9a741",117,69,61,13.4262295081967,117,0,3,3
"12544","57bf482e9d516f25d2b74e9a8e42b987",72,54,23,21.9130434782609,37,35,2,1
"12545","57bf69b36f612812547f8dfd3cdf9644",39,39,0,39,39,0,1,2
"12546","57c08b49821bc2f0f6320d415a75c2ec",122,92,67,12.7462686567164,95,27,3,1
"12547","57c11193675e76678a919ff5107e4687",4,4,0,4,4,0,1,2
"12548","57c1bdd98f0d56cee58f212012757af5",71,61,70,7.1,71,0,2,3
"12549","57c2fe5f60c238d8971ab033636104cd",44,39,58,5.31034482758621,44,0,2,1
"12550","57c37a2c944f1f16bcc3a420b4314192",74,43,70,7.4,59,15,2,1
"12551","57c57920c01bfb6491c76dea40ae34c8",107,72,78,9.6025641025641,107,0,3,3
"12552","57c7442946fa93312fd2fb5f55391c6d",24,24,0,24,24,0,1,2
"12553","57c783d7dd7ad13fabc83f65aa5a1a5f",9,9,0,9,9,0,1,2
"12554","57cbb8259cffc618e0f642dfd66b5647",45,35,13,24.2307692307692,45,0,1,1
"12555","57d19dfa284de68c708eddccd9efcb0f",24,18,31,5.41935483870968,24,0,2,1
"12556","57d5249631f4a37d39af713c02944bf3",24,24,0,24,24,0,1,2
"12557","57d5e25088ac6f417f8a501ea86b1105",3,3,0,3,3,0,1,2
"12558","57d62eb7d6a7998f62efac11cea15e24",67,43,28,16.75,54,13,2,1
"12559","57d825118e4537fd88bd1e6a31722b92",123,68,68,12.6617647058824,123,0,3,3
"12560","57dbf260cdef3e3eac98549fad25bafd",53,43,60,6.18333333333333,40,13,2,1
"12561","57dc2138661e8fcd17394035c3d7ad78",11,11,0,11,0,11,1,2
"12562","57dd36b228f7cfb085f882b3df2c12b3",62,45,38,11.4210526315789,62,0,2,1
"12563","57dec4181464f4ba3fd7c37f529c3c45",41,32,49,5.85714285714286,0,41,2,1
"12564","57e29d740a80af76ee2a7d4e95d4bd02",8,5,63,0.888888888888889,8,0,2,1
"12565","57e39a41c95e93ac2764897f1ef20d3e",55,40,48,8.02083333333333,19,36,2,1
"12566","57e3a01d96786f58d3143f9d941b9997",108,88,54,14,108,0,3,3
"12567","57e5ef8d9e6034e43913365f6b742124",22,22,0,22,22,0,1,2
"12568","57eabdf124ac648afe4e6b5b1c5c43c5",54,46,7,54,0,54,1,2
"12569","57eb8340184c02fcd184a28c5daacc0a",8,8,0,8,8,0,1,2
"12570","57edb94aa29b2463d9dbabe323794edd",43,43,0,43,43,0,1,2
"12571","57edcbbf23c421e891d7ab004148bfed",34,34,0,34,34,0,1,2
"12572","57eea8e23100910d7a77f1cfd6a988a1",2,1,1,14,2,0,1,2
"12573","57f0bac698e698aed3983011bf7a5a01",140,71,79,12.4050632911392,140,0,3,3
"12574","57f12358fe8462fdd76974beeba2eae7",29,29,0,29,29,0,1,2
"12575","57f12a16064467dc168f0b36c953b362",32,32,0,32,0,32,1,2
"12576","57f2d280eeea0388a5c6bb0d8b75d58d",92,53,52,12.3846153846154,92,0,2,3
"12577","57f326bab66ea0198cd149281ff58102",71,63,71,7,71,0,2,3
"12578","57f396c0c41bb9ee4c10fed7d0af1a38",23,23,0,23,23,0,1,2
"12579","57f5323e3b2ada9b5d1376b1b08c4641",48,48,0,48,48,0,1,2
"12580","57f737ed2cfb04cc43682f3f0836ff85",63,44,61,7.22950819672131,63,0,2,1
"12581","57f82731f1f3b9bc483a2492cc658b82",28,28,0,28,28,0,1,2
"12582","57fb47ce2b2228156f716505020c1959",87,72,43,14.1627906976744,87,0,2,3
"12583","57fb6ea8e2ef74979ddf9e41d60f52d1",33,33,0,33,33,0,1,2
"12584","57fb9cf964a88a89ffe33d4c13cb83df",4,4,0,4,4,0,1,2
"12585","57fd0b49fe0193d677598ed9bbaa3e21",47,35,8,41.125,22,25,1,2
"12586","57fd0bd5603f0ba0742bd78ef86c4e34",59,44,63,6.55555555555556,59,0,2,1
"12587","57ff35deb1c2e7438b5bb956fb3c94bd",46,46,0,46,46,0,1,2
"12588","5805cce9b4667d821f4947cd82b62363",216,124,43,35.1627906976744,191,25,3,3
"12589","5805ce7804ba4b3ca4bb9d004e31096f",29,25,67,3.02985074626866,29,0,2,1
"12590","5805d881371473e0db6f070a772883b6",86,64,81,7.4320987654321,86,0,2,3
"12591","5807fe02f583a74bb1ae206d72c807ff",58,52,70,5.8,58,0,2,3
"12592","5808127e8265dcb163cd77787b16626c",135,98,53,17.8301886792453,135,0,3,3
"12593","58084918b86341e6895ec28fb4fc7102",90,73,70,9,66,24,2,1
"12594","580a0fcb6ef94af481221ecf9705f256",209,108,51,28.6862745098039,209,0,3,3
"12595","580aac82b8ac59229ce81cf992967787",21,21,0,21,21,0,1,2
"12596","580dbf43aad8db9e58a8e1643fde4bf5",47,47,0,47,0,47,1,2
"12597","580e0a6730c9ed583340e7bccdb5fca3",127,101,25,35.56,127,0,3,3
"12598","5815c26f0ec726e6ab76566eb8caefb1",24,24,0,24,24,0,1,2
"12599","58177955dfb08b3174317339c5eb5071",7,7,0,7,7,0,1,2
"12600","581a13134a657a59ef7c8d3e98c3378a",156,110,41,26.6341463414634,156,0,3,3
"12601","581b64a3bc9de8bb9d0a8bf8f24445e2",42,33,18,16.3333333333333,42,0,1,1
"12602","581e1dcc2ea102f597804c4f4bd81216",89,73,70,8.9,60,29,2,1
"12603","582073edd2dd317c2ead2cd74d6e255e",10,10,0,10,10,0,1,2
"12604","5822dc81387492cf0ccaeb8e9fff1f78",21,21,0,21,21,0,1,2
"12605","58290e20fe042e81f47f9c2ede160d58",15,15,0,15,15,0,1,2
"12606","58296f45f8a5bce1e5f71e35343a8653",37,37,0,37,37,0,1,2
"12607","582d8e531021858d491fb65947a80578",17,17,0,17,17,0,1,2
"12608","582dc149ba02d9fcb302418c0bb11e39",24,24,0,24,24,0,1,2
"12609","582e3cbaa1f4c0174294b8aef6f098f2",126,96,21,42,126,0,3,3
"12610","58351b1f58ac0e35ba7ec54126a033ff",101,67,51,13.8627450980392,101,0,2,3
"12611","58377314ab0fc7673cf9a783b58c6160",134,100,78,12.025641025641,109,25,3,3
"12612","5837a18615ded6b5a16c1ac28582f6e5",93,81,61,10.672131147541,53,40,2,3
"12613","583858869435a476fe13ba9a26d6beef",27,27,0,27,27,0,1,2
"12614","5838dfb44a5f5a2fa291b26692e5ab98",88,61,67,9.19402985074627,88,0,2,3
"12615","583ab62b1a6523ddc0859a09dd8af15c",28,28,0,28,0,28,1,2
"12616","583ad3ac4bbdf411fa5a514628b1b97b",42,37,36,8.16666666666667,42,0,2,1
"12617","583c8e8bb16486337393aae917889ebf",65,49,54,8.42592592592593,37,28,2,1
"12618","5843e9bed81f39f1de943296e94c1f5e",137,80,26,36.8846153846154,137,0,3,3
"12619","58441f2da1738ba00d5bf1b002647044",166,127,30,38.7333333333333,166,0,3,3
"12620","5844317dc2d668df5ae0de32bdfc7bc2",45,45,0,45,45,0,1,2
"12621","58477b527043493f8c7344527f4c6647",8,8,0,8,8,0,1,2
"12622","584961e26375bf96f24e8e5161d1033a",13,13,0,13,13,0,1,2
"12623","5855b33a06e45d13cff5450fc6ebe03a",47,34,35,9.4,47,0,2,1
"12624","585611dff56d1d367220d2898b27416f",42,35,29,10.1379310344828,28,14,2,1
"12625","585734cbcf0349a2b3df82a7f623cea5",122,63,64,13.34375,122,0,3,3
"12626","5858d23c1af09ff268f9ab536fc61aff",80,59,35,16,80,0,2,1
"12627","585924cc3d9e3811c7af1893e2d2d6a7",49,41,17,20.1764705882353,28,21,1,1
"12628","585ae7f929e096b2f2740af13283ca1a",24,24,0,24,24,0,1,2
"12629","585d00f53cd14406fd87fbfbb81432f5",157,90,86,12.7790697674419,109,48,3,3
"12630","585e36f12e38afddb6f9fc016facb96f",54,54,0,54,54,0,1,2
"12631","585f60b52de3223113114249d9a38550",83,60,28,20.75,83,0,2,3
"12632","585fcce8c0dcf8461decbf4379c4a0b7",32,32,0,32,32,0,1,2
"12633","5864fbba52ec26d4e7f6cd0fddf131ba",113,81,64,12.359375,113,0,3,3
"12634","5867ab1ef894afcff7c91f7d60aea33e",75,60,26,20.1923076923077,75,0,2,1
"12635","5867ddbc12e4418a6523d2ab663d41b8",38,38,0,38,38,0,1,2
"12636","58684d84a3727565b22e2334669774c8",153,78,53,20.2075471698113,153,0,3,3
"12637","58686b5a81a6470bcc45564ca40f6c68",35,35,0,35,35,0,1,2
"12638","5869894d3439817e43e14e8a5e598a32",96,71,65,10.3384615384615,96,0,2,3
"12639","586b1b59c1c2b38f03aaa707c08927fb",131,95,51,17.9803921568627,100,31,3,3
"12640","586b9b2886dd3e54abe0b5194c5055b5",143,89,81,12.358024691358,143,0,3,3
"12641","586c9629bec47f34e9cdcb0e6eb190e1",159,72,64,17.390625,106,53,3,3
"12642","586d02471fa4ab13e701203448756e82",54,54,0,54,54,0,1,2
"12643","586d88bec59a2ef38dad62c99e3e26f4",94,66,66,9.96969696969697,94,0,2,3
"12644","586e569330fe0ed8d72dffb7ed087f0b",41,37,49,5.85714285714286,41,0,2,1
"12645","587079ef4bdc94611a8499c9c56efc9e",6,6,0,6,6,0,1,2
"12646","587133f090147cfd357cddbb94920a33",38,38,0,38,38,0,1,2
"12647","58740dccee5cd28102fe0f9f8f2f58db",122,64,71,12.0281690140845,122,0,3,3
"12648","5875d7c3b33d28264001a77783e0c5cb",31,31,0,31,31,0,1,2
"12649","5876a6d62db49a924ad743280623a7ff",34,34,0,34,34,0,1,2
"12650","587903e9cae201903a5c6486cc57c536",8,8,0,8,8,0,1,2
"12651","587a762e2da86f5d516f98ed8459059f",27,27,6,31.5,27,0,1,2
"12652","587d118f0b1ff200ae0af89c1ba8c481",58,44,80,5.075,34,24,2,1
"12653","587e5c62a7ab7d295a7aac25268d79c3",70,63,28,17.5,70,0,2,1
"12654","58810907ce5820d91258355eec434835",30,28,49,4.28571428571429,30,0,2,1
"12655","58849db49d72e5d2a6469ac6be2e4cb1",44,44,0,44,44,0,1,2
"12656","5884f1e5b50352ed294e5713bcea51f3",60,44,35,12,60,0,2,1
"12657","58863369d1b444f65444c0b7f0b10b0a",83,49,52,11.1730769230769,83,0,2,3
"12658","588638c63cf069f8941e0b30d7918fb1",48,44,25,13.44,48,0,2,1
"12659","588677e4a4e95d2f97e4a5c3b73c3c93",5,5,0,5,5,0,1,2
"12660","5888b83c68141b4f0abaaf9a4e72920f",90,62,31,20.3225806451613,46,44,2,3
"12661","5888c69afa3329d153a752584a0c3983",14,14,0,14,14,0,1,2
"12662","588adeaa42d5a2eddf2028f3c86f32ed",3,3,0,3,3,0,1,2
"12663","588af68da8324b1d0d8d8162174144d1",12,12,0,12,12,0,1,2
"12664","588f5b9929ecf3b8f2c3dd5fb2e2a52f",143,68,84,11.9166666666667,109,34,3,3
"12665","589295056b81cbd02069027551e6996d",192,84,83,16.1927710843373,169,23,3,3
"12666","5894614f6c634c5db22ea660ca8314b0",102,82,37,19.2972972972973,102,0,3,3
"12667","58947cf02d04519d7f1f43650f8ec3ca",187,91,86,15.2209302325581,187,0,3,3
"12668","5894f791f5139f071d3fbe13f942d953",90,54,48,13.125,90,0,2,3
"12669","58953164d535b3da55cee67cbf535436",55,55,0,55,55,0,1,2
"12670","5895e820106d83ea95b4f00106d8982c",9,9,0,9,9,0,1,2
"12671","589c5dbe7f56dc5c16e536d3feebf493",98,67,55,12.4727272727273,98,0,2,3
"12672","589d881090131aa605d7a208f0e59401",175,129,60,20.4166666666667,120,55,3,3
"12673","589ebc520b9cf7607dde58204aabc9b8",44,38,24,12.8333333333333,26,18,2,1
"12674","589f8148538f8325d8a169f791a9f8a5",4,4,0,4,4,0,1,2
"12675","58a17fa410b50fb091c35fc8e66c1e27",97,81,41,16.5609756097561,97,0,3,3
"12676","58a239d36f812ce4b7f86005ebbec3ea",125,91,84,10.4166666666667,125,0,3,3
"12677","58a610824bf01e9524f8ea2603bc938a",29,29,0,29,0,29,1,2
"12678","58a7854adb4525ba8e2630dacc4a7cde",77,61,21,25.6666666666667,77,0,2,2
"12679","58a7a45ac230c3a7a9955e7f9059699f",26,26,0,26,26,0,1,2
"12680","58a936566826810608e2da3ddc8bcdd3",43,39,9,33.4444444444444,24,19,1,2
"12681","58ad6cc2d50b5a3ac4aa362910618722",23,23,0,23,23,0,1,2
"12682","58adf03b85cfafe3ead37b1add39a390",203,90,55,25.8363636363636,166,37,3,3
"12683","58b075d85e7e4cad1d48272285a22fd0",209,114,68,21.5147058823529,168,41,3,3
"12684","58b251e8ea8d0f950700aea31d328abe",102,78,26,27.4615384615385,102,0,3,3
"12685","58b47c5f33eeb1617ce6a05f3bccff1a",76,47,33,16.1212121212121,76,0,2,1
"12686","58b70de9896d80745385c54269a7a78b",45,41,36,8.75,29,16,2,1
"12687","58bb3c49728bee1e4087c02b34f8bf18",125,83,59,14.8305084745763,85,40,3,3
"12688","58bc6ba85fcd57265d9e2ba86d4a13b3",103,69,61,11.8196721311475,72,31,2,1
"12689","58c1d2f9e1baf4759beed91b69956d12",17,17,0,17,17,0,1,2
"12690","58c2b5bd92fe6d077d946efdd4c9fc2a",63,54,77,5.72727272727273,63,0,2,3
"12691","58c398f348054c39baee3101bae096cb",22,22,0,22,22,0,1,2
"12692","58c3b20cd41529a04b789c8661eb46bf",209,124,82,17.8414634146341,209,0,3,3
"12693","58c4e574a5b31e9eb6ac1fe1bb2a992d",36,36,0,36,36,0,1,2
"12694","58c65c126a8deea75b2552397c6700f2",196,97,83,16.5301204819277,196,0,3,3
"12695","58c83bc5da6839bab471a5e3675cbee9",54,54,0,54,54,0,1,2
"12696","58cae80b99506428c3d46b2ffcd76618",47,47,0,47,47,0,1,2
"12697","58cb7be9d36f09c3292ab2588f76acc0",49,42,43,7.97674418604651,19,30,2,1
"12698","58cbab2460e13f5a7085b786108acfa0",11,11,0,11,11,0,1,2
"12699","58cbf1672b460c05ebd4ae74112e827e",42,42,0,42,42,0,1,2
"12700","58cce871499549b0c38798a0c93190a5",193,75,76,17.7763157894737,166,27,3,3
"12701","58d4354fc95fcbdba39979a2266a3b7f",24,24,0,24,24,0,1,2
"12702","58d66a06034e9c1cf12a09c445956901",3,3,0,3,0,3,1,2
"12703","58d67ae70b5d9ce7814dd466f38b2fc0",66,53,14,33,66,0,1,2
"12704","58d9c0206743f5288cc8b49ae11f156f",24,24,0,24,24,0,1,2
"12705","58db17a26a2327bcf54daf6bb7b51e47",23,23,0,23,23,0,1,2
"12706","58db37a1e11f64b4edf048122e561a97",217,111,85,17.8705882352941,217,0,3,3
"12707","58dd11a4694d0865f7ddeb57e12d59f3",50,40,53,6.60377358490566,50,0,2,1
"12708","58df18cb1a103e9f80d11ed2098f0e4c",38,38,0,38,0,38,1,2
"12709","58df68583eccf3a2f072f58c4c515128",38,38,0,38,38,0,1,2
"12710","58df80f3a8e78c2e81511ef081966aa0",158,74,74,14.9459459459459,121,37,3,3
"12711","58e01e2b8b9c4d831bc8ed89ad4be644",81,75,51,11.1176470588235,81,0,2,3
"12712","58e0fd18b70cfc7033d85129100af4d6",233,103,69,23.6376811594203,184,49,3,3
"12713","58e427e3defbe9e7ad39e3814d5895a8",1,1,0,1,1,0,1,2
"12714","58e4cc3fb31564d6cedb1f9a002007df",34,27,38,6.26315789473684,34,0,2,1
"12715","58e6577ac3f2d205e548d8c3c7688eca",52,40,51,7.13725490196078,52,0,2,1
"12716","58e9d58a1779241060e55acad4c89a1c",88,51,25,24.64,88,0,2,3
"12717","58f11857933c55685337858367249e79",51,42,29,12.3103448275862,51,0,2,1
"12718","58f1ffba67e3073dba57d19242d44e96",15,15,0,15,15,0,1,2
"12719","58f6a5ae9af1411827a10dc02511aff0",17,17,0,17,0,17,1,2
"12720","58f709a8e5b474375c10575115638a08",44,39,42,7.33333333333333,32,12,2,1
"12721","58f72086caed3edff6d972a362877b66",25,25,0,25,25,0,1,2
"12722","58fa3e213c61eed73e564b40db3d5c48",238,112,83,20.0722891566265,219,19,3,3
"12723","58fb026dedc7144cd8bd45f8a29ed7e7",26,26,0,26,0,26,1,2
"12724","58fbff5a3f58e80aef4769e5b1710ba2",97,66,64,10.609375,97,0,2,3
"12725","59027840aad8ee70438dbbf862cf8908",24,24,0,24,24,0,1,2
"12726","59096c3d271e3a73aa7c83c8e30c5633",22,22,0,22,22,0,1,2
"12727","5909d865c53b7aef5aeb2c2190d63c2c",86,68,44,13.6818181818182,49,37,2,3
"12728","590d28c51c227da0d9575b38365ea550",4,4,0,4,4,0,1,2
"12729","590f35726eff20d6586d08ad0aac3b23",14,14,0,14,14,0,1,2
"12730","590ffe0281e429271328105962895cfe",89,31,49,12.7142857142857,58,31,2,1
"12731","5910178b5f19bdb678757067ae6e8b05",17,17,0,17,0,17,1,2
"12732","5919e15d5bf30a4cb4683231b853eb66",43,42,35,8.6,0,43,2,1
"12733","591ba1e79dbb7f550ab85b2f87fed3a2",47,47,0,47,47,0,1,2
"12734","591bd0534c8d123cad1e24afe06629bc",118,62,68,12.1470588235294,118,0,3,3
"12735","591c5473e2e749b6ff97edfa79a89d66",6,6,0,6,6,0,1,2
"12736","59220daeaf84d2294ca4efcc5fdd7018",87,65,29,21,33,54,2,1
"12737","5924067678c74b9c8cca1e391ca9d0e8",63,47,36,12.25,37,26,2,1
"12738","592481379750d9119d1f51a7de237db9",193,86,78,17.3205128205128,193,0,3,3
"12739","592d24a363bfcad1aacfd24715ef3e48",158,95,56,19.75,158,0,3,3
"12740","592d99ab541fb18fca5b80ae20742436",36,36,0,36,36,0,1,2
"12741","5931a2c0174a881450a42a404b7e0572",104,78,34,21.4117647058824,104,0,3,3
"12742","59340e9c16d39bae6c371c2a07ae9a13",24,24,0,24,24,0,1,2
"12743","59349f1d98a98be588b8f05077326ae7",6,6,0,6,6,0,1,2
"12744","59350bdb56599e558748602d1841b911",20,20,0,20,20,0,1,2
"12745","5937479fab4605828ebd57ef40aa7e2d",80,57,67,8.35820895522388,80,0,2,3
"12746","5937725869d79b31208146dc8d1a4983",26,26,0,26,26,0,1,2
"12747","593d811c57f141de15dd9b9dc9608f72",33,33,0,33,33,0,1,2
"12748","59418209428ceab134d3769c20ce23ca",87,68,33,18.4545454545455,87,0,2,3
"12749","59433320d3369fab8f0ae7ede0f97a06",18,18,0,18,18,0,1,2
"12750","59450812601936e7f5c6f92ec2221613",27,23,63,3,27,0,2,1
"12751","594544fdb653a0ee5f978b7886504cdb",34,34,0,34,34,0,1,2
"12752","594699e6bcd28a635ad3654ca46d1b4c",44,37,21,14.6666666666667,44,0,1,1
"12753","594a4812328f1627c954932eef821b97",46,37,64,5.03125,46,0,2,1
"12754","594e4eddb41cf8020df97b5cf41ce6c6",20,20,0,20,20,0,1,2
"12755","5957335bb6a6c312d8d94a3582513ff6",46,46,0,46,46,0,1,2
"12756","5958b7946e6dc615b2d0c3f137316229",102,83,69,10.3478260869565,72,30,3,1
"12757","5958f0e3b3f99df6053fd7bc6a1dfe0f",78,51,28,19.5,78,0,2,1
"12758","5959565f5f996b42f2fa9648d29740d3",97,71,14,48.5,97,0,1,2
"12759","595a56673269bb90a1ed37e8a9a5a118",32,32,0,32,32,0,1,2
"12760","595ca181536c808774724a591bd7010a",27,27,0,27,27,0,1,2
"12761","595cf9e92badcc67416a189ffbee2237",177,89,71,17.4507042253521,136,41,3,3
"12762","595d457b865b2d09df3b533f6136e154",23,23,0,23,23,0,1,2
"12763","595d66cb953b841d32e9a27cc712a7af",167,91,62,18.8548387096774,167,0,3,3
"12764","59623fe95b2003cd741d4d43186cc0f7",40,28,49,5.71428571428571,40,0,2,1
"12765","5963dc621492b0913f29114ad5fd7048",107,83,56,13.375,107,0,3,3
"12766","5963ee2a25d872d810e685d366711705",35,35,0,35,35,0,1,2
"12767","596485b9b0aa9700c2dac27f43580092",60,53,13,32.3076923076923,60,0,1,2
"12768","596b167db2865bd2ea3974afd492c80e",150,86,76,13.8157894736842,150,0,3,3
"12769","596d86dec781e26c03fec0df4ff0184a",47,35,49,6.71428571428571,47,0,2,1
"12770","596e339ecd6342941e7d0542f9fa2f9c",24,24,0,24,24,0,1,2
"12771","596e9bdddf12752976422b3f547224aa",164,98,74,15.5135135135135,120,44,3,3
"12772","596f522fbe972b1bc13bd767e27bae02",12,12,0,12,12,0,1,2
"12773","596fa4a40796eafecbc1b946f046a191",144,67,74,13.6216216216216,113,31,3,3
"12774","59707aea1b7c2446a190e754bf428d3f",28,28,0,28,28,0,1,2
"12775","5971385c603245bcf1e1384ffa0a22f9",20,20,0,20,20,0,1,2
"12776","597167568c9370bd6f8f4b571d293ab3",34,28,63,3.77777777777778,34,0,2,1
"12777","5971b55c5cd1818345aa469126d5983c",79,68,48,11.5208333333333,61,18,2,1
"12778","5972428cc7da429a30ab46dec670932a",20,20,0,20,20,0,1,2
"12779","5972aa8b78702ff75a2db127258e072e",197,125,29,47.551724137931,197,0,3,3
"12780","59748b4d5ff1e657ed7dd21a1ed970b1",3,3,0,3,3,0,1,2
"12781","59755cebf77da9fb2f3378b39c7d66c6",82,58,68,8.44117647058824,56,26,2,1
"12782","5976a848fa244db1242c987fb5f27ecb",53,49,25,14.84,53,0,2,1
"12783","5978f0411b52fd462a371b1307899991",41,41,0,41,41,0,1,2
"12784","5979f5f6c8b6e73082d2b9e2764b8022",26,26,0,26,26,0,1,2
"12785","597c66cac3f87c050c6f8bacfe148a5c",55,40,76,5.06578947368421,55,0,2,1
"12786","597ee2e064c6de0937aaf55608704e3e",166,90,77,15.0909090909091,166,0,3,3
"12787","597fd83985229c387b9b18afad76015d",208,103,90,16.1777777777778,208,0,3,3
"12788","5981ac873e8613efa741faacad3fd898",28,28,0,28,28,0,1,2
"12789","59855ae44383ad61418e0986ad926ff8",38,38,0,38,38,0,1,2
"12790","59868fd651966da70491bfb64929163e",10,10,0,10,10,0,1,2
"12791","598726ced043883fe536c50a1c4b16f4",88,58,48,12.8333333333333,88,0,2,3
"12792","59879e4a4b5d5dcc455db394fc62995d",41,41,0,41,41,0,1,2
"12793","5988846437bece743be9fd46a795d4a4",22,19,31,4.96774193548387,22,0,2,1
"12794","598995bea3418d213f497b528f5434a4",85,70,31,19.1935483870968,85,0,2,3
"12795","5989faf2348e282da405c8b03d6db3ad",53,38,84,4.41666666666667,12,41,2,1
"12796","598b70e48e7fa169fb942ccab1d40ac0",75,59,68,7.72058823529412,75,0,2,3
"12797","598c3cbe6ba068d5b82c733da5763c26",23,23,0,23,0,23,1,2
"12798","598d4bf557456f0c577ce1fa637abf10",188,92,53,24.8301886792453,145,43,3,3
"12799","598dfc9b578f276e1f7b089fc0dc5930",69,64,13,37.1538461538462,69,0,1,2
"12800","598faaca3da777739d3aeadbe01c646b",99,58,66,10.5,99,0,2,3
"12801","598fb85e7638ab9210f8e384b44e071b",2,2,0,2,2,0,1,2
"12802","59980727892940e291b8dad5f477f25f",17,11,41,2.90243902439024,17,0,2,1
"12803","599b90289992046eeee64f24e6147738",12,7,44,1.90909090909091,12,0,2,1
"12804","599f1489ffc5d7af724165c70b6ad9d8",162,101,42,27,162,0,3,3
"12805","59a0250b6b9826117fb896390d60e110",24,24,0,24,24,0,1,2
"12806","59a03bdbb9a3a04439d432bac87cfdbd",19,10,57,2.33333333333333,19,0,2,1
"12807","59a0946b3e8e7b5a3c91e6864e98bba3",35,35,0,35,0,35,1,2
"12808","59a117628ca42af205a2b8765ba0e922",29,29,0,29,29,0,1,2
"12809","59a2d03ab7a24566a6d02d36ab660dc6",39,39,0,39,39,0,1,2
"12810","59a5befd0ab6384650b9fbd55422ee9c",87,72,27,22.5555555555556,46,41,2,3
"12811","59a958fd42476f59aa8e66312fb4d091",45,45,0,45,45,0,1,2
"12812","59b0f9f437749978a311eef05da861d4",37,37,0,37,37,0,1,2
"12813","59b13ba489a63ba3e5a4b376be109d74",76,58,83,6.40963855421687,76,0,2,3
"12814","59b160fd5435dab1633b520337d69318",77,43,77,7,32,45,2,1
"12815","59b1e373a058abc48787512daac1ee8a",22,22,0,22,22,0,1,2
"12816","59b5d06fec76e5020720aae77c23c275",60,54,83,5.06024096385542,60,0,2,3
"12817","59bb03d97d80c93122e951c2db529a63",106,88,80,9.275,89,17,3,1
"12818","59beb6355a5f0eb2e9f88b2850e07fc0",66,46,62,7.45161290322581,66,0,2,3
"12819","59c12794b6a96a0a87f91fcd4c5867c0",183,113,60,21.35,183,0,3,3
"12820","59c333fffa7ef68bd497631355790f32",41,41,0,41,41,0,1,2
"12821","59c577e2a63f12ff003a31a86e5f24e5",49,49,0,49,49,0,1,2
"12822","59c5b8169510971726ecf56183bb5f16",139,71,56,17.375,102,37,3,3
"12823","59c6138abfd98455d41f8ef2ed833e75",36,36,0,36,0,36,1,2
"12824","59c654a3f0786b06366255332a3d48ac",145,97,56,18.125,145,0,3,3
"12825","59c6d74f353434185a2a30fbeb6ee4f8",100,71,51,13.7254901960784,65,35,2,3
"12826","59c6e8634a4c51cf000ce8b1badc6af8",24,24,0,24,24,0,1,2
"12827","59c74af437f42d0eb98c3fabaeaf603e",88,73,20,30.8,51,37,2,1
"12828","59c8d48007ded9818571f17c9a00e0be",45,40,30,10.5,45,0,2,1
"12829","59c9086ed970584725d42d8dc5070cd6",34,17,74,3.21621621621622,34,0,2,1
"12830","59c9ab8de805435895ff95981028f935",15,15,0,15,15,0,1,2
"12831","59ca2d25db3debc71dd7dcc79800f08c",59,49,22,18.7727272727273,30,29,2,1
"12832","59ca3c2a7e74ed11492d1c88e75d76e7",58,41,48,8.45833333333333,58,0,2,1
"12833","59cace1da9417536b1b28bd33de349cf",26,26,0,26,0,26,1,2
"12834","59cc7b6f83e8e603d351cfaa66597b15",57,50,49,8.14285714285714,57,0,2,1
"12835","59d0d528fe3e3baa0af24f7e78873a14",113,68,59,13.4067796610169,113,0,3,3
"12836","59d4639377a8953bbf72e60b17e84dae",36,36,0,36,36,0,1,2
"12837","59d469a5a37835edcf4848f675c95d81",87,62,36,16.9166666666667,47,40,2,3
"12838","59d8b11770123bfae00229a1f1fc2373",46,46,0,46,46,0,1,2
"12839","59ddc4e778db5808d7192daec830b602",67,55,43,10.906976744186,67,0,2,3
"12840","59ddfe819e20cf7201dfc3f00b9c0259",168,91,75,15.68,168,0,3,3
"12841","59df39d24b400f40f3566592a0573260",126,40,80,11.025,75,51,2,3
"12842","59dfc808b364869be765f9c9ece0ee04",73,31,77,6.63636363636364,73,0,2,1
"12843","59e414c7282223b95a127789af139839",22,22,0,22,22,0,1,2
"12844","59e48f9238f74660378257499d1ee497",40,40,0,40,40,0,1,2
"12845","59e5484f49d15a00c4548405a1a2f43b",30,30,0,30,30,0,1,2
"12846","59e677c2f14cf619c6951f08a25c5e8b",80,63,43,13.0232558139535,80,0,2,3
"12847","59e733dc77c1605c601f60ff266bec69",62,50,29,14.9655172413793,62,0,2,1
"12848","59e7760634fc17aa23823c4d19480870",10,10,0,10,0,10,1,2
"12849","59ea5fbd8e9eba25fbcc656168dfbf91",51,42,59,6.05084745762712,51,0,2,1
"12850","59eb73d57a483040f1812fdceefbecdb",45,41,63,5,45,0,2,1
"12851","59eb7ba804286e55842e2732fc0699ab",87,76,23,26.4782608695652,87,0,2,3
"12852","59eca3bef376b01aa2a78cd87ca36fc1",33,33,0,33,33,0,1,2
"12853","59ecd8bbd4e353d0a5713f1921fe0da3",45,28,71,4.43661971830986,9,36,2,1
"12854","59ef465ce2daaafeca1dfab5bb0ca1ab",175,68,79,15.506329113924,175,0,3,3
"12855","59ef87f5e5b6bb23a1653ec7e016b6b0",5,3,38,0.921052631578947,5,0,2,1
"12856","59f3c2e536fec9bd3a55000ff0fc62e9",43,43,0,43,43,0,1,2
"12857","59f47131f45ed49871ab460426bf7624",75,55,71,7.3943661971831,75,0,2,3
"12858","59f490de498f1a98a41d8488241a7282",67,46,28,16.75,67,0,2,1
"12859","59f5e8bd52d7d74cc60634bbebdea73c",19,19,0,19,19,0,1,2
"12860","59fc8d125c2fd95f45a48c24c81b1c82",158,74,56,19.75,116,42,3,3
"12861","59fe29a6c7971ef97d4e91bdbd162398",87,77,11,55.3636363636364,51,36,1,2
"12862","59ff0488e329c6a3c705624d740f3f99",166,114,75,15.4933333333333,166,0,3,3
"12863","59ffedcdc9742f64cbb50e535e20f468",28,28,0,28,28,0,1,2
"12864","5a0067295d5e674e03fdd4507392a15b",34,34,0,34,34,0,1,2
"12865","5a0448d274aee8fcaff1f5d37a58b77f",23,15,78,2.06410256410256,23,0,2,1
"12866","5a07832f41a445cbc975c30190b84358",59,52,18,22.9444444444444,27,32,1,1
"12867","5a0b2eb696bf1c8db113add69df2acee",101,79,31,22.8064516129032,101,0,3,3
"12868","5a0b31c2f48956155fece636184aa62d",18,18,0,18,0,18,1,2
"12869","5a0d6747f2cdcf85b9f87bc6130780da",5,4,46,0.760869565217391,4,1,2,1
"12870","5a0eebecf724eb2851385e89c1720c8e",184,93,70,18.4,163,21,3,3
"12871","5a11419c335402a1e97632f5c2c4da53",146,92,81,12.6172839506173,98,48,3,3
"12872","5a119997932b023f7bf5b97c826eecff",19,19,0,19,19,0,1,2
"12873","5a11a550863c10b99d504d8a2bbc6a81",56,56,0,56,56,0,1,2
"12874","5a1352569fe2d61584ec4c5f28e6c415",103,66,68,10.6029411764706,103,0,2,3
"12875","5a1599e99e919ed310bfb36531d53064",218,114,62,24.6129032258065,218,0,3,3
"12876","5a1620c37072d6a199b0cd5cf2fe840d",26,26,0,26,26,0,1,2
"12877","5a1664813212c0c4800ce4d9de0a50e4",7,7,0,7,7,0,1,2
"12878","5a17c377c0e72925784b87230cd80c9d",112,70,56,14,112,0,3,3
"12879","5a18eafdab04f1889d86f0c4c38661da",37,37,0,37,37,0,1,2
"12880","5a1ab2401e8046f8da2af8e6ec502a2e",14,14,0,14,14,0,1,2
"12881","5a1d5080d8ac47316a1f70e0b9aff85d",27,19,28,6.75,0,27,2,1
"12882","5a1e3667a3e628765aa771fccfd2b3bc",167,90,68,17.1911764705882,167,0,3,3
"12883","5a209ed92938e68087b87a32740fb5f2",29,29,0,29,29,0,1,2
"12884","5a219b7220cab9ec4f968eb75334f94c",35,31,9,27.2222222222222,35,0,1,2
"12885","5a23f202b735f0ef4788593ca6cc7e5d",54,54,0,54,54,0,1,2
"12886","5a23f9c16e140f0cdb840f7cfc7efbcf",110,65,63,12.2222222222222,110,0,3,3
"12887","5a252d141b7b639158f12a481d318dc1",39,39,0,39,39,0,1,2
"12888","5a25dbe5cfee89478f191c0f21459ed8",35,25,30,8.16666666666667,35,0,2,1
"12889","5a25e7aaa217294305b0fabe2ec36f5f",34,28,65,3.66153846153846,34,0,2,1
"12890","5a26869edd4491c063bcfa67c997655e",38,38,0,38,38,0,1,2
"12891","5a26f7aba97478c0ddcc9a885db4bdfa",46,46,0,46,0,46,1,2
"12892","5a282c0930b7992e165a929d447e95b8",77,47,62,8.69354838709677,77,0,2,3
"12893","5a29920ce4673e3ce6e4b8219e64fafd",32,32,0,32,32,0,1,2
"12894","5a2c76e6c659c436bd109a1bb8d8d5da",85,57,56,10.625,85,0,2,3
"12895","5a2d830ce618ecda587c2e985a4f653e",9,9,0,9,9,0,1,2
"12896","5a2ea9cd78f933ee899750b046e63704",137,90,72,13.3194444444444,137,0,3,3
"12897","5a2f080f9941e4cec4bb60e3ce27d078",20,14,84,1.66666666666667,20,0,2,1
"12898","5a30a60408228acdc83b110f86afc38a",31,31,0,31,31,0,1,2
"12899","5a3254078766de43db4061f2886497d8",48,40,38,8.84210526315789,28,20,2,1
"12900","5a3739550f410f468536658172832a1b",76,35,15,35.4666666666667,76,0,1,2
"12901","5a399a531a819ff2a04d806721121a36",112,72,33,23.7575757575758,112,0,3,3
"12902","5a3ae2ffbc7dd25be43d19771770c112",99,77,20,34.65,99,0,3,3
"12903","5a3affde14062d03a7f6bebdb73abb6f",34,29,61,3.9016393442623,34,0,2,1
"12904","5a3b7e31583cdbb4c16393a30f72e3dc",34,34,0,34,0,34,1,2
"12905","5a3b91d7770bdba4d6337fa4973447e6",77,63,40,13.475,44,33,2,1
"12906","5a3ceb2339bbe2e242874bfb225feb49",16,16,0,16,16,0,1,2
"12907","5a3d46bc8610c16916030f1463890065",111,90,56,13.875,111,0,3,3
"12908","5a3db0669282dfa43bc797de15c13fd9",28,28,0,28,28,0,1,2
"12909","5a3dc4831fe97818aaf932cc66dbfb1b",150,100,49,21.4285714285714,125,25,3,3
"12910","5a3ecd34b8ad48a986e75fb9e90293ed",55,49,13,29.6153846153846,55,0,1,1
"12911","5a415f309a729a1e2bee8401b6073d63",31,31,0,31,31,0,1,2
"12912","5a4204aee5ec3859a9d358956eeb43ec",246,103,49,35.1428571428571,214,32,3,3
"12913","5a4323a472bfba68adeffb21de97c708",25,25,0,25,0,25,1,2
"12914","5a43fc2d02a537e53456ba980b6b5735",22,18,51,3.01960784313725,22,0,2,1
"12915","5a448a67b065811a98486543d33f19bf",28,28,0,28,28,0,1,2
"12916","5a45751e5ee5c791f53b48b302ae72e0",55,39,59,6.52542372881356,55,0,2,1
"12917","5a45c6450b523f9fc424af30905f9aa7",14,14,0,14,0,14,1,2
"12918","5a46c7db4324da59201180bc1c507820",20,20,0,20,20,0,1,2
"12919","5a484156482b6250d3311296724a8db8",76,55,63,8.44444444444444,57,19,2,1
"12920","5a492be977df81a701889d2fc737dd58",92,64,37,17.4054054054054,68,24,2,1
"12921","5a4b67f06927f324c7374c1744f2a0f5",15,15,0,15,15,0,1,2
"12922","5a4cc22b21652951a496e28e8aedfae7",99,81,32,21.65625,53,46,3,3
"12923","5a4d9f6de9bf3a2b36e1e6eadb4cc41e",31,31,0,31,31,0,1,2
"12924","5a4eaad8d682002ff087311fa2048fa4",114,69,38,21,114,0,3,3
"12925","5a4f36eecd030b0f3c024fc45776026b",144,67,71,14.1971830985915,97,47,3,3
"12926","5a4faa7f21814f8d1f0eac8eb0dec1fc",33,33,0,33,33,0,1,2
"12927","5a5100d7ba2c84ddb74eeef458b46145",46,29,70,4.6,46,0,2,1
"12928","5a53653f325dbad0e220be775b1f797e",40,39,36,7.77777777777778,24,16,2,1
"12929","5a5515fb1d8ae9a6ef1a54febb4d08ef",93,78,29,22.448275862069,93,0,3,3
"12930","5a55ca9ba9e1edcab44cd459c7e411ad",33,33,0,33,33,0,1,2
"12931","5a58b8ea4e7d21ff718e884b4a95e55c",59,52,33,12.5151515151515,59,0,2,1
"12932","5a5a1617b5a329eb6b9bda1d66f749f1",142,119,68,14.6176470588235,142,0,3,3
"12933","5a66990be38ab4d679644e936da8ed91",163,103,63,18.1111111111111,163,0,3,3
"12934","5a672a4a92dd0bfcaf0c51fef2fe2eb9",54,54,0,54,54,0,1,2
"12935","5a6a57a91aa51e56ae13a5c4c726bd1f",109,90,32,23.84375,60,49,3,3
"12936","5a6a76370b332e029bfd0fffeee5a945",37,37,0,37,37,0,1,2
"12937","5a6e9ff395482ed728a877b3ae00d0eb",30,30,0,30,30,0,1,2
"12938","5a6f9d8fe8222381af379a1eb83d53c6",182,105,80,15.925,139,43,3,3
"12939","5a728a00a494c9267d21d9bd5838619b",96,75,36,18.6666666666667,96,0,3,3
"12940","5a729e0564419eb5473e6ee95c5d8f18",36,36,0,36,36,0,1,2
"12941","5a7310084dacf71ba0737bf5ff650a7d",29,29,0,29,29,0,1,2
"12942","5a7887b0523210cbae956f4b1b07310f",31,24,50,4.34,31,0,2,1
"12943","5a7891202bdf3bd60d12ea976f69bd0b",38,38,0,38,38,0,1,2
"12944","5a78b2c3d75533b870a17b62ce5ea850",24,20,49,3.42857142857143,0,24,2,1
"12945","5a7c3859d92d20ff6716285f060de021",82,55,55,10.4363636363636,82,0,2,3
"12946","5a7ce5275482f5d6924cb27b1aff4a8a",4,4,0,4,0,4,1,2
"12947","5a7d7c4cfd44c7457d98c4947717b1b0",14,14,0,14,14,0,1,2
"12948","5a7f991bfef922e80066c3676c3bc82a",15,10,52,2.01923076923077,6,9,2,1
"12949","5a819b1fcd9f76620ddf80bc54ea2f8e",27,27,0,27,27,0,1,2
"12950","5a81a522b92e4b2d1b9271f748c13536",21,21,0,21,21,0,1,2
"12951","5a81c477dcc164367b295a8e3ec80ea8",59,49,28,14.75,59,0,2,1
"12952","5a8251fd583b12505bf67ac7789bd99a",181,108,87,14.5632183908046,181,0,3,3
"12953","5a83bf5e0b4ea7b8f5f737a3a35d2950",50,40,31,11.2903225806452,45,5,2,1
"12954","5a84f527843b289b1730376875c579f5",13,13,0,13,13,0,1,2
"12955","5a85a29a0b1df68edf4f951bd4cb3bd8",84,71,28,21,84,0,2,3
"12956","5a89efc22b9590fd935b251630556ba4",41,41,0,41,41,0,1,2
"12957","5a8f028d7c2101731a93956e94221e1e",36,36,0,36,36,0,1,2
"12958","5a91086cdc6c61b0a87df38e6088cde1",34,34,0,34,34,0,1,2
"12959","5a92a308d5d107595ccb4162a7d293b8",79,50,65,8.50769230769231,79,0,2,3
"12960","5a92b9bc7f6b6ded267d5ceaf4312a2a",103,80,28,25.75,103,0,3,3
"12961","5a93cef6212d82e2a8813950b02b6126",30,30,0,30,30,0,1,2
"12962","5a9563e49d247846a970ccaa82b565ec",197,141,51,27.0392156862745,197,0,3,3
"12963","5a97ac36addd4e108e51420bd9838288",27,19,39,4.84615384615385,27,0,2,1
"12964","5a9982668fa851da740eb006ab6224b9",39,39,0,39,39,0,1,2
"12965","5a99e989e2dc608e85c4f629813bc696",6,6,0,6,6,0,1,2
"12966","5a9a83bcfcc4ae57592424f83fc92f12",17,17,0,17,17,0,1,2
"12967","5a9b1f075608cd735940e5c2bfc15f90",209,113,79,18.5189873417721,176,33,3,3
"12968","5a9ca90b67a38acd7167c92759b029b2",31,31,0,31,31,0,1,2
"12969","5aa1198ef6e89ed2236977a14d2c3bad",35,35,0,35,35,0,1,2
"12970","5aa1850ac9e93f48ce2174c2f5e568dd",28,28,0,28,28,0,1,2
"12971","5aa5e7586ba48962d01705056c88570d",18,18,0,18,18,0,1,2
"12972","5aa6a560b3ae5a0575ea5b65a17de816",32,20,49,4.57142857142857,21,11,2,1
"12973","5aa990eda4fbf489cb419a5b8792557d",45,41,16,19.6875,16,29,1,1
"12974","5aaad63be04968f7d0f4f837c777565d",117,96,37,22.1351351351351,69,48,3,3
"12975","5aac8500b4497401be21cfe3479bc7d9",17,17,0,17,17,0,1,2
"12976","5ab036fe39ffb3830a59123c29328e8e",17,13,58,2.05172413793103,17,0,2,1
"12977","5ab92bef82ef74f488f38d2596322548",52,42,15,24.2666666666667,52,0,1,1
"12978","5ab984dbd35fc1d51f557a5461f15b9f",93,47,64,10.171875,93,0,2,3
"12979","5ab9f54a1f42fcc73242752fa8d81585",20,16,30,4.66666666666667,20,0,2,1
"12980","5abab317b936b94a13665857551ea3f1",50,50,0,50,50,0,1,2
"12981","5abc2cbf3a390905db257a436b8be2cd",15,15,0,15,15,0,1,2
"12982","5abc9cbe3dc785567e17b54583a20bab",25,25,0,25,25,0,1,2
"12983","5abd543770abdecbfa576f2cae9d1f64",20,20,0,20,20,0,1,2
"12984","5abe7bbfc86d906549edc73f3d21f2d9",83,57,28,20.75,83,0,2,3
"12985","5ac3aa4b7a498a4a2a970dc264d50ca1",33,33,0,33,0,33,1,2
"12986","5ac431cae9ff07fc2216d28cf7c79c0d",22,22,0,22,22,0,1,2
"12987","5ac805cb6f484949f70eef5e2e5fbb90",19,19,0,19,0,19,1,2
"12988","5ac91630928ee1e8e7589577c473027b",160,22,84,13.3333333333333,160,0,3,3
"12989","5aca437a0a68aab1ca4efbeae9d8e2ae",92,37,71,9.07042253521127,92,0,2,3
"12990","5acc3b8a166e7519358bdf1a79abcbe7",27,27,0,27,27,0,1,2
"12991","5acc6e02d3202bcf5c8580ff5a89dfa7",66,57,16,28.875,40,26,1,1
"12992","5acca6f8f4a17b8587d65ab1158743a7",30,30,0,30,30,0,1,2
"12993","5ad05f424e06167ef678506cb4a5b6e8",19,19,0,19,19,0,1,2
"12994","5ad1f252fe5c9ecb9714538ebbc53451",133,61,72,12.9305555555556,105,28,3,3
"12995","5ad2799d71272b33c3ca2a3dde38d692",60,50,69,6.08695652173913,21,39,2,1
"12996","5ad70677cdf01c7c0656a148a6e314ea",142,73,68,14.6176470588235,142,0,3,3
"12997","5ad856c497f8998ce85cbed25e22050a",100,78,64,10.9375,65,35,2,3
"12998","5ad99240cc137ad52080c380d946a68d",112,92,57,13.7543859649123,112,0,3,3
"12999","5ad9f6c1399ecf6d18f219659c9fae67",188,81,62,21.2258064516129,188,0,3,3
"13000","5ada7de20f2e11dfa614f3d789d20da1",32,32,0,32,32,0,1,2
"13001","5adb08f9391656aabb9d2cd06bf9970b",36,35,9,28,8,28,1,2
"13002","5add30e97d2028352e071ec003861553",20,20,0,20,20,0,1,2
"13003","5ade6120465a2e19b5557d0cd1cadd4f",58,46,70,5.8,48,10,2,1
"13004","5adede88a70a0460d9361b295f77938e",34,34,0,34,34,0,1,2
"13005","5ae32324181e77fd2fe67fe0ceb650e3",209,126,28,52.25,209,0,3,3
"13006","5ae3fe82d15cd173b3e52539be1fcc76",83,60,26,22.3461538461538,36,47,2,1
"13007","5ae4a2509a3048675902958ad25cb493",15,15,0,15,15,0,1,2
"13008","5ae74f1e3aaf31fce88e6fda1c4b0eb5",30,30,0,30,30,0,1,2
"13009","5ae86f2399ee0a2d06a2543d63a5b448",28,28,0,28,28,0,1,2
"13010","5aea398f720da05655480827d2a93127",20,9,69,2.02898550724638,20,0,2,1
"13011","5aecc8464591ef8846b1007f72856e06",202,130,26,54.3846153846154,202,0,3,3
"13012","5aedf95a2e9ab62d1e3d5b9679c9a17f",21,21,27,5.44444444444444,21,0,2,1
"13013","5af0ae50fb8bda44e7db63842ff3eccf",61,55,9,47.4444444444444,61,0,1,2
"13014","5af5e00b31ad80032682e130895cf20b",121,95,58,14.6034482758621,67,54,3,3
"13015","5af6c5752d63ae3bdaa0f6beb90cb7b5",38,38,0,38,38,0,1,2
"13016","5af72a38c06cd40391e9d62a80c85c33",67,58,9,52.1111111111111,67,0,1,2
"13017","5af8e3e4a57dff79859cd222374eb7b4",37,34,64,4.046875,15,22,2,1
"13018","5af8fbfab7d00e9a87659b3da887f751",62,50,52,8.34615384615385,29,33,2,1
"13019","5afb71a3d6fa2069211a3d8cd335a918",96,76,80,8.4,96,0,3,3
"13020","5afd4a46c577b07fb19abf15ad5041ef",30,27,83,2.53012048192771,30,0,2,1
"13021","5afe05d2889c40f915895962eedd29a9",24,24,0,24,24,0,1,2
"13022","5afe3f7c298f3f285a9b33d699dd74a5",30,30,0,30,30,0,1,2
"13023","5afe8f34d38c2783a3449ed16f9a5cf0",177,70,81,15.2962962962963,131,46,3,3
"13024","5b012bb7752ae8f889e06f1fd4d71f61",81,54,49,11.5714285714286,81,0,2,3
"13025","5b045492d3f9a6536421bbe93bc394a5",173,68,84,14.4166666666667,146,27,3,3
"13026","5b05c833553ae284b98a7e2b999843ec",161,55,59,19.1016949152542,161,0,3,3
"13027","5b06eb52a9445250127b7723c32a720d",82,52,89,6.44943820224719,82,0,2,3
"13028","5b0d2f7cbff8f830bb469d89844664dc",20,20,0,20,20,0,1,2
"13029","5b14e60b2b4864dca26e4ed669837e96",67,41,53,8.84905660377358,67,0,2,1
"13030","5b166b7441d0bbc3d2698607f3d97bd1",105,67,52,14.1346153846154,105,0,3,3
"13031","5b166ca298ee9a11f48d73a79eceb54f",141,104,35,28.2,141,0,3,3
"13032","5b17a7d74faa29f0047bd5e89716a8fa",40,40,0,40,40,0,1,2
"13033","5b1dbb01707280749da7e28b6515e712",27,25,49,3.85714285714286,27,0,2,1
"13034","5b1f922ed7ffe040d28e88bd645c5d4a",20,20,0,20,20,0,1,2
"13035","5b1fe04e910b5756c8d608852e939a77",26,26,0,26,0,26,1,2
"13036","5b20b97765ea34df57c91061ccab7d8c",66,51,39,11.8461538461538,66,0,2,3
"13037","5b214a24d8b88e07feecdabc212d654f",94,79,22,29.9090909090909,94,0,3,3
"13038","5b22be58876b9fa0ab54d2a40769f910",129,101,61,14.8032786885246,129,0,3,3
"13039","5b22c4e0ceceef143082dc163bfa5205",82,71,62,9.25806451612903,82,0,2,3
"13040","5b2678239e6adda47adf4681dd783e66",50,38,28,12.5,50,0,2,1
"13041","5b2796da17779fec4dd88dea4183ede9",97,38,55,12.3454545454545,97,0,2,3
"13042","5b286f9d10f2acb311a2cf2224a0fdec",75,51,79,6.64556962025316,75,0,2,3
"13043","5b28de219d7e7616b03d296f38cf0536",102,59,55,12.9818181818182,102,0,2,3
"13044","5b2af6da77be97472eccf5d8e11b2889",46,46,0,46,46,0,1,2
"13045","5b2d346ea96e26e8e6a5a686d6bc424c",50,43,7,50,50,0,1,2
"13046","5b2df74e5caee245f2a35b5e24de3332",88,73,62,9.93548387096774,88,0,2,3
"13047","5b2f2e76b4bf715797ee793c9ea366bc",43,38,13,23.1538461538462,43,0,1,1
"13048","5b301035f0e7ceed5504cb64fe5cb18f",32,19,47,4.76595744680851,32,0,2,1
"13049","5b328809aa9337b028f53ab3beeba66f",29,29,0,29,29,0,1,2
"13050","5b328c73ad743af881bdafc0d92a9b8f",77,49,79,6.82278481012658,34,43,2,1
"13051","5b337e2a438642d7e64e44c0f2593c74",51,46,35,10.2,51,0,2,1
"13052","5b3a0dc85205f006d9f92230c8b4ac6c",33,33,0,33,0,33,1,2
"13053","5b3a51fccce54601b76032a84e9996d3",164,78,60,19.1333333333333,164,0,3,3
"13054","5b4052226b4e740246f2ada0534157e3",96,66,89,7.55056179775281,79,17,2,1
"13055","5b40ed5a9fdf5d11b0646738d9b7e164",25,22,54,3.24074074074074,25,0,2,1
"13056","5b413cc1a98262e07b0f9ea28a3b682f",8,8,0,8,8,0,1,2
"13057","5b420beb85d9ccc7ff9c85103e03cbc8",154,90,79,13.6455696202532,114,40,3,3
"13058","5b422315b058659b92a28724c979e57b",41,41,0,41,41,0,1,2
"13059","5b460c97c1d4ddc1170075106ab4243d",43,43,0,43,43,0,1,2
"13060","5b469680c65216d5d71dd33328e61ccb",97,76,73,9.3013698630137,97,0,3,3
"13061","5b46a5a383082b4c20aa79dbeb2a91c6",43,43,0,43,43,0,1,2
"13062","5b46f32fd03bf081964e18d7d2389b04",89,72,84,7.41666666666667,89,0,2,3
"13063","5b47ea78e98b522d052057ffa084e3c4",44,42,31,9.93548387096774,44,0,2,1
"13064","5b4b2e2ee41c0100d01a42d4b08b1d02",44,41,28,11,44,0,2,1
"13065","5b53ee4780b8d3e7fe53fe64a57eb9b7",26,26,0,26,0,26,1,2
"13066","5b547f56cd72a3f9bf12ec99db0a25cd",113,71,27,29.2962962962963,113,0,3,3
"13067","5b55a3c163dbfda59441e3bad0df29c3",14,14,0,14,14,0,1,2
"13068","5b56d7945709361dd515e99c442aaa33",36,36,0,36,36,0,1,2
"13069","5b587bc2ccd4342f17f94d65e819fa48",59,52,29,14.2413793103448,17,42,2,1
"13070","5b58871a824ad956c0bb388e31f6902c",105,82,57,12.8947368421053,84,21,3,1
"13071","5b58a5a3f0b26fca27f4c04153dc5163",104,83,72,10.1111111111111,104,0,3,3
"13072","5b59442fe77233baebe7fad0dd93d84e",40,37,85,3.29411764705882,34,6,2,1
"13073","5b5a37c1a152845544ef17874118d62e",8,7,5,11.2,8,0,1,2
"13074","5b5a9b8f3be6bffe69ec60256f7dba97",132,94,67,13.7910447761194,116,16,3,3
"13075","5b5bc7444b2ea0b56de22184b64e7d62",29,29,0,29,29,0,1,2
"13076","5b5d877ce547f863900f21acd08e5803",142,76,61,16.2950819672131,142,0,3,3
"13077","5b5dcf4898a3d1964082ac6112f93a7f",20,20,0,20,20,0,1,2
"13078","5b60e7cc5120a7b7d5795b423ddde7ac",146,94,39,26.2051282051282,146,0,3,3
"13079","5b61503c8d43de8d3e167bf4a2d0e42d",112,80,45,17.4222222222222,112,0,3,3
"13080","5b617eba7da703f58533e83c02c320d1",53,53,0,53,53,0,1,2
"13081","5b61c1303a325b08b72cb1c61fce90d0",36,36,0,36,0,36,1,2
"13082","5b6205006166e5bed16af0c88b578ee1",162,84,87,13.0344827586207,142,20,3,3
"13083","5b6497151cc2eb6fd3c463ea5c240a6e",98,89,33,20.7878787878788,98,0,3,3
"13084","5b65dc59c3ad402246d7a8a716158190",29,27,21,9.66666666666667,29,0,1,1
"13085","5b663d08577928b74ad484edacf3303b",51,43,42,8.5,0,51,2,1
"13086","5b698c75e4e79bcaca5ca9b172358684",90,64,56,11.25,90,0,2,3
"13087","5b6aadfcf18fdb6c7c14bd1ba058a165",1,1,0,1,1,0,1,2
"13088","5b6e50b342e88052195a9e05b5a1c6d0",151,94,72,14.6805555555556,104,47,3,3
"13089","5b6ea7060c360094aa8feb7a697959d6",38,38,0,38,38,0,1,2
"13090","5b73fec46afdd623892cd9ab44d65cf9",13,13,0,13,13,0,1,2
"13091","5b742d904a765e479dd5a5112b1d7da4",15,15,0,15,15,0,1,2
"13092","5b744a747c216389552b13a873e1cb23",93,63,84,7.75,93,0,2,3
"13093","5b7a0429390be40d7910802a43a10cc7",93,80,69,9.43478260869565,93,0,2,3
"13094","5b7bc72780bfbf85a042c303ca2a3842",116,75,49,16.5714285714286,116,0,3,3
"13095","5b7f210c17b6e9f4566ffa01b78286c9",33,30,15,15.4,33,0,1,1
"13096","5b82671885949e89342cf2ec7d9afd6b",94,68,55,11.9636363636364,94,0,2,3
"13097","5b86fcf276f8a7647cc5c721a014b13c",65,53,39,11.6666666666667,65,0,2,3
"13098","5b8cb7437b50cffd71e7075b5109dff8",52,48,32,11.375,17,35,2,1
"13099","5b8d919e9110a20ecf534b0cf9824fc7",25,25,0,25,25,0,1,2
"13100","5b8e5953a331f55b3bcfb0b2cf866848",117,75,76,10.7763157894737,117,0,3,3
"13101","5b8f64535bd13022bf157aa3e515d31e",35,35,0,35,35,0,1,2
"13102","5b91237f33e358047afacffa601085bb",9,9,0,9,9,0,1,2
"13103","5b93169c70f1fdbf885a176a66af5b36",63,47,30,14.7,47,16,2,1
"13104","5b94ecea9ffe946c09215850ba3a48ea",16,7,88,1.27272727272727,16,0,2,1
"13105","5b962f353b55908f018d1d6acd8bf137",73,55,61,8.37704918032787,60,13,2,1
"13106","5b9ad0ca278bab90395128c2e4176d5c",229,121,89,18.0112359550562,175,54,3,3
"13107","5b9de62516a924c3ac03d133a6d9bf7f",107,56,64,11.703125,82,25,2,1
"13108","5b9e9497703d766016bb1c289505c505",36,25,23,10.9565217391304,36,0,2,1
"13109","5ba1f2efaed6262718220661cbdc43d1",35,33,44,5.56818181818182,20,15,2,1
"13110","5ba40575868a68a8901eec17c53c7cfd",26,26,0,26,26,0,1,2
"13111","5ba669239c24d923c87f8716e3612860",27,27,0,27,27,0,1,2
"13112","5ba69702f38b93762c9ce6fd599ed8c6",42,42,0,42,42,0,1,2
"13113","5ba74e73a82882f8d15be61c0c85e6bd",37,23,20,12.95,37,0,1,1
"13114","5ba7b8afb6b00576685b94615a197703",53,48,16,23.1875,53,0,1,1
"13115","5ba7f73aceeb154ce7a7aa00046d212f",142,103,66,15.0606060606061,142,0,3,3
"13116","5bb3289f77af5a8be1c06c7815ad3893",90,70,22,28.6363636363636,90,0,2,3
"13117","5bb47ee38afae82168ea9ae440dea62e",36,36,0,36,36,0,1,2
"13118","5bb6ec4dcbdc178f2dd4cf271643ed23",25,25,0,25,0,25,1,2
"13119","5bb7caf4a05222ca65242818a9c291c3",6,4,28,1.5,6,0,2,1
"13120","5bba211d57f7912637bbc67c826e4fa0",104,87,24,30.3333333333333,104,0,3,3
"13121","5bc195b0c6afa461d6838a3a99dfefc1",187,80,79,16.5696202531646,187,0,3,3
"13122","5bc25d50142fa8fb2f25832d58dbda4f",67,52,43,10.906976744186,67,0,2,3
"13123","5bc39d36a983810d5da6d1b2d870dfc8",103,77,49,14.7142857142857,103,0,3,3
"13124","5bc438a8a7add7fc67200255c6218668",69,63,20,24.15,69,0,1,2
"13125","5bc588f0529bdf3cc6862232ac38cf69",96,73,13,51.6923076923077,96,0,1,2
"13126","5bc5a3359a840d8b95cdeb3e0a5122f4",50,35,69,5.07246376811594,50,0,2,1
"13127","5bc745f7935244eb58406f65596679fa",168,66,77,15.2727272727273,168,0,3,3
"13128","5bcb3a37c56025e989ee321b440fc6e6",30,30,0,30,30,0,1,2
"13129","5bcb8d4bc9321e5601febd39928e539a",51,51,0,51,51,0,1,2
"13130","5bcce7165b4ef70888326d32c55763d9",47,47,0,47,0,47,1,2
"13131","5bcde84c35f74f6351f6ef7bf0c384ed",42,37,64,4.59375,42,0,2,1
"13132","5bcfbfdd7dac63ab9eb945385940e43e",214,128,67,22.3582089552239,214,0,3,3
"13133","5bd16991f4e3c12a3cdb04de7c33e633",15,15,0,15,15,0,1,2
"13134","5bd281bed177382f6e795b74d10d01be",21,21,0,21,21,0,1,2
"13135","5bd29d70b2435fb54c21d589b97098ce",75,50,56,9.375,75,0,2,3
"13136","5bd300705695f45f5f0ea1a2bbc953bc",29,29,0,29,0,29,1,2
"13137","5bd41b355ea45fb5332200f297494dde",68,51,56,8.5,68,0,2,1
"13138","5bd5f176699d68e5f63a4f273b19fb7f",137,85,45,21.3111111111111,105,32,3,3
"13139","5bda0ffb646a3eaab100fcc41d379724",41,41,0,41,41,0,1,2
"13140","5bdc198ec39282f6fddc28954bb20f75",15,15,0,15,15,0,1,2
"13141","5bde0cd614a0bb5d682e3a07905312be",79,65,53,10.4339622641509,33,46,2,1
"13142","5be17d528c745dd3f823f3ea7afe27df",15,15,0,15,15,0,1,2
"13143","5be2fd90440da71989b8176a407ad667",67,51,35,13.4,67,0,2,1
"13144","5be329689f2eddac2c717431708d1b47",234,114,64,25.59375,179,55,3,3
"13145","5be8d7dd19af0ded6f71f94d538cacc3",138,71,75,12.88,104,34,3,3
"13146","5bea9d40ab7878229502fdaabe5d2b5f",13,8,48,1.89583333333333,13,0,2,1
"13147","5bec65b39ae44b6422792ce43cf5111b",34,34,0,34,34,0,1,2
"13148","5bef5904552df25e6b2fb6690b4848cb",111,90,78,9.96153846153846,63,48,3,3
"13149","5bf0753516d241c4dd2ec1fdd8e4fae2",31,31,0,31,31,0,1,2
"13150","5bf321ffae5e3035a11630e911ac7dff",26,26,0,26,0,26,1,2
"13151","5bf4e38e89e185b665978bc3ef9dd994",25,13,63,2.77777777777778,25,0,2,1
"13152","5bf51cd9700a0e104e69c537860773ea",199,116,73,19.0821917808219,199,0,3,3
"13153","5bf5c0bcda22de660d2b989025cc34a7",32,27,14,16,0,32,1,1
"13154","5bf5e18521d8439ef9609eddf0b420af",22,22,0,22,22,0,1,2
"13155","5bf5f4d2a15cb33a9e89f5aa1afd37cc",27,21,10,18.9,27,0,1,1
"13156","5bf6376bf68a5e94870f4b3c8a960839",7,7,0,7,7,0,1,2
"13157","5bf703c671690f1ea73f0f52da23f76e",130,100,83,10.9638554216867,115,15,3,3
"13158","5bf8ffef83c23332496ede563a971e95",69,54,60,8.05,69,0,2,3
"13159","5bf91a6ae4c91df86edc0c22a2f264f8",10,10,0,10,0,10,1,2
"13160","5bf97aefb3d45db901552b13101f4340",43,43,0,43,43,0,1,2
"13161","5bfbbf8baa26b2b2787655210e43e51d",250,109,87,20.1149425287356,208,42,3,3
"13162","5bfe2d7baa41ed94aa811f65255ff07c",33,33,0,33,33,0,1,2
"13163","5bfee49560274a9652855b187cd9fa9a",91,71,29,21.9655172413793,91,0,2,3
"13164","5bff650fcc88b2e45e325c03e59b26a6",29,29,0,29,29,0,1,2
"13165","5c001f51437adad0ec87179cb7e290b0",26,26,0,26,26,0,1,2
"13166","5c0368e4768b8ad982f6e79470b44814",53,53,0,53,53,0,1,2
"13167","5c062a311ad27945bba1bc6ae93baa3c",67,51,28,16.75,67,0,2,1
"13168","5c08da0339db83597f07541f4541e5d7",9,9,0,9,9,0,1,2
"13169","5c09a5bf771ac33bb52e4029495c727b",119,73,80,10.4125,79,40,3,3
"13170","5c0a8a32a877d81799b2332091218e19",25,25,0,25,25,0,1,2
"13171","5c0b2da87f0f95f6d6f73e5da92e1265",88,80,46,13.3913043478261,79,9,2,3
"13172","5c0e7f5eaf356ef2de02705a3633a5e8",52,41,87,4.18390804597701,52,0,2,1
"13173","5c0feb5680101bda4edf192cabd6f4a5",37,37,0,37,37,0,1,2
"13174","5c10a8058ae12610d71efbdc71cb037f",28,28,0,28,28,0,1,2
"13175","5c14b3f0486a76252b1ff9bc80a1b924",22,22,0,22,22,0,1,2
"13176","5c152cc54f39c3043d6a20cb6a10f323",98,77,46,14.9130434782609,98,0,3,3
"13177","5c1583df76e2260c31a85363d82cb0d4",21,21,0,21,21,0,1,2
"13178","5c1898d9e6e6c578b38a93c6492c2450",235,116,83,19.8192771084337,203,32,3,3
"13179","5c1931e0b919c5ca2da9624b617cd4bf",11,11,0,11,11,0,1,2
"13180","5c1de93da4e4f700e9b1848d58d69bb0",41,41,0,41,41,0,1,2
"13181","5c1f206f8bf580e7d258958db71d176c",172,92,83,14.5060240963855,172,0,3,3
"13182","5c20bde9913b5a332f52f530ad969063",40,32,25,11.2,40,0,2,1
"13183","5c23dc6421ecd1683f4b0a52ed508333",21,21,0,21,21,0,1,2
"13184","5c24535055d512b722c5b9af942c21bf",27,27,0,27,27,0,1,2
"13185","5c29a7f307c9f708af079c2dc4b1ef23",191,108,63,21.2222222222222,191,0,3,3
"13186","5c2d939a108460031f5f0eed2736e4f3",22,22,0,22,22,0,1,2
"13187","5c2e7650102660ca2ec8e698ac7fd799",201,127,60,23.45,147,54,3,3
"13188","5c31dd2a3756685066dc0a729a80bcac",91,59,44,14.4772727272727,64,27,2,1
"13189","5c32728e33203e0a9965d21275efafee",11,11,0,11,0,11,1,2
"13190","5c327a2168a8f0765e65daba5bbd5f6b",20,20,0,20,20,0,1,2
"13191","5c33a28cb3348ea524caf3a69fc436ac",8,8,0,8,0,8,1,2
"13192","5c35310fcb8a3227e1ea8c4ddfacb628",97,77,43,15.7906976744186,97,0,3,3
"13193","5c394945febf63744dacb0f88e970c9d",213,137,75,19.88,182,31,3,3
"13194","5c3a03b23669dd2ed8df11c410351de3",52,48,10,36.4,52,0,1,2
"13195","5c3d13cb74806b3950d1d6624da5bc1d",87,76,76,8.01315789473684,87,0,2,3
"13196","5c3f69a6fcd283bdb3cf9d86d5468409",146,76,81,12.6172839506173,146,0,3,3
"13197","5c43604c120ab6953e9a2bb0d30ff4d2",153,112,61,17.5573770491803,105,48,3,3
"13198","5c44bea2f2d771f484af0942c0fdc49d",26,26,0,26,0,26,1,2
"13199","5c454e4a4ca8bf1dcb3c3f953447c875",33,33,0,33,0,33,1,2
"13200","5c45cb98809d772e0aaa764196fbb62c",55,55,0,55,55,0,1,2
"13201","5c4671e9c337bc2bdba0f5205cea3ab2",6,2,53,0.792452830188679,4,2,2,1
"13202","5c473876e24804710483c37c4d3e92a1",16,16,0,16,16,0,1,2
"13203","5c47c5a67eaf9acde625296ecce0880c",71,61,27,18.4074074074074,23,48,2,1
"13204","5c4981387792e00bad3b8d5284b7bb29",73,54,82,6.23170731707317,73,0,2,3
"13205","5c49b4fecbc29c074b2369a24c5c65b9",78,63,34,16.0588235294118,78,0,2,3
"13206","5c4de62a1b9cca37b6a4073df277b835",143,103,30,33.3666666666667,143,0,3,3
"13207","5c4f5a179482af4c684837284c1a24b1",127,89,61,14.5737704918033,127,0,3,3
"13208","5c5573e1079f0c11602c82790b6d9455",83,63,26,22.3461538461538,83,0,2,3
"13209","5c57a963d934f862294330787a0deb0c",4,4,0,4,4,0,1,2
"13210","5c5837880f829ad695a29f906576df73",36,35,16,15.75,36,0,1,1
"13211","5c5a37998c43e5ed0a6e537f02e16104",89,71,21,29.6666666666667,89,0,2,3
"13212","5c5aa1dffa4eab18020a9f386c315c33",16,16,0,16,16,0,1,2
"13213","5c5b93dc52c0b2d698557aed3392ea2c",39,39,0,39,39,0,1,2
"13214","5c5c76319fa9a83d94bc1df657ae3741",120,83,38,22.1052631578947,120,0,3,3
"13215","5c5d0d37d0a84c3450f16ce3f203c1ac",33,33,0,33,33,0,1,2
"13216","5c5d94ae0340ae48a96f587b42790b07",22,22,0,22,22,0,1,2
"13217","5c5f862df6d7881012702244414e629f",7,7,0,7,7,0,1,2
"13218","5c605068caf67c545f298a980eac3faf",12,9,48,1.75,12,0,2,1
"13219","5c6575d89ef01489ea26ec24a956c61f",69,59,22,21.9545454545455,69,0,2,1
"13220","5c667fbe8a22e232f9f259fdfec19a23",2,2,0,2,2,0,1,2
"13221","5c66b5e54bd6c136b7c354b694c0c0cd",66,44,83,5.56626506024096,66,0,2,3
"13222","5c66e16025dd31fcb87b9616fae954a6",78,48,24,22.75,49,29,2,1
"13223","5c699606e8637f68f86b13671baec7cb",61,37,60,7.11666666666667,61,0,2,1
"13224","5c69de295d21fe4cbb25201a4b6d3df7",4,4,0,4,0,4,1,2
"13225","5c6a2b040703ab0eb67c8f41a6b2a9c2",126,106,59,14.9491525423729,99,27,3,3
"13226","5c6a79bd03a03afc3b247a10ea72f017",47,47,0,47,47,0,1,2
"13227","5c6bacd959cf294ff799aff953a327bc",38,22,47,5.65957446808511,32,6,2,1
"13228","5c705de1948cf60cc1ea2ab0e1aaa185",136,103,90,10.5777777777778,136,0,3,3
"13229","5c71249ec7f610f5fe141ce8db63496c",28,28,0,28,28,0,1,2
"13230","5c718289d9d19d6925f1460105ede717",72,58,24,21,72,0,2,1
"13231","5c725a9a5b915a2b8c8495017b96cd9f",86,67,29,20.7586206896552,60,26,2,1
"13232","5c73fc0b2d082209aa845f79c5718bbe",109,80,40,19.075,109,0,3,3
"13233","5c7460a213426f410c82a1f636a0c559",21,21,0,21,0,21,1,2
"13234","5c7528d69b96e21b5591a3260858e68b",63,22,88,5.01136363636364,44,19,2,1
"13235","5c774198a246d77ee00611305fd59f01",25,25,0,25,25,0,1,2
"13236","5c794e17adcbb8277d856d530cfff462",12,12,0,12,12,0,1,2
"13237","5c79a66a8e49ae64261cb7c2a951e1fa",176,92,76,16.2105263157895,129,47,3,3
"13238","5c7a6ab318246245c738dd35386fdb42",38,38,0,38,38,0,1,2
"13239","5c7a895b6d013409213329f6c6113a5b",125,63,52,16.8269230769231,76,49,3,3
"13240","5c7bbcd83e395cfd42a4fe38b07a6ba1",170,89,89,13.3707865168539,170,0,3,3
"13241","5c7d83bf9c368663b50bc9f2f48278f3",30,30,0,30,30,0,1,2
"13242","5c7d9ac7a6d0ef8208957839b43abad1",42,35,41,7.17073170731707,42,0,2,1
"13243","5c7e4c9edf59c8e9878ebd20c60c8680",51,39,50,7.14,51,0,2,1
"13244","5c7f6baa17cd0390793e89bf6c7c37ae",35,34,5,49,35,0,1,2
"13245","5c82f53ddccd75c8a429d5de464d0cf6",5,5,0,5,5,0,1,2
"13246","5c854391a6b84bb396976bc4624c18f2",48,48,0,48,48,0,1,2
"13247","5c8572a897ad7efae95476b9f64b66d7",28,28,0,28,28,0,1,2
"13248","5c8c1b6693b7ea3f0a001d0084cfe226",28,28,0,28,28,0,1,2
"13249","5c8d847deef42a3e31c1b62bff9f05cb",115,90,40,20.125,115,0,3,3
"13250","5c8f2e7d57113246e262f751aacced75",9,9,0,9,9,0,1,2
"13251","5c8f8b4a751f91930c6259cb5bc6ebcf",16,16,0,16,16,0,1,2
"13252","5c9001f9eb49fde798ab71aec8cfce6e",24,24,0,24,24,0,1,2
"13253","5c906ee584943bc3cec218dfb9dd59ca",31,22,15,14.4666666666667,31,0,1,1
"13254","5c947d5b92811ef9447730f11afd7cf7",56,37,88,4.45454545454546,56,0,2,1
"13255","5c97be22b340039a2cfeb60eb8444edf",54,52,12,31.5,36,18,1,2
"13256","5c9a13e5558bdb597c16e3f865d0aad7",6,6,0,6,6,0,1,2
"13257","5c9addbd61a55d4f8d7f85ded10e5428",44,44,0,44,44,0,1,2
"13258","5c9f020cf96195e43066e8b6e8b09dca",46,27,70,4.6,46,0,2,1
"13259","5ca36ff2615960edff08e9ec41bcce7a",9,5,28,2.25,9,0,2,1
"13260","5ca54eebaeab39f37f061ed169e564cc",64,48,27,16.5925925925926,64,0,2,1
"13261","5ca6084303dae0a20952c3caec9e521d",36,36,0,36,36,0,1,2
"13262","5ca9f9581cbd1aa8f8d9afd847ab74d7",61,55,16,26.6875,61,0,1,1
"13263","5caa12abad1184844ac45392972e8a7b",152,107,59,18.0338983050847,152,0,3,3
"13264","5caad90751973f75435bc0c056432a18",78,70,14,39,78,0,1,2
"13265","5cae0145d86a1b6a4e325f1cb381e9b4",42,42,0,42,42,0,1,2
"13266","5cafb9e9e7fa401a0717f1f92f642665",14,14,0,14,14,0,1,2
"13267","5cb17dcd570b5f9985c12954daa5957a",131,80,89,10.3033707865169,131,0,3,3
"13268","5cb1838afe08943639e937b4318fa7cc",50,49,21,16.6666666666667,50,0,2,1
"13269","5cb193c0e7a72217e936afa79205d410",112,101,48,16.3333333333333,80,32,3,3
"13270","5cb4a9666f7e261d9961522ef59d8cd7",15,15,0,15,0,15,1,2
"13271","5cb6e8b0d9e6ae76a7fc3a232fcf9fa6",8,8,0,8,8,0,1,2
"13272","5cba90267e17e7a63d1a565be7b80977",209,97,66,22.1666666666667,209,0,3,3
"13273","5cbc84288c0d84357e94225558d27543",67,50,36,13.0277777777778,67,0,2,1
"13274","5cbdba6673765b991e6499ad664d0580",7,7,0,7,7,0,1,2
"13275","5cbe900ed7a3f20b5ebc7e6741068cdb",25,25,0,25,25,0,1,2
"13276","5cc013c6d32e31c3d821f54b8024d1bb",40,40,0,40,0,40,1,2
"13277","5cc2c073b634b6f1a91c96bdb751ae25",155,96,75,14.4666666666667,155,0,3,3
"13278","5cc3c187222403b5b131ee429aa81c25",51,51,0,51,51,0,1,2
"13279","5cc643b1fa1ea29dd218ec89d4bb6ddc",23,23,0,23,0,23,1,2
"13280","5ccb16410f891bdb9549306811310f49",50,50,0,50,50,0,1,2
"13281","5ccc4ec9ccb0c58eb76d858a416cb5c1",44,44,0,44,0,44,1,2
"13282","5cce8167236b16a0688206e1017c2def",110,66,50,15.4,110,0,3,3
"13283","5ccf2d96cd19435b0e79a672576e050d",19,19,0,19,19,0,1,2
"13284","5cd22918b8b9c9b5c76b431da22116ae",30,30,0,30,30,0,1,2
"13285","5cd38e18426c4b13d225823e78bc5f73",214,106,79,18.9620253164557,214,0,3,3
"13286","5cd4d6c21ab1af07455b6f8bdd459f9a",110,83,83,9.27710843373494,110,0,3,3
"13287","5cd52724945952040767c25e548d5109",69,57,18,26.8333333333333,69,0,1,2
"13288","5cd6fb1600217a2be7feb5cc0ca30c39",23,23,0,23,23,0,1,2
"13289","5cd771ea2e1367e531bef4d30c8d6f84",28,28,0,28,28,0,1,2
"13290","5cd93bb4d49bdc37f4305af33e3127f8",64,53,9,49.7777777777778,64,0,1,2
"13291","5cd999f31c123a9ec106635fb48a1ce9",84,55,47,12.5106382978723,84,0,2,3
"13292","5cd9b152ef747c140db38054fae001e7",95,65,33,20.1515151515152,95,0,2,3
"13293","5cda31280e12354be569c57f1b3a57fc",249,94,46,37.8913043478261,198,51,3,3
"13294","5cdd812621ffe85c22091f26c1373b66",185,88,69,18.768115942029,185,0,3,3
"13295","5cdd95fbc5e5048d6cbd014c4d0566e9",28,28,0,28,0,28,1,2
"13296","5cdf158035ad9ee18dc3893a991a270b",183,91,60,21.35,183,0,3,3
"13297","5ce12a06e32c33d08b11ae8f4673871b",27,26,32,5.90625,15,12,2,1
"13298","5ce49f40536d7ab6f9052d2661a36af1",36,36,0,36,36,0,1,2
"13299","5ce725bd16ad1dcf2751710acdf0ea1e",172,93,70,17.2,172,0,3,3
"13300","5ce842e465a02fa8e698f82fd3484c4a",34,14,86,2.76744186046512,27,7,2,1
"13301","5ce9ee308e486e11611b0b4acccac749",163,58,75,15.2133333333333,163,0,3,3
"13302","5ced255a737f2222e922072eaabf4fab",54,54,0,54,54,0,1,2
"13303","5ced43d00782a100cc8816fd2ab2bf5b",47,42,47,7,37,10,2,1
"13304","5cee7e46ddddd561ec4183488ce67845",99,76,30,23.1,99,0,3,3
"13305","5cef03f093ec5068781274d5f3ef105b",5,5,0,5,5,0,1,2
"13306","5cf062ef49c9d8999f1cb4d96211fa85",138,99,75,12.88,138,0,3,3
"13307","5cf068ebeb8eb33b0d2f5ca6b7d1bba9",46,46,0,46,46,0,1,2
"13308","5cf2e7cc2e2186a55f9ea66de623e62c",128,78,60,14.9333333333333,97,31,3,1
"13309","5cf6083cc6826f3122ba31d4487ae137",13,13,0,13,13,0,1,2
"13310","5cf70b28aff478ca0bab07e8507566f4",6,6,0,6,6,0,1,2
"13311","5cf940a27b4364e4492677c11ea46de8",14,14,0,14,14,0,1,2
"13312","5cfabfd4c8adb53e3a3f4a0444a81bfc",142,95,56,17.75,142,0,3,3
"13313","5cfbf7966fcec5a92f342fed12bf021b",50,29,62,5.64516129032258,33,17,2,1
"13314","5cfc2e58a2bf2c2b94bf6a8c7d09abb2",100,52,90,7.77777777777778,100,0,2,3
"13315","5cfea36f41ab952567272e6a446078e8",19,19,0,19,19,0,1,2
"13316","5cfedb7abd99a3af81759425331fe240",60,52,28,15,60,0,2,1
"13317","5cfef18e9dfc0df0b0e21d3a2fb0f835",59,57,23,17.9565217391304,23,36,2,1
"13318","5d003b111cef39c071943977513a4cc0",16,16,0,16,0,16,1,2
"13319","5d0285ae1e05c23b2c575afbdeb4a9f5",107,76,79,9.48101265822785,85,22,3,1
"13320","5d0358b701f336848d251b8bd224cd2b",25,25,0,25,25,0,1,2
"13321","5d06ed9ee7e605985ac8bee36e231301",53,53,0,53,53,0,1,2
"13322","5d0788c8857f00b5c603e4fabac29855",127,100,27,32.9259259259259,127,0,3,3
"13323","5d07cd2556cd1adcbfdbf00d0c4fc7d7",84,56,55,10.6909090909091,53,31,2,1
"13324","5d0adb9b597c548067580d8a92cf053d",34,34,0,34,0,34,1,2
"13325","5d0b9e11cdff8f76cc6a609e7f954ee7",85,76,42,14.1666666666667,85,0,2,3
"13326","5d0dd4b71db41e3c9eb5d33174bc8691",33,33,0,33,33,0,1,2
"13327","5d0fb859cbbf9940c445cfa4c2f10c7f",14,6,50,1.96,14,0,2,1
"13328","5d14f3662d43433d49b143be2a5edf46",52,52,0,52,52,0,1,2
"13329","5d1622a56f2096b9dd4c97b10c8da5fe",62,53,57,7.6140350877193,62,0,2,1
"13330","5d1909288df3cbcc59155858d8a63499",65,44,57,7.98245614035088,65,0,2,1
"13331","5d19cfb43f6cf63bf50059ceb5b953ba",7,6,18,2.72222222222222,7,0,1,1
"13332","5d1cd9af1caa6c306dc2b790890bc320",24,21,28,6,0,24,2,1
"13333","5d1e216754994182884441b713b7bba0",9,9,0,9,9,0,1,2
"13334","5d225e690ade721682fe1a3fcb0973f6",14,14,0,14,14,0,1,2
"13335","5d2d1d9ac98bf5544af355a3023e119a",56,38,55,7.12727272727273,56,0,2,1
"13336","5d2d8dda065ac8486c76dad120ebdc2a",106,69,84,8.83333333333333,106,0,3,3
"13337","5d30e8ab5b130b786c8385755c411f0c",161,75,38,29.6578947368421,125,36,3,3
"13338","5d3311b181dd651583785ac70a214798",79,67,65,8.50769230769231,79,0,2,3
"13339","5d33fbf1d1ec1714201414277a6dacfa",104,83,84,8.66666666666667,92,12,3,1
"13340","5d344c07850bf81a278aabe07c911f94",36,36,0,36,36,0,1,2
"13341","5d3847e5d5948529e98ce02eed309e69",55,39,53,7.26415094339623,31,24,2,1
"13342","5d3a63232c2292b7856e8012e6b7c54f",115,66,75,10.7333333333333,115,0,3,3
"13343","5d3b14de9de85f760c08cf86377efe07",77,66,35,15.4,77,0,2,3
"13344","5d3c2fad241511cd253406d59c8b6faa",50,50,0,50,0,50,1,2
"13345","5d3ea8da7d906f7131c0803eead04f54",2,2,0,2,2,0,1,2
"13346","5d3ff7358a5e9d30b584c661b957b75a",32,32,0,32,32,0,1,2
"13347","5d403eb8f6c4cdb09f2afe9f809af832",12,12,0,12,12,0,1,2
"13348","5d414f427e6233091f66146d2ada4bd2",111,56,72,10.7916666666667,111,0,2,3
"13349","5d41ef6ea07042c92658fddc41f0ff45",42,42,0,42,42,0,1,2
"13350","5d42357aead07717119ddecd3a371652",14,14,0,14,14,0,1,2
"13351","5d445708d6327a0cee74e00a553b3a81",204,100,78,18.3076923076923,204,0,3,3
"13352","5d445a2bea5e40bacc1a76054013f4ee",56,52,24,16.3333333333333,28,28,2,1
"13353","5d44764923bb62ccf822979e44518718",10,10,0,10,10,0,1,2
"13354","5d44797cae4998a269936e5ef906983c",186,113,73,17.8356164383562,151,35,3,3
"13355","5d44b201530b47a1e53df0a54acdb532",3,3,0,3,3,0,1,2
"13356","5d44e40e853f7fd96324f33ef46c1d6e",54,54,0,54,54,0,1,2
"13357","5d45fad84325b0bc78aade48ae9cb105",30,30,0,30,30,0,1,2
"13358","5d491e2c4054d0d6d34f4d5f2b4615de",34,30,42,5.66666666666667,34,0,2,1
"13359","5d4a65aad6a147a5140f32e8b6927856",14,14,0,14,0,14,1,2
"13360","5d4a89edc34acdf2b861e2c9bde329cd",61,55,24,17.7916666666667,61,0,2,1
"13361","5d4b5649cfed13ad5e9c88e1626299ee",73,52,59,8.66101694915254,47,26,2,1
"13362","5d4ef5dd4eda1eb71b24c446819cb330",15,15,0,15,15,0,1,2
"13363","5d4f046a921452d1d7dfbf30777a7f51",35,35,0,35,35,0,1,2
"13364","5d4fb54638bfe75336cebefe0f0a2e8e",23,23,0,23,23,0,1,2
"13365","5d538fb18ef3f26ad6fcc1c1a3b61bbf",15,15,0,15,15,0,1,2
"13366","5d568bf9e237fd096f48ddf87e118ff0",21,21,0,21,21,0,1,2
"13367","5d56dfc3e6aa9a0b53984778ae204fe8",31,28,17,12.7647058823529,12,19,1,1
"13368","5d587b65f4681a0705a5dd612113a630",23,23,0,23,23,0,1,2
"13369","5d5b94cfe09f4f5b222539b68f70c8e6",108,77,75,10.08,108,0,3,3
"13370","5d5ba57badc6ce641c329c18c21da237",109,75,65,11.7384615384615,109,0,3,3
"13371","5d5f08f6224f6444cbc2042a1cb95f8b",34,34,0,34,34,0,1,2
"13372","5d610a1625c744c701dcd5bb7c88f692",85,63,27,22.037037037037,85,0,2,3
"13373","5d611bad2af32a3b7705e6eff3fababd",83,65,30,19.3666666666667,52,31,2,3
"13374","5d6229ea523ebdec07b0c9bf70c9adb9",10,10,0,10,10,0,1,2
"13375","5d6318a9a982956fa287f6066e9580c3",60,49,35,12,60,0,2,1
"13376","5d6365ce377acf921c5e2f1ed92b7b12",82,61,19,30.2105263157895,38,44,1,1
"13377","5d648ddb11b4f58d2e6cb761c6b26b1f",49,49,0,49,49,0,1,2
"13378","5d66820a1c1cc023006b108cc0f17a54",60,38,49,8.57142857142857,10,50,2,1
"13379","5d6819a4981e6493fa9773e5c70cd2f7",99,23,84,8.25,99,0,2,1
"13380","5d728407ccde346d615065f6c8d7a3fd",178,110,52,23.9615384615385,178,0,3,3
"13381","5d73a1f42c580067deaa2194ead9c57a",27,27,0,27,27,0,1,2
"13382","5d74427ebad7e3f003714bd31e132ce6",36,36,0,36,36,0,1,2
"13383","5d76af61e34f0dac83b688069a211dda",81,63,26,21.8076923076923,81,0,2,3
"13384","5d76b9a2e6cca0b5bd83f45c9e29b0bc",107,51,71,10.5492957746479,56,51,2,3
"13385","5d77c69e9b942ac9cac72a0e2fb5cfd4",29,29,0,29,0,29,1,2
"13386","5d7cf020bad34266f247880fc726f33f",51,51,0,51,51,0,1,2
"13387","5d81b3bfea52615d11fb6c964e3290b9",21,21,0,21,0,21,1,2
"13388","5d841e5d77778f66845a3d73a48266d2",70,33,77,6.36363636363636,70,0,2,1
"13389","5d84477a5722d9ff8208b55574955407",44,44,0,44,0,44,1,2
"13390","5d84aa52ca36b9523a89632b11ca71e9",34,34,0,34,34,0,1,2
"13391","5d864c4066ac4078a026c6211007a18c",105,83,34,21.6176470588235,105,0,3,3
"13392","5d8867808afbf69a6caa3fdd97c5797c",113,71,61,12.9672131147541,113,0,3,3
"13393","5d8a64e8a88868c8d2849c011cee71ab",31,31,0,31,31,0,1,2
"13394","5d8ae718846efc94f01532d814be3db9",76,56,44,12.0909090909091,76,0,2,3
"13395","5d8b524880293b3bda90eae8c1414fda",114,79,57,14,92,22,3,1
"13396","5d8ca17a56a1942dadf81e8aa53c2bf2",51,44,13,27.4615384615385,19,32,1,1
"13397","5d8f0c2c4eaf4901616dc49287025f6c",19,19,0,19,19,0,1,2
"13398","5d90d97b3f6d33eb6555aa7d23fcbf89",216,127,68,22.2352941176471,216,0,3,3
"13399","5d973884844e2bcaec5c8367fe165ea7",25,14,53,3.30188679245283,25,0,2,1
"13400","5d9df6c97f9eef4cfabedc38a35f3f8c",17,17,0,17,17,0,1,2
"13401","5d9f32bba2300cbcb946dd1bdd55cfd6",66,63,72,6.41666666666667,66,0,2,3
"13402","5d9f49e3d0c616702479028e54d8ad95",27,27,0,27,27,0,1,2
"13403","5d9ffe91ee0e26649e00029d3adcffe6",9,9,0,9,0,9,1,2
"13404","5da13ae0568cc1996057d077effa9f6a",51,51,0,51,51,0,1,2
"13405","5da2795c679b59599071c1ddf0655393",22,16,35,4.4,22,0,2,1
"13406","5da38527a76286267119adc101125a52",93,37,62,10.5,83,10,2,1
"13407","5da4f2a58250a926187ccfb70464e076",69,46,57,8.47368421052632,69,0,2,3
"13408","5da75aa304f6826224cadad7bab78720",130,61,50,18.2,130,0,3,3
"13409","5dabcb13a4115ba3192eb523ced15884",58,39,69,5.88405797101449,46,12,2,1
"13410","5dad5fcbdedb4bdfd516890475bc9829",178,80,69,18.0579710144928,146,32,3,3
"13411","5dafbcba5d05ffebd46ec3c352e20b8f",43,43,0,43,43,0,1,2
"13412","5db09537def995f395c4153115bbf3d0",11,11,0,11,11,0,1,2
"13413","5db376529ac3351c58d412c78899bea2",31,31,0,31,31,0,1,2
"13414","5db558ae743ba836d2ca0ea0a9eae881",94,73,56,11.75,94,0,2,3
"13415","5db5ef94a4b22150fd009fa358438484",26,26,0,26,26,0,1,2
"13416","5db6e783a21d677b958ab9d270eac830",18,18,0,18,18,0,1,2
"13417","5db855f8df842760ff4750dc82e36bc4",30,30,0,30,30,0,1,2
"13418","5db8811c6e693466dc437af5fb14c299",27,27,0,27,27,0,1,2
"13419","5dbaead4089a834dc69df786def7493c",104,65,88,8.27272727272727,104,0,3,3
"13420","5dbb67438c6d4fe4a772dc4969cd7fb7",23,18,57,2.82456140350877,23,0,2,1
"13421","5dbbbec1197fdaac4e604f2411a26a12",31,31,0,31,31,0,1,2
"13422","5dbe3de6a3b4c23c67ccb7312d9e0a45",52,39,46,7.91304347826087,52,0,2,1
"13423","5dbeb679d59435f5e7c91eb5c58e6587",25,25,0,25,25,0,1,2
"13424","5dbfce2cc239a7956d2f82f7e75debe5",37,37,0,37,37,0,1,2
"13425","5dc0bfd8a2c00637e2fdc03eba3da842",81,66,42,13.5,81,0,2,3
"13426","5dc7272c3206772933d7797e3e921551",1,1,0,1,1,0,1,2
"13427","5dcaa3dc662ba14c109b7df1dc0935d0",164,120,62,18.5161290322581,164,0,3,3
"13428","5dcc63c67fbc2cc03cbd50c239c83605",33,33,0,33,33,0,1,2
"13429","5dcdb46f589f67e699f85c5f59c50bc1",27,27,0,27,27,0,1,2
"13430","5dcdd290ef5b70987cf78860b89fc35c",150,83,74,14.1891891891892,150,0,3,3
"13431","5dce747270586f93aef598430ef7742b",142,64,81,12.2716049382716,142,0,3,3
"13432","5dcf5e340d00c085151c06c944b8d4f8",30,30,0,30,30,0,1,2
"13433","5dd49b0d1a3739a20bc3cffba6723abf",29,29,0,29,29,0,1,2
"13434","5dd5831dabef5b506652dfa6b0ea3d27",21,21,0,21,21,0,1,2
"13435","5dd7364811add95ccf045d70c320a902",112,57,72,10.8888888888889,101,11,2,1
"13436","5dd79a949cf89b6ff3870b77d80210bd",35,35,0,35,0,35,1,2
"13437","5ddabf82f82080eabde30bf952c84ee0",43,43,0,43,43,0,1,2
"13438","5dde0016f5cfed78dae811e289be9dd5",55,43,42,9.16666666666667,55,0,2,1
"13439","5dde6a771376ee0aede132c094850cc2",13,13,0,13,13,0,1,2
"13440","5ddf0746870ab85ca5f8669045633b39",148,94,74,14,148,0,3,3
"13441","5ddf62d176e2cc8c9ca2588225a8f7d5",122,84,61,14,86,36,3,3
"13442","5de23483dd9f54670ad92fd888c5354f",17,17,0,17,17,0,1,2
"13443","5de363c3dbc9c98cc2795cf6d2956ad8",136,91,78,12.2051282051282,136,0,3,3
"13444","5de8e17be34ee2b11161c3cd6601cd7f",103,66,40,18.025,103,0,3,3
"13445","5de9754ae03718eb0e7681f86aaba69a",64,44,59,7.59322033898305,39,25,2,1
"13446","5df3816ee88954424ef9437dba74c21d",40,33,36,7.77777777777778,40,0,2,1
"13447","5df3c779b0c0b6c7b4b77142c30c32ce",29,29,0,29,0,29,1,2
"13448","5dfe5d647e8dabedbfc5878af8defd5b",20,20,0,20,20,0,1,2
"13449","5dfeceed9644da31c7cff12a29dcb4ef",31,31,0,31,31,0,1,2
"13450","5e032adff609cafd3501a2878561dc0c",10,10,0,10,10,0,1,2
"13451","5e0867a5708cedafd2fcb94e00dc0e86",4,4,0,4,4,0,1,2
"13452","5e0d0c020dc841e74c596f22e0580e77",63,47,36,12.25,63,0,2,1
"13453","5e0e0a11b420ff13896363e97bcc9e87",116,87,44,18.4545454545455,116,0,3,3
"13454","5e0e91be2093a75baa70014a97bd34f2",29,29,0,29,0,29,1,2
"13455","5e105c8874507d48d9d0d920f63af915",21,21,0,21,21,0,1,2
"13456","5e109b9c0cbe7d0c97570e3de6790440",72,62,23,21.9130434782609,30,42,2,1
"13457","5e10d562147b78bb9c5398eecc31c47d",19,19,0,19,19,0,1,2
"13458","5e1117002c251a8de2751b99d0c3703e",152,84,69,15.4202898550725,152,0,3,3
"13459","5e16b80604e710447d326642dd37c9e3",4,4,0,4,0,4,1,2
"13460","5e175cf50bcbdb04bd13c1742137b9da",38,31,7,38,38,0,1,2
"13461","5e194170f1cc471250ed7529a932ef7d",11,11,0,11,11,0,1,2
"13462","5e2012e6dca41a084d8e4cc8d8da24bf",31,31,0,31,31,0,1,2
"13463","5e2339226c2da70523202797b41c3623",167,86,49,23.8571428571429,167,0,3,3
"13464","5e26445a442c76d869f1e46fd57d2807",133,89,45,20.6888888888889,133,0,3,3
"13465","5e26c18f38c90bd69d20b272dbc7b41f",54,46,21,18,54,0,2,1
"13466","5e2a2e0d3ed3277dcbedc2bcb9131251",9,9,0,9,9,0,1,2
"13467","5e2a332731354f5e128f168da8cfb30c",203,119,69,20.5942028985507,203,0,3,3
"13468","5e2af699eb7c00ef5edeadd181401f93",47,32,57,5.7719298245614,23,24,2,1
"13469","5e2b1115081e9ad254639f384acb7844",83,63,41,14.1707317073171,42,41,2,1
"13470","5e2be51337fd699a1ed51c466cd53f31",49,38,70,4.9,49,0,2,1
"13471","5e30b7a540c4fa0e7320b1dedecc7959",69,25,79,6.11392405063291,69,0,2,1
"13472","5e3161ac96dc9d87f94d61d27cfcfc53",22,22,0,22,22,0,1,2
"13473","5e36db54d5f600a2755c5ff5e258b4e2",22,21,44,3.5,10,12,2,1
"13474","5e37a2f7c20c6512c3fe8db6befa6ff2",113,86,39,20.2820512820513,113,0,3,3
"13475","5e3b943b6782fe6a2f781b1704e038a9",5,5,0,5,5,0,1,2
"13476","5e3eb8243817a0f1b2b906ec5bdb1608",60,45,58,7.24137931034483,60,0,2,1
"13477","5e402566498b8f276faee25f3de62daa",55,50,28,13.75,55,0,2,1
"13478","5e41edd23ce2b2a2579f41ac1fd483fc",9,9,0,9,0,9,1,2
"13479","5e43dd7498f9eb643641d522da2ce829",35,35,0,35,35,0,1,2
"13480","5e462e31b2ed2c14f007a903e436bafa",47,46,12,27.4166666666667,1,46,1,1
"13481","5e466bc3a60c4c5e52f7af0b98ebd9f6",110,74,76,10.1315789473684,110,0,3,3
"13482","5e47098b33af7ac88d72fdd2dbf77a30",25,25,0,25,25,0,1,2
"13483","5e470a4616ae1c0f075dcc85ddfdcd85",94,71,42,15.6666666666667,94,0,2,3
"13484","5e476b5109d6e543cbb576fd94fc74fc",36,36,0,36,36,0,1,2
"13485","5e477b64c03de7b4a9d1d255a4d46dd1",104,76,30,24.2666666666667,104,0,3,3
"13486","5e48044ea5b712ff1f4d6a0d084b5b3b",65,48,42,10.8333333333333,65,0,2,3
"13487","5e49f8fd402aa61ccfba3e2bc53d0349",17,17,0,17,17,0,1,2
"13488","5e4a5ca46b0316b2b73bd47b48c57555",25,25,0,25,25,0,1,2
"13489","5e4abde9ee9060c9c4f3900264971eb4",40,39,22,12.7272727272727,40,0,2,1
"13490","5e4c7aac6f42a12138bbb97fe86596fd",199,118,71,19.6197183098592,158,41,3,3
"13491","5e4de1b311678606cec6a8873fc066de",24,24,0,24,24,0,1,2
"13492","5e4f1125a3bf28ccf8f57d725b54a5b5",10,10,0,10,10,0,1,2
"13493","5e5076d56d5b3ea8c5b1879cc4bbe160",109,61,61,12.5081967213115,109,0,3,3
"13494","5e514d0099916ed42101b07c48447cce",5,5,0,5,0,5,1,2
"13495","5e517884d5855bd3d3dc2ad578d46af0",168,80,73,16.1095890410959,143,25,3,3
"13496","5e52dc27574177d509abf976ba5e4baf",71,60,19,26.1578947368421,71,0,1,2
"13497","5e587bba51e5a190573ba2e89e939975",34,34,0,34,0,34,1,2
"13498","5e5b288f677379fad98e25d0f1799e54",197,77,83,16.6144578313253,184,13,3,3
"13499","5e5b46254c360924433686f1c04bf759",48,48,0,48,48,0,1,2
"13500","5e5c74f2c4442ad4ce38e29e9932a833",76,67,55,9.67272727272727,76,0,2,3
"13501","5e5e4e73762c7386f96b389614d9bdcb",9,9,0,9,9,0,1,2
"13502","5e5e73dfcf3ef79e58888d21661db8a9",5,5,0,5,5,0,1,2
"13503","5e5fe54dbf1e7f5a941199f8fe972287",35,29,30,8.16666666666667,35,0,2,1
"13504","5e603f811ee1772062d69c4a5b30d8ab",62,47,31,14,62,0,2,1
"13505","5e627a8168420f3782b49ccfc1214c86",35,35,0,35,35,0,1,2
"13506","5e6333bdec1d714c4dd71963cb3ec723",38,38,0,38,38,0,1,2
"13507","5e687eac1b091409c0f81df816db019b",32,32,0,32,32,0,1,2
"13508","5e6a73fea54f9d55850bd03a338618dc",3,3,0,3,3,0,1,2
"13509","5e6e918175aab5a66e31ae5076145b2e",7,7,0,7,7,0,1,2
"13510","5e6f6714179d5f58a42cf2a4a02e0f55",68,50,32,14.875,68,0,2,1
"13511","5e70dc5b1daf0b509cd0e01ec79dd65e",19,19,0,19,19,0,1,2
"13512","5e716027512dcf252c20df096fc3a4c9",124,69,59,14.7118644067797,124,0,3,3
"13513","5e71ab048cfd8329d941c8792927710a",19,19,0,19,19,0,1,2
"13514","5e75ec09928a6aa4049492bc0cf05116",111,76,35,22.2,111,0,3,3
"13515","5e7b552bfd56a60ac32fd45e03f60334",108,81,64,11.8125,108,0,3,3
"13516","5e7c4643c63fbc547ff1384e9be84034",6,6,0,6,6,0,1,2
"13517","5e7e925f9360e1e5a56ac3d5f4c3798e",50,50,0,50,50,0,1,2
"13518","5e7ea983e99da24599e443ec02485f13",57,51,58,6.87931034482759,57,0,2,1
"13519","5e7f04ef5cb08787f40c25ae0f7bea87",2,2,0,2,2,0,1,2
"13520","5e7f30b2b37e4327252be470c261fc56",14,14,0,14,0,14,1,2
"13521","5e8112f08610fc243f7cc41f3acb0f69",123,96,31,27.7741935483871,123,0,3,3
"13522","5e81f9c4eacb9101dc5b31fc6ff5c727",91,57,14,45.5,91,0,1,2
"13523","5e84d20f1050f2b4f9507cc53297ba2c",83,53,74,7.85135135135135,57,26,2,1
"13524","5e857ff7b393c27e331cd2cad32c7ebc",31,31,0,31,31,0,1,2
"13525","5e867a53f2573763ec85b857f4d6578d",54,36,42,9,0,54,2,1
"13526","5e877a6649a6ca36bd5fdab0c21e2bf0",98,70,55,12.4727272727273,98,0,2,3
"13527","5e8802a05d061c376b2ede18e7edc8a2",32,32,0,32,32,0,1,2
"13528","5e8a3f2dc34e8eb719643076b681be8f",151,115,84,12.5833333333333,151,0,3,3
"13529","5e8bfe607a440b7c48f8ef965af7a193",42,36,56,5.25,2,40,2,1
"13530","5e8edda3dac76065c2af4983fb8de42d",29,29,0,29,29,0,1,2
"13531","5e90c974bf433344961b5529f28a3299",19,11,45,2.95555555555556,19,0,2,1
"13532","5e915a49c7495e9bab61e9e99ec46054",72,58,9,56,72,0,1,2
"13533","5e92bfa458f1f55c1127bfafd95c1cc4",33,33,0,33,33,0,1,2
"13534","5e9958ead32ebf9d53fe1abb828568ed",73,48,56,9.125,73,0,2,3
"13535","5ea32a1578e5694bd491e22389bab86f",221,121,84,18.4166666666667,166,55,3,3
"13536","5ea6245dfae1c45bfcdf7491d9e572a5",92,70,77,8.36363636363636,92,0,2,3
"13537","5ea95035f4bce988014b5a4f51feca7c",55,55,0,55,55,0,1,2
"13538","5eac545e1f70e8129fdd9291cccff1a4",22,22,0,22,0,22,1,2
"13539","5eacbf25ebee8367b8fe4a8e39a8b251",13,13,0,13,13,0,1,2
"13540","5eacbf95d9bb905b9a97a14885c1eb58",201,101,79,17.8101265822785,201,0,3,3
"13541","5eae4a4732fb7d683a13d8e529c0af22",16,16,0,16,16,0,1,2
"13542","5eb169d78741028ef56544072a56cd3d",43,43,0,43,43,0,1,2
"13543","5eb3bf6c3bf6eb563dedcd3c91803d73",68,58,74,6.43243243243243,68,0,2,3
"13544","5eb4bdb626c14e9209bebae4e74ab08e",60,46,47,8.93617021276596,60,0,2,1
"13545","5eb68c3e508eaa5bdbf1c8a9e4d7e5e1",66,49,47,9.82978723404255,66,0,2,3
"13546","5eb6c52e0807d1aaf93ab548b57d2876",57,47,16,24.9375,57,0,1,1
"13547","5eb74be66b0176f38a7a0a479a952a92",20,20,0,20,20,0,1,2
"13548","5eb8a5c17192233b7bafc73ac53ce30f",38,36,57,4.66666666666667,38,0,2,1
"13549","5eba7754952563eb43999178f80efff6",28,27,6,32.6666666666667,28,0,1,2
"13550","5ebb5063b63afe7b0b47ce7dfce13a70",5,5,29,1.20689655172414,1,4,2,1
"13551","5ebc1c226598492409369c99dc597c2f",184,102,81,15.9012345679012,149,35,3,3
"13552","5ebde9825a0ccaaeea129759cb1d24ed",13,13,0,13,13,0,1,2
"13553","5ebe4d3e639e82ffc074d8e31f4de062",194,110,70,19.4,194,0,3,3
"13554","5ebf89764e6e87d7a4755aede689137f",42,42,0,42,42,0,1,2
"13555","5ec16d632b2bad5bc5d2bbf0d181e4f1",105,57,81,9.07407407407407,105,0,2,3
"13556","5ec55ce622bb1cbd96df8ec1cc56903f",5,5,0,5,5,0,1,2
"13557","5ec57632cd3c8002d2b7d1045e123cd3",80,61,60,9.33333333333333,80,0,2,3
"13558","5ec58a3bd614832200c3e385279ae539",68,52,84,5.66666666666667,52,16,2,1
"13559","5ec7b02cccd0229596f82ea93b4f7e2b",47,47,0,47,47,0,1,2
"13560","5ecd710518f1655e13dd76fa250cab41",167,133,61,19.1639344262295,167,0,3,3
"13561","5ed3437a0e91b8bfb6ad1c3a25907b6d",30,30,0,30,30,0,1,2
"13562","5ed690a31fcfcdc6fa33354a0a79119e",25,25,0,25,25,0,1,2
"13563","5ed7b149f84c21d100ddfff5981423bc",52,52,0,52,52,0,1,2
"13564","5edf79d75caa1ee75e1d6dc66dfb849a",48,37,19,17.6842105263158,48,0,1,1
"13565","5ee1fe3a838b0096b136e03aca5e3506",188,124,74,17.7837837837838,188,0,3,3
"13566","5ee206be8946b211b72a3b743b91f0c5",45,45,0,45,45,0,1,2
"13567","5eea9fcd9296f9e94c342dc3e6ffd6cd",41,28,65,4.41538461538461,41,0,2,1
"13568","5eeab726cd90272130ebf2bc1ebb3722",40,40,0,40,0,40,1,2
"13569","5eed86920e300d130cdaf721a35d96c2",153,82,82,13.0609756097561,153,0,3,3
"13570","5ef38d6b5a67583970f13eef0d21f8d0",18,18,0,18,18,0,1,2
"13571","5ef4a20ebad64401ab145f4bc7214b5d",160,99,49,22.8571428571429,131,29,3,3
"13572","5ef4d606e24812c2ab7e4b5a25d63a8c",159,82,74,15.0405405405405,113,46,3,3
"13573","5efd72bcce979544a6bd7037f658e858",9,9,0,9,9,0,1,2
"13574","5efe99c45fad855bfc0d0ecb1caed952",39,37,48,5.6875,39,0,2,1
"13575","5f005c56d67251c1082743b40af6fcdd",45,41,43,7.32558139534884,21,24,2,1
"13576","5f012c037c14f3a54e3e4360a82dae0d",34,34,0,34,34,0,1,2
"13577","5f0837e295cf7994619010f525c80e05",44,44,0,44,44,0,1,2
"13578","5f0891f291ebf6e8b4a96ce107889205",33,33,0,33,33,0,1,2
"13579","5f09009c88e79385c24a886af823d857",167,103,64,18.265625,125,42,3,3
"13580","5f0ce98abefd14c99075fe0fd6c0afe5",71,58,19,26.1578947368421,71,0,1,2
"13581","5f0f9deb657f5eb98a8a12f083e08240",36,36,0,36,36,0,1,2
"13582","5f10e9a3b1a0b74838b363d016e13ad8",5,5,0,5,5,0,1,2
"13583","5f15fe4d9b9e5aff4b2a352fe2dbf3e6",1,1,0,1,1,0,1,2
"13584","5f183ff2566c833c0d67acf0945acbeb",108,77,37,20.4324324324324,108,0,3,3
"13585","5f18cac9696db0999fa7ab05e86eea38",264,131,82,22.5365853658537,213,51,3,3
"13586","5f1bcd2d0e677494fb184a7bf55b14b1",108,85,77,9.81818181818182,108,0,3,3
"13587","5f1c5c65c1d48a15e5beceb20c4370d3",49,46,63,5.44444444444444,49,0,2,1
"13588","5f1c7d82c3d884f74cb84fe19e753b1d",33,33,0,33,33,0,1,2
"13589","5f1cd290a76bf4948aac71d72f74a729",34,34,0,34,34,0,1,2
"13590","5f1ede2c971a0bcfb1ee97ac1e29d20d",31,30,5,43.4,31,0,1,2
"13591","5f208b629fb65369e2286e8c48203118",35,23,54,4.53703703703704,35,0,2,1
"13592","5f237a86a6fc3ef5f2387eeda6c03bb6",40,40,0,40,40,0,1,2
"13593","5f248f845b5b236c2432d5448281b3eb",29,29,0,29,29,0,1,2
"13594","5f268aa99ead519461ed3dd4e431fa58",14,14,0,14,14,0,1,2
"13595","5f282b365945792956280aa68780d90e",1,1,0,1,1,0,1,2
"13596","5f29eeabb5da06daffec8b83e7ebc5fa",124,82,65,13.3538461538462,124,0,3,3
"13597","5f2b13ac631bf2eb0849bfe6d869ec11",104,80,54,13.4814814814815,104,0,3,3
"13598","5f2bcd2da21c4998f95d963e2598e92a",24,24,0,24,24,0,1,2
"13599","5f2c9fcaf054e00368f45a974ac76950",180,86,77,16.3636363636364,180,0,3,3
"13600","5f30b96eb3c109856e509ed3959c74ee",23,23,0,23,23,0,1,2
"13601","5f30faf051f01af5255f40047afc49f0",66,46,42,11,66,0,2,1
"13602","5f33e63912923d109d9ad1c9b38732b1",82,63,25,22.96,65,17,2,1
"13603","5f373f9630a75a501ae147baea90244b",28,28,0,28,28,0,1,2
"13604","5f378a5764f8d36c97e02180c69921e0",27,27,0,27,27,0,1,2
"13605","5f3b0577b3c62183d0df8c9c1255b16e",63,44,70,6.3,63,0,2,1
"13606","5f3d5e42ba07a45d5deacc32a2b99c63",22,22,0,22,22,0,1,2
"13607","5f3d9bcc1971ba2de650fa5cb609d0de",71,54,57,8.71929824561404,71,0,2,3
"13608","5f4079a5eb405b6d8dec5e1ecdb9e475",144,84,61,16.5245901639344,96,48,3,3
"13609","5f4192544862ac9cfec59c4f262c07f7",29,29,0,29,29,0,1,2
"13610","5f422a65cc0c49b393042c5cc14c4216",153,107,54,19.8333333333333,109,44,3,3
"13611","5f45777c11cb5c4c6d80eac42bc17821",54,54,0,54,54,0,1,2
"13612","5f458de13ce7faf02753aaf0e31c3947",29,29,0,29,29,0,1,2
"13613","5f45f54b5706873102b8307e87a4145d",49,49,0,49,49,0,1,2
"13614","5f4616267e436263938715a01e811d02",29,19,16,12.6875,13,16,1,1
"13615","5f5193fa056743d62cfead915814f26c",43,39,21,14.3333333333333,43,0,2,1
"13616","5f526cc57b8be0607d2526f8454d520e",24,24,0,24,24,0,1,2
"13617","5f548b17f49e1e6449e6f17c953924d6",104,63,48,15.1666666666667,74,30,2,1
"13618","5f552b99c2ccc78b98880ada2e681044",88,45,74,8.32432432432432,65,23,2,1
"13619","5f592fe421059b2cc39fe763b31a52b9",26,26,0,26,0,26,1,2
"13620","5f5b1390a5923c59d7be9f0d2e0bdfa3",13,10,30,3.03333333333333,13,0,2,1
"13621","5f5d7af53edc932543991564922a2953",13,12,3,30.3333333333333,13,0,1,2
"13622","5f5db6557637ae190cc49a98dc953ae3",22,22,0,22,0,22,1,2
"13623","5f6227d3912eef55bdaca48cdc92b7cd",22,22,0,22,22,0,1,2
"13624","5f6347280f191f164ebe3725eab674d1",31,31,0,31,31,0,1,2
"13625","5f64bf120165bb7beedcc9ce425dc30e",108,67,78,9.69230769230769,108,0,3,3
"13626","5f6b3671ae594a73ac0c8fbe573d9045",25,25,0,25,25,0,1,2
"13627","5f6c2d8050c29a824b93defdc5b26647",151,97,67,15.7761194029851,151,0,3,3
"13628","5f6d5941bd51d3393a5f957858831a08",96,56,22,30.5454545454545,96,0,1,2
"13629","5f6d5eae4abdc888ee4798e4a977a707",34,34,0,34,34,0,1,2
"13630","5f6e4993051a19845e2f3d75fd920f61",40,40,0,40,40,0,1,2
"13631","5f6fe9abc786b19b0337d6b22185db43",30,30,0,30,30,0,1,2
"13632","5f7138b28c0e94237bfd5ddd27399d2b",9,9,0,9,0,9,1,2
"13633","5f71881c65f1450a129b36ab45de896e",30,30,0,30,30,0,1,2
"13634","5f72ac652cdd9302c23e26ca40e07492",18,18,7,18,0,18,1,2
"13635","5f73acaec6d19585819f8d37b51546d4",26,26,0,26,26,0,1,2
"13636","5f754c6d1cdedc9e4509ea4d7a1c94c8",27,27,0,27,27,0,1,2
"13637","5f7563a3595d2c6a14c56c0d7ba98d7f",176,119,88,14,176,0,3,3
"13638","5f75abcd82ae421fc9534de7163044f2",102,87,46,15.5217391304348,102,0,3,3
"13639","5f76b1d58f3f699f37f126c053285269",59,50,28,14.75,59,0,2,1
"13640","5f7e03f53f792742f47750b2207107b3",23,22,18,8.94444444444444,23,0,1,1
"13641","5f7fc6d5d415542044f75bf030fe39d5",37,37,0,37,37,0,1,2
"13642","5f893c0f703b6ff410bd143b64a90e78",198,88,69,20.0869565217391,198,0,3,3
"13643","5f89b0bc29e5f1b6501881d7afe06f96",155,99,84,12.9166666666667,155,0,3,3
"13644","5f8ade3e0d159045252b1b41eb2665a1",42,38,17,17.2941176470588,42,0,1,1
"13645","5f8e469ac2c7a18645f8f6ed63f3c3b9",18,18,0,18,0,18,1,2
"13646","5f8e65ef1484783669b2ac53920aac6a",164,82,56,20.5,164,0,3,3
"13647","5f90cfabb1327b8b596a71ffb63b9c73",25,25,0,25,25,0,1,2
"13648","5f90e3390c91001d502028fd11a2eda9",107,80,62,12.0806451612903,107,0,3,3
"13649","5f923db8dd2f7b8b927cd3d4fd9591ee",147,68,73,14.0958904109589,122,25,3,3
"13650","5f92dd045542223590927e68e7f28fc0",41,32,24,11.9583333333333,41,0,2,1
"13651","5f93225e31193c94de09c225934a1a82",83,67,70,8.3,83,0,2,3
"13652","5f96ec0c2a4ab2eecb08ba6386ee921c",39,38,14,19.5,0,39,1,1
"13653","5f999ff2f77a5d47e4eb277438e7d716",57,49,27,14.7777777777778,57,0,2,1
"13654","5fa09b50c82316c8cc0bc0f494b3d075",145,71,51,19.9019607843137,117,28,3,3
"13655","5fa0fdeb4e4de9367819dc7964d34d26",28,28,0,28,0,28,1,2
"13656","5fa196dd12d367106cbf877bcb3626c7",100,56,61,11.4754098360656,79,21,2,1
"13657","5fa3726ebc5b7763f69c93af382f05c0",17,10,58,2.05172413793103,17,0,2,1
"13658","5fa42f71265976c59fdde74dce776c20",36,28,21,12,36,0,1,1
"13659","5fa6a39d90a7a74fd811af97a1d9e729",51,39,59,6.05084745762712,17,34,2,1
"13660","5fa7e47be701146f09ac00df5bdb787c",53,17,70,5.3,53,0,2,1
"13661","5fa81c88f0bc3fc3322b7f69f148c34b",8,8,0,8,8,0,1,2
"13662","5fa844c4c85a49e97067d02b45e52b7c",26,26,0,26,26,0,1,2
"13663","5fabdc2c9cec53465802bbf7be88713a",36,24,63,4,0,36,2,1
"13664","5faceb2997b8419bf51a5398d0f7060c",4,3,1,28,4,0,1,2
"13665","5fad8502bdf9281aa47d4f8fe8cf7751",124,71,42,20.6666666666667,124,0,3,3
"13666","5fae0ec801301ded42d8724b6ef4fa03",37,37,0,37,37,0,1,2
"13667","5fb11a8cdc806b7b0c42849727f2ae5e",76,67,50,10.64,76,0,2,3
"13668","5fb3d40c2eccadd1e6e3bbd3cb13ab99",39,39,0,39,39,0,1,2
"13669","5fb5169fc1481a2c6e0fd3bec76d4267",78,61,68,8.02941176470588,55,23,2,1
"13670","5fb519cdaba80486dab8ae69e2d7ff42",87,67,31,19.6451612903226,87,0,2,3
"13671","5fbb7ce834e132c9da0682e8ce2de280",68,50,87,5.47126436781609,43,25,2,1
"13672","5fbd72c7d49acba2c4068c5ce5862bec",39,39,0,39,0,39,1,2
"13673","5fbf2ce965380bffbac2956179a33fdb",70,55,38,12.8947368421053,70,0,2,3
"13674","5fbfa7d66df21b953c9ce3d7d74771bb",68,57,14,34,68,0,1,2
"13675","5fc2389ad7c20895659ecb8d8494da32",6,6,0,6,6,0,1,2
"13676","5fc46b093171ac5fe021f6da40a29929",35,24,78,3.14102564102564,28,7,2,1
"13677","5fc54923589f0a5e9e2f0b86d031173c",52,50,20,18.2,32,20,2,1
"13678","5fc54b43e9b7b001967b7697f5bcb95a",19,13,15,8.86666666666667,19,0,1,1
"13679","5fc54c6cdab1b35bade663f4bdf00b25",140,78,25,39.2,140,0,3,3
"13680","5fc7552179f0cd028874d2202fefef6f",49,49,0,49,0,49,1,2
"13681","5fc8ad3b7b7b11020ad2428f4f013f25",133,97,42,22.1666666666667,133,0,3,3
"13682","5fc9cdbe819b18333400f7966552bbb0",19,19,0,19,19,0,1,2
"13683","5fcad59df97d3aca25e41ad9158c4937",19,17,21,6.33333333333333,19,0,1,1
"13684","5fce11911d6535c9fe8e7991538a6b63",77,53,61,8.83606557377049,77,0,2,3
"13685","5fcefeac778fb5d4d5645eb5f459b1b3",40,31,32,8.75,40,0,2,1
"13686","5fd092f93f9e3ac485baa1c9ab0b1df1",26,26,0,26,0,26,1,2
"13687","5fd0bdbe9404d3273b5ed03fb4be06a4",20,20,0,20,20,0,1,2
"13688","5fd24e1cef4d318b7a7873e8d09d7f5c",8,6,15,3.73333333333333,8,0,1,1
"13689","5fd3d3b02b05fa6a7ae78bb411bc3626",48,48,0,48,48,0,1,2
"13690","5fd488d2d0377190af40fdd430c1041f",23,23,0,23,23,0,1,2
"13691","5fd72297cf4fc499c68a993273e0ab95",40,35,41,6.82926829268293,40,0,2,1
"13692","5fd8d038c76cedab8f8000467765d0ba",67,45,63,7.44444444444444,67,0,2,3
"13693","5fd96632138c4125b70c9163d53e8ce1",21,21,0,21,21,0,1,2
"13694","5fdbfbddf6e471571ea43e0b990a771e",89,64,65,9.58461538461538,89,0,2,3
"13695","5fdcf76da524bf65ae67678fa9f4b4b0",50,50,0,50,50,0,1,2
"13696","5fdd5a7962032cd01540eabe1adc76a8",29,27,14,14.5,29,0,1,1
"13697","5fddf54d3ffa63ef6863a5c4cb75270c",163,98,70,16.3,163,0,3,3
"13698","5fe66b34619130521a9271535a6b59d9",11,11,0,11,11,0,1,2
"13699","5fe7daa4d93ea3c614717c4b570b5f62",130,96,50,18.2,130,0,3,3
"13700","5feaf03b88c46d2bc53092e1253a4755",19,18,3,44.3333333333333,19,0,1,2
"13701","5fef028196a0acbd73aea7cf6125c0a4",195,93,84,16.25,172,23,3,3
"13702","5fef29516b38efd5322f222bb1b59d15",27,27,0,27,27,0,1,2
"13703","5fef619423cce7d3fa6dc620a8dbe6d5",5,2,75,0.466666666666667,5,0,2,1
"13704","5feff4fe34c4c2708426087361223f65",10,10,56,1.25,10,0,2,1
"13705","5ff317595f016164e46a27447ee3e9a9",56,47,20,19.6,56,0,1,1
"13706","5ff5628b33caa0bb56e7328fdc8cb068",36,36,0,36,36,0,1,2
"13707","5ff7b7fdcd476e56a28e494b7eb3a26c",51,29,71,5.02816901408451,15,36,2,1
"13708","5ffa04ddc43c9ab974118caae24dd2ae",77,63,29,18.5862068965517,77,0,2,1
"13709","5ffb402e369c158787abbe1c44c5ba5e",213,102,72,20.7083333333333,180,33,3,3
"13710","5ffbed560acde407440daf1a33d601b8",78,47,52,10.5,78,0,2,3
"13711","5ffd91dd055579c8fa84c0b59c600199",2,2,0,2,2,0,1,2
"13712","5fff0275d0bb5c04c62f8b9bc1d09d34",69,48,74,6.52702702702703,69,0,2,3
"13713","6000390550efcbe4db4cbfb696d55aa0",179,130,67,18.7014925373134,145,34,3,3
"13714","6000d194ed1caba0142085245958dc45",239,145,77,21.7272727272727,203,36,3,3
"13715","6001002cd618230a7057d356f87a0895",1,1,0,1,1,0,1,2
"13716","60017c18e434f22f75c54d5c0a3e5a28",31,31,0,31,31,0,1,2
"13717","60039d2a9aa651e9b572b6c71303ec67",101,89,47,15.0425531914894,101,0,3,3
"13718","6007aaf7d39a188483cf3fcc03a289d8",38,34,24,11.0833333333333,22,16,2,1
"13719","60087aed9edb6c92fb7fa178f20801f9",16,16,0,16,16,0,1,2
"13720","6009bd7132697235e57212b50af102f6",59,48,53,7.79245283018868,59,0,2,1
"13721","600a07e173858108ad9f08c168eb447d",69,53,36,13.4166666666667,69,0,2,1
"13722","600a3c3232f7910e9698e961347e5a0d",76,63,30,17.7333333333333,76,0,2,1
"13723","600ae823b18fa59180e9c14bb4d8cfcd",38,33,35,7.6,0,38,2,1
"13724","600b70317a7165734c55ff05e712df54",28,28,0,28,28,0,1,2
"13725","600c4212888e87cdd1f671ab85be377c",69,46,56,8.625,69,0,2,3
"13726","600d37893f18dca60562267f7ab4dcc9",29,29,0,29,0,29,1,2
"13727","600ee83c6c8cc751601bec3b45cdacf8",49,35,24,14.2916666666667,49,0,2,1
"13728","600ffc9e9c420be15fa0eab1c8970055",75,60,26,20.1923076923077,75,0,2,1
"13729","60109ab4c954b3bad03e0e7f2431cfb6",20,20,0,20,20,0,1,2
"13730","6014bfd0e89780b0ac30c24238406932",21,21,0,21,21,0,1,2
"13731","6016c1a76cbeccc983f02b03d80c6003",61,57,72,5.93055555555556,61,0,2,3
"13732","6018accf175834a5fe0ef6bce0f4e49e",17,17,0,17,17,0,1,2
"13733","601957954868a0028862eb3a5a3e07d4",54,54,0,54,54,0,1,2
"13734","6019a30d3c4b38e87e910d4a7e623195",204,88,82,17.4146341463415,179,25,3,3
"13735","6019e884e5bc0ba4e4eeb3a6f0ce5f2e",24,22,6,28,24,0,1,2
"13736","601a040389b29f8aee3485b3d2a9d9c3",8,8,0,8,8,0,1,2
"13737","601a79f7a0cf5c94473e96af541e2db1",3,3,0,3,3,0,1,2
"13738","601ce0e7e4170cf51c188df68150dda0",107,60,88,8.51136363636364,79,28,2,1
"13739","601e78a2bc4c13d8e639f42dd8ce5f0b",32,32,0,32,0,32,1,2
"13740","601fd67ae4048874227a37a436f8df23",19,19,0,19,0,19,1,2
"13741","602012a16c7af78b3c39e2276fde212a",67,55,25,18.76,67,0,2,1
"13742","6020eb62273b64da10c753992ca912fd",196,92,65,21.1076923076923,148,48,3,3
"13743","60223e11bec736537416f9eb556e591a",42,34,56,5.25,42,0,2,1
"13744","6022960d0c53f63093dddaf2c878481a",116,86,56,14.5,62,54,3,3
"13745","6023dd86fc68af0ff59f47f2a7b751e4",40,40,0,40,40,0,1,2
"13746","6025eede818caf232174f4a17924c6b6",33,33,0,33,33,0,1,2
"13747","60272d34273a532f5827b3f9da435675",260,142,63,28.8888888888889,216,44,3,3
"13748","602a282f2790cdd7c7a724f49b4a3d11",10,10,0,10,10,0,1,2
"13749","602a4ff10e757f0e6d932105bcefd371",36,36,0,36,36,0,1,2
"13750","602b7eb5d5aec4d6d7f4694465f0c220",16,16,0,16,0,16,1,2
"13751","603022d84e16532d8f25e5432e3366eb",47,43,28,11.75,47,0,2,1
"13752","603078123c3938c4448dd4b92d1531f8",136,99,54,17.6296296296296,89,47,3,3
"13753","603239d8b2b6edc89ef576f3ff0a1bc7",52,52,0,52,52,0,1,2
"13754","6032db1dfc817be2bb5d4103c9ac3bbf",28,28,0,28,28,0,1,2
"13755","603548542c97e8d911b4a25906438fb6",105,89,56,13.125,105,0,3,3
"13756","603650d849b9ed92765cf56edb24b111",20,20,0,20,20,0,1,2
"13757","6037635235c15072ab6cfb46fd3d00cb",24,17,35,4.8,24,0,2,1
"13758","603a0e21cc4a79f3e2dc5a0e06872379",67,53,34,13.7941176470588,67,0,2,1
"13759","603d4b61d57b4c1dbea68d0662e86fd1",13,13,0,13,13,0,1,2
"13760","603e02d52e7c2355d486f5e09b4035d3",118,61,61,13.5409836065574,118,0,3,3
"13761","6040c14ce456cbe25952bd95596821b7",11,11,0,11,11,0,1,2
"13762","6040f269e4acf656fdec6d124df26375",131,69,45,20.3777777777778,131,0,3,3
"13763","6043d2df851388f16a17482ac85e829f",96,63,56,12,96,0,2,3
"13764","604448d64954c2f5d68ace8bcbf1f633",62,50,29,14.9655172413793,62,0,2,1
"13765","6045590661ac1c93b3f0058e7067d321",118,64,57,14.4912280701754,118,0,3,3
"13766","604757e9a99265bddf54cd58d5869e56",37,24,21,12.3333333333333,0,37,2,1
"13767","604b1170ee9ddd2e520a34b3bc78af60",62,39,28,15.5,62,0,2,1
"13768","604b5bc8df08b0058b4c13190b32fc8a",115,88,63,12.7777777777778,115,0,3,3
"13769","604bc1958fc5d7f12627154beaf33f03",122,57,67,12.7462686567164,86,36,3,3
"13770","604c090768ac94f99955b5a0bd1598ec",108,58,52,14.5384615384615,75,33,2,1
"13771","604cf0f12865e40cae2803c76cfa203d",188,122,64,20.5625,188,0,3,3
"13772","604d7d92ea8cfa66d31d2385cb783610",84,57,62,9.48387096774193,84,0,2,3
"13773","604e0ba09c47666f6d6d915fb0451dd4",120,75,83,10.1204819277108,115,5,3,3
"13774","60526b98552d37f78540916215ba1147",25,25,0,25,25,0,1,2
"13775","6053f4409962ae501887fe7beb1182de",11,11,0,11,11,0,1,2
"13776","6053fd8a60d8018e7f65b3556e2aacf3",1,1,0,1,1,0,1,2
"13777","60585d79e6cf77adcccb5d9efb8b81ce",21,21,0,21,21,0,1,2
"13778","6058772732ae1671daffabdac25bb32b",37,37,0,37,37,0,1,2
"13779","6059a42a31ba2f902bead2f95043af89",17,17,0,17,17,0,1,2
"13780","605ae86a57d5a15a1b04fea74802e0cd",26,26,0,26,26,0,1,2
"13781","605c21c829538645cf68fafaf5c45885",20,20,0,20,20,0,1,2
"13782","605ced2f423f851cccef91fd78eadcb5",64,55,64,7,64,0,2,3
"13783","605d857725e04dd990a36fedd34144e3",92,68,21,30.6666666666667,92,0,1,3
"13784","605e21d0efbe860c12e211bf9621baaa",44,36,29,10.6206896551724,44,0,2,1
"13785","605f3ebeb50a80d2a412bea2ddd244fc",26,26,0,26,26,0,1,2
"13786","6060955574f7ffbf65c93984304d79cf",106,71,23,32.2608695652174,87,19,3,3
"13787","6061ea831c22be849211d74d3d2089f9",36,36,0,36,36,0,1,2
"13788","60638ea212c2a041b2203d3c0d0a9dbe",34,23,45,5.28888888888889,34,0,2,1
"13789","60641705a95acc5fd38c55cb4ee0cb71",31,31,0,31,31,0,1,2
"13790","6065d76cdbb1904d4ce21d3dcf55341e",15,15,0,15,15,0,1,2
"13791","606693119bbd556e9ac755c833b2d6a5",6,4,54,0.777777777777778,6,0,2,1
"13792","60671ed52bc87a18fa0f5e664363b9f6",20,20,0,20,20,0,1,2
"13793","6067b01562492cf3609a87038c89d789",34,34,0,34,34,0,1,2
"13794","6068723331e11ab6b7df90ab920f951e",13,13,0,13,13,0,1,2
"13795","6069967a96298cca9441abfd8dd5dc57",34,34,0,34,34,0,1,2
"13796","606a880c04dc4e84651679d26ad8efb5",26,26,0,26,26,0,1,2
"13797","606a8b9901f94500259691b8934fb3eb",1,1,0,1,1,0,1,2
"13798","606aa8a82df8222f6bc726c19fa67335",47,47,0,47,47,0,1,2
"13799","606adb8540e7ab25937f0af5bf4abc3c",44,44,0,44,44,0,1,2
"13800","606e43cf578993515e1ea3e6cf0ed6ce",28,28,0,28,28,0,1,2
"13801","606ed33a1b0e3d683e3fdd7d48f4740c",25,25,0,25,25,0,1,2
"13802","606f956a77d8b06e6ca6eab7ec5bd2ab",97,65,44,15.4318181818182,97,0,2,3
"13803","607540be522f6cb458520bdf0af2f88d",27,27,0,27,27,0,1,2
"13804","6077dcb712d205e5b1bf2481842f4b57",13,6,53,1.71698113207547,13,0,2,1
"13805","60791a9a23878741f7a45b0c86cf8281",72,60,17,29.6470588235294,38,34,1,1
"13806","6079a63a56ee77a554299bf880243f55",9,9,0,9,9,0,1,2
"13807","607b5293e1145f3eeee3e5815ffffbc3",6,6,0,6,0,6,1,2
"13808","607b640cb046f34a9e3f9ec214835a40",157,91,63,17.4444444444444,106,51,3,3
"13809","607bbe8d8ab269bbfa098b08c582681a",58,33,37,10.972972972973,58,0,2,1
"13810","607cc8534a57029628c8c5d1b9e3dc03",176,67,84,14.6666666666667,144,32,3,3
"13811","607e9c769d53bf76717a6c8d7a6caadd",54,37,51,7.41176470588235,26,28,2,1
"13812","6081c93951c078fcce78ec9f2340cce7",42,42,0,42,42,0,1,2
"13813","608401df395795f45d88e00ab59c7657",39,35,36,7.58333333333333,39,0,2,1
"13814","6085646cf04477671b04bfc18c6a391a",64,63,14,32,64,0,1,2
"13815","60859e4a0ed52fa4c19cd3d464dd9fd1",134,76,61,15.3770491803279,89,45,3,3
"13816","6085a98442fdc3bf88825fd64e357be6",170,108,59,20.1694915254237,121,49,3,3
"13817","6087cec85380d085d998a1705fd1bde6",5,5,0,5,5,0,1,2
"13818","608961c71f3191016dfdca353ae0f52b",9,9,0,9,9,0,1,2
"13819","60896e8bef249b77f72c882e4875462a",237,102,82,20.2317073170732,194,43,3,3
"13820","608bf186c54975dcb06b78ebff083147",25,25,0,25,0,25,1,2
"13821","608cdddd9cc645fc22df9e4925f7dd61",87,56,66,9.22727272727273,87,0,2,3
"13822","608ce12b7dd55f8dd9af7992a53409a8",13,13,0,13,13,0,1,2
"13823","608f034b1a3e846a3f32a29825b2bebf",43,43,0,43,43,0,1,2
"13824","608f44eab6ed950e168797ba2f956dd5",90,85,35,18,90,0,3,3
"13825","6090e8afd7ed0b9614df7625dad0ccb3",35,35,0,35,35,0,1,2
"13826","6094a7ae28465e896cd3375be14c2e99",4,4,0,4,4,0,1,2
"13827","609890dd5387f18f7d12438b71959446",41,35,39,7.35897435897436,41,0,2,1
"13828","6098f4aa5bc7aa39c5922dd2737e5682",46,46,0,46,46,0,1,2
"13829","609a49dedb1189b54f86ff33857199da",36,36,0,36,0,36,1,2
"13830","609d60c334c21edc9fe5d19c75ca9a5b",17,17,0,17,17,0,1,2
"13831","609d744aee3354db5e12ec059873fbb7",25,25,0,25,25,0,1,2
"13832","609f55db6d9248b4be752ef13cb765b8",75,35,70,7.5,75,0,2,3
"13833","60a175605380021b8df8e4e34c1240dc",24,24,0,24,24,0,1,2
"13834","60a34c1ca55e0423b4f4d85ef4afd729",32,32,0,32,32,0,1,2
"13835","60a4fce8cf30132d0079022c34adfee3",68,41,15,31.7333333333333,68,0,1,2
"13836","60a8a4c40628cec69e70b857f555f420",54,45,32,11.8125,54,0,2,1
"13837","60ab076e1ebea550781bf870d8fd9ce5",148,77,75,13.8133333333333,98,50,3,3
"13838","60ac1f41183f7c4208e99d673b87624c",12,10,45,1.86666666666667,5,7,2,1
"13839","60ad67f3ac6058113d3ecd51dfce0166",31,31,0,31,31,0,1,2
"13840","60aec1b9fdbb6fa6cd5e185b6cf79a85",95,79,64,10.390625,95,0,3,3
"13841","60b1f9cddf192933224116a1f18789d2",194,111,57,23.8245614035088,194,0,3,3
"13842","60b373cb74b778141a075ad67c17e960",23,23,0,23,23,0,1,2
"13843","60b4658e344a9494d8f1cb9ed890c6bf",11,11,0,11,11,0,1,2
"13844","60b46a8d95ce2873eccb8a1ea4d675f5",60,56,40,10.5,60,0,2,3
"13845","60b954c79382b401db7b7e4dbaff3a30",95,83,46,14.4565217391304,40,55,2,1
"13846","60bb2ed4c0e6a02a0bef078d29d8ee99",92,73,44,14.6363636363636,52,40,2,3
"13847","60bc301d9a6736fb6cfb4119affc17cd",180,116,77,16.3636363636364,180,0,3,3
"13848","60bc72819dab3d5f5201db524cc48809",29,29,0,29,29,0,1,2
"13849","60bced5a0fa0b0618806cc52d52051ee",1,1,0,1,1,0,1,2
"13850","60bee0eb5e92dff7a160b51c55ea09bd",10,9,33,2.12121212121212,3,7,2,1
"13851","60bf84043bfdef2332f6e3029a9ad9c4",73,55,75,6.81333333333333,73,0,2,3
"13852","60c1ba6d1fef6e6d86f4ec834d1a77aa",181,105,77,16.4545454545455,181,0,3,3
"13853","60c290e760536cfd48733423e6544df3",2,1,0,2,2,0,1,2
"13854","60c44b335ebbff5b054ade6e14ae34fb",55,44,57,6.75438596491228,18,37,2,1
"13855","60c52c3a6a09ef50fff358233ccdf818",88,79,28,22,88,0,2,3
"13856","60c5a604bbc3993720d20c451da303f9",25,25,0,25,25,0,1,2
"13857","60c7e996489c5a3feeaf5b6c7dbaa199",73,35,80,6.3875,43,30,2,1
"13858","60cb83cbca7eacb68f222d2e2143edd1",84,72,77,7.63636363636364,84,0,2,3
"13859","60cbd292b7a6bc5e47d236cf63ad2cc0",67,51,48,9.77083333333333,67,0,2,3
"13860","60ccd5a64b6fba75c5cdf52b30d5feba",91,48,60,10.6166666666667,91,0,2,3
"13861","60ce13c827072b3e240cafd027f89c77",11,11,0,11,11,0,1,2
"13862","60ce595da5f8576ce1bec277096ff07a",73,55,12,42.5833333333333,73,0,1,2
"13863","60d0bf5487a68c239fbe9f328bf840e9",26,26,0,26,26,0,1,2
"13864","60d17b0da3234d14ca231038b4b97a32",85,62,56,10.625,85,0,2,3
"13865","60d2df77280b390ffe54e5563c0c41f8",190,106,63,21.1111111111111,190,0,3,3
"13866","60d3771a063f242edbd0a697686c20bb",112,94,65,12.0615384615385,112,0,3,3
"13867","60d3815bb89444176a13064646df76c5",12,7,67,1.25373134328358,12,0,2,1
"13868","60d684106c36f7226b7e838e02279810",12,12,0,12,12,0,1,2
"13869","60d771a50cda4cd67c3edc66d4b8c044",97,69,75,9.05333333333333,62,35,2,3
"13870","60d87d2b0c161daff3da2c79a5e706c7",96,75,57,11.7894736842105,96,0,2,3
"13871","60d95750ebdfd98a27bf08e299cb11d5",94,77,21,31.3333333333333,94,0,3,3
"13872","60dbf93c5bb2259ba1359256e09b4450",20,20,0,20,20,0,1,2
"13873","60dcddcfac653b2c231491fd7f534d15",58,44,57,7.12280701754386,37,21,2,1
"13874","60de4068d69c9d2ab0ad3c9a89be44fe",45,39,14,22.5,45,0,1,1
"13875","60e015921c6a68bdc01f6bc78a4baa6c",63,54,21,21,63,0,2,1
"13876","60e2e2bcbf3389c7fbaf50c3adcb76ec",67,36,68,6.89705882352941,67,0,2,1
"13877","60e4560e57fae2c6b70119bb94f36cb0",53,53,0,53,53,0,1,2
"13878","60e558570f4c4f6abea4cba079fa4077",15,15,0,15,15,0,1,2
"13879","60e5c478e6099b631e0b6d518485c6f9",108,89,39,19.3846153846154,108,0,3,3
"13880","60e6901e5305855b353f056df72e139d",144,78,77,13.0909090909091,144,0,3,3
"13881","60e6ceca8ca8ea303d51a6d94ff1857a",21,21,0,21,21,0,1,2
"13882","60e9ba894b2537fec57e96e4e61009d6",98,49,68,10.0882352941176,98,0,2,3
"13883","60e9e8206761f5c0fa1206c10cbb6225",184,109,83,15.5180722891566,184,0,3,3
"13884","60eda8d3fe6592b0ba552744f3c639c6",32,32,0,32,32,0,1,2
"13885","60ee479657ba2a3d8c311bd69715e4f0",59,49,40,10.325,18,41,2,1
"13886","60f091cde64d1d31aab7bcc8113751c2",40,29,46,6.08695652173913,40,0,2,1
"13887","60f160ec22c176f7b9491625ddd4f9d0",93,54,70,9.3,93,0,2,3
"13888","60f205e55eb31b6d045ca39ca00e04c6",44,39,28,11,44,0,2,1
"13889","60f55121d711c8eaded33a397be5a327",252,115,74,23.8378378378378,214,38,3,3
"13890","60f599dc35c46051abaa3e25080b5438",22,22,0,22,22,0,1,2
"13891","60f6c8ffe7debac32e593afe3ca1d983",41,41,0,41,41,0,1,2
"13892","60f78df0367d33bd1613199fd27c26d9",14,14,0,14,14,0,1,2
"13893","60f82368ec72579141405f8dfbc68399",47,42,6,54.8333333333333,47,0,1,2
"13894","60f8c9f28d21f435e74a3ca9f0434db6",19,13,38,3.5,19,0,2,1
"13895","60fd334484d53194956003a98403072c",29,29,0,29,29,0,1,2
"13896","60fe3261d3d4c944ef755846da70d452",146,114,31,32.9677419354839,146,0,3,3
"13897","60ff3a11b9fdd136fed644ca7338170a",170,127,65,18.3076923076923,170,0,3,3
"13898","61001fc1b70e93afdb0e50910e0b9834",171,134,61,19.6229508196721,120,51,3,3
"13899","6100805bc3f12569bc6c118f1d949eaf",89,64,57,10.9298245614035,89,0,2,3
"13900","6100b69b132411dd205f8bcbf88c332f",51,39,36,9.91666666666667,51,0,2,1
"13901","61018a14aeb80a42c12ac99e1ab0f077",14,14,0,14,0,14,1,2
"13902","610302d70df3cbbe2d549ca3f136bd8f",25,25,0,25,0,25,1,2
"13903","61037e7cc0062cb3b6a6ab0418f8bee0",24,24,0,24,24,0,1,2
"13904","61038666dc20383fc3bb116606dc111a",9,9,0,9,9,0,1,2
"13905","6107b1d9c137556de32161262b696d4c",28,28,0,28,0,28,1,2
"13906","610a5c43c1add0300f441606c5675077",47,43,29,11.3448275862069,47,0,2,1
"13907","610d5a80bc22b27089ad99c8d44ac754",4,2,57,0.491228070175439,4,0,2,1
"13908","610e1207777a41ecd3768306d3dfc581",49,31,63,5.44444444444444,29,20,2,1
"13909","61125b1a6c68d9bfab3d251a4dea4824",23,10,71,2.26760563380282,23,0,2,1
"13910","61137ca5e6366e15072bdaa255006aec",32,28,22,10.1818181818182,32,0,2,1
"13911","61142daa22c52dd8f552e406f0d54487",21,21,0,21,21,0,1,2
"13912","61146bff84c3d3b8f40893219b4437c0",4,4,0,4,4,0,1,2
"13913","611778c59d9c4ed741fc52bbaeebc7ea",66,55,45,10.2666666666667,66,0,2,3
"13914","6118d47f9273d29540c8b4b6db97f471",19,19,0,19,19,0,1,2
"13915","6119f53933e97ab826aab979c7b42123",32,32,0,32,0,32,1,2
"13916","611a288a2b52eb25bed641cd8d1565ce",16,16,0,16,16,0,1,2
"13917","611a4b63b8634adeb0106e68210fe23c",12,12,0,12,0,12,1,2
"13918","611b2705096ce97cae80a7fe596cc8e8",38,30,27,9.85185185185185,38,0,2,1
"13919","611b5a912f34b2d5d13f22f7ac93c66c",37,30,14,18.5,37,0,1,1
"13920","611d0c45ac975821454573f29111a986",99,62,70,9.9,71,28,2,1
"13921","611f8929ae5b3e69a79088c144ca73c3",9,9,0,9,9,0,1,2
"13922","6122b1df03bccb2f4e491c9da7dc7371",117,81,70,11.7,117,0,3,3
"13923","6124c67956307c2729aaac87d92ee683",52,41,63,5.77777777777778,52,0,2,1
"13924","612685b5af8d8c84e6795b8ea5433745",30,30,0,30,30,0,1,2
"13925","61271ac964c4a3146f3acce0dc95bf5b",185,76,60,21.5833333333333,185,0,3,3
"13926","6128321227e56f4f94aa4afcb7a5bc05",20,20,0,20,20,0,1,2
"13927","6128530e7c0f4504ed8e4ecec895ec24",135,100,37,25.5405405405405,135,0,3,3
"13928","61285e667cd127f3989e5d51ef76b251",198,116,58,23.8965517241379,198,0,3,3
"13929","61296e59d5a443690bd5f7ec44d4ac9e",45,45,0,45,45,0,1,2
"13930","612a9d507158839b9224fa312c910a56",97,68,57,11.9122807017544,97,0,2,3
"13931","612c19bb9217e8c123f25516ac99574d",203,118,62,22.9193548387097,203,0,3,3
"13932","612c41ec195448ea3870b74ab1f63c3b",25,22,41,4.26829268292683,25,0,2,1
"13933","612e263e9aaf2eb508058bc9bfc2914b",16,16,0,16,16,0,1,2
"13934","613015637c26ad092738c95ad37fb028",80,54,44,12.7272727272727,80,0,2,3
"13935","6130fcd3b870a05eee75ca2ee340dae6",49,49,0,49,49,0,1,2
"13936","613169d4d5af1b5a570f2d6facaba1cd",35,35,0,35,35,0,1,2
"13937","6131aab2b91e5c890bff8a7c964380e2",33,31,7,33,33,0,1,2
"13938","6133b6c499be730fe3aa1e5df067ea67",73,66,34,15.0294117647059,73,0,2,3
"13939","61354117f5510ba9468c697ea814e9c2",168,105,49,24,168,0,3,3
"13940","613847b5821465416d4bb7e713e402fd",15,15,0,15,15,0,1,2
"13941","613cd6c014e51ab284c621578db05d8b",10,10,0,10,10,0,1,2
"13942","613ef5fb93b1f173dddfc1cc0ead6879",34,27,39,6.1025641025641,16,18,2,1
"13943","613f91249e2fef1514f963c884bbb016",10,10,0,10,0,10,1,2
"13944","613fee8d2a2b7c027fcd2b838d144fad",34,34,0,34,34,0,1,2
"13945","61414382e4a5f7b141c217f5a511d592",27,27,0,27,27,0,1,2
"13946","6141f147da51a7b132a89f1e95f921e2",18,18,0,18,18,0,1,2
"13947","6142045d6e4d03f72229c0fe3ea0310f",122,74,54,15.8148148148148,91,31,3,1
"13948","614275455a4be830fcbc90c091f741cb",122,60,80,10.675,105,17,3,1
"13949","6143b7526987bf30fc687a21078ea275",52,45,10,36.4,52,0,1,2
"13950","6143ec20293fcc001f74f0eae4c80c00",1,1,0,1,0,1,1,2
"13951","6146c9e3b83477330ad869d5c82987bf",51,47,29,12.3103448275862,51,0,2,1
"13952","614787b291ad58d95dcb3d1c0c3f5e13",23,23,0,23,23,0,1,2
"13953","614c0800c368eb271f58a004694f4530",105,56,79,9.30379746835443,86,19,2,1
"13954","614c5c25df66da2053b35d5c14d57ab2",39,30,13,21,39,0,1,1
"13955","614e0cdcfcaacbf187703e11d79dcbc2",188,76,83,15.855421686747,175,13,3,3
"13956","614e95c087e0cfe191890914e0c50898",14,14,0,14,14,0,1,2
"13957","6151b625aca88c6065a613e118a5fc22",55,44,87,4.42528735632184,55,0,2,1
"13958","61520d285dab8bb3a12e66b70563873f",35,29,37,6.62162162162162,35,0,2,1
"13959","6159e262feb526e70ff37a11b01be4a0",31,24,73,2.97260273972603,15,16,2,1
"13960","615b81d9bacec42b09c9279f330f647f",7,7,0,7,7,0,1,2
"13961","615b8941810d71e2ad937e6dd52cfe99",128,105,61,14.6885245901639,98,30,3,3
"13962","615cb5199ffd7a9272e524ed8514bad6",40,40,0,40,40,0,1,2
"13963","615fdbc9fb13b75cc61fd730db301f5b",76,25,73,7.28767123287671,58,18,2,1
"13964","616c6963caae6905f598ebef463da82e",4,4,0,4,4,0,1,2
"13965","616cd537b23e82ebcc4b023010dd8c08",48,48,0,48,48,0,1,2
"13966","616ef33cde656bae89dcfff779f2c1ba",89,70,42,14.8333333333333,89,0,2,3
"13967","6170a8cd68efda3e44a260616cea97a4",29,29,0,29,0,29,1,2
"13968","617248f2e0e77e2bef5b3b6fa7fbc589",16,16,0,16,16,0,1,2
"13969","61724e4d06d7a98506a64aaf00f1286c",219,109,65,23.5846153846154,219,0,3,3
"13970","6172f3eb494672145ebd209b202df74a",224,112,73,21.4794520547945,184,40,3,3
"13971","6173353480a5cf61b779910bfc6b93fe",45,40,26,12.1153846153846,16,29,2,1
"13972","617433382aa8f2fbdcd33272fd866f0b",6,6,0,6,6,0,1,2
"13973","6176eddee959756d08c98ffd03e0fd3b",5,1,79,0.443037974683544,4,1,2,1
"13974","617ad58b5052488d2cc3f0c6c8f4737a",26,14,60,3.03333333333333,26,0,2,1
"13975","617c332f2cd4f4fae683aa2baeea126b",178,112,43,28.9767441860465,178,0,3,3
"13976","617c43237c4cb08c56e79e892eef3155",29,29,0,29,0,29,1,2
"13977","617d3b9a52da1849e331ca1335ba3421",15,15,0,15,15,0,1,2
"13978","6180b17275448661a9c497d09dd203a5",32,32,0,32,32,0,1,2
"13979","6180f667161c975f4b087ec15b9d4ba7",64,46,73,6.13698630136986,38,26,2,1
"13980","618394c2ae270f7051f4664f38829db4",11,10,2,38.5,11,0,1,2
"13981","61841ad849fd0218508361577255b40f",16,16,0,16,16,0,1,2
"13982","6185428a9e3265167288aa15b540d0d5",5,5,0,5,5,0,1,2
"13983","618715bb3029270f346b48568e8b0b59",26,26,0,26,26,0,1,2
"13984","61873c1efacbf0ddc000318371fc7927",111,95,20,38.85,111,0,3,3
"13985","61887a5fe8e34d52fa0ddd33a0bdd819",27,27,0,27,27,0,1,2
"13986","6189bcafd0727d700f6e3be185dfebe0",100,65,82,8.53658536585366,100,0,2,3
"13987","618b826b5fec71be2b9731dba63bd70d",59,52,16,25.8125,30,29,1,1
"13988","618bcd7e753e08c90e41a2872acd556b",15,15,0,15,0,15,1,2
"13989","618d1db5b9205fb458d9decf2ed1d918",3,3,0,3,3,0,1,2
"13990","618dd61974894a4b3529f9ac41469f7c",44,44,0,44,0,44,1,2
"13991","618e76d5ff95fb79b6ae589c31839fe1",21,20,26,5.65384615384615,21,0,2,1
"13992","61908add1a3ac2dcaaedc578e3ee38e2",24,24,0,24,24,0,1,2
"13993","61913e40d525006cc5601876f6b5d383",87,59,30,20.3,87,0,2,3
"13994","6192d2fb4e328e24eb3affdd746a7a38",130,88,44,20.6818181818182,130,0,3,3
"13995","6193b4e5628cbf7bec0bfabb027d021a",15,13,44,2.38636363636364,15,0,2,1
"13996","61994503a29d20a194f9bfc28d8d79da",25,25,0,25,25,0,1,2
"13997","61999900684082ce78ef229e2f10800a",114,69,71,11.2394366197183,78,36,3,3
"13998","61a0f8b4039169bd7b0636bda2e2d0fe",84,69,64,9.1875,84,0,2,3
"13999","61a569b38e824592b7b6e4a87800e484",5,5,0,5,5,0,1,2
"14000","61a56a18326379a08828927fa7670fdc",203,118,77,18.4545454545455,203,0,3,3
"14001","61a88698418c3ae5ed315567bd8087bb",31,29,26,8.34615384615385,31,0,2,1
"14002","61a9853dd6ea5ce1de631f12951c97b1",47,47,0,47,47,0,1,2
"14003","61aaf5ba6bf5635c90ee69a7e623b2a8",115,82,57,14.1228070175439,115,0,3,3
"14004","61b0306fb781d8431fe6009b3ccdbe1b",57,46,77,5.18181818181818,57,0,2,1
"14005","61b10781b352f9bd65cdce4f9dc5de16",81,26,90,6.3,81,0,2,1
"14006","61b43bd9f5597db8ec357b0f6dbb23f8",138,83,74,13.0540540540541,138,0,3,3
"14007","61b49969398effeca96d79966d53b46e",38,38,0,38,0,38,1,2
"14008","61b8961fee0570b132eb413075e11a48",96,82,35,19.2,96,0,3,3
"14009","61b9a7faca63f1190c2cf2ac78a97e03",17,17,0,17,17,0,1,2
"14010","61bcf306a2a802b32400cf6ee6fe827a",42,42,0,42,42,0,1,2
"14011","61be53073e46e3bd0bb15368e2e4721f",50,37,70,5,50,0,2,1
"14012","61be8588d73d47c607a354b2c5414679",24,24,0,24,0,24,1,2
"14013","61bf21c46764642ef04025c33c6b2904",145,78,55,18.4545454545455,145,0,3,3
"14014","61bfabc951da05aee20a0804bdacf1bc",228,126,86,18.5581395348837,202,26,3,3
"14015","61c0fed13b316b5714c8647bd51b30dd",22,22,0,22,0,22,1,2
"14016","61c2d75aa4139c8eb8d91544f7afe4c3",74,57,36,14.3888888888889,74,0,2,1
"14017","61c457a5a6dfd9197ffc6ea218b56ac9",36,36,0,36,36,0,1,2
"14018","61c4872e9597c171d8a171a47cabff0d",62,36,66,6.57575757575758,62,0,2,1
"14019","61c6c609ed051ca4d0de602cfa5ca31a",39,39,0,39,39,0,1,2
"14020","61c827b6f1f93221ac1f4a889c2f232a",98,75,15,45.7333333333333,98,0,1,2
"14021","61cde787f1915f0772cbbe6c9087bd7e",23,23,0,23,23,0,1,2
"14022","61cf7477af02da3df97143e6f0b66692",60,58,65,6.46153846153846,60,0,2,3
"14023","61cffb76568bb7c4d74c106391da4670",54,28,75,5.04,41,13,2,1
"14024","61d28536cf31a6e81d0d79b4da74f2d6",136,59,78,12.2051282051282,136,0,3,3
"14025","61d2b48bdf4289ca8d28ec8388264be7",31,26,61,3.55737704918033,12,19,2,1
"14026","61d3d0f1fa18a7b95fefb6fd6efb5159",20,20,0,20,20,0,1,2
"14027","61d6360d9fe2b39a327b8e70e693e470",25,25,0,25,25,0,1,2
"14028","61d8159b8c135c3451af584f027103ef",165,85,77,15,165,0,3,3
"14029","61d96437f04830b9a13cd966217f8c06",72,66,55,9.16363636363636,72,0,2,3
"14030","61d9bb4efdcec961793ae29e82a24dbd",47,47,0,47,47,0,1,2
"14031","61de6aaf8c64b75641d4dc1054c6b37e",56,40,29,13.5172413793103,33,23,2,1
"14032","61e171734271273ebce6b8f11754bbe5",111,82,78,9.96153846153846,111,0,3,3
"14033","61e2218e5f290a4d17d00fec66a6f335",11,7,43,1.7906976744186,11,0,2,1
"14034","61e2e697c3ed3082a9a24df28e86253b",175,115,56,21.875,175,0,3,3
"14035","61e3a712c9e778381779845e767c2699",211,114,84,17.5833333333333,211,0,3,3
"14036","61e583ec8c498cd770e326e33ebd9a0e",102,68,82,8.70731707317073,102,0,3,3
"14037","61e6992567af97a01139ff9cad807654",97,77,73,9.3013698630137,97,0,3,3
"14038","61e96dbd2bd9aab03a12447a660c3594",55,45,37,10.4054054054054,55,0,2,1
"14039","61ecb1e1ce4fa212fe94b0cf9f978556",65,59,11,41.3636363636364,65,0,1,2
"14040","61ed923988f5ca609efbf7f6ee77fc33",10,10,0,10,10,0,1,2
"14041","61eda852881119059c7c11e2009f7c06",86,61,63,9.55555555555556,62,24,2,1
"14042","61f1560516c28e71028b2633f2c29a7c",128,73,85,10.5411764705882,128,0,3,3
"14043","61f3889b10a2aac9e926e3b2fe6c59d7",45,45,0,45,45,0,1,2
"14044","61f44a3be39e33fd945889cbfdf261bd",41,37,7,41,41,0,1,2
"14045","61f4970877ff43a3d61808eacb324d6b",20,20,0,20,0,20,1,2
"14046","61f4aa0f2c8152f4dbccbd39b5be7553",24,24,0,24,24,0,1,2
"14047","61f57563be5aad5c7737781246c20672",118,86,59,14,67,51,3,3
"14048","61fba814e7d28514d6f9f24a774cff08",36,36,0,36,0,36,1,2
"14049","61fc5b20ab4d50c2f1ed490c1e26d4d7",27,27,0,27,0,27,1,2
"14050","61fccdeea4f8e15dbf738cfc2bd2d12b",52,52,0,52,52,0,1,2
"14051","61fe6680486c202ae0d847e3873d97d8",22,22,0,22,22,0,1,2
"14052","6200272b5f0fc4f76a78403cf38c13bb",191,100,83,16.1084337349398,191,0,3,3
"14053","6201ef1f85b3717cc6dc93a4656e1255",47,38,29,11.3448275862069,25,22,2,1
"14054","62028943a15c91aa3c1eef5cb6bba442",50,48,9,38.8888888888889,50,0,1,2
"14055","62040af36e8176b2c37e45ca3bf50785",193,104,60,22.5166666666667,193,0,3,3
"14056","62048cb4b2225795de562ee21c39ba4c",183,91,69,18.5652173913043,183,0,3,3
"14057","62049c2c953a1ac5659f738fc72d9d4c",142,112,32,31.0625,142,0,3,3
"14058","620c2f5562a1209c487c41badbe34360",60,54,42,10,60,0,2,3
"14059","620ca967642dc62f7c37974018dfcffb",19,19,0,19,0,19,1,2
"14060","620e8010c846b55968617b3fef1a81cd",209,115,61,23.9836065573771,209,0,3,3
"14061","620f0b245db46e63e1fd1902eabc9ade",45,31,56,5.625,45,0,2,1
"14062","62106814fa4eaac78a87826a468e931d",116,58,41,19.8048780487805,116,0,3,3
"14063","6212b866c3b3f36c8fa083e8a793d4c8",11,11,0,11,11,0,1,2
"14064","62175b7f14f8c836b39a25df4da49b44",45,45,0,45,45,0,1,2
"14065","6218ac6e70d9204f53029b713730bfc0",138,119,35,27.6,138,0,3,3
"14066","621900a518735c4232bcf906026b9d80",12,12,0,12,12,0,1,2
"14067","62196e9327a88af89723022cb8e054c8",33,33,0,33,33,0,1,2
"14068","621c20e239ae9c0dfc3f12a68564cfbc",26,26,0,26,26,0,1,2
"14069","621e20ef9f4b6b35f88a30260219795a",40,31,17,16.4705882352941,40,0,1,1
"14070","621e37f74707207ecbc39e06c6f4d660",49,43,15,22.8666666666667,49,0,1,1
"14071","62225e922d67e508b81a25919adfde35",71,60,14,35.5,71,0,1,2
"14072","6224833108f766335d5bed071ea22a69",27,27,0,27,27,0,1,2
"14073","6224f154b3001d5c80bd6eed943ae8a2",77,53,29,18.5862068965517,53,24,2,1
"14074","622645feeb2c2d967968f6ae46ba942c",84,76,79,7.44303797468354,84,0,2,3
"14075","622676fef31a2b98dafce0bff87102bd",41,41,0,41,41,0,1,2
"14076","62287fde0444f6d823c637f2a91b755f",45,45,0,45,45,0,1,2
"14077","6228ea1755ca70dbbdf81efd09e866a5",133,107,38,24.5,133,0,3,3
"14078","62296302e5bedd780f5c769182f1128c",17,17,0,17,17,0,1,2
"14079","622c167a1b72e34c48309f39e6f8aa56",31,31,0,31,0,31,1,2
"14080","622d8e6ba12b50331053d81175d1a388",40,36,14,20,40,0,1,1
"14081","622db30e698291ad440c2b2daf12f28c",2,2,0,2,2,0,1,2
"14082","622fceefa5d398cc89e891cf99cf5267",47,47,0,47,47,0,1,2
"14083","6233b8902d1890c0523ec972c8fbe234",143,108,77,13,112,31,3,3
"14084","623465b9c322497639e8c0ea9f530617",30,30,0,30,0,30,1,2
"14085","623795852521ea97368f87d24e2268a4",48,40,45,7.46666666666667,48,0,2,1
"14086","62398c8c4dcac3ed633bc499ce19053d",95,65,48,13.8541666666667,95,0,2,3
"14087","623a57f8cab3cbaa8dd848ad97db0c90",84,71,38,15.4736842105263,38,46,2,1
"14088","623ac111476b6860b27aea18c461d8aa",12,12,0,12,12,0,1,2
"14089","623df88be78934e5026d21c96eee494b",60,45,56,7.5,60,0,2,1
"14090","623ff9a6b43c447dbbc4cc6e97397c73",81,56,32,17.71875,81,0,2,1
"14091","624208cd6babd2d17eaa1f5524682619",245,144,59,29.0677966101695,198,47,3,3
"14092","6246f0d7ac87a618400886510dd0cc1a",21,21,0,21,21,0,1,2
"14093","6249656a80191c6ef3708fb654f4f3bd",132,82,67,13.7910447761194,132,0,3,3
"14094","6249f38589a0762365b97434aec33844",30,30,0,30,0,30,1,2
"14095","624ca2145c2e0c7d37846ddcaf057c62",20,20,0,20,20,0,1,2
"14096","624fea56c613cd2c3de0d66b3ce2c22d",18,18,0,18,18,0,1,2
"14097","6253b5f141e27103f0dce676cf3e842a",17,17,0,17,17,0,1,2
"14098","62557b577c75b73b51bb9c1ae7d5a399",164,88,88,13.0454545454545,164,0,3,3
"14099","625624e534d11fdd465b1f35362232f6",25,25,0,25,25,0,1,2
"14100","625e68a7bae99efe2e3dcc6cf5e0e31e",58,44,52,7.80769230769231,58,0,2,1
"14101","625f067b57bd674d59a0f83728affe2a",23,23,0,23,23,0,1,2
"14102","625f58f63e826407dfc2f92f18f30c47",24,14,56,3,24,0,2,1
"14103","626021137cf9f75e69025b240ec4e353",4,4,0,4,4,0,1,2
"14104","6263878c3a5b4e79bec8fd780401c5e8",19,19,0,19,19,0,1,2
"14105","6265fbc4c86a26440ec82997c33a250b",3,3,0,3,3,0,1,2
"14106","6266af3993ae84ca5dede3a27cab1c04",111,58,61,12.7377049180328,111,0,3,3
"14107","6267159ca97c96df4ce969f8425cb0eb",67,38,35,13.4,41,26,2,1
"14108","6267af12286f4013dabc9eccd6f8d6f6",4,4,0,4,4,0,1,2
"14109","626b2d4bae0a74254554d225a5aa0464",23,23,0,23,23,0,1,2
"14110","626bbb6f511b54b6bb65c634e20ebab0",24,24,0,24,24,0,1,2
"14111","626c3f0919cff6d15cf03af8432f6000",56,56,0,56,56,0,1,2
"14112","626d8f7b4b70800d2d5a1508c187d5d9",10,10,0,10,10,0,1,2
"14113","627086e05316790fd9a25c7db8d81598",76,61,65,8.18461538461538,76,0,2,3
"14114","62710166ca9849ff86486d9323152978",30,30,0,30,30,0,1,2
"14115","6271739de0c3157626fbe3b34aad1fec",36,36,0,36,36,0,1,2
"14116","6274df3222d6eaa76223803a6bf3ec77",193,104,73,18.5068493150685,172,21,3,3
"14117","6277adf1b185eb6d3647c5e012ae4465",78,62,37,14.7567567567568,35,43,2,1
"14118","6279dd4cab9763723bef673d0c70164d",178,103,59,21.1186440677966,178,0,3,3
"14119","627a27f2281723e492c27f999915c68d",45,45,0,45,45,0,1,2
"14120","627abce782576a79233f7d7e05bb822c",115,85,50,16.1,115,0,3,3
"14121","627dd2cc501fa44b35382721efb1f873",129,65,49,18.4285714285714,96,33,3,3
"14122","627eba60c831e20c664d8e422d466036",119,75,86,9.68604651162791,119,0,3,3
"14123","627f67d20d83fd9a6e81c73b5c78884e",12,12,0,12,12,0,1,2
"14124","6280dfc00f9029393bbabc33614abc9e",213,79,90,16.5666666666667,186,27,3,3
"14125","628375736f6f6d0287079b34b5ab2b4f",46,46,0,46,46,0,1,2
"14126","628510acbb9304b1c5811c268df9488b",8,8,0,8,8,0,1,2
"14127","62877f317ca304bd1bcdc5adb57f4d09",36,22,63,4,36,0,2,1
"14128","62880a93926e81dc52bfd7852f140295",43,39,57,5.28070175438596,43,0,2,1
"14129","628903d31d73309a05cb9b9d513c9bcf",42,42,0,42,0,42,1,2
"14130","62891d8dab2953758b0439c4fe6d7e9e",29,26,27,7.51851851851852,12,17,2,1
"14131","628a784a9d13eb92357405955e97c2dc",133,92,64,14.546875,133,0,3,3
"14132","628acbe59938909c4973efabf54ffe2a",48,43,9,37.3333333333333,48,0,1,2
"14133","628b09e3d58eba46471b7c24def06ac4",51,51,0,51,51,0,1,2
"14134","628cd7a837b62763c03a3d13a1109543",9,9,0,9,9,0,1,2
"14135","6292d15a4beb066fb18cc2d76c83b2db",48,39,54,6.22222222222222,48,0,2,1
"14136","6297efedf8435a1ca927338491423fd9",88,67,34,18.1176470588235,88,0,2,3
"14137","629994d3bc177f4d866d92738a39c24b",25,25,0,25,25,0,1,2
"14138","629becdb72ab602e817af994f463c563",71,60,23,21.6086956521739,71,0,2,1
"14139","629edbd55cd0bace674c20e75b3ceec2",153,99,58,18.4655172413793,153,0,3,3
"14140","62a01265f868cdf9b1f0bdb242b04e29",110,73,62,12.4193548387097,72,38,3,3
"14141","62a207aeb676f6c7407e975d2a744c5a",49,35,29,11.8275862068965,49,0,2,1
"14142","62a2efb6a58bcbe5043f59ae4ef49a4a",27,27,0,27,0,27,1,2
"14143","62a359029d0f56cad80a706fa13d86d4",111,61,39,19.9230769230769,72,39,2,3
"14144","62a58e133a92cfb04c263cf4d310771e",16,16,0,16,16,0,1,2
"14145","62a79fd5f3c953843d4f044b909d0c06",140,76,60,16.3333333333333,140,0,3,3
"14146","62a91267e9221ce58371f3dec62feeff",197,76,77,17.9090909090909,197,0,3,3
"14147","62ab57ed38a46747447fbe71a56d0f79",30,30,0,30,0,30,1,2
"14148","62b0bc9a154d7460d4c68e4d10b7324d",61,47,63,6.77777777777778,61,0,2,3
"14149","62b63f3f6aaaecee7a5acac4b81883a0",114,82,19,42,114,0,3,3
"14150","62b7e0d6ae2f4fea42a10348acb53dda",179,91,67,18.7014925373134,134,45,3,3
"14151","62b85dddbfca4874ab67a40cf68fb5b4",13,8,37,2.45945945945946,13,0,2,1
"14152","62b9d9a316d53b41d41337f1d0442712",16,16,0,16,16,0,1,2
"14153","62b9ed02e77617e8b26ffda9934ae123",43,38,45,6.68888888888889,43,0,2,1
"14154","62bb8c38dc2cc1a9bfbcc3484d2a41bc",25,25,0,25,25,0,1,2
"14155","62bd056365098c4fbc8ed987877d60a5",170,103,77,15.4545454545455,150,20,3,3
"14156","62c10a0d9ded0f489970a02d8e63cfec",25,23,37,4.72972972972973,25,0,2,1
"14157","62c11e6139438f9a9d4bf23dc8305b49",39,39,0,39,39,0,1,2
"14158","62c12ca987ee0b4c6ecc970f9e88afaa",5,4,3,11.6666666666667,5,0,1,2
"14159","62c1c76e305759372c8565844cf86c7c",36,31,31,8.12903225806452,16,20,2,1
"14160","62c348c77354f25c16c38f66e7e19b92",30,29,4,52.5,30,0,1,2
"14161","62c51829bcc1ef1c8a8661496f4a1927",20,20,0,20,20,0,1,2
"14162","62c541a9144b8742508fb4cfd6b32b8c",174,93,77,15.8181818181818,174,0,3,3
"14163","62c7497973abc39f540f2c8fef5bc985",42,42,0,42,42,0,1,2
"14164","62c8eb3ce518b97432588285386bfffd",90,67,64,9.84375,51,39,2,3
"14165","62c957b6334393892001694c24fa4e8a",29,29,0,29,29,0,1,2
"14166","62c95e42ed9b1160349205d7bfd30e01",41,41,0,41,41,0,1,2
"14167","62c99a45ab808c2cf357c9b6f8cabf45",25,25,0,25,25,0,1,2
"14168","62cad39e124bf332c5aba394f12469c6",68,52,38,12.5263157894737,34,34,2,1
"14169","62cbaaa8f8aa9680bf8c8db836a84cdd",24,24,0,24,24,0,1,2
"14170","62cbf3332e3f4ddd6db52ac17db684a6",110,76,65,11.8461538461538,110,0,3,3
"14171","62ccc08b101f1fef2d4934a42914fb38",11,11,0,11,11,0,1,2
"14172","62ce932ab4e8ff99634e00be2a0f2eed",88,80,15,41.0666666666667,88,0,1,2
"14173","62d12c83b126831138170dcb0b58db9b",83,70,80,7.2625,57,26,2,1
"14174","62d425352725ededdd6595cf4cd3ff4f",85,55,85,7,36,49,2,3
"14175","62d59191770db4dbd13f656c2acd38af",104,63,59,12.3389830508475,104,0,2,3
"14176","62d6c5e318d78fae48660231ff86e922",61,39,38,11.2368421052632,34,27,2,1
"14177","62da288bcf77ca4e382198279845f3a2",12,12,0,12,12,0,1,2
"14178","62db6ce8e287f0e1f50517f56a11c2d4",66,42,65,7.10769230769231,66,0,2,1
"14179","62dba61fa428a4738e3b7ba1b40f5617",40,40,0,40,40,0,1,2
"14180","62dbe4236076fe3f6c9f60ca9e80da23",1,1,0,1,1,0,1,2
"14181","62de914f3f107ceb50089fa27c9d264c",4,4,0,4,4,0,1,2
"14182","62deafaf02aa97c58d586e80533addf6",29,29,0,29,29,0,1,2
"14183","62dfb753c42c86f4743c0971df968e3c",29,28,15,13.5333333333333,29,0,1,1
"14184","62e20cfce9e2a5a23876ac9e59227f72",2,2,0,2,2,0,1,2
"14185","62e49ef6c488c9ef73dcb16e7c7a871e",133,89,75,12.4133333333333,80,53,3,3
"14186","62e6b9a26d23df20341d07b3ee1d459b",101,60,47,15.0425531914894,79,22,2,1
"14187","62e741139fbb73f74121c69d8c21b3f7",1,1,0,1,1,0,1,2
"14188","62e9ea643fa1a4ad77f78b67b16a2ed9",16,16,0,16,16,0,1,2
"14189","62ed2ba6d454414c59722fa4e4006e69",145,108,64,15.859375,145,0,3,3
"14190","62eec52226db4f2379b36cfc9ea7e8cf",115,56,68,11.8382352941176,115,0,3,3
"14191","62f2e0a938bd51a6f56912eda591d1a9",115,90,63,12.7777777777778,115,0,3,3
"14192","62f41fc35b798ca857b43ba278aefb3f",39,39,0,39,39,0,1,2
"14193","62f4ce727f0a058db3f072afca817d37",67,54,51,9.19607843137255,44,23,2,1
"14194","62f4ed85b5d31ac7e04adc4ef87557a4",70,45,50,9.8,21,49,2,1
"14195","62f528b9bf06f46f22513af0fe900aaa",57,36,43,9.27906976744186,57,0,2,1
"14196","62f577bb5256c43372f1babb817d99e2",16,15,44,2.54545454545455,13,3,2,1
"14197","62f5dda62c765a50d69ffd3a66d44754",52,37,21,17.3333333333333,0,52,2,1
"14198","62f61e8208d9eeb4ab9de1816d589c27",12,12,0,12,0,12,1,2
"14199","62f74ea33363147d7dc96414662b3de1",96,73,51,13.1764705882353,43,53,2,1
"14200","62f7a43fa86ed564094739cd927160b0",48,48,0,48,48,0,1,2
"14201","62fabe7c4d6377767bdea11664d3d858",21,21,0,21,0,21,1,2
"14202","62fd902541e8e1592aa9af49256fe919",26,26,0,26,26,0,1,2
"14203","63021cc0b2babaa7c8c00d6de6ec8d6b",7,7,0,7,7,0,1,2
"14204","63022e0e433ae346a49ca948e6add66a",132,90,49,18.8571428571429,132,0,3,3
"14205","630260324e2ba010a457e10716d7afef",19,19,0,19,0,19,1,2
"14206","630273531d5f3380d46fe59857ff2b93",116,70,19,42.7368421052632,116,0,3,3
"14207","6308d5e9549a20bd34dfa54eda5275e2",41,30,64,4.484375,41,0,2,1
"14208","63096662fddebdf87eb3556dae98324b",47,47,0,47,47,0,1,2
"14209","63099733d2e3becf376e30bd155da7bc",18,18,0,18,18,0,1,2
"14210","630c8097d6eef6dd96f78b7d7b536eda",81,70,28,20.25,81,0,2,3
"14211","6312a8484dbe2e5a4cd1c082f28f8629",78,71,12,45.5,78,0,1,2
"14212","631341e7f013f53329646274e964a6ee",117,85,40,20.475,117,0,3,3
"14213","6313760ed187c1d35bc7d33916289add",1,1,0,1,0,1,1,2
"14214","63145e21000f08c4c718384f9b2ee1eb",83,60,46,12.6304347826087,83,0,2,3
"14215","6317c2427e734122b95f76e96655e359",42,41,6,49,42,0,1,2
"14216","6318169b8882a31fc1b60318fecca9ba",32,32,0,32,32,0,1,2
"14217","631924defb4507ee6943a9324f27ae35",52,34,18,20.2222222222222,22,30,1,1
"14218","631ec8d3603dd391ce4b8af21a5bc00c",107,64,49,15.2857142857143,107,0,3,3
"14219","6320ed78e34e972e90a0fdb2f5ed40de",33,33,0,33,33,0,1,2
"14220","63229497deeb08eb16cd9cbeedf1996d",20,20,0,20,20,0,1,2
"14221","6322d8faac514335a1a187adfb260c22",33,28,57,4.05263157894737,33,0,2,1
"14222","63254ecd2d8afe186f4417c18de30364",29,29,0,29,29,0,1,2
"14223","63257340c8825e4e412bfdbaa4cd54c3",11,11,0,11,11,0,1,2
"14224","632a01c53109ae85e9a2688ab9f53af0",6,3,63,0.666666666666667,6,0,2,1
"14225","632d2c16b7f47da30ac8904dd381ac73",24,23,31,5.41935483870968,24,0,2,1
"14226","632e40890ce0f807e2fb5ba78ade3ca4",184,101,43,29.953488372093,184,0,3,3
"14227","632eba8ec497fcb1c3e7d12e121bf1c7",21,21,0,21,21,0,1,2
"14228","632ef2cef90f37c6bc3da75e2504eeee",33,33,0,33,33,0,1,2
"14229","633008b9f4d7ed9ceadd2ecb0c66eb48",43,43,0,43,43,0,1,2
"14230","6331e1418d89ded5dd2a887bb9f06995",26,26,0,26,26,0,1,2
"14231","6331e91fe1578aec3c2f9a0d331541f3",49,40,9,38.1111111111111,49,0,1,2
"14232","633666593ca5b3e42b8c1a053c739b5a",53,53,0,53,53,0,1,2
"14233","6338427e6ae597730c47406ef04434c6",15,15,0,15,15,0,1,2
"14234","63386ccc7daca65a4a822d99296c1d8e",23,23,0,23,23,0,1,2
"14235","6338a292cf9314f0babc6d9ccd2420ec",167,109,32,36.53125,167,0,3,3
"14236","6338a329125a291a1abd2c4deb3029c0",28,28,0,28,28,0,1,2
"14237","633a97ac931b0001e7fd68ff827bb158",14,14,0,14,14,0,1,2
"14238","633ad29f17fc864b1b4560c820d80ec3",24,22,56,3,24,0,2,1
"14239","633ad5327985c94428ff2d7cecc1a81a",158,67,77,14.3636363636364,158,0,3,3
"14240","633c7c8c15a6d233c476fa6e17496ac7",5,5,0,5,5,0,1,2
"14241","633cab6d17e5e924ced0328e4d7d9554",30,30,0,30,30,0,1,2
"14242","633d28c04cdb6e64ae211a9eaa73138e",19,19,0,19,19,0,1,2
"14243","633df7980b1cb00653c31bbfa0987351",6,6,0,6,6,0,1,2
"14244","633e3aa766232d1924893f5584c0442b",47,47,0,47,47,0,1,2
"14245","633e3d0d57a1971287ca9391a6c138e8",41,28,53,5.41509433962264,32,9,2,1
"14246","6343c7865e3700b1829bbcea2fb87171",152,110,75,14.1866666666667,152,0,3,3
"14247","6346b97e37571c30f03b8857625109b0",40,34,78,3.58974358974359,15,25,2,1
"14248","63489ebdf13dbcb320a6d24a31d39e02",54,54,0,54,54,0,1,2
"14249","634afa2bc7556e046703a56d2b25f15f",33,29,14,16.5,0,33,1,1
"14250","634b1677c1226d9c68ac70ed7d4298f0",29,29,0,29,29,0,1,2
"14251","634c60a06ce71717c14bf4d4e2dfe275",154,109,72,14.9722222222222,154,0,3,3
"14252","634c9b0a7841a0b3c184f75efd2a34fe",59,41,56,7.375,59,0,2,1
"14253","634da19b70b64469e3f791750491732c",101,72,62,11.4032258064516,101,0,3,3
"14254","634f51eeb036b38782c1636122895aa6",15,15,0,15,0,15,1,2
"14255","63507f0671658d9e5ee42c137397c536",57,36,60,6.65,57,0,2,1
"14256","63542acb0c0b770d535881ef8406e35b",5,5,0,5,5,0,1,2
"14257","63559f510e6300331ff959003661ca69",35,31,33,7.42424242424242,35,0,2,1
"14258","635aa80babcd7265c3f6bf35e8444bc6",154,66,80,13.475,154,0,3,3
"14259","635e4a62f8528f3cdab247bd4d236f4e",173,122,69,17.5507246376812,173,0,3,3
"14260","63602bf443401ac6248491593869d392",27,27,0,27,27,0,1,2
"14261","636158985e3e47ab307eb28ce6a5b5e6",21,21,0,21,21,0,1,2
"14262","63615be321a74109d9e54296039aafd0",35,31,30,8.16666666666667,10,25,2,1
"14263","6362b8536233d494079d115097b94868",21,16,57,2.57894736842105,21,0,2,1
"14264","6362e001a55ce5da3676b74295ed9886",54,54,10,37.8,54,0,1,2
"14265","6367cc63ddca8fc9d03bbb80fc48b431",48,48,0,48,48,0,1,2
"14266","63685733b63ae6c6188203ee2232696b",1,1,0,1,1,0,1,2
"14267","63691da05ef05f306e3036eaa3ff3ce2",12,12,0,12,12,0,1,2
"14268","636973b9fc1b68eed63fff5f9a4b188b",14,14,0,14,14,0,1,2
"14269","6369e00796ad5379c71a933795217593",11,11,0,11,0,11,1,2
"14270","636ce57ae5fee08037f0892ee4d6d0c7",33,33,0,33,33,0,1,2
"14271","636e5a2915459faeeab17ebafdb736ef",27,27,0,27,27,0,1,2
"14272","6370c655679575cc03afe7cbe0427d7a",77,59,42,12.8333333333333,77,0,2,3
"14273","637162f2b202b76e8e61003d711132e9",24,22,32,5.25,24,0,2,1
"14274","6372a4ba690d41601b45a15c4cf09bb7",13,13,2,45.5,13,0,1,2
"14275","6373ae930c450ea4147367452a03339d",40,34,24,11.6666666666667,40,0,2,1
"14276","6373ecce093f916ce931a4ea2bfcfc6f",15,15,0,15,15,0,1,2
"14277","63746e008cbdfd2b6c64db6f5dcf528f",28,28,0,28,28,0,1,2
"14278","6378bf4ba5d5f75d3b8ee9553d7f1b79",112,55,76,10.3157894736842,112,0,3,3
"14279","6379987a44eb1f04b1eedf169b82967f",198,66,77,18,198,0,3,3
"14280","637a2632df361c09968a4f966bdf91d9",68,50,28,17,22,46,2,1
"14281","637d9cfaee02649f97333139bf493cf4",52,22,80,4.55,52,0,2,1
"14282","63827000af721a4d88f9cbe46df0c9b1",22,22,0,22,22,0,1,2
"14283","6384d48a101beda0aaeefb650b7cb6d9",36,26,69,3.65217391304348,36,0,2,1
"14284","638566ca9c76541f522c246b7100221b",182,111,78,16.3333333333333,128,54,3,3
"14285","6386dfdea85c240fdffc3334e64b7b8e",254,118,82,21.6829268292683,212,42,3,3
"14286","638851ed0516907cc1e372e40cff340e",172,124,44,27.3636363636364,172,0,3,3
"14287","63886c0a7b6fdf977309812e767ca9c5",2,2,0,2,2,0,1,2
"14288","63895eb93be8f4fed153a829d9677f42",47,47,0,47,47,0,1,2
"14289","638ab6c9f21acb26a6f6aac297c8a536",15,15,0,15,15,0,1,2
"14290","638adb3ee3a68db08b2bd7e3c8e4cd6b",112,87,63,12.4444444444444,112,0,3,3
"14291","638b343eb0e7a4b3617eb93209ad4138",27,27,0,27,27,0,1,2
"14292","638c75164fcb89b5779f310e852defe0",50,37,32,10.9375,50,0,2,1
"14293","638e6a81c29f83c00fcd2b73adca5edc",227,115,50,31.78,186,41,3,3
"14294","638fe92202173bb713d3aa2f5bf5d1c5",141,68,74,13.3378378378378,108,33,3,3
"14295","63919da1968dd92b4ad23fed351014a6",4,4,0,4,4,0,1,2
"14296","6391f92233838a6ae90eddefc06f28c3",11,11,0,11,11,0,1,2
"14297","639215a19a4f2079c794853e0bc908c6",33,33,0,33,0,33,1,2
"14298","6395ee9bda85442d26566865977e0b82",32,32,0,32,32,0,1,2
"14299","639616f8a680b0bbbed1a936b121f92f",12,12,0,12,12,0,1,2
"14300","6398055365b8b4dfc9672d85662f620c",116,66,77,10.5454545454545,116,0,3,3
"14301","639ce1c27bd7b4920b5bd41107f7ee5a",51,40,54,6.61111111111111,20,31,2,1
"14302","639dc0c58a8b527c329de626aa6cdca4",171,113,86,13.9186046511628,171,0,3,3
"14303","639e748b3bdf282453e31184856a347c",31,31,0,31,31,0,1,2
"14304","63a03c153c49751fc4b7b99a59796036",65,54,62,7.33870967741935,65,0,2,3
"14305","63a59c83373868fbd0c3b05ae8fc968a",51,41,53,6.73584905660377,51,0,2,1
"14306","63a616874830af49682efdce2fdc9fa4",20,20,0,20,0,20,1,2
"14307","63a6471ca2bcee8aeea2e490bfd83341",55,41,48,8.02083333333333,55,0,2,1
"14308","63ab776179d57475568a50de73a2986f",22,22,6,25.6666666666667,22,0,1,2
"14309","63ac8361cf56ab2d8caf7b4771151774",164,102,61,18.8196721311475,164,0,3,3
"14310","63ad47d011dcb37966dfb08feae8c0f7",21,21,0,21,21,0,1,2
"14311","63b0f7858cd4e89082d87ee8f80c5b72",55,45,35,11,20,35,2,1
"14312","63b1b14bc3ebcc493a5fefe976f3b5c3",112,60,56,14,87,25,2,1
"14313","63b3ec8d99e46fe4b46e16d5a9ec6df5",68,57,42,11.3333333333333,68,0,2,3
"14314","63b4665567e30e4e9fe5f03cbd5cbdf2",37,37,0,37,37,0,1,2
"14315","63b4dcabac026d419639933d390243df",38,26,65,4.09230769230769,38,0,2,1
"14316","63b6923c4d3f949eac0b3b3e61a07bff",29,29,0,29,29,0,1,2
"14317","63b825469ebec93eddbb606161163021",9,9,0,9,9,0,1,2
"14318","63b82b302627c7adf7e44c58aa0ec4cd",66,52,52,8.88461538461539,66,0,2,1
"14319","63b921f36bf64f790f5e2d597a7384cc",46,35,33,9.75757575757576,46,0,2,1
"14320","63ba70e3edf50ca55c76601f1fd087e3",12,12,0,12,12,0,1,2
"14321","63bbc4bfa33492434914ab78e3859e90",25,25,0,25,25,0,1,2
"14322","63bd656407049bf688f655c513f5f768",30,24,38,5.52631578947368,30,0,2,1
"14323","63bd9c1b5081d08f8883068f34ee1d50",32,32,0,32,32,0,1,2
"14324","63c02f0557e785c613fb220594600045",2,2,0,2,2,0,1,2
"14325","63c0581d799ed4fe7d21ef0647b6ac34",30,30,0,30,30,0,1,2
"14326","63c06ee4026cbebac9a67af2d10b00ea",27,27,0,27,27,0,1,2
"14327","63cc07fbe7e222d0ea664b0b1dc737f5",28,26,37,5.2972972972973,28,0,2,1
"14328","63cd9cbc48e47a3d247b4308cf45cf1e",47,38,42,7.83333333333333,47,0,2,1
"14329","63ce2a9b4e6c5f9d68ef3cfe47ed3f53",131,86,62,14.7903225806452,84,47,3,3
"14330","63ceced61d08ce1dba03e83e0500ab73",73,61,36,14.1944444444444,73,0,2,3
"14331","63d481821b262eb1b20a6d1ebe0ff293",1,1,0,1,1,0,1,2
"14332","63d5f5d4a14c9054496bd35920530eee",27,27,0,27,0,27,1,2
"14333","63d6a714ccf8e7fd5a0b591d1c91554f",40,36,51,5.49019607843137,40,0,2,1
"14334","63dc36aa0d866a3b99e13f7891db4d80",48,45,20,16.8,48,0,1,1
"14335","63dc886f61070a8c8e5ef15884c35442",21,21,0,21,21,0,1,2
"14336","63de0b687df330f61897de69d8efc5fb",74,51,55,9.41818181818182,74,0,2,3
"14337","63de5ceece0b38d52f0338228d4dcef4",26,26,0,26,26,0,1,2
"14338","63df569c1b610787d67f4da0f2f5d2ea",33,33,0,33,33,0,1,2
"14339","63e0be0351d34760a3f04a6cdc55f8c9",32,32,0,32,0,32,1,2
"14340","63e407b6a44b9d68769970ae5014ccb4",141,46,85,11.6117647058824,125,16,3,1
"14341","63e418614945f65f642f689b75d3b0c5",132,76,65,14.2153846153846,132,0,3,3
"14342","63e55a49c3398f4a93c212359c164d92",48,48,0,48,48,0,1,2
"14343","63e899f37bbb073a8b1fa22c1d0b016d",20,20,0,20,0,20,1,2
"14344","63e91f23e967eea957022adb12a6240c",15,15,0,15,15,0,1,2
"14345","63ea6f438991ed23350780eb255151cc",95,69,53,12.5471698113208,95,0,2,3
"14346","63ec292e25441e34dfe919309675efef",8,8,0,8,8,0,1,2
"14347","63ed16d214bb48f57aa374cb6ea53ecb",153,89,72,14.875,153,0,3,3
"14348","63eef61f7aa6dff6869114a1c14c823a",46,39,39,8.25641025641026,33,13,2,1
"14349","63f0c97cffdcb6f4d1c421732ed8da4c",67,57,31,15.1290322580645,67,0,2,1
"14350","63f20d396a24620e9f2bf0e5cc733acc",61,57,52,8.21153846153846,61,0,2,3
"14351","63f21f5ceb246fa57d94a701ecf7b61c",103,67,77,9.36363636363636,103,0,3,3
"14352","63f3ed8d005bae6d7c1ef2cd6aad30d6",135,105,53,17.8301886792453,135,0,3,3
"14353","63f45c4128f8e20b0b34a527242e1f10",1,1,0,1,1,0,1,2
"14354","63f4941ff2e9aa3912d8cf7d68eb3536",79,65,13,42.5384615384615,79,0,1,2
"14355","63f4c3ddd31bdad6e296ef9dd44d742a",32,32,0,32,32,0,1,2
"14356","63f5854bd22a9b681dae34e2e43e04c8",37,37,0,37,37,0,1,2
"14357","63f74f3a69073ddf9a635d794ee88555",51,44,42,8.5,51,0,2,1
"14358","63f7eba205efea2c7b9c7f60c0c3df3c",59,50,65,6.35384615384615,59,0,2,3
"14359","63f82278f84a1bfaf5d0e61592942a42",101,64,63,11.2222222222222,101,0,2,3
"14360","63f889f88d087771191f1a1840dcd864",15,15,0,15,15,0,1,2
"14361","63f89b023307f26d057c801609f504d9",17,17,0,17,17,0,1,2
"14362","63f9d0e6cbf0b2768cf21ee155a57560",30,30,0,30,30,0,1,2
"14363","63ff1614e52e66bff4244e0e19fcc5ef",116,72,80,10.15,116,0,3,3
"14364","63ff92feaea16f3c06b0486ecabe4ca2",79,66,15,36.8666666666667,79,0,1,2
"14365","640065eaa0240f7acbcd10cbbfe3e77b",20,15,49,2.85714285714286,20,0,2,1
"14366","6402585621785562d5c2c8fb46665a2a",99,80,22,31.5,99,0,3,3
"14367","6402f278094db29a552edaac6fc10c94",34,34,0,34,34,0,1,2
"14368","64048749cf6f8bb1370766359ab5d851",82,54,64,8.96875,82,0,2,3
"14369","64055b913034091c6412c85a5e7143da",44,31,35,8.8,34,10,2,1
"14370","6405c88eecd58982c8f53835a855d1b5",9,9,0,9,9,0,1,2
"14371","6407a527a2b0d8f6c742f3b3b371e8f2",11,11,0,11,11,0,1,2
"14372","64091a6481052f7af7e2504e76ef0a9a",15,11,48,2.1875,15,0,2,1
"14373","640a10b5138d6c2ac9bd22868d37e25c",14,12,37,2.64864864864865,9,5,2,1
"14374","640bd17b62d8e894b20487a5c4c0d02e",17,17,0,17,17,0,1,2
"14375","640c1049c47577062cdcf9618b50a9cf",23,23,0,23,23,0,1,2
"14376","640c1a7093d55d00818065e87d85495a",27,27,0,27,27,0,1,2
"14377","640dde421b776bffb8105fa2caad5899",21,21,0,21,21,0,1,2
"14378","640e20fcc7ddb1dc350cf3ee7019537d",2,2,0,2,2,0,1,2
"14379","6412e7bfd7fdf459022cd5ddba22e5ad",37,37,0,37,37,0,1,2
"14380","6413f9a384118b1ad2d6bf1de337ecd2",187,123,73,17.9315068493151,187,0,3,3
"14381","6414c915afd06d8b9cf2d66a60a464ba",16,16,0,16,16,0,1,2
"14382","6415cf448fe512bead536f8e9c18e855",23,23,0,23,23,0,1,2
"14383","6417ef56e5954ffe965d12c99400cd4a",83,64,69,8.42028985507246,83,0,2,3
"14384","6418039add62066c442ac35c5a5a58cd",100,83,60,11.6666666666667,100,0,3,3
"14385","64183606fc8549f53b1bf5a80c2c2841",122,51,75,11.3866666666667,83,39,3,3
"14386","6418b516e9c0fc8e5c16dbc3010c3c37",86,64,69,8.72463768115942,86,0,2,3
"14387","6419b8632e9043c520b34a6a20ea4bdc",47,39,65,5.06153846153846,47,0,2,1
"14388","641b6f1454530346c2eb5b3012131816",125,90,23,38.0434782608696,125,0,3,3
"14389","641e8e4af152d748f72f18988a11979f",154,97,64,16.84375,154,0,3,3
"14390","641f33486e2ff872358d1371114aab41",123,99,36,23.9166666666667,123,0,3,3
"14391","6422af170de208d3199e686630490a70",27,27,0,27,27,0,1,2
"14392","64233d13290572422b91539fe2192c60",208,112,87,16.735632183908,208,0,3,3
"14393","64233f9fc383df5437eb2350d42df781",79,63,43,12.8604651162791,79,0,2,3
"14394","6423f2de7534a2799bee4bc7099c870e",157,99,46,23.8913043478261,157,0,3,3
"14395","642732465d27b05a68258f1547678dca",48,39,39,8.61538461538461,34,14,2,1
"14396","642a5ca73490351afb35e1bc34114c8c",31,31,0,31,31,0,1,2
"14397","642e702bac5e9d4b8e3e3cd192cfa3cd",87,64,14,43.5,87,0,1,2
"14398","6433debd82517392f57b520d29b184f1",5,5,0,5,5,0,1,2
"14399","64356f6d29a56b33f3f9035ec7c618c3",95,64,77,8.63636363636364,95,0,2,3
"14400","6436151a83f9c2d56cea3b5345a69e74",58,37,61,6.65573770491803,33,25,2,1
"14401","6437000b6056d4778c16919111ddf3db",5,5,0,5,5,0,1,2
"14402","6437f2a15899aab4e0cbc85d214aa13d",106,63,80,9.275,106,0,3,3
"14403","6439e9d72ca3749f964f561f8a5276bf",224,106,78,20.1025641025641,194,30,3,3
"14404","643af9b4be86dce59f7fbc2dde5f804c",1,1,0,1,1,0,1,2
"14405","643c1038491e42837658b7238f5fc357",128,77,50,17.92,85,43,3,3
"14406","643da281ffe0eee176c642f0a44058f0",198,125,77,18,198,0,3,3
"14407","644a014783fa1d5a6d0c431da8f7ded3",62,50,21,20.6666666666667,62,0,1,1
"14408","644c8c04ac595ebf5aa5e57179d3cec0",22,22,0,22,22,0,1,2
"14409","644d2f94cc1c1ffa40765f6d04847225",53,50,56,6.625,24,29,2,1
"14410","645049be9d2f36a8bf59034c832351e3",97,67,70,9.7,97,0,2,3
"14411","6450dfe6171e612d180aae42cacea9bb",132,110,74,12.4864864864865,132,0,3,3
"14412","64592aea074dfe73422757ba5f3ce5ae",34,34,0,34,34,0,1,2
"14413","6459a349797695339272d2abb76bfa55",24,24,0,24,24,0,1,2
"14414","6459cdf160836d838970b36856bbda0e",9,9,0,9,9,0,1,2
"14415","645b112ba3e9fd36db68a4b1fa97ae8e",49,17,85,4.03529411764706,38,11,2,1
"14416","645dad33ac63b29da22aa5d5b8c1b788",214,126,84,17.8333333333333,175,39,3,3
"14417","64625b93e5f6381f52202bf2a6d29edf",201,86,63,22.3333333333333,161,40,3,3
"14418","64638843caf0f5079ce9474b4e162878",12,12,0,12,12,0,1,2
"14419","6464acc57a85d230902df62a3d13c947",46,39,55,5.85454545454545,46,0,2,1
"14420","646503a7bdcf976de1ff6e686612711d",30,30,71,2.95774647887324,30,0,2,1
"14421","646816d2e788275d01ab3e93aeb3828c",18,18,0,18,18,0,1,2
"14422","646ae9189f388998b11abc34deea2293",26,11,62,2.93548387096774,26,0,2,1
"14423","646c9501d1ab7849c037f14a67212490",53,48,12,30.9166666666667,27,26,1,2
"14424","646cec43a969f6f6ebf22174092ac21b",41,37,48,5.97916666666667,22,19,2,1
"14425","646df903fdd68485db5afd769b8d1dfd",81,52,49,11.5714285714286,81,0,2,3
"14426","646ef1bb99f32c02cc0f27816a3af063",84,54,32,18.375,84,0,2,1
"14427","64749f1d210c8d90f73367fb505662d1",99,59,37,18.7297297297297,74,25,2,1
"14428","6475f64b02e7a80ab66a6c22c6c34ee8",174,80,78,15.6153846153846,174,0,3,3
"14429","6476cd14aa136ad4f818e9e7bb55cbb3",99,50,55,12.6,99,0,2,3
"14430","6476f55b552dc206a2ef0dbc58a395e2",36,36,0,36,36,0,1,2
"14431","647a0f5f8a991975c83645791ba05b1c",207,130,40,36.225,165,42,3,3
"14432","647a59e511e755f572b71c1170efcade",56,56,0,56,56,0,1,2
"14433","647bd11f7364a403cfc11e58d33b8074",15,15,0,15,15,0,1,2
"14434","64809e3f4662860abf79bb8c1d404a40",66,48,56,8.25,51,15,2,1
"14435","6483d3ec4c3d47be3ae92054371f90e7",86,48,85,7.08235294117647,72,14,2,1
"14436","6484ebf751f588d767d16a0ba68fa296",128,92,37,24.2162162162162,75,53,3,3
"14437","648655ae643a95f02ac7e018b5a60b44",40,40,0,40,40,0,1,2
"14438","6486ba6b4f3189929c9e6b24111735a2",18,9,54,2.33333333333333,18,0,2,1
"14439","648a176999e9ef8f3cf9b92258d6df1d",14,14,0,14,14,0,1,2
"14440","648b31ae4f7b2bcea1a01afc72d8cb38",88,44,67,9.19402985074627,88,0,2,3
"14441","648c49b217f8b63fbd7bb6bfbdfd7352",143,79,84,11.9166666666667,118,25,3,3
"14442","648d8a8bfb7366b1e8d42e77e29cdd81",94,65,67,9.82089552238806,94,0,2,3
"14443","648ed8b4d295d4ada07acb1629724f19",207,116,58,24.9827586206897,207,0,3,3
"14444","649063354b9f9e123f2c1610e9347356",38,38,0,38,38,0,1,2
"14445","6490b6398fe5e9e5fe6e58dbb789e37e",38,28,32,8.3125,12,26,2,1
"14446","64912894ba45558bfcce023f8aa6ed8b",14,14,0,14,14,0,1,2
"14447","6491ecf6a688053633e836c853b4a125",102,77,33,21.6363636363636,54,48,3,3
"14448","6495147739838210c4112a6c5efa3e69",29,29,0,29,29,0,1,2
"14449","6499aaf157b8c94132910aee6577a574",113,63,42,18.8333333333333,113,0,3,3
"14450","649ebd84081b1e52ce1e1a4f17eefca8",56,34,21,18.6666666666667,56,0,1,1
"14451","64a0480a258ca9f993c554b21b8365e4",18,18,70,1.8,18,0,2,1
"14452","64a214ed5e7fecc6d85f6c7e12d6c915",20,20,0,20,20,0,1,2
"14453","64a50af6f4a8a4dc2c9c8f08125db10e",124,83,71,12.2253521126761,124,0,3,3
"14454","64a744255eb5363db5478746398f3553",24,24,0,24,24,0,1,2
"14455","64a7b79ee4f6d24b510d7708b19b6005",41,41,0,41,41,0,1,2
"14456","64a8a9da48c5d6b66985a4e99fe037b1",31,31,0,31,31,0,1,2
"14457","64a967aaf51a71cef4e5c2c427899521",29,29,0,29,29,0,1,2
"14458","64aa38233d6718754e9ad33127f1821f",31,31,0,31,31,0,1,2
"14459","64aa63682fdc967ec04ff040401c4a94",71,59,32,15.53125,44,27,2,1
"14460","64ab0c5957ac86abd83af9604947521e",63,45,40,11.025,36,27,2,1
"14461","64ab2fc844178d75f9e9b1833da58486",20,15,68,2.05882352941176,20,0,2,1
"14462","64abc5285916615a57c6c8af19e99057",12,12,0,12,12,0,1,2
"14463","64ae4da6e5ec8396ba1e0c160594b63f",96,63,70,9.6,84,12,2,1
"14464","64afa74effc9935dc4ffec2ddd46feba",114,88,21,38,114,0,3,3
"14465","64b1a048285138d96284be380c43340a",20,20,0,20,20,0,1,2
"14466","64b2e3081310bc5ef6b7823c6149a581",41,41,0,41,41,0,1,2
"14467","64b6714a2c0fc6dc69ee1b60c356ec1f",11,10,6,12.8333333333333,11,0,1,2
"14468","64b6f05e81b642f81eb1553607f8a4b5",13,13,0,13,13,0,1,2
"14469","64b91e671fe04c7524718fdf98a38084",100,64,69,10.1449275362319,100,0,2,3
"14470","64bb986bbdadb13b604ee54f745bcd0e",23,23,61,2.63934426229508,23,0,2,1
"14471","64bc01d7e88fbcb6b69a031575864767",100,72,35,20,100,0,3,3
"14472","64bfd16ebace99a24b1a5bd3e12a503d",57,40,29,13.7586206896552,57,0,2,1
"14473","64c20aacb470e5a3241d95adc15514aa",108,84,40,18.9,108,0,3,3
"14474","64c517ebea322f7b5b3bfca9d7f0faa1",32,32,0,32,32,0,1,2
"14475","64c59e5330bd1a9b5e53002449faa9ed",30,30,0,30,30,0,1,2
"14476","64c7eaf418be99594dbfba7f0147eaef",135,72,51,18.5294117647059,109,26,3,1
"14477","64c9bc8d7844023638c0b1e87d2769d9",21,21,0,21,21,0,1,2
"14478","64cb1e024ddc347bd10c60c19f4726c9",16,16,0,16,16,0,1,2
"14479","64ce7dcebde263eb826605c6a332bcd4",23,23,0,23,23,0,1,2
"14480","64cede36912c2d92b83f3f7b41725a88",11,11,0,11,11,0,1,2
"14481","64d14fdc6e7d4f9c048c38af7fa6e488",194,150,74,18.3513513513514,194,0,3,3
"14482","64d366c43cd4d35f22623198b4797c32",73,55,54,9.46296296296296,73,0,2,3
"14483","64d5024ee787b11342abbf25729d73cc",27,27,0,27,0,27,1,2
"14484","64d5593f70e9288cd0a3bbc074a5f005",35,35,0,35,35,0,1,2
"14485","64d56c6774b8facf8be5a913f3ac10bd",33,33,0,33,33,0,1,2
"14486","64d5ed8e2809858855cd8f25c3667bd7",51,51,0,51,51,0,1,2
"14487","64d6686fc0e4d0cb8f43deeaf91df4ab",21,21,0,21,0,21,1,2
"14488","64da28375de39ebc25c790407ef647fb",57,44,28,14.25,57,0,2,1
"14489","64e117bbf0dfc21bbd5217eef84c5c3c",44,44,0,44,0,44,1,2
"14490","64e1e87361bcb7cc12c46bee1638df05",89,55,79,7.88607594936709,78,11,2,1
"14491","64e384974c01b4365248d1f96b920cb4",97,78,49,13.8571428571429,97,0,3,3
"14492","64e3fc79c3b36c0fb5876316deba480d",19,19,0,19,19,0,1,2
"14493","64e5afdf1958e8869cc940be922edafd",29,29,0,29,29,0,1,2
"14494","64e619c794231ad77958638f5f7067a9",63,55,45,9.8,63,0,2,3
"14495","64e693968a7ae7bed273b97068d100b1",44,44,0,44,44,0,1,2
"14496","64e6d6b925c6f17df8f6e839db39155c",106,61,74,10.027027027027,54,52,2,3
"14497","64e86db2844b2d916e49344d79a867bf",150,104,74,14.1891891891892,150,0,3,3
"14498","64ea271a3c76629f531eea496f746314",72,58,60,8.4,72,0,2,3
"14499","64eadbc0f1fa876e53cb3ab2173b0698",78,62,26,21,78,0,2,1
"14500","64eade16499db9c14236bced639942d4",70,43,54,9.07407407407407,70,0,2,3
"14501","64ec0b56aab1a1d931c72d5395e9e044",19,19,0,19,19,0,1,2
"14502","64eca474bc6c1ae3186e61b51b77a513",10,10,0,10,10,0,1,2
"14503","64f1353b38d5b3d2d69b6f24350b5ce1",11,11,0,11,11,0,1,2
"14504","64f2ab386e77c1b98df0401a3190429c",51,51,0,51,51,0,1,2
"14505","64f485d9b5f6267085c66b3e946420a6",23,23,0,23,23,0,1,2
"14506","64f52a95545bd98cb7f8f28e29ec0971",71,50,54,9.2037037037037,71,0,2,3
"14507","64f57164d1968c8605ac603022deac62",97,82,74,9.17567567567568,97,0,3,3
"14508","64f70275d6227a5e61acfde954045e67",78,67,58,9.41379310344828,78,0,2,3
"14509","64fb0f7e976735c066f8ffb04a784a1b",138,68,71,13.6056338028169,88,50,3,3
"14510","64fb9844fa6d1c086ec10b27d5bd34bf",27,19,21,9,27,0,1,1
"14511","64fbbdd219197d8e18aa15613357c03f",101,84,35,20.2,101,0,3,3
"14512","64fcb7e3499986304e76d4249b108f70",29,29,0,29,0,29,1,2
"14513","64fd2aa865c0d55bdb0394e55b91720a",22,22,0,22,22,0,1,2
"14514","64fd33c2f4e2129384a2157d0c1a9b51",9,6,30,2.1,4,5,2,1
"14515","64fd4111a8858a4348977aa1c43ba2df",56,56,0,56,56,0,1,2
"14516","64ff95a656711e7101fad16023b82376",25,25,0,25,25,0,1,2
"14517","65002107bb501fa579dc0151bb057873",67,44,77,6.09090909090909,67,0,2,1
"14518","65002f1f230a0f8fb6fc9239b1bf59af",133,92,66,14.1060606060606,83,50,3,3
"14519","6501c851cd3361621f8afe0788aa3f35",46,37,39,8.25641025641026,46,0,2,1
"14520","6506438082b5c82d5f2b7946d1625ef1",6,6,0,6,0,6,1,2
"14521","650801cd14af23f0d2ba77077d464268",76,58,43,12.3720930232558,76,0,2,3
"14522","65093ecd02932162f9ed9f981b2fed07",43,43,0,43,43,0,1,2
"14523","650d29698f657cbb63e159df116b6748",216,96,65,23.2615384615385,172,44,3,3
"14524","650df44d9d3b81ba843ce870c475f92a",44,44,0,44,44,0,1,2
"14525","650ef7de28d7b144d4b14fe14626d66e",104,77,61,11.9344262295082,55,49,3,3
"14526","650f7cbc8db425016d479cc1b214702f",177,67,72,17.2083333333333,130,47,3,3
"14527","651114a685672d39b5e4ac6e9a293ac5",15,15,0,15,15,0,1,2
"14528","65145c81fa9ad83c56a4e8981c96af92",88,64,30,20.5333333333333,88,0,2,3
"14529","65147291c5acc58e38cf26333047fc53",29,29,0,29,29,0,1,2
"14530","65154dfd391e994703822f81619815f4",128,91,68,13.1764705882353,128,0,3,3
"14531","65175dabebad6e5a270d75c0e809acd3",35,32,6,40.8333333333333,35,0,1,2
"14532","65184f8eb431aa8882ad6897cc91252f",84,66,32,18.375,84,0,2,3
"14533","65195614aed65d584a0e0147c07b889e",14,14,0,14,14,0,1,2
"14534","651cfd93916e3ce6668767f5f8513819",41,37,15,19.1333333333333,41,0,1,1
"14535","651d1957250c382f1ca4b4d90fb7bf1c",113,68,65,12.1692307692308,113,0,3,3
"14536","651dc487cf22a656a8adeb64f5a778f8",152,50,72,14.7777777777778,125,27,3,3
"14537","6520b3cfbbf08410e6eee4b6142d35a4",113,70,46,17.195652173913,113,0,3,3
"14538","6520bd446bac47de4598a5bf2a46e300",80,69,23,24.3478260869565,80,0,2,2
"14539","6523c086bba503055adad37cfa95405a",4,4,0,4,4,0,1,2
"14540","6523d1a8a70bdbbc55cb7d9f3253b122",20,20,0,20,20,0,1,2
"14541","6523feb290d0e1cb2363fbc846731931",32,32,0,32,32,0,1,2
"14542","652467d0d295401ccc8e74ec9c3c5b42",43,43,0,43,43,0,1,2
"14543","6527f1da6d8c8835fa56e27a37054d0e",81,57,32,17.71875,42,39,2,1
"14544","652936a593cf2bc67aa5a5a8db1a056b",97,55,83,8.18072289156627,97,0,2,3
"14545","652a59b03e229ecd2405d9ee59b3ac6a",32,32,0,32,32,0,1,2
"14546","652a67c82e1e2ce353ce6d085f1a5a24",6,6,0,6,0,6,1,2
"14547","652a75f4a3a7339595a7fe2d024ff493",10,10,0,10,10,0,1,2
"14548","652d095a853de482a96192c3a1a98276",20,20,0,20,20,0,1,2
"14549","652e7b26d65333ca6f6029a328b283f0",77,63,66,8.16666666666667,77,0,2,3
"14550","652edfc861a9f9bfd941bd76986a6697",54,39,44,8.59090909090909,54,0,2,1
"14551","653389e6c4af2f156ae143b67c07bdb5",77,50,71,7.59154929577465,77,0,2,3
"14552","653793f468c7d3d05a79fa4982fefe7c",160,78,54,20.7407407407407,127,33,3,3
"14553","65384c0dd85c40262c5bde8f4c9b4b2c",21,21,0,21,0,21,1,2
"14554","6538ac3f527be9bcfe93a4d5e60014ca",49,45,21,16.3333333333333,49,0,2,1
"14555","6539dc5cec69e2016ae677075ace3dcf",17,17,0,17,0,17,1,2
"14556","653c70aa46c3990ab846f8a52fed4c78",32,29,8,28,16,16,1,2
"14557","653d8c6695a285327cae3907f2f39494",22,22,0,22,22,0,1,2
"14558","65415232a5f6f189d4f9b04860673997",27,23,70,2.7,27,0,2,1
"14559","654599e58f3671e71c862fbbc98ac1c4",104,60,50,14.56,104,0,2,3
"14560","65490422d90b757c09c64cffab1bf98b",87,59,82,7.42682926829268,87,0,2,3
"14561","654a20ed540b54cbe802ee60051ab162",44,44,0,44,44,0,1,2
"14562","654a2598f157f5e2e6a54a49a66007c9",40,40,0,40,0,40,1,2
"14563","654a32388bc340e2892b7bf5d84231d0",42,38,17,17.2941176470588,42,0,1,1
"14564","654b88c2729766d125de1505fa4aaf9c",86,60,49,12.2857142857143,86,0,2,3
"14565","654b8e24b58d10cf1e808831d7ad256e",107,48,61,12.2786885245902,107,0,2,3
"14566","654ff3594239bba2a72e8f16659cce67",82,60,46,12.4782608695652,65,17,2,1
"14567","65521d3e93c4fe225294763b52d72c97",96,72,14,48,96,0,1,2
"14568","6552f03b148825233bf6318e9b283a69",31,31,0,31,31,0,1,2
"14569","65535faaef200b1b149f252d034c596c",142,76,83,11.9759036144578,109,33,3,3
"14570","6553b1d2305b1fd06a29c75c7eb092d0",77,52,25,21.56,77,0,2,1
"14571","6555c594c1dc91cd589840073a79e355",128,57,72,12.4444444444444,128,0,3,3
"14572","6556f33bf0b2101b4eb5149e9f6985e6",35,35,0,35,35,0,1,2
"14573","655824760ee3fe8569ac9242f78d0380",22,22,0,22,22,0,1,2
"14574","65584bcff3c899a4941b05a55dfe404d",73,61,51,10.0196078431373,73,0,2,3
"14575","655c9acd20fd8a3391914dcdd72c825b",12,10,50,1.68,12,0,2,1
"14576","655d0e7dc95f62fb3cb94db1fda13035",170,107,78,15.2564102564103,170,0,3,3
"14577","655d6e809a050ed6a0ae33debd8e8688",66,47,29,15.9310344827586,66,0,2,1
"14578","655ebd4e58db9473ebb75e66380f5c5d",15,15,0,15,15,0,1,2
"14579","655ec6b057cb65e19b281492a988a97c",158,98,75,14.7466666666667,158,0,3,3
"14580","6560e884891b6af37dc0dd8a628ca526",26,26,0,26,26,0,1,2
"14581","6560f1f853f4a51c5dba265b1f102ab7",18,18,0,18,0,18,1,2
"14582","6563d69a954a49b1f3a2b3c5f5227db4",25,25,0,25,25,0,1,2
"14583","6564c843c4607d3a6a0014beeaf8e095",55,55,0,55,55,0,1,2
"14584","6564f9fb9c4ad7ecf071a80956c9e906",18,18,0,18,0,18,1,2
"14585","65655ce9d19d9079196fc8532e1a7143",192,100,59,22.7796610169492,192,0,3,3
"14586","65661db9dd6d51603b171a4ca76089cc",5,5,0,5,5,0,1,2
"14587","6567a9118c03e518e0011eaaad17aab7",112,85,68,11.5294117647059,83,29,3,1
"14588","656853d8e3db45d938dffe156683b406",141,75,53,18.622641509434,141,0,3,3
"14589","6568d495509dd8a9185f1890bd3e9fe4",3,3,0,3,3,0,1,2
"14590","656a7272d1233fdc4231ace3c0b1e3b8",5,5,0,5,5,0,1,2
"14591","656ba68d8bc78fc3ef571aea64e9c926",53,53,0,53,53,0,1,2
"14592","656eab06e9819a8a57c6b50a11d30010",22,22,0,22,22,0,1,2
"14593","6570bd78d41c12ac34f0beff8c3a95e1",21,16,35,4.2,21,0,2,1
"14594","65721299c989104cbb098ec4aac9fcd2",22,22,0,22,22,0,1,2
"14595","6572a7b8d77ef71df2f47dd9650f394b",50,43,23,15.2173913043478,50,0,2,1
"14596","6574732f18b943afe6ac7bba88ddb0c1",72,63,19,26.5263157894737,33,39,2,1
"14597","6574c5f499af4c4cc847347203a8e380",123,97,73,11.7945205479452,105,18,3,3
"14598","657793d3bfe3f21b69080d3a25801ea4",151,92,66,16.0151515151515,151,0,3,3
"14599","65779e0b1928047a63706972a5627e9e",25,25,0,25,25,0,1,2
"14600","6579ac91ea7d3fcb4203a45165114f6a",18,18,0,18,18,0,1,2
"14601","657b536354ed79fb2a64702fd4a75ee9",41,41,0,41,41,0,1,2
"14602","657be12aaa305589ee74fcfc11e27a12",34,33,15,15.8666666666667,34,0,1,1
"14603","657cce5247492cda5db989c5e0673e62",67,50,49,9.57142857142857,20,47,2,1
"14604","6582bb9545f0580f4ae8e697b169a737",73,42,14,36.5,46,27,1,2
"14605","65831c5e8a66331edac37f9b0958cfa3",146,137,55,18.5818181818182,146,0,3,3
"14606","658509866c37450ed489bc9464c70c9c",43,43,16,18.8125,3,40,1,1
"14607","6585dd02a465a0fefea6f30d4b3281df",52,25,61,5.9672131147541,42,10,2,1
"14608","658894fd66d0016e4d5645b19c832497",124,70,56,15.5,124,0,3,3
"14609","65894f263c3702e9708ad4b40ff9bd09",72,54,38,13.2631578947368,56,16,2,1
"14610","658a4de7bb5db3fd6c6fd3ee996d366f",3,3,0,3,3,0,1,2
"14611","658c487714c7cbb0cb982d4fbf33cce8",20,20,0,20,20,0,1,2
"14612","658d5c46e73449d4aabc0ee70f44f2bb",2,1,35,0.4,2,0,2,1
"14613","658eb3abf4b1def8f89b184619582abb",70,50,42,11.6666666666667,70,0,2,3
"14614","658f5bfa53e3c6625a650418c082a1c0",63,50,46,9.58695652173913,34,29,2,1
"14615","658fbcee9cf60320f1afbddcbc0c8442",30,30,0,30,30,0,1,2
"14616","6590f7198b701679c6bffd39747a4b2c",28,28,0,28,28,0,1,2
"14617","6594489ce9a749bec30b99bc0c0955d6",39,28,57,4.78947368421053,39,0,2,1
"14618","659b9c63163ae2b5ecb0862890754b7d",32,32,0,32,0,32,1,2
"14619","659d9f0570210d53cd7dca1093b26c5a",27,27,0,27,27,0,1,2
"14620","659edee40f4b182df461953051c14078",92,50,60,10.7333333333333,92,0,2,3
"14621","65a04a71867f701a4c7d95dcfc42060c",55,55,0,55,55,0,1,2
"14622","65a2606e2150c5d0ad33fccb4b454d27",84,67,20,29.4,84,0,1,3
"14623","65a39b53772d33a38ecccaccd02db45d",16,13,57,1.96491228070175,16,0,2,1
"14624","65a43a256ba6f5f9ee88ad602c6c9c09",101,56,67,10.5522388059702,101,0,2,3
"14625","65a53f1bd85d2e22e531236d86c8f79d",16,16,0,16,16,0,1,2
"14626","65a5531193a6931e64531c0e672a8e16",42,42,0,42,42,0,1,2
"14627","65a585749559b81869eb021ad27000c6",229,135,78,20.5512820512821,185,44,3,3
"14628","65a6447839a044f63c8ebdb23b57bb3e",178,85,56,22.25,178,0,3,3
"14629","65a6674125047818a972936e9a68b5b9",188,101,75,17.5466666666667,188,0,3,3
"14630","65a685fdcf9ac324e8b9405d3b37b263",177,97,80,15.4875,158,19,3,3
"14631","65a69bb6af60455c684d6a2ac64c68f7",112,88,63,12.4444444444444,112,0,3,3
"14632","65a95b2761381bf6ee5e1307163c5bec",15,15,0,15,15,0,1,2
"14633","65aba257c62e31fd4e2b1abea279ac99",48,48,0,48,48,0,1,2
"14634","65ac47405cbbce2cb778a294a819e2c6",28,26,6,32.6666666666667,28,0,1,2
"14635","65ae2ef34ab8550c10aa8911b174bb61",36,33,40,6.3,36,0,2,1
"14636","65aeacc42499a0318f369f67b00db7aa",135,72,77,12.2727272727273,96,39,3,3
"14637","65aeb175f4838785e1149866013a394f",40,25,57,4.91228070175439,40,0,2,1
"14638","65aebd57d0957a73154de9245ca71883",36,36,0,36,36,0,1,2
"14639","65af3a83ced6fea3cb2b2e5f18fd0744",31,31,0,31,31,0,1,2
"14640","65af3dbbd2f8e38c7b1690e09e8adf5b",37,37,0,37,37,0,1,2
"14641","65afcc8d5eb868023c37a5885b5b37a1",78,56,38,14.3684210526316,70,8,2,1
"14642","65b117547885455e1abb72ad1f3d9975",19,19,0,19,19,0,1,2
"14643","65b148dae7fa0f01b26c7a3028d05364",52,36,82,4.4390243902439,52,0,2,1
"14644","65b3eb3a0a5c8dec1c52eb7e18f18189",53,32,25,14.84,53,0,2,1
"14645","65b47d16669e0c00978c5c05f3f1338e",139,102,25,38.92,101,38,3,3
"14646","65b4f2f74410c576bc5c9bc71362b55e",17,17,0,17,17,0,1,2
"14647","65b60a9c18b0a1d79d9695476ac7d20d",41,35,18,15.9444444444444,41,0,1,1
"14648","65b92e93ea5650fe7da0e70ed55a8dbf",54,39,57,6.63157894736842,54,0,2,1
"14649","65b9dc7ea996b7c4195e9fd103417887",76,50,45,11.8222222222222,38,38,2,1
"14650","65badf71dbd2b7c9cd00f3d47cd8a4f6",76,45,90,5.91111111111111,76,0,2,3
"14651","65bb0f23152ecebfa500424797065f60",195,89,58,23.5344827586207,158,37,3,3
"14652","65c0e9b8ae8a72cb5c5a65a121dbcdd8",63,44,40,11.025,35,28,2,1
"14653","65ca5a3c5477d306a83b7a957fe3262f",12,12,0,12,12,0,1,2
"14654","65cae4a6ed8a294e8169e6c451e3cf8b",14,11,18,5.44444444444444,7,7,1,1
"14655","65cb58c488c32fdc0b4b871aa71cafa9",164,112,67,17.134328358209,112,52,3,3
"14656","65ced4a1d4f14a9096a070b82262edd0",5,5,0,5,5,0,1,2
"14657","65d0e64c58fefe4b0ef03f29ba63806f",169,85,82,14.4268292682927,169,0,3,3
"14658","65d178e47ea8a36a1d57f6490a174214",41,41,0,41,41,0,1,2
"14659","65d287d8a0af0f2f69d5264d0779c1cb",18,18,0,18,18,0,1,2
"14660","65d2930f0bb3926b23855bdc8eee1c94",22,22,0,22,0,22,1,2
"14661","65d2fb07a147e8b8397139034e3e67e2",29,29,0,29,29,0,1,2
"14662","65d34429ba5e27fddc181732f810a1f6",100,58,65,10.7692307692308,100,0,2,3
"14663","65d35184893c75ccdd195b79a8f60014",157,104,40,27.475,112,45,3,3
"14664","65d5a109874dd783b6ab372a7e211088",10,10,0,10,10,0,1,2
"14665","65d67604d8a7023e02d12e1eb1ffdbc2",73,42,41,12.4634146341463,73,0,2,3
"14666","65d695013bfd0c596e25bb49c4a51724",22,22,0,22,22,0,1,2
"14667","65da5cf642ef20a0dc255f48db0c8c9f",86,53,75,8.02666666666667,43,43,2,1
"14668","65dbdd2b1e3e122c7184034bc2170309",117,88,35,23.4,117,0,3,3
"14669","65dc92d82601f73217d25f369da35e38",8,8,0,8,0,8,1,2
"14670","65dd05bc54dafe78cbfb41614fe6ac63",73,57,38,13.4473684210526,40,33,2,1
"14671","65dd743c96005d8f74700ca30bca980b",31,31,0,31,31,0,1,2
"14672","65e25e63cf082ef2ec94e86903da0410",43,33,49,6.14285714285714,9,34,2,1
"14673","65e3adb20e6cccd15a1741d39eb71cda",47,39,24,13.7083333333333,47,0,2,1
"14674","65e526b378d983d4e906c06cced7bda0",82,71,50,11.48,82,0,2,3
"14675","65e58da2214cb2fb4e9a7adfb8fdea2b",25,25,0,25,25,0,1,2
"14676","65ea9b757aac7e44174997d8a78a4973",74,50,59,8.77966101694915,56,18,2,1
"14677","65ebeb750d5efef62cbed98ac981c858",78,32,71,7.69014084507042,74,4,2,1
"14678","65f08889ace520499cbfa29c26a73fe0",116,67,80,10.15,95,21,3,1
"14679","65f0f202bbac9dfe0b997652441001c0",218,103,84,18.1666666666667,171,47,3,3
"14680","65f28e9f7ea8842dabd207f3f07aa727",69,47,67,7.2089552238806,62,7,2,1
"14681","65f658a31bcc5efa546538885abb4f5f",125,36,79,11.0759493670886,87,38,2,3
"14682","65f9a30fa5f35f81f6af1de673adbe3f",27,27,0,27,27,0,1,2
"14683","65fa4b3b4c5ab8e850373dad06c1f4f6",203,124,65,21.8615384615385,173,30,3,3
"14684","65fc5fdc7b9488ca5af4ebb6c59ee106",45,45,0,45,45,0,1,2
"14685","65fdf1530d88883f5fe00a45a84ac103",23,23,0,23,0,23,1,2
"14686","65feda705ce42f8d4b94e64b4a33643a",30,30,0,30,30,0,1,2
"14687","66072ad8703289d8c527eab77332ec4a",77,58,65,8.29230769230769,77,0,2,3
"14688","660db07dd878b632579ad6239a776b10",4,4,0,4,4,0,1,2
"14689","660dc0978554adaa57cf30420617d0ee",44,44,0,44,44,0,1,2
"14690","660e11cc03dd0125642a3cc40c40da8a",17,17,0,17,17,0,1,2
"14691","6610058d9523695f94530a86bee3b8c3",41,41,0,41,41,0,1,2
"14692","661247c22926a545f100efbe110d73e1",136,77,46,20.695652173913,136,0,3,3
"14693","661561f17448d4719a21888a1ad33f38",6,5,66,0.636363636363636,6,0,2,1
"14694","6616bf11ec0d17586a5ebad9a26251e3",129,63,66,13.6818181818182,129,0,3,3
"14695","6618a47bf14dc5f72f8f87ad1d5246a9",84,59,33,17.8181818181818,58,26,2,1
"14696","661905bd53e601f134819c25ae0db07e",69,50,53,9.11320754716981,69,0,2,3
"14697","66195781e0ec55e1d413e716dc76b8dc",46,38,66,4.87878787878788,46,0,2,1
"14698","661f6e3b85d47bcf6f1b00c175a03822",63,43,39,11.3076923076923,63,0,2,1
"14699","662065e0a3623979560c1c59aa03907f",32,32,0,32,32,0,1,2
"14700","66219f17fe803ad89810324ec83ac32f",8,5,34,1.64705882352941,8,0,2,1
"14701","662261ff6e6c7e244241bead3616e1f9",16,15,4,28,16,0,1,2
"14702","662330c40158c0ca54072d527a29921c",49,39,57,6.01754385964912,49,0,2,1
"14703","6623b1b83030a322d2f2aa9d318e5869",245,100,67,25.5970149253731,212,33,3,3
"14704","662571d1961f467c1644fd298b4a66c3",11,11,0,11,11,0,1,2
"14705","66274c49df86dbbe9073b9b0add2f627",58,48,42,9.66666666666667,58,0,2,1
"14706","662b08ff7679f810924225222a1b6991",24,24,0,24,24,0,1,2
"14707","662b21c69dbc777a24508549691abd54",15,15,0,15,15,0,1,2
"14708","662b4a6af32809635b8c033e2a03719c",55,55,0,55,55,0,1,2
"14709","662bb43db1f6d5ad2976fa2998fc9583",51,47,36,9.91666666666667,16,35,2,1
"14710","662fd967c98cf34aae3839601c8eb323",23,23,0,23,0,23,1,2
"14711","663065fdb2cfc62bc8030837b40d7ee6",21,21,0,21,21,0,1,2
"14712","663261806a273d36d716d35a9dd7b1cd",99,68,45,15.4,99,0,2,3
"14713","6633914d67069b323a951761106a8a24",106,93,59,12.5762711864407,106,0,3,3
"14714","6633acd73bbe7c57bde93d8ed30df838",27,27,0,27,27,0,1,2
"14715","6636553a676f3ec4b7a7ac2e2f3702f9",37,37,0,37,0,37,1,2
"14716","66389a309af6caed038fdd992b08fc2b",40,40,0,40,40,0,1,2
"14717","6639d1595c6356291ecb5ed3aae3f5f3",2,2,0,2,2,0,1,2
"14718","663db58bf63cb3139134bc0508e7c1e0",106,85,67,11.0746268656716,53,53,3,3
"14719","66402923821298166cf3ac3e50007f4e",37,30,26,9.96153846153846,37,0,2,1
"14720","66417e54b7dcb03f16522039b9b04b93",76,57,43,12.3720930232558,76,0,2,3
"14721","6641ed3db9bffd5f0f01bc29de3e4687",29,29,0,29,29,0,1,2
"14722","6642a40b2d5d1231ad71cf147f978915",62,52,56,7.75,62,0,2,1
"14723","66473a1203b80e70a552de691fc1eb25",103,86,49,14.7142857142857,103,0,3,3
"14724","6647761a56ef312e2bc935c2c685c051",73,62,62,8.24193548387097,73,0,2,3
"14725","66496a07b9140ae6ceb19570b749e085",46,33,68,4.73529411764706,46,0,2,1
"14726","664c1dac50e2bad2d4bff7e0b8ca229e",104,61,74,9.83783783783784,88,16,2,1
"14727","664d2253fc4d4f9d0cb2b05773300044",133,92,64,14.546875,101,32,3,3
"14728","664e8b468ea59bb23446e44af68300c3",85,68,22,27.0454545454545,85,0,2,2
"14729","664f67ef3e0e4aa4b86dcb20d4921e86",78,44,47,11.6170212765957,64,14,2,1
"14730","6652bb7076ebe192a9d1dfe171f38fb3",57,42,59,6.76271186440678,27,30,2,1
"14731","6654e837cf8d675a256f39a25076df4f",14,14,0,14,14,0,1,2
"14732","665b544fd9b0988755f17b2e40342543",27,21,42,4.5,0,27,2,1
"14733","666029a9ad41096597578767cc54e662",35,17,81,3.02469135802469,35,0,2,1
"14734","66604e72478b0e1e2c22a5680e84e7bb",47,28,42,7.83333333333333,0,47,2,1
"14735","6662beb70c3e8edca6d99602511dc521",133,60,79,11.7848101265823,88,45,3,3
"14736","66636073ae6c942c05ce8ab73089b4aa",79,46,64,8.640625,79,0,2,3
"14737","66650d06f053979d3d787d01e930de38",29,29,0,29,29,0,1,2
"14738","6665e0e6ebd34bd7423c50b3ea9410cd",88,64,57,10.8070175438596,68,20,2,1
"14739","6667475e06d2084fb26efcacaefd07f8",50,41,7,50,50,0,1,2
"14740","6668433beac2a393d52d28f61f0f56f9",25,25,0,25,25,0,1,2
"14741","666b946b78701e33f31be56e970cf6af",169,67,79,14.9746835443038,169,0,3,3
"14742","666c098f02f1b0f00542509181ef3ec5",137,88,79,12.1392405063291,137,0,3,3
"14743","666e7c5e64c2d356179b44935d296370",154,125,53,20.3396226415094,154,0,3,3
"14744","6672a9c14cc13935827ad3295cd56169",47,37,8,41.125,24,23,1,2
"14745","6674122df748509a03373792cce240b3",17,17,0,17,17,0,1,2
"14746","66748d8e0050a1e7cab2c942b394d5d0",28,22,38,5.15789473684211,28,0,2,1
"14747","66751ab918e955a5b7db6716f6f638a9",175,85,82,14.9390243902439,152,23,3,3
"14748","6675def75280cae77c60d3515b235e9a",2,2,0,2,2,0,1,2
"14749","66765f5eba0c74c3f1bb932cb6c42267",23,23,0,23,23,0,1,2
"14750","66770e821fbc7798222afb3d7d95f736",77,65,42,12.8333333333333,77,0,2,3
"14751","66770e9a1bc60d9d48d22078bd3ddedb",80,64,57,9.82456140350877,80,0,2,3
"14752","6679def34e0c903715dd37efe2edbf2a",81,56,81,7,81,0,2,3
"14753","667cbf9f5f8521f671ae258a0dc24cb1",29,29,0,29,0,29,1,2
"14754","667f590e1d559f820f531fbb5e57f1de",99,44,81,8.55555555555556,82,17,2,1
"14755","66821c0370139f5729f0de64b45f1998",23,23,0,23,23,0,1,2
"14756","668299fceb6b18ee39d0530381a0389d",164,118,48,23.9166666666667,164,0,3,3
"14757","66846e430f88310bc0da8a61fa9fab4b",209,102,67,21.8358208955224,209,0,3,3
"14758","6687a4c1b0f3c4f6a7a117b81cb68337",89,70,40,15.575,42,47,2,1
"14759","668d1c6fa409e78cb6cedfb9e172b602",144,116,69,14.6086956521739,101,43,3,3
"14760","669322fd1bb62eb7f23dec0b87d1c938",36,29,58,4.3448275862069,36,0,2,1
"14761","6693c9fa9f0c8eb50c2efe5e358c18a0",66,45,57,8.10526315789474,66,0,2,1
"14762","66956f785a53ba737bdc3052d588c646",42,42,0,42,42,0,1,2
"14763","6695d45209b235fa8459d9a9bd7599d7",25,25,0,25,25,0,1,2
"14764","6696e92c3df6bc5eb09873b5e81865f2",140,59,77,12.7272727272727,110,30,3,3
"14765","669795e8c391e1b0a5c30c6944e61b96",36,36,0,36,36,0,1,2
"14766","6697f6294dfd0ca947b9dbb361210daa",43,43,0,43,43,0,1,2
"14767","669d14b855125806e670583a21a54902",66,52,58,7.96551724137931,51,15,2,1
"14768","669d4289e73c07fd8b88b7a58efc29e9",76,66,30,17.7333333333333,43,33,2,1
"14769","669f282c9b7cf29b67d14bfbf0800047",101,86,74,9.55405405405405,51,50,3,3
"14770","66a071c3bdf5feef669e6b0fdae95171",24,24,0,24,24,0,1,2
"14771","66a1388b6f6e9ffa1bbc5b8f81c6a633",35,35,0,35,35,0,1,2
"14772","66a2c4e0daa326cc456da5cf5817b71f",13,11,21,4.33333333333333,13,0,1,1
"14773","66a327d2460e67cc64f2a4a019bb0c10",97,79,66,10.2878787878788,97,0,3,3
"14774","66a3cfc6f1fd1cf4eb9798f482a077cb",12,12,0,12,12,0,1,2
"14775","66a7df8896fe864672d04ca51b56c4fa",84,59,77,7.63636363636364,84,0,2,3
"14776","66a918b7e28eb8a16ee5c24008b4b500",11,11,0,11,11,0,1,2
"14777","66ab0edba42c8717c1ed1403a6e4d036",83,68,65,8.93846153846154,83,0,2,3
"14778","66acf4c3ffef7f7981098255df4bd1b9",38,38,0,38,38,0,1,2
"14779","66ad1a02af908ef8b406f84259072c48",68,40,71,6.70422535211268,52,16,2,1
"14780","66aeb415206a777d0eb2b5215b729e55",25,25,0,25,0,25,1,2
"14781","66b15e4f2d0118c6b138c7aa8df5811c",12,5,46,1.82608695652174,12,0,2,1
"14782","66b4426f5b3ca9b783f8ba3673d65015",19,19,0,19,19,0,1,2
"14783","66b4fa00424eee1f658994ea736a62f5",131,87,77,11.9090909090909,131,0,3,3
"14784","66b55908b78c2e7aeddf5010e77a9222",14,14,0,14,14,0,1,2
"14785","66bd40a6c9078026387e729aee8785bc",5,5,0,5,5,0,1,2
"14786","66bfad23528e61a683f0b7a210d055dd",12,12,0,12,12,0,1,2
"14787","66c0bea626e52f2ccce1af319c1461fb",122,54,70,12.2,122,0,3,3
"14788","66c2e11fe4673c1b4e162e6a240ec27c",136,81,68,14,136,0,3,3
"14789","66c2eb63a97fea8714324f8e004e4b47",135,92,58,16.2931034482759,135,0,3,3
"14790","66c3d5b74544f54c0d54fa84b60b3cdf",69,38,84,5.75,54,15,2,1
"14791","66c81f613cdd9a1804885a60341a00f1",47,47,0,47,47,0,1,2
"14792","66c89936b689f7c991f863a184a54e12",45,45,0,45,0,45,1,2
"14793","66c8fcd95577549c6358b16c3044479d",23,23,0,23,23,0,1,2
"14794","66ca48fb420a3ad74ed61fc12bce3ae2",197,99,75,18.3866666666667,197,0,3,3
"14795","66cb14232bb418c1459d34ca8da05661",92,67,46,14,42,50,2,1
"14796","66cc4b1b36e4e48d3fc02f7c86c76c26",43,43,0,43,43,0,1,2
"14797","66cc54888ebd5f878f14edfb7c2baa3d",52,52,0,52,0,52,1,2
"14798","66ce255cac75ed4d4df701d1d7b5f0d8",52,40,37,9.83783783783784,52,0,2,1
"14799","66cea9917f558e0d7a4c72ab5cac4f3f",31,26,68,3.19117647058824,31,0,2,1
"14800","66d3fa6ae0dab92f1e747af5626ea8fd",17,17,0,17,17,0,1,2
"14801","66d42a02e1f9f6cdb5ac0ab338bd35e1",35,35,0,35,35,0,1,2
"14802","66d5108f53f5e24f0d9a06526c660406",81,67,36,15.75,43,38,2,1
"14803","66d5c47eb272eb3fe4522f06c4afb8eb",174,88,78,15.6153846153846,174,0,3,3
"14804","66da33c0c776330acc0369febdc43535",75,63,72,7.29166666666667,61,14,2,1
"14805","66da4327d6ec3cbc965e940dfaff7c5c",18,18,0,18,18,0,1,2
"14806","66e0a1865fa8aba70abcb5566e08ddfe",169,88,73,16.2054794520548,169,0,3,3
"14807","66e1071ac939997a20d7e43c8cf614fc",5,5,0,5,5,0,1,2
"14808","66e15a6627b56f9e27e9f6e6735e5d3d",51,45,21,17,51,0,2,1
"14809","66e1b49c1ecdf2c18d62af23f30b55d0",26,26,0,26,0,26,1,2
"14810","66e5083cf233c496d7f199735fd4e7c0",9,9,0,9,9,0,1,2
"14811","66e915fa6179d61c8e09141dd538ccb3",26,26,0,26,26,0,1,2
"14812","66e9524c3f8f56281d5450e54613d9b8",85,57,42,14.1666666666667,85,0,2,3
"14813","66e96d51002ccf5d29da4722225da71e",204,114,56,25.5,204,0,3,3
"14814","66ea8dbbeb678e0881f018471c4b1100",74,63,51,10.156862745098,74,0,2,3
"14815","66eab26c58477f3fcaa84a251ea828e1",33,33,0,33,33,0,1,2
"14816","66eb0fd615a4a70e02cb4755cd9095d7",24,24,0,24,24,0,1,2
"14817","66f07bd7832ed357612277761404667b",47,40,27,12.1851851851852,47,0,2,1
"14818","66f2e0d46688897e531ed7b3b3ccf7b5",28,28,0,28,28,0,1,2
"14819","66f2ee0f845eb6d9b14cd1a39c9fcaaf",36,30,28,9,36,0,2,1
"14820","66f2fce20961ddab76c2932efa826b9f",40,40,0,40,0,40,1,2
"14821","66f3f8308bfba960238c17dd20f630db",129,29,73,12.3698630136986,119,10,2,1
"14822","66f46f34ad826134745c5a370b46b301",43,43,0,43,43,0,1,2
"14823","66f4a68d8b97f15d5069a1a9ac41b0ba",150,115,30,35,150,0,3,3
"14824","66f4dba776c1472cbd35e02eed8fa21e",3,3,0,3,3,0,1,2
"14825","66f5d81a0f5ce69e887993910969e223",122,74,85,10.0470588235294,93,29,3,3
"14826","66f6791d890230abad7a32fccd2d38ef",24,23,47,3.57446808510638,24,0,2,1
"14827","66f7210f5b3ee830b526b0a4203dd176",110,43,71,10.8450704225352,93,17,2,1
"14828","66f7abcf7bca46000aee51ae795f531c",10,10,0,10,10,0,1,2
"14829","66fecd47e044aa7505973a1318c2b16a",103,80,61,11.8196721311475,66,37,3,3
"14830","67019f90870b709344d30025097a11da",4,4,0,4,4,0,1,2
"14831","6703b47b6d138006db358902a22e2fab",108,51,59,12.8135593220339,108,0,2,3
"14832","6703bff0204f18ff19d92195376a67eb",62,42,43,10.093023255814,42,20,2,1
"14833","67058912541a9d2cb989178d538b71fc",164,80,21,54.6666666666667,164,0,3,3
"14834","670d2b2f87e597a724470d19de34e40f",20,20,0,20,0,20,1,2
"14835","670ec73b84edd237dd1442d155cdfdf3",19,19,0,19,19,0,1,2
"14836","67118f7fd2b8322f3e3c24a314be0ae4",43,43,0,43,43,0,1,2
"14837","67129159dc825644618bf08fe030ee4b",3,1,74,0.283783783783784,2,1,2,1
"14838","671473b427bfac9993d8d45efa495eae",103,87,43,16.7674418604651,103,0,3,3
"14839","67148edb095c329bd741cbac8bdbd282",14,11,42,2.33333333333333,14,0,2,1
"14840","6716cbbac2ce67113aeeab04065413b2",125,73,60,14.5833333333333,125,0,3,3
"14841","671808ebfcb9aac9525c8421399ce5c7",97,67,53,12.811320754717,97,0,2,3
"14842","67183cfefaaaac30b971f87dd16f3159",54,44,14,27,54,0,1,1
"14843","671a7b7b9341262ff77851bf8a7580b6",73,64,11,46.4545454545455,24,49,1,3
"14844","671c95c9a33ecfce8bda71596160b327",55,43,41,9.39024390243902,55,0,2,1
"14845","6720300df07acaa373b4be1b3a7a3264",151,79,81,13.0493827160494,151,0,3,3
"14846","6720e30dce91b393536312b64b33b196",186,88,71,18.3380281690141,186,0,3,3
"14847","6720f40dc1074238917c27ded9ae9f5d",36,36,0,36,36,0,1,2
"14848","672100c505e3e1e9ca255bffd593556a",85,50,74,8.04054054054054,79,6,2,1
"14849","6722e7beaef66eda0fd028f62b124b33",41,37,61,4.70491803278689,41,0,2,1
"14850","67232d280dd0451dd7202d616746d903",55,51,61,6.31147540983607,55,0,2,1
"14851","6728d7e55932b778813f69e072253a89",26,26,0,26,26,0,1,2
"14852","672c78dbfbe9dcc04c3ce95ef82a8dfb",25,25,0,25,25,0,1,2
"14853","672cbc7c47ddfa5bb6897e46c7bc7823",31,31,0,31,31,0,1,2
"14854","672dc236e0842ca54bacdb055e032b27",122,82,68,12.5588235294118,122,0,3,3
"14855","673101103f92cafaa6fd622ba0bfb531",37,26,88,2.94318181818182,37,0,2,1
"14856","67329bc3f4291c0def932bcd389dcb66",31,31,0,31,31,0,1,2
"14857","6732cfcd1d10778c875fc8704988205b",8,8,0,8,0,8,1,2
"14858","6732de8eab11a44272e36f657bf395c8",16,16,0,16,16,0,1,2
"14859","673358914781bdb032c195f94d16db67",83,65,51,11.3921568627451,37,46,2,1
"14860","6736b44508077ff28ecc3160ce89f6bd",45,32,57,5.52631578947368,45,0,2,1
"14861","6738dcbe75b8938f8a7f49f26abd4b01",34,34,0,34,0,34,1,2
"14862","6739e67e12263feb40eeeeaf9402bfa6",35,35,0,35,0,35,1,2
"14863","673a04bec6ee3385c84fcb8c0f124b24",17,17,0,17,17,0,1,2
"14864","673a9931c5cdd76a14f53e3bf4d3c374",25,25,0,25,25,0,1,2
"14865","673c0322a5d2aec6644dba9e1189d524",23,23,0,23,23,0,1,2
"14866","673ccd56434cb171d1ee095b0b356dcd",164,124,46,24.9565217391304,164,0,3,3
"14867","673cf99eede1f2daefab879d81ad694f",51,31,60,5.95,31,20,2,1
"14868","6744179932bd7f44095a8a3c5abc6d5d",46,40,59,5.45762711864407,25,21,2,1
"14869","67443e2e04531158864b6619408a9645",22,22,0,22,22,0,1,2
"14870","67458f534a7fbda86715a5d0ae57e218",29,29,0,29,29,0,1,2
"14871","6745f50b40de588955157f1a4ab1cb72",14,14,0,14,14,0,1,2
"14872","674721130ad4617afa04b6a52314d5f3",3,1,0,3,3,0,1,2
"14873","674a33745a4a61c4a914a03e42cae60d",5,5,0,5,5,0,1,2
"14874","674bdc48c7db4270c721bfe99b770089",29,29,0,29,29,0,1,2
"14875","674c630a73fbf2babe2926ca749ea3b8",10,9,2,35,10,0,1,2
"14876","674d644a00f2d98dfa3b47164fe8969e",7,6,67,0.73134328358209,7,0,2,1
"14877","674dfeaf85adee713ee0bb70c5c5c1c4",113,70,38,20.8157894736842,113,0,3,3
"14878","675014f25e7d9b1d6ff76225f11ed461",24,24,0,24,24,0,1,2
"14879","67506c4be0fff8a5ccfbbeaaa5908b4e",9,9,0,9,9,0,1,2
"14880","6752a369d97006d92b83d44fa327cf8c",44,44,0,44,44,0,1,2
"14881","6752b0c08d1f943e75d45bb785b22a93",48,48,0,48,48,0,1,2
"14882","675319234b7134ab5c8a3f5082009f0a",142,98,35,28.4,142,0,3,3
"14883","6754ec283020255d0e485e3d4386d2d6",116,91,59,13.7627118644068,67,49,3,3
"14884","67581a6a42d0e5927a8e104c4bbc5b61",43,43,0,43,43,0,1,2
"14885","675a4b8e382becd230fab29708e6cc11",13,13,0,13,0,13,1,2
"14886","676390767922503f1247ae9723814304",226,115,85,18.6117647058824,187,39,3,3
"14887","67675967a9b0c6941f5f2bb0566d5cc6",9,9,0,9,9,0,1,2
"14888","676b2d795b2212827196e0f20fe8a981",147,92,75,13.72,115,32,3,3
"14889","676c681613ccbd405a8b33613c13a342",36,23,62,4.06451612903226,36,0,2,1
"14890","676ecbe24cd62dbf401cca6f805abb2e",21,21,0,21,0,21,1,2
"14891","67741155fa008e38a177a69b5c5a34bb",25,25,0,25,25,0,1,2
"14892","6774ae92629fdaa7ccd188988f5b21ec",48,48,0,48,0,48,1,2
"14893","67777d257963fc7c8cdd8d5f86dcc5d8",21,15,37,3.97297297297297,21,0,2,1
"14894","6779455df6dc01ceea9a26031d302db7",30,17,64,3.28125,30,0,2,1
"14895","677a6ccc9c3d6542638d2d6523b422b6",35,35,0,35,35,0,1,2
"14896","677f38cc5af92bfaf57d7eb2245cb1c1",62,49,62,7,62,0,2,3
"14897","67818920b8261cc22bf5d45ceb027f42",33,33,0,33,0,33,1,2
"14898","6781e05c6aa2d554d970aa73add71390",44,44,0,44,0,44,1,2
"14899","678220da999b9860cbdb1dbbd95d39eb",100,68,87,8.04597701149425,70,30,2,3
"14900","678461facd2a9a1848ef919f38a7fada",28,28,0,28,28,0,1,2
"14901","67851b8a7cdc3f524e8b3bda7a67bb86",79,54,80,6.9125,56,23,2,1
"14902","6785b0220fe3b266aef7ddb1d1d91cf4",42,42,0,42,42,0,1,2
"14903","678666b4871cf753c4511e8d5c59f8e4",5,5,0,5,5,0,1,2
"14904","6786c13da0f6d352b8bf0cc46ab7fb37",227,74,72,22.0694444444444,204,23,3,3
"14905","6788fe10cd32c0c5278d43478dcb65d4",28,28,0,28,28,0,1,2
"14906","678b58bb899a9728aac721ec583232e3",19,19,0,19,19,0,1,2
"14907","6791de6e03e402908ce5b280dfa5a29a",13,13,0,13,13,0,1,2
"14908","679338c8ef421edd1ae5f5f406810ffa",19,19,0,19,19,0,1,2
"14909","679631827335718e870efe6140422f45",64,54,20,22.4,64,0,1,1
"14910","6797bda3038679b86e65321d0926218f",77,61,50,10.78,77,0,2,3
"14911","679d7e868837f4c0a4651b62bba1c67e",55,55,0,55,55,0,1,2
"14912","679decafb953759085ae6c37f4a94890",87,64,19,32.0526315789474,87,0,1,2
"14913","679e9973995bda62c9679d1026cfa4da",51,51,0,51,0,51,1,2
"14914","679ef7f493b8fae813186d07b0f20e46",33,33,0,33,33,0,1,2
"14915","67a06a45c65f5bbe4b24be8beb134e06",158,103,65,17.0153846153846,158,0,3,3
"14916","67a34eebae1a93b318f8cf2297180098",62,36,30,14.4666666666667,62,0,2,1
"14917","67a377b94450ab2545da4b830a0d752b",126,88,76,11.6052631578947,126,0,3,3
"14918","67a56de32ec78851e82e4c817b6a91f4",85,59,26,22.8846153846154,85,0,2,3
"14919","67a97dfcbf522200e9b105847639aee7",30,30,0,30,30,0,1,2
"14920","67ada8cd9f4a4fb43fc3371384af594b",33,33,0,33,33,0,1,2
"14921","67aeae764cabc60c60ce4cdf0049b694",23,23,0,23,0,23,1,2
"14922","67b130eb108476f6ea57e05fa1290afb",73,62,77,6.63636363636364,32,41,2,1
"14923","67b7997ba1c69eef20d620fe4f1348d7",136,88,79,12.0506329113924,136,0,3,3
"14924","67b89c99eeee1733fffced5c10a9e41e",37,37,0,37,37,0,1,2
"14925","67b9ea797d9ab5fa87a79543baa6f919",25,19,14,12.5,25,0,1,1
"14926","67bb76653922c67ebe57347066c03835",14,14,0,14,14,0,1,2
"14927","67bc9ba17a7968e5de002f33daa50ad3",34,34,0,34,34,0,1,2
"14928","67bcdc418348b46d3200a675a307a56b",23,23,0,23,23,0,1,2
"14929","67bcfdd02c9877b08c7b9b493aa58f84",94,63,37,17.7837837837838,94,0,2,3
"14930","67bf18941a879c07cd97710e2ef7a0f8",72,60,54,9.33333333333333,72,0,2,3
"14931","67c047feb3d7c0e4e473e45054280e1c",32,27,78,2.87179487179487,32,0,2,1
"14932","67c28eb974bcc1703a6a7a94ae73826b",158,70,63,17.5555555555556,126,32,3,3
"14933","67c2d1a984c0463aabfb19fcb45c32f3",160,112,62,18.0645161290323,160,0,3,3
"14934","67c6b76263e6c95d2e2408ed1f13886b",29,29,0,29,29,0,1,2
"14935","67c826d922cb2dae1b7cb75e1567848d",17,17,0,17,17,0,1,2
"14936","67c88771a4b7fd27c586bb7ae76da44f",76,63,11,48.3636363636364,76,0,1,2
"14937","67c9ec0b4a33a61d845aae6d74d11aa5",47,47,0,47,47,0,1,2
"14938","67ca684a937853e8c06f319c6359c357",35,35,0,35,0,35,1,2
"14939","67cc18bded06dc99198207ac9b76bd53",30,30,0,30,30,0,1,2
"14940","67cc51d2469d036d083342c118c3e8df",25,25,0,25,25,0,1,2
"14941","67ccc1a39d2fba2a32bc33b1b712a3b1",31,25,58,3.74137931034483,31,0,2,1
"14942","67cf1b69ead22c7dfe84e6730f104b06",159,90,69,16.1304347826087,159,0,3,3
"14943","67cf37600d1ac82b3651ba1c719322e6",10,10,0,10,10,0,1,2
"14944","67d01ce9103db9f421ea751d3cf238f5",47,47,0,47,47,0,1,2
"14945","67d070d867edd321ba31a94d7daa075e",29,29,0,29,29,0,1,2
"14946","67d3511801440ed8219d30d28cffa50b",61,46,61,7,61,0,2,3
"14947","67d5cb8e6a329eeaf44e5a2b157e8ad0",73,45,73,7,73,0,2,3
"14948","67d6438e9350833050bc9abe8dcbf6d8",12,12,0,12,12,0,1,2
"14949","67d6d0ef3e4599ce466c859e8a9c0841",27,27,0,27,27,0,1,2
"14950","67d6e5c714d9641b21737cea87da9180",51,32,35,10.2,22,29,2,1
"14951","67d72c0a47c486374c9813b5edee9739",36,36,0,36,36,0,1,2
"14952","67d9d1704e072295458b963572dc7f21",138,95,74,13.0540540540541,138,0,3,3
"14953","67db953d671c700d36e7f8b302d65a67",40,40,0,40,40,0,1,2
"14954","67dcdd5fdc41d30fb324819f5383e0f3",49,49,0,49,49,0,1,2
"14955","67ddd24bea322248bad5564c32f6b9ba",35,34,35,7,35,0,2,1
"14956","67dfe6eda7322859537d3ed8efc6e2e9",31,28,61,3.55737704918033,31,0,2,1
"14957","67e08d0d276c42ac8cb4aba5a1ab9357",29,29,0,29,29,0,1,2
"14958","67e4f6b89965fc8539b118cf12886c99",72,57,51,9.88235294117647,58,14,2,1
"14959","67e7bd08e6b85c34f1e3b7240f38d6ef",75,60,42,12.5,75,0,2,3
"14960","67e87f339b0796f6a659f315992aefba",7,7,0,7,7,0,1,2
"14961","67e8f6444e6524ac05aa57308daecf22",31,9,80,2.7125,31,0,2,1
"14962","67e929907172cb3e80dc5738a900b776",112,73,55,14.2545454545455,112,0,3,3
"14963","67ec3d725baba3f7c7728dea3b41e07b",91,74,17,37.4705882352941,51,40,1,3
"14964","67ecbcc37f1e3bccd5d0636dc9b29ae9",8,8,0,8,8,0,1,2
"14965","67ed464cb83de011e015096d50b7358d",87,72,15,40.6,87,0,1,2
"14966","67ed76dcb13e4ecc7883d5360bef0020",65,57,14,32.5,65,0,1,2
"14967","67ed9da96a1620fa076e1e660948e288",104,63,39,18.6666666666667,74,30,2,1
"14968","67f111e6cf1d4ec1035c837fcc3aaaa1",128,94,68,13.1764705882353,128,0,3,3
"14969","67f26a512bbc00e35b171f54ac5ccbb8",38,30,33,8.06060606060606,38,0,2,1
"14970","67f52c150a7845c82f9bbdd49a01ebd7",51,49,22,16.2272727272727,51,0,2,1
"14971","67f658589e17dc9aa36a78735aa20d5b",24,21,66,2.54545454545455,24,0,2,1
"14972","67f972c400e4681ac08f9fb54434ebca",190,123,65,20.4615384615385,190,0,3,3
"14973","67f9d468b1d72cd7d8ba6ce8fa3b929c",16,16,0,16,16,0,1,2
"14974","67fb3d8dcd3110c6e467c570885e7b2a",52,34,67,5.43283582089552,31,21,2,1
"14975","67fb7d7f0e175dce0fe1647209c4ea94",33,31,11,21,22,11,1,1
"14976","6801a1963ae1d0f6913f45232741bc81",208,99,77,18.9090909090909,208,0,3,3
"14977","6803681c7510c5b027a2a127b40c6b78",77,59,30,17.9666666666667,37,40,2,1
"14978","6803843eedcacb3211108339c8f5dd47",62,38,69,6.28985507246377,62,0,2,1
"14979","68049c38787a854116f496ff36f160a0",95,58,56,11.875,95,0,2,3
"14980","68059ad5e9a413721ccbda4dc1da2bec",62,53,14,31,62,0,1,2
"14981","68070ac77db8e5ce658498d3b8b26cea",72,44,61,8.26229508196721,72,0,2,3
"14982","6807621726d2f862a948cca07143f1ef",96,69,21,32,96,0,3,3
"14983","680cd7e6bf8c7652f4e9238a4273aae4",90,57,78,8.07692307692308,90,0,2,3
"14984","680decfbb46820cd88c362dd67c1356c",33,33,0,33,33,0,1,2
"14985","681220a964cc08059696a77ca4821b29",119,83,54,15.4259259259259,119,0,3,3
"14986","681349ab53b964dc56c3927e8f60f6fd",27,27,0,27,27,0,1,2
"14987","681365658ff0b69e4cd9ed58cfe07c69",19,19,0,19,19,0,1,2
"14988","6815960e0186aa59ebed4ce292898472",31,31,0,31,31,0,1,2
"14989","6815a07c5e866bf385452a557e3b0504",124,55,64,13.5625,86,38,3,3
"14990","68161a65c3a3f96b6487fb6243464637",114,71,68,11.7352941176471,89,25,3,1
"14991","6816db30c2941aec0596e7336e9e2a3a",18,17,0,18,18,0,1,2
"14992","6816eeccb9d3f354469b96496334cb78",89,66,41,15.1951219512195,89,0,2,3
"14993","6817ccd896ea11bfd194d52737c93a5f",19,19,0,19,19,0,1,2
"14994","681870af9f36127fd96fe0551d34923f",25,19,44,3.97727272727273,25,0,2,1
"14995","681a0dc8d9fe6b50d2a1436ad953d7b1",37,37,0,37,37,0,1,2
"14996","681ca7753ddff4492bedc66213aa53fb",66,57,40,11.55,66,0,2,3
"14997","681e0b523a1fc53bd88a025ca6f99182",91,76,67,9.50746268656716,91,0,2,3
"14998","681e0f990b94d63daf4b0a0a0b774d20",42,42,0,42,42,0,1,2
"14999","681f273cab09301a9f7f2640b94d56ce",22,22,0,22,22,0,1,2
"15000","6820036babc438b1e4193a7ec4d5b232",15,15,0,15,15,0,1,2
"15001","6822994f03bb190b0cd737c733f712a6",143,82,81,12.358024691358,120,23,3,3
"15002","6826419d7a32e28980f255adf5d77e7c",14,14,0,14,14,0,1,2
"15003","68277d28532572b45033e2eb82676111",123,98,42,20.5,123,0,3,3
"15004","6827be8548790be3494bf34b33584b4a",56,48,48,8.16666666666667,56,0,2,1
"15005","682bebb41d87d6cd7acf1ae05ca2f6c1",68,42,76,6.26315789473684,50,18,2,1
"15006","682c5a3a64af7f86a0891f58ec65ceff",68,41,44,10.8181818181818,68,0,2,3
"15007","6832ae42f8926d5cae90a1d586ac86ab",93,60,67,9.71641791044776,93,0,2,3
"15008","6834e92fa8fb6983da8bc8d4295eefdd",85,68,41,14.5121951219512,53,32,2,3
"15009","6836056446ea77936838d1fe602b2d8a",42,31,42,7,42,0,2,1
"15010","6836e0e9b2f04622693ef23441a068b3",35,35,0,35,35,0,1,2
"15011","6838ffb32a32dfa163c9e7f05951466c",23,23,0,23,23,0,1,2
"15012","68399ccd290796690b12560d96abae94",76,60,48,11.0833333333333,49,27,2,1
"15013","6839ec0bb4039e9a2b993a1a65d633cb",92,82,21,30.6666666666667,92,0,3,3
"15014","683e337e7c09b857303af08125f97b34",30,30,0,30,30,0,1,2
"15015","684189dd6ba71750a8ecf9fe0e05dbcf",41,35,36,7.97222222222222,41,0,2,1
"15016","6841fab65e815cca68d4ba1bda73d09d",48,45,77,4.36363636363636,48,0,2,1
"15017","684561d23d66bd5da319523e93ad7869",13,13,50,1.82,13,0,2,1
"15018","684be1ef1e6984637cf616c904070f18",111,87,23,33.7826086956522,57,54,3,3
"15019","684c1eef4d3275a03cdad2a99ab54c4a",34,34,0,34,34,0,1,2
"15020","684d41d2d22222654c5ce603ee3b04ca",25,25,0,25,25,0,1,2
"15021","6851a39d85e2bd36f913dd9f8dc42319",78,65,39,14,78,0,2,3
"15022","68533caf1fed178df9cf69ab92fc080a",34,32,35,6.8,34,0,2,1
"15023","68571fcf1a4622230bfa86d7124a20ef",75,54,38,13.8157894736842,75,0,2,1
"15024","6858701ffdf5bc96d149423d342ce656",56,56,0,56,56,0,1,2
"15025","6859191535ed7966b1be001153b33512",70,57,59,8.30508474576271,27,43,2,1
"15026","685b4f8778d1dfa58ba296fcd08083b5",24,24,0,24,24,0,1,2
"15027","685cf26d9b9ee2e6f6dce0d7054b1c09",1,1,0,1,1,0,1,2
"15028","685d5b0b486be7b78871b4331d52b81c",133,104,28,33.25,133,0,3,3
"15029","685d7efc40b7d3c1abf9f35276972417",17,17,0,17,17,0,1,2
"15030","6860dfa5822df317f99d2077de8d6d1b",22,22,0,22,22,0,1,2
"15031","68642c10061448ba80607f10627f5b10",100,60,77,9.09090909090909,78,22,2,1
"15032","68649a512394297cb4aba1eba04c28b9",151,106,69,15.3188405797101,151,0,3,3
"15033","6868ad4f189dfcf458f98923db7ab9fd",14,9,81,1.20987654320988,14,0,2,1
"15034","686c4a6732ac4d89f059c9fd671699e1",22,22,0,22,22,0,1,2
"15035","686cae4f3714af451262f388c085702d",118,80,20,41.3,118,0,3,3
"15036","686e0d4081f37841d5d34f1c17585b62",98,68,65,10.5538461538462,56,42,2,3
"15037","68704850a20a5c5f7b471ad2469c7487",38,38,0,38,38,0,1,2
"15038","687223692cb56689ac379e55c0931420",146,95,70,14.6,109,37,3,3
"15039","6872eabedc0598b4a7b11e7ab5161319",29,29,0,29,29,0,1,2
"15040","687ad63a1d2a110209bd11d4e1b10bf2",128,78,82,10.9268292682927,128,0,3,3
"15041","687c4aef40fc72790bf2836089a16f21",37,37,0,37,37,0,1,2
"15042","687ca3386debb7a7604fbc8f43a3516d",29,29,0,29,29,0,1,2
"15043","68801d90e5a40105184a068cafe79611",29,29,0,29,29,0,1,2
"15044","6882cc7c55f23d824fca1ddddde28c3d",125,73,76,11.5131578947368,94,31,3,3
"15045","688312048229c43d5314290c0a2944bf",28,28,0,28,28,0,1,2
"15046","68838f0ca7be65d2b4bc7f7461537852",44,44,0,44,44,0,1,2
"15047","68840aaec476c602122e8596f7832d38",34,34,0,34,34,0,1,2
"15048","68854abc16430a88726d7daedf0fd475",43,38,47,6.40425531914894,43,0,2,1
"15049","6885f656d150f83fac910dbcad8b093b",115,76,90,8.94444444444444,115,0,3,3
"15050","688621d8f55c487aa6d973fcf6eb02f8",2,2,0,2,0,2,1,2
"15051","688950eb269d9dfa0d93eafa1ed1c7d3",150,100,62,16.9354838709677,103,47,3,3
"15052","688a49ca9afdf5605e29d4164d426a23",98,77,28,24.5,98,0,3,3
"15053","688bbe375c975e0eb7dca251fdc90d89",169,101,85,13.9176470588235,169,0,3,3
"15054","688c6861aa2167080c3af9c65d49e84e",22,22,0,22,22,0,1,2
"15055","688ff8ce428b670f2374584d938cbda3",141,94,77,12.8181818181818,141,0,3,3
"15056","68909118398069fcae8ec181ccb49613",50,50,0,50,50,0,1,2
"15057","68915ab308a5f9b2f7e04bb5189ffa56",61,44,36,11.8611111111111,46,15,2,1
"15058","6892876008336146041a3308506f59aa",29,29,0,29,29,0,1,2
"15059","6893598745a48dace505747e59a2c319",116,83,50,16.24,116,0,3,3
"15060","6893d57835a26343a38afc12f46195d0",45,45,0,45,45,0,1,2
"15061","6895b726e4b4dcb1d21300e26abb7b00",11,11,0,11,11,0,1,2
"15062","689e2884d377f0acfb5bc13cdf84a24b",29,29,0,29,29,0,1,2
"15063","689f2b33fdc0eac55c31e0ed137d12fb",42,36,28,10.5,0,42,2,1
"15064","68a02c468a00a783b800b8aa68a5ed44",38,27,54,4.92592592592593,38,0,2,1
"15065","68a053e86f577b877399cd73dcc6343b",18,18,0,18,18,0,1,2
"15066","68a0e33f73564f07312736d1f6d5bc7b",66,51,32,14.4375,66,0,2,1
"15067","68a90213a82c3e099494d3938a6f62f5",29,29,0,29,29,0,1,2
"15068","68ab28aaea8e72dd93004cddbbb8d1d1",33,26,56,4.125,33,0,2,1
"15069","68acb0bbb48b92dfda17613b0c35e9bf",13,13,0,13,13,0,1,2
"15070","68ad5125e452b4da100c1565ddc43814",71,46,56,8.875,27,44,2,1
"15071","68ae85d97fcc39f99040829a69aefaf4",43,43,0,43,43,0,1,2
"15072","68b1d20aa1deda86fd262e3d0d0f7511",12,12,0,12,12,0,1,2
"15073","68b3b10f217d506677c337732ca81588",63,54,72,6.125,40,23,2,1
"15074","68b686d94a5b2d3e1f9187dd2c6bffbd",75,57,68,7.72058823529412,75,0,2,3
"15075","68b771a48c1ccaf7681041fe84acfdf0",96,88,56,12,96,0,3,3
"15076","68b8652e869755dfeae98913b7f79ca2",165,119,62,18.6290322580645,165,0,3,3
"15077","68bac89146e3482f377a1ae099d7f677",52,40,24,15.1666666666667,26,26,2,1
"15078","68be26dc1c876cbf72c134103e934242",82,51,43,13.3488372093023,82,0,2,3
"15079","68bf3bc77314256a6153ef398b5d1428",4,4,0,4,4,0,1,2
"15080","68c05544537cfecdb1b2031f544416f0",39,31,33,8.27272727272727,39,0,2,1
"15081","68c0de7a1485279b3886515e1db7bffe",8,8,0,8,8,0,1,2
"15082","68c115819bc2ec1fdada3505cf3c38fb",12,12,0,12,12,0,1,2
"15083","68c1a918305b175d90822cd3517edeeb",38,38,0,38,38,0,1,2
"15084","68c3305def75273d6f303befc2a5e3ba",31,21,58,3.74137931034483,31,0,2,1
"15085","68c671381e577ec2bd67de0c653d4b7c",88,54,61,10.0983606557377,54,34,2,1
"15086","68c80fc4cf4fd6a7beedc9082c344cd7",38,38,0,38,38,0,1,2
"15087","68c8129afaf85f5ef0b1c7f6502a8345",52,47,17,21.4117647058824,52,0,1,1
"15088","68c9bcb702d0434188964d76f7b2e4fe",52,52,0,52,52,0,1,2
"15089","68c9f818985516023538353f43945802",115,70,84,9.58333333333333,115,0,3,3
"15090","68cb805ef15d6ac891be916cdb5106fe",84,67,15,39.2,84,0,1,2
"15091","68cb86c0009a9ef6185f400b1f990bbb",35,33,23,10.6521739130435,35,0,2,1
"15092","68cbaa953525a47f003f3f3f544f4e51",50,48,18,19.4444444444444,37,13,1,1
"15093","68cf6d0f02b518e0869e7d2d4f76101a",160,92,89,12.5842696629213,160,0,3,3
"15094","68d090755fec1482c560ce576a240960",55,55,0,55,55,0,1,2
"15095","68d1bde3bf242c8990278fada0b7a66a",59,48,44,9.38636363636364,59,0,2,1
"15096","68d1d09cee4e9d6a96d4bfe8aa224ac8",44,44,0,44,0,44,1,2
"15097","68d2f4623ae295259fb192e4f5d377d1",20,20,0,20,20,0,1,2
"15098","68d3c7e8fddad0bc5ae1a6654e5d0552",48,38,49,6.85714285714286,48,0,2,1
"15099","68d48466e2a1775d7951c1c3d9053c92",21,21,0,21,0,21,1,2
"15100","68d7b08a9e74803c3781dfcaf8415db8",46,41,7,46,46,0,1,2
"15101","68d7ccf927e604f0c67787d775bb1cc5",54,54,0,54,0,54,1,2
"15102","68df8d2316662eaa6ed05b6dca388a54",8,8,0,8,8,0,1,2
"15103","68e03a36542fc4c154b0b0100651ca0f",61,53,80,5.3375,34,27,2,1
"15104","68e1392791f7aa017243013cd6a4f4b5",24,19,55,3.05454545454545,24,0,2,1
"15105","68e476a815bf212d526fcd21742a6825",12,12,0,12,0,12,1,2
"15106","68e6a35c96737a2cf6c0330647bc37d5",29,29,0,29,0,29,1,2
"15107","68e734a0489655cacb67c344966c5cf9",63,48,53,8.32075471698113,43,20,2,1
"15108","68e7a59b7e47dab6be80b86e73ec7653",31,31,0,31,31,0,1,2
"15109","68edc1f70dddc3a28b244ff744f4bf9e",47,47,0,47,47,0,1,2
"15110","68ee06fac660ebaa98d742e3b86305c5",4,4,0,4,4,0,1,2
"15111","68f1a898be01e11ccf064a2f434f8bd7",20,20,0,20,0,20,1,2
"15112","68f1ece2e7180d29657177318bc38b39",114,83,60,13.3,114,0,3,3
"15113","68f298e59b76dd3ebe6d954294cdfb0f",212,151,88,16.8636363636364,169,43,3,3
"15114","68f3f380e5775cdea7b5fb1a5b438a46",79,57,53,10.4339622641509,79,0,2,3
"15115","68f67f96dbbdf456284ad753134a9406",150,34,81,12.962962962963,138,12,3,3
"15116","68f6bc2c72aa2611e34049ab6ef4c853",41,41,0,41,0,41,1,2
"15117","68f8230fac0c5200bfc867f61e0c9d83",55,48,21,18.3333333333333,1,54,2,1
"15118","68f873b4331d056d136838b5af0d6b5a",9,9,0,9,0,9,1,2
"15119","68fa9f347a26bc3d07a93257d7f85dca",49,41,30,11.4333333333333,49,0,2,1
"15120","690082e7ae70af710d8d8d145ac4894f",102,77,46,15.5217391304348,102,0,3,3
"15121","6901532d060491118a4f311f593000ed",43,39,10,30.1,43,0,1,1
"15122","69032309eb333d5b6115cab020c73765",24,24,0,24,0,24,1,2
"15123","69081d172af9f638264beecafdf01121",10,10,0,10,10,0,1,2
"15124","6908a3caddb6e45227fe90f4f6fa9066",160,114,78,14.3589743589744,119,41,3,3
"15125","6909696db56a19ad815773f6b3bcaeb3",29,29,0,29,29,0,1,2
"15126","690c89160dc9615dd6c5a49753b4f304",82,54,21,27.3333333333333,82,0,1,2
"15127","69103ff25701af685119ffa083e21ca5",124,82,62,14,101,23,3,1
"15128","69134c4405678ce69b0c988203b8ed56",96,57,49,13.7142857142857,96,0,2,3
"15129","6915f9965a96cd7ea2fc1ee5fb883761",44,44,0,44,0,44,1,2
"15130","6917911277bfc8a6beeebf1d0dba7138",42,42,0,42,42,0,1,2
"15131","69187cb47cf037ad1ee1e062b8399fac",32,32,0,32,32,0,1,2
"15132","69191f697a002ebc3a0f12dabd7f0390",31,31,0,31,0,31,1,2
"15133","6919bf6f23a3bd76a57270aba1a0506e",54,45,31,12.1935483870968,54,0,2,1
"15134","691ca301697dfb8fce0747b8a6b600c3",159,90,58,19.1896551724138,159,0,3,3
"15135","691e0eae906b5e863ac530a7f34c459e",71,57,75,6.62666666666667,71,0,2,3
"15136","691f05994e0c33af32c3031046cccd60",167,65,86,13.593023255814,116,51,3,3
"15137","6920c2ba8ddd59004ba8ab9ff3246e96",18,13,39,3.23076923076923,11,7,2,1
"15138","6922c151329b661edf1e0ccb082ec749",147,79,78,13.1923076923077,147,0,3,3
"15139","69262f5d14a1f18e439143a19d35fcad",96,65,43,15.6279069767442,58,38,2,3
"15140","69267bcf77adfc753339ae3668baff17",7,7,0,7,7,0,1,2
"15141","69277876bc9856ab54c4a7419bd58b39",1,1,0,1,1,0,1,2
"15142","6927a022f9c9cc8bf286d59049b6ee11",9,9,0,9,9,0,1,2
"15143","6928fbfe9898e6944ef71feda11c5232",32,32,0,32,32,0,1,2
"15144","692c84c4f5fd19c8c64b461c82a0f852",169,107,63,18.7777777777778,169,0,3,3
"15145","692ca266996b9820c83a70047c989f5a",55,38,64,6.015625,30,25,2,1
"15146","692cb0f624423733b52af9f9739369fd",96,81,68,9.88235294117647,69,27,2,1
"15147","692e07c118ebbdbe9626f01deb89797f",29,29,0,29,29,0,1,2
"15148","692f294a63c7c4b98b800b460b84de31",19,19,0,19,19,0,1,2
"15149","6931f9503ba99b97638f21e7fbce23cf",25,25,0,25,0,25,1,2
"15150","69321392009f65cf62e8850d9478001e",12,12,0,12,12,0,1,2
"15151","6934466080fe195eb1ef5a98ab450dcc",17,11,74,1.60810810810811,17,0,2,1
"15152","693719986ceb55bc124aacab2955850b",186,98,80,16.275,159,27,3,3
"15153","69378b17dfaace741b36aaa13b0ff0da",132,95,55,16.8,132,0,3,3
"15154","693d3f573a766db94ece3facdaf4441d",11,11,0,11,11,0,1,2
"15155","693d867a4b41e47b405f5c0eb54d5dfe",23,23,0,23,23,0,1,2
"15156","69403be00abac7416836e935f57cdc27",48,44,14,24,48,0,1,1
"15157","6940d5b0009b911ba412d1b124d1a248",16,16,0,16,16,0,1,2
"15158","6942dd78b01d2eed9901213f0bb1270c",121,91,59,14.3559322033898,95,26,3,1
"15159","6943bccbe97fc25b767913720a6b6cad",136,99,69,13.7971014492754,89,47,3,3
"15160","69446461ec4f6bf0586e54f37c59d807",102,67,49,14.5714285714286,102,0,2,3
"15161","694d196f794553542c9fe4dfbcbcd324",8,8,0,8,8,0,1,2
"15162","6953bf2c9896f491d1e35c0bc68039cd",39,39,0,39,39,0,1,2
"15163","6956ac9daefeb3711a7275a98e230527",25,25,0,25,25,0,1,2
"15164","69573a4491f158f687637d7aefece1a6",39,24,63,4.33333333333333,39,0,2,1
"15165","695767c053e0438ae5e679585e8c1181",9,9,0,9,9,0,1,2
"15166","6957beb56a0d5b168d9b0d0f177f7da1",85,45,50,11.9,85,0,2,3
"15167","6959d2c6331d7a92101f6815cf78acca",82,53,66,8.6969696969697,47,35,2,1
"15168","695a73b7515f4b1b8ad36afc729ad3eb",78,52,56,9.75,55,23,2,1
"15169","695d6f448f28eeaeb59277244bd2ea49",210,99,76,19.3421052631579,185,25,3,3
"15170","695f53e5356d0bc3c2181025673e37ae",45,37,20,15.75,45,0,1,1
"15171","6962efa311a3d3a67dd27cf60655030c",106,75,77,9.63636363636364,88,18,3,1
"15172","6962f7e5e6e2f405ac4b2a967ccf0e2d",19,15,28,4.75,19,0,2,1
"15173","6963472a517246c0f9493fcdbb479d06",13,13,7,13,13,0,1,2
"15174","69639d63acf7bb9379b3891e0002b238",192,92,62,21.6774193548387,192,0,3,3
"15175","696636e6f1b78a0e70b9d7f4217e82d6",11,11,0,11,11,0,1,2
"15176","6966b64024886efdaa0de73f4a0b552d",21,21,0,21,21,0,1,2
"15177","69671891163c12ff3d6fff8d1c9b193b",29,29,0,29,29,0,1,2
"15178","696a670be753fa5842e0784eb83bb9dc",45,45,0,45,45,0,1,2
"15179","696b5c9d7f2a630305643ca0f0e9233f",6,6,0,6,6,0,1,2
"15180","696b5e57d59d3241f1c6822539f4720c",28,16,63,3.11111111111111,28,0,2,1
"15181","696b9e2fa245c2c5ec60ed36ccedf484",204,101,72,19.8333333333333,157,47,3,3
"15182","696befb9bb22e41e7e0cad36a422f202",76,55,57,9.33333333333333,57,19,2,1
"15183","696f216ec8307774638ce691dd056364",28,28,0,28,28,0,1,2
"15184","696f7a58706f5c78f6623dcd6ffbe5d9",22,22,0,22,22,0,1,2
"15185","69714595af139a6dc1c96737b30dda0b",35,35,0,35,35,0,1,2
"15186","6972af97ce7341dd62ca31059ba0c937",87,45,42,14.5,87,0,2,3
"15187","6973cae7c8f2094a9fb21da0357d4d50",33,33,0,33,33,0,1,2
"15188","6975e443225c2919bf2c9a03a80b0b41",27,27,0,27,27,0,1,2
"15189","69771a39b2c5139576b00e58ea47d5b3",90,77,14,45,90,0,1,2
"15190","6977fda1da8be3b1170cd076090003bc",22,18,27,5.7037037037037,22,0,2,1
"15191","6979e9ed8c91f4abbc643e0b9b1d3a2a",26,26,0,26,26,0,1,2
"15192","697a35c9d2ada58e036dc9c942150a26",52,42,20,18.2,52,0,1,1
"15193","697abe89db72eb546270b769860e4b5c",24,24,0,24,24,0,1,2
"15194","6984bbedb547c6d8001edb616ff0a89d",29,29,0,29,29,0,1,2
"15195","6985cb3b67a9cd0689070bf4182aff8b",19,19,0,19,19,0,1,2
"15196","69866e4aa3e9164021cf62e8fa18b65d",142,62,84,11.8333333333333,142,0,3,3
"15197","698889efa61ba51ef567e79518bdf94f",191,85,65,20.5692307692308,191,0,3,3
"15198","6989918f5602e534599c127246df9bb3",95,75,23,28.9130434782609,62,33,3,3
"15199","698cb617d6713ac827b04921f01dfed2",15,15,0,15,15,0,1,2
"15200","698d2585a9b1d70e2312d4f1d005af5e",25,25,0,25,25,0,1,2
"15201","698e6d4c43ad1296c058e4f40a520d7d",19,19,0,19,19,0,1,2
"15202","69902c77f66d0e2e07da6a22ff640ce5",115,71,62,12.9838709677419,115,0,3,3
"15203","699108a76214e78b6947fda42ab752fc",81,63,67,8.46268656716418,81,0,2,3
"15204","6993b6f761f514ecb851c1afd435270b",44,44,0,44,44,0,1,2
"15205","69944a6503b931b1bbdc72a901fc5a24",99,54,60,11.55,77,22,2,1
"15206","69966f9bfcb6cbe66e92f674bd4d46c7",84,76,28,21,84,0,2,3
"15207","69998c81c0faad80965f8236af241700",29,29,0,29,29,0,1,2
"15208","699b52973887efd24c11259599e114e6",57,47,46,8.67391304347826,57,0,2,1
"15209","699c2f1b1b58b01a302be7f77b005c4c",27,21,47,4.02127659574468,10,17,2,1
"15210","699e6d95607da34d84858891452df101",26,26,0,26,26,0,1,2
"15211","699eab7cbb1cd9dc7dce4b62f79b2ff3",159,105,85,13.0941176470588,139,20,3,3
"15212","69a2d0a4800c16ca3166cf6724711431",167,113,65,17.9846153846154,167,0,3,3
"15213","69a2ed684ded1ecb64cda31563063c35",119,88,86,9.68604651162791,119,0,3,3
"15214","69a386940ee11e1ae48ae543359b1267",31,31,0,31,31,0,1,2
"15215","69a5e3af6402467490ea87243c5279cf",26,26,0,26,0,26,1,2
"15216","69a799debb44c8fe155d3b1ddc556f62",62,50,57,7.6140350877193,62,0,2,1
"15217","69a905133f9460756f87c3eb45a7c321",38,30,9,29.5555555555556,20,18,1,2
"15218","69ab5ad38b3adc90ee6ed97b2b2b299c",45,45,0,45,45,0,1,2
"15219","69adcd5d6d05b66e0082f0bb52c1d69d",15,15,0,15,15,0,1,2
"15220","69addb24f0931fa28413f9ac5b52e583",46,46,0,46,46,0,1,2
"15221","69b33f54f70e764b2751a7706f920eec",65,56,56,8.125,65,0,2,3
"15222","69b61cf3531f9d4650357a939153f48c",108,69,76,9.94736842105263,108,0,3,3
"15223","69b916b7ce2bd9af75c066ec5c7f28b5",31,31,0,31,0,31,1,2
"15224","69ba10c8e292a7619b397152197e598a",55,37,28,13.75,55,0,2,1
"15225","69be538bd38fc538f3677ff58a2297d4",79,65,54,10.2407407407407,51,28,2,1
"15226","69c0d0490d5218709a17c70cf273490f",22,22,0,22,22,0,1,2
"15227","69c262f629b11fa4ffba913cc4b14525",53,38,60,6.18333333333333,53,0,2,1
"15228","69c548375653e45aea6a0e3e989c2c37",159,81,88,12.6477272727273,120,39,3,3
"15229","69c8a636dc1194781cdd07b88469fd99",139,81,84,11.5833333333333,139,0,3,3
"15230","69ce97133106bf5de633b03be0e6cdc4",28,28,0,28,28,0,1,2
"15231","69cf43125b460d7fe175537ce8bc3fe6",5,4,71,0.492957746478873,5,0,2,1
"15232","69d16ce8c2060878d53ad01f20021ed0",39,39,0,39,39,0,1,2
"15233","69d3e59cfff2e188d5f3e44eae52e3b3",80,63,56,10,80,0,2,3
"15234","69d4a3a4dd23e5530f8902367ea7f74a",44,31,57,5.40350877192982,22,22,2,1
"15235","69d5ec82908f3ec6464ae7cf9026a42e",14,14,0,14,14,0,1,2
"15236","69d77eb3c8885fe340f946682b79c397",22,22,0,22,22,0,1,2
"15237","69d790ee3094d74511d3d7684d6c7232",172,97,85,14.1647058823529,143,29,3,3
"15238","69d99d0d4c48707e0c941d9b2e9650d3",26,26,0,26,26,0,1,2
"15239","69daca3b653724cf4ba0db106e40e9e5",46,46,0,46,46,0,1,2
"15240","69dd8c801e25551f05e0240a0ffeb387",110,73,65,11.8461538461538,110,0,3,3
"15241","69ddd17335bbb3531b9898185b17f68c",121,82,50,16.94,121,0,3,3
"15242","69ded21e62e6fec0c8aa8b2fc70e63cc",33,33,0,33,33,0,1,2
"15243","69e1230d40d42f03a0d31eabc6d4cb97",61,46,21,20.3333333333333,61,0,1,1
"15244","69e138b52c4a565dbb8426ed892122c5",75,53,73,7.19178082191781,47,28,2,1
"15245","69e5607cd309d9e3e5d82e60026f3619",29,27,33,6.15151515151515,29,0,2,1
"15246","69e5e303d14a8aa2085be4d48c7ba5c8",83,63,34,17.0882352941176,83,0,2,3
"15247","69e8776ff33ea05d1806c4e2592b0fc4",24,24,0,24,24,0,1,2
"15248","69e954913f823e9ea8226c89981eb252",99,73,25,27.72,99,0,3,3
"15249","69e9890a3f5c5ecccfac37c6bd2dd20b",20,20,0,20,20,0,1,2
"15250","69e9913adee43b85a7311f85fa9ab7c6",160,70,85,13.1764705882353,160,0,3,3
"15251","69eb48548ca20d665fc9f80062cc6e06",21,17,77,1.90909090909091,21,0,2,1
"15252","69ebfdadb393aadb36d10cdbfc5d88d6",52,52,0,52,52,0,1,2
"15253","69ec352d8850330087db63cbd4677e47",59,49,54,7.64814814814815,59,0,2,1
"15254","69eedeecd11313d6c4de24ccb57eb97b",50,50,0,50,0,50,1,2
"15255","69efd60cbdd45da1d1ada7efd3ca9620",32,32,0,32,32,0,1,2
"15256","69f23a874f40b55521ea444e796b8e6b",129,102,44,20.5227272727273,129,0,3,3
"15257","69f328c090668161032a207509ee8302",23,20,31,5.19354838709677,23,0,2,1
"15258","69f3931fa5a4c481cb99fff8ab457e85",164,60,75,15.3066666666667,116,48,3,3
"15259","69f55e449581424cc1710333a13441e9",70,49,70,7,70,0,2,3
"15260","69f6ad8d97bce6373455ecc11aeb8abe",100,79,59,11.864406779661,79,21,3,1
"15261","69f7a5a40a443c317221fdbc95d82772",37,37,0,37,37,0,1,2
"15262","69f945b75c2e41f276b1a26b20f84367",20,20,0,20,20,0,1,2
"15263","69f9f6e9252ffb77553e7b089a183f40",14,14,0,14,14,0,1,2
"15264","69ff328cf52442e99b0e2e2ff194a8c7",53,53,0,53,53,0,1,2
"15265","6a00c179a5a88a76b0a66ff6826e78a4",4,3,51,0.549019607843137,4,0,2,1
"15266","6a01bb3618fa0239cfebdd84529774b2",39,39,0,39,39,0,1,2
"15267","6a02e02592cb98b08cc4799f3fee9813",196,84,57,24.0701754385965,196,0,3,3
"15268","6a03762a516b526da04cac811a302b2e",54,35,57,6.63157894736842,54,0,2,1
"15269","6a0442e01e6bea415a094ab4070c3b43",24,24,0,24,24,0,1,2
"15270","6a08677a3d0581ea5c5b2cdc08df3032",16,16,0,16,16,0,1,2
"15271","6a08c3c0244d89034209c6d2ccd4f00c",76,52,51,10.4313725490196,76,0,2,3
"15272","6a0a70d2e27b47c36213f995f4783362",14,14,0,14,0,14,1,2
"15273","6a0e12380fa0c2e54e2e9fa955950fa4",75,72,28,18.75,75,0,2,1
"15274","6a0f30970cb92fd0e9e410a55b11aba9",45,45,0,45,45,0,1,2
"15275","6a124411ab1a9de7775c4697a8ae0849",33,28,41,5.63414634146342,33,0,2,1
"15276","6a12dbaa55669f65bc366e9be7834fb6",73,58,39,13.1025641025641,42,31,2,1
"15277","6a18bd9fe96da8ff0fefb1044e49e13b",153,86,70,15.3,117,36,3,3
"15278","6a18c39522a75045b9879a57f243ab0f",110,67,58,13.2758620689655,72,38,3,3
"15279","6a191d7523892374ed4808b960f27584",23,23,0,23,23,0,1,2
"15280","6a1bb64eceb26bdd785725102b5a9fef",2,2,0,2,2,0,1,2
"15281","6a1d126e170fff2b47ff563598416e9e",53,53,0,53,53,0,1,2
"15282","6a1e605b08fb976ecf14a96e64c1e14a",100,55,65,10.7692307692308,69,31,2,1
"15283","6a1e8b7fde12a8cfa0b7a3e0e107c7da",51,51,0,51,51,0,1,2
"15284","6a21ce35ade8e5d281f4b82626b7507b",109,74,35,21.8,76,33,3,3
"15285","6a2228e984dbab537b34eb76ba33982e",25,25,0,25,25,0,1,2
"15286","6a227152cc0890044347744bf671e8fd",45,45,0,45,45,0,1,2
"15287","6a243351cf15e136515d339465f9db24",35,35,0,35,35,0,1,2
"15288","6a24da5380963100057a1cac99e41022",31,28,27,8.03703703703704,31,0,2,1
"15289","6a24efa55d252cd8c019c38d8052a020",173,91,75,16.1466666666667,126,47,3,3
"15290","6a24f4ebd5344e9178958e2178a2c7d9",159,106,58,19.1896551724138,159,0,3,3
"15291","6a2536e81cb4f67ae64a202d58362daa",83,72,15,38.7333333333333,42,41,1,3
"15292","6a262d3ec3c0476364638273b46d9f90",202,112,75,18.8533333333333,166,36,3,3
"15293","6a263a9ba787686d0268fcb7cc0fbc6f",103,82,45,16.0222222222222,103,0,3,3
"15294","6a2645fa707dba9933f2b03dad27a454",96,59,71,9.46478873239437,96,0,2,3
"15295","6a2b44df565ea39853066ec9df1b8092",9,9,0,9,9,0,1,2
"15296","6a2b51033c42a7e2c1f7942a791433ee",88,64,70,8.8,88,0,2,3
"15297","6a2c421d0e8e5e63613603253158abff",104,87,46,15.8260869565217,83,21,3,1
"15298","6a2f56325913faacc2c3730c0c60f843",81,69,76,7.46052631578947,81,0,2,3
"15299","6a305c908dd68f89ff1abfbacf8b094f",92,70,81,7.95061728395062,40,52,2,3
"15300","6a306589f304826020ff6758e121e70b",51,43,35,10.2,0,51,2,1
"15301","6a347dcc0c03f7a6ea5465f68bdaa1dd",53,42,50,7.42,53,0,2,1
"15302","6a370a27f82f4688dee4c8218511e0f1",16,6,49,2.28571428571429,5,11,2,1
"15303","6a3867e28feb08fd74ccdfbac284db4f",4,4,0,4,4,0,1,2
"15304","6a38ab5a4b6ce7b78059d75b0dd8209f",60,35,57,7.36842105263158,60,0,2,1
"15305","6a3a59472c4546edccc3ca43226ac8b6",71,53,62,8.01612903225806,71,0,2,3
"15306","6a3b3b61808c5fbc1259726ff22f0292",17,17,0,17,17,0,1,2
"15307","6a3b7caa929be20afb6fd60010849a66",25,25,0,25,25,0,1,2
"15308","6a3c1fcbe72bf9981bd4dd04a6d3458c",62,50,20,21.7,32,30,2,1
"15309","6a3f24cab1b2f0a4f026d0e97683be18",127,103,77,11.5454545454545,127,0,3,3
"15310","6a45d7914aac1e16c51ab23c793935e1",143,90,68,14.7205882352941,143,0,3,3
"15311","6a46b2206e5b154ebca1e0e56711b74b",26,20,21,8.66666666666667,0,26,2,1
"15312","6a49c1629094171c0102747a2905cbd9",115,64,55,14.6363636363636,115,0,3,3
"15313","6a4d0a96d17bbbd24e3f914e81a7f5c0",24,24,0,24,24,0,1,2
"15314","6a4e7f7700983888d600f51ba2b7f36e",25,25,0,25,25,0,1,2
"15315","6a502c72fd06589239d01efa77287af4",34,28,18,13.2222222222222,34,0,1,1
"15316","6a506f0696e7cb37e800184943d7ac10",1,1,0,1,1,0,1,2
"15317","6a50bddc79d7673f40c49dda67353406",12,12,0,12,12,0,1,2
"15318","6a5613eb1d5ef6c86f48d8060d7dbca3",122,86,57,14.9824561403509,74,48,3,3
"15319","6a57532892f8621dc07bd302025c4953",23,23,0,23,23,0,1,2
"15320","6a57689d92ead2e6a8e25b56d24275b6",1,1,0,1,1,0,1,2
"15321","6a57b03a960c1f954fc2198cfb5e2475",46,46,0,46,46,0,1,2
"15322","6a591a6d9626b57b1dc49b1c9038a8eb",4,3,3,9.33333333333333,4,0,1,2
"15323","6a5d0117afc9c227f9802b8b4c670b18",9,9,0,9,9,0,1,2
"15324","6a5f9cd20fbf22e74fb77c53f6a4b062",107,77,69,10.8550724637681,82,25,3,1
"15325","6a60da4a7dfba231e90c4e3ad5dfb2d6",87,79,74,8.22972972972973,87,0,2,3
"15326","6a62f26ad0a8e27212b4a2e39fda584c",62,48,36,12.0555555555556,62,0,2,1
"15327","6a64c26653d23922c826a9211a5aa477",9,9,0,9,9,0,1,2
"15328","6a6cba9da7846f681181ba8cda5eca83",190,67,76,17.5,190,0,3,3
"15329","6a6cfcd79f39d4b6d0d8593d60159310",185,89,79,16.3924050632911,158,27,3,3
"15330","6a6f148767e7c35c6c38cf8ee8b96b29",24,23,38,4.42105263157895,19,5,2,1
"15331","6a80848eb3bad53035c2e7f5e263d9dd",98,60,43,15.953488372093,54,44,2,3
"15332","6a811f37527798c4eb7ff360206d1759",52,35,39,9.33333333333333,52,0,2,1
"15333","6a82a1e9009356ccd9b61580dd202349",118,66,54,15.2962962962963,118,0,3,3
"15334","6a83355bfaad02b3332e031e3a636299",116,73,61,13.3114754098361,116,0,3,3
"15335","6a839632e4481116061cda3dfac06457",40,31,33,8.48484848484848,15,25,2,1
"15336","6a866dc5ced84fd6a3dbc789fc387f3d",25,25,0,25,25,0,1,2
"15337","6a86d73fb50777bf727ddcef476b12e2",36,36,0,36,36,0,1,2
"15338","6a89c4f40f2a352b976fea9747330ec3",17,17,0,17,0,17,1,2
"15339","6a8b71676e44c0c949b726143bb0259f",22,22,0,22,0,22,1,2
"15340","6a8d45f44596a11e0b822ff2b3625e38",9,9,0,9,9,0,1,2
"15341","6a8d74fb6bfc9586a23f6096e41ff7c9",18,18,0,18,18,0,1,2
"15342","6a8ed3d3699071ebc02fa4347ba02e10",89,59,34,18.3235294117647,89,0,2,3
"15343","6a92405ebc34cd9fd0135562bcf8c109",63,37,58,7.60344827586207,63,0,2,1
"15344","6a92a21ea5dbc7262beb098bd2157241",32,32,0,32,32,0,1,2
"15345","6a93956d3b9e241648c175a01100ced0",19,19,0,19,19,0,1,2
"15346","6a96c5d66a886527905ef6d31968b74b",197,156,61,22.6065573770492,159,38,3,3
"15347","6a971c10a8d47cafd089de3cfa70e0f7",149,119,63,16.5555555555556,149,0,3,3
"15348","6a973f2070bd3ca26c8ddb42134c39c2",6,6,0,6,6,0,1,2
"15349","6a982c274cc0f845cac95df5087037af",27,15,41,4.60975609756098,27,0,2,1
"15350","6a99ba94088cdde8ffecd7663e7f825f",101,80,70,10.1,101,0,3,3
"15351","6a9c68127d66de0cc3682933faee8780",5,5,0,5,5,0,1,2
"15352","6a9d4154b036b416165cebc38aba2a68",150,122,52,20.1923076923077,100,50,3,3
"15353","6a9f565ee1c71d0977818bf58cb30c4c",82,70,17,33.7647058823529,82,0,1,2
"15354","6aa11a778cccfb9f98f8e673d69bcc35",21,21,0,21,21,0,1,2
"15355","6aa189e0bca7982ce1d645838faf2c8e",139,88,68,14.3088235294118,139,0,3,3
"15356","6aa22d17b7c0e925c486a1b8106dd381",37,28,64,4.046875,37,0,2,1
"15357","6aa588b6cae2e017046a5c44dc28c4f9",3,3,0,3,3,0,1,2
"15358","6aa8847956beb51223998b47f12c147d",137,87,56,17.125,137,0,3,3
"15359","6aa9db962966b513d847a19cb5a10e8a",20,16,36,3.88888888888889,20,0,2,1
"15360","6aad42908f02b2476e4a8e60fbf0fcea",21,21,0,21,0,21,1,2
"15361","6aad7eb135648fd74f327dd23314a1fd",33,33,0,33,33,0,1,2
"15362","6aadff57f1202a1012c048de79fe7e80",88,54,67,9.19402985074627,88,0,2,3
"15363","6aae42a92c0cdd9f511d132b353fce1a",32,32,0,32,32,0,1,2
"15364","6aaec4f5079d9cd07666bf9084bdb5f2",162,96,38,29.8421052631579,127,35,3,3
"15365","6ab130b8a23c6bdf8509f9357f1a4602",41,34,7,41,41,0,1,2
"15366","6ab29539e41a2daec4dba55eecf9530d",11,11,0,11,11,0,1,2
"15367","6ab4d5dfe6275872353d2e9a00d946a9",50,46,44,7.95454545454546,50,0,2,1
"15368","6ab4f9328368239b12dbafb871db9095",5,2,73,0.479452054794521,3,2,2,1
"15369","6ab85c5f6ebfaa64e7175f37d0984dd8",43,43,0,43,43,0,1,2
"15370","6ab887a25f1f4552abc4fff46f4dae70",9,9,0,9,9,0,1,2
"15371","6aba73ae466f83ad36a685299df65942",156,106,45,24.2666666666667,130,26,3,3
"15372","6ac2d22a757f5890a0271cbd5391597d",2,2,0,2,0,2,1,2
"15373","6ac2d2b5f3006c4dd379b15ccdaf3aa5",30,30,0,30,0,30,1,2
"15374","6ac3ab28d46ab7e6793c711074dc895a",23,15,30,5.36666666666667,23,0,2,1
"15375","6ac42dfcdb3aff6311b59c800c2e1158",125,46,70,12.5,125,0,3,3
"15376","6ac4488ccc30eec14097980152aa8d97",40,40,0,40,40,0,1,2
"15377","6ac69e84cbfa556cb8a5b8f1c1f923d1",46,46,0,46,46,0,1,2
"15378","6ac6cc689dfb2e4c1047db1d312e74f5",24,24,0,24,24,0,1,2
"15379","6ac8f17fa9ab8ed555126a71b0497d38",12,12,0,12,12,0,1,2
"15380","6accbc4ff4c8e94bad38389bc15382d1",30,30,0,30,30,0,1,2
"15381","6acf073c0e59f1cffe08fa7efc34b4c0",15,15,0,15,15,0,1,2
"15382","6ad1aa1fad14d7130ee94d8a8b406b77",31,15,77,2.81818181818182,31,0,2,1
"15383","6ad3c09c51b01ee4ecf0c04e71a228ec",29,29,0,29,29,0,1,2
"15384","6ad4cd5c8874480a95f393e8d08fc469",69,39,34,14.2058823529412,69,0,2,1
"15385","6ad4e99868de547a7f334f52d631b68d",32,32,0,32,32,0,1,2
"15386","6ad69afa0dfdb35a223467be6d8b2bef",30,30,0,30,30,0,1,2
"15387","6ad728af6f54d7c85febb2a783dada53",26,26,0,26,0,26,1,2
"15388","6ad7abdda44b3d46fb57a67c812d487f",67,58,22,21.3181818181818,36,31,2,1
"15389","6ad7e3e4a2a1f2de6ecf15b0678ac0c6",101,65,62,11.4032258064516,101,0,2,3
"15390","6ad8e52f7d623d3e446a987b8d14ca85",120,52,66,12.7272727272727,120,0,3,3
"15391","6ad97a80d716cc0f945a410be22e061a",33,33,0,33,33,0,1,2
"15392","6addb584a24b2833589dbbba8dce6935",60,44,34,12.3529411764706,30,30,2,1
"15393","6adf68ecad5c1ce676ffe9bf5e088b29",75,50,76,6.90789473684211,47,28,2,1
"15394","6ae122df3463dcf6483d0c1c4fe4d1da",97,54,62,10.9516129032258,63,34,2,1
"15395","6ae29b87846c9a19f3b8397504334484",18,18,0,18,18,0,1,2
"15396","6ae617b596b5b195cff5285909590514",15,15,0,15,15,0,1,2
"15397","6ae6b22b2d832b8eaa7ca9e165621f1d",37,37,49,5.28571428571429,37,0,2,1
"15398","6aeaaa87e860efae391d1721cc13282c",45,45,0,45,45,0,1,2
"15399","6aebe243eee6b1ded68461cb82c0574d",147,73,84,12.25,147,0,3,3
"15400","6aec1a189bf286d326569ba35529cd3a",56,44,11,35.6363636363636,56,0,1,2
"15401","6aed1d32630c52cc200b3bb4a2d5d721",143,95,76,13.1710526315789,100,43,3,3
"15402","6af22f861b9fd8fab62416bb141f06fb",29,29,0,29,29,0,1,2
"15403","6af3a4861e5e0ffca1d50b6ad6f89ea2",67,45,46,10.195652173913,41,26,2,1
"15404","6af533f37bcaa45c5efda5ca730abfb9",28,28,0,28,28,0,1,2
"15405","6af60a5d8e950eb1f12be77f03a2dced",87,65,29,21,87,0,2,3
"15406","6af61e63649b56e7b26f0181e30c2080",23,23,0,23,23,0,1,2
"15407","6af80c4a3604178c7fa3c62141e6a2f4",34,30,22,10.8181818181818,34,0,2,1
"15408","6afb77772c7b0c5bb992e178f9b7dae0",23,23,0,23,23,0,1,2
"15409","6afd1dd79af658c3974f690702441106",49,49,0,49,49,0,1,2
"15410","6aff0f0300dc9b55f54a22838e039045",65,51,69,6.59420289855072,65,0,2,3
"15411","6affb68b7f6f1c34a9f1fe0fbfb554dc",176,96,64,19.25,146,30,3,3
"15412","6b00f9c1f2cf7c1ce7e866fe13bc567b",198,125,69,20.0869565217391,198,0,3,3
"15413","6b04474d7832c33e6840c6bdbd7c0aac",58,36,75,5.41333333333333,58,0,2,1
"15414","6b047724f60049261070b9132a762aa4",79,51,56,9.875,79,0,2,3
"15415","6b06a42c90478e8089253e3df6c465ee",29,29,0,29,29,0,1,2
"15416","6b06f6cc7506c504e93868f9f6fdf5a3",27,27,0,27,0,27,1,2
"15417","6b0821bad9b332bebbc262388358cff4",44,44,0,44,44,0,1,2
"15418","6b0ad2594b3cc5046b7dadf33a3a9ace",71,62,81,6.1358024691358,71,0,2,3
"15419","6b0ae307a095b89fdee475e6969d1b6b",137,99,69,13.8985507246377,137,0,3,3
"15420","6b0c37ba0e190317bd27d8dfd9e4315d",29,28,71,2.85915492957746,29,0,2,1
"15421","6b0e4bdfce3cc6ced29e0c550685b81d",201,108,89,15.8089887640449,201,0,3,3
"15422","6b0f0e1adbaf7bd9baa093d51023b44d",55,42,16,24.0625,55,0,1,1
"15423","6b1234f8466d000c2512bd25d2c5ac6e",20,20,0,20,20,0,1,2
"15424","6b13411f58953e5b949c87414778e499",34,33,51,4.66666666666667,34,0,2,1
"15425","6b13e03159009f7aca3f707ad1111dd9",132,104,74,12.4864864864865,132,0,3,3
"15426","6b15b909c2dfae08788a1797dc1300e9",33,33,0,33,0,33,1,2
"15427","6b16eb618ffb203d230cb6cad5e4fb0d",114,63,78,10.2307692307692,83,31,3,1
"15428","6b19198ee85d0f0305acd55d13da10ca",21,21,0,21,21,0,1,2
"15429","6b1e11ee61dd1588230919dc67d78d2d",28,28,0,28,28,0,1,2
"15430","6b22aef58f8efb4837845f3b396ff8d9",28,28,0,28,28,0,1,2
"15431","6b2310f175d1818e2422465b2f90c572",100,66,68,10.2941176470588,100,0,2,3
"15432","6b264ad8014dec991d372cd45e4b6492",44,44,0,44,0,44,1,2
"15433","6b268774348c58c959d0b21fde28338b",112,87,50,15.68,112,0,3,3
"15434","6b2cb2b45b54792cd873d8bbc4480434",30,30,0,30,30,0,1,2
"15435","6b2e2402c16b9cf152cdd7592f2cf426",29,29,0,29,29,0,1,2
"15436","6b2f4640e4056c301e34e83afc4cc840",120,83,45,18.6666666666667,120,0,3,3
"15437","6b2fa8817c22010d4be5405d40a7a9e0",27,27,0,27,0,27,1,2
"15438","6b3203436ffe840b1e912ee175502f75",115,87,67,12.0149253731343,115,0,3,3
"15439","6b3428dc8ed266c0e25b14c566143a45",82,55,47,12.2127659574468,72,10,2,1
"15440","6b350570a2db1e4f65eb9dd27aba6246",38,38,0,38,38,0,1,2
"15441","6b352d350dfe8de626e105e16db174bc",18,18,0,18,18,0,1,2
"15442","6b36620662362506e5ad0d660c89f69a",42,42,0,42,0,42,1,2
"15443","6b3761b5a2bd674bc0e70f88d96ca366",143,82,54,18.537037037037,143,0,3,3
"15444","6b3786b4efbf804a5ba4ff1cdb534d55",206,77,84,17.1666666666667,177,29,3,3
"15445","6b383edaab4076ea940aa3d1445d86ea",61,48,23,18.5652173913043,27,34,2,1
"15446","6b397828a572937e2b8c1b51eef35f38",91,63,31,20.5483870967742,42,49,2,1
"15447","6b39f47224238573f6ceb5e2070d7a60",17,17,0,17,17,0,1,2
"15448","6b3da8d0d845a8e0c4fce4f80b533c3e",52,41,7,52,52,0,1,2
"15449","6b4303f44357fe122e21df5311b907b5",163,96,59,19.3389830508475,116,47,3,3
"15450","6b435608d65421f736a9359d49f1ebd7",2,2,0,2,2,0,1,2
"15451","6b47358fa6e912a44393a049ac8495a1",11,11,0,11,11,0,1,2
"15452","6b4d284c00dff53659a7a3be51f5c6b9",37,30,37,7,37,0,2,1
"15453","6b4d376b46ee6424287b09cbbffb43c7",43,43,0,43,43,0,1,2
"15454","6b4dfaec0c9164bb711e0f87e1fce1df",46,38,33,9.75757575757576,20,26,2,1
"15455","6b4eb3abd53bf816300c5473ec7a8bbd",51,44,29,12.3103448275862,51,0,2,1
"15456","6b527c61e31935b7945e22b64fa333f9",76,59,65,8.18461538461538,48,28,2,1
"15457","6b543d1e7ff71db69fec1a43fa426f32",121,97,48,17.6458333333333,98,23,3,1
"15458","6b54bd302041b01a7f57c7ef3c859710",108,72,75,10.08,108,0,3,3
"15459","6b55cff99687382dee5786becb3f4ed4",66,61,68,6.79411764705882,66,0,2,3
"15460","6b5718b4596457ce3ec36a22d549a7a9",61,53,51,8.37254901960784,61,0,2,3
"15461","6b59e03778b355fda6d73425c264e2ac",17,10,56,2.125,17,0,2,1
"15462","6b5b874aa8c85899111d3e7976d9713e",6,6,0,6,6,0,1,2
"15463","6b5b94cb320eb678a7af6fd7398ce707",45,38,17,18.5294117647059,20,25,1,1
"15464","6b5eb8491c621a516656399419e13864",7,7,0,7,7,0,1,2
"15465","6b5f8b7dd96df4700d6758fc339e9e96",66,55,64,7.21875,66,0,2,3
"15466","6b5faa5358a181bd2cabd2b3fe473b3e",10,7,33,2.12121212121212,5,5,2,1
"15467","6b6007e9e35dcaa3945cf17b5404bfc2",162,106,70,16.2,162,0,3,3
"15468","6b6185232621c25050ba621c9b708741",231,145,75,21.56,193,38,3,3
"15469","6b62a3ecd8f05e47eb4b0331b71fa92a",7,7,0,7,0,7,1,2
"15470","6b62c8118a1cb0ecd89a6368d916be48",77,64,35,15.4,53,24,2,1
"15471","6b64410a8f510568a03601aff03c51ac",86,59,71,8.47887323943662,86,0,2,3
"15472","6b64cad89e4200d83cad1dd64c69209e",92,56,56,11.5,92,0,2,3
"15473","6b64ed4cae7dd90736d90a8872dcf520",160,105,64,17.5,108,52,3,3
"15474","6b657de44ebf36dac4e292ac02bde79a",129,75,60,15.05,101,28,3,1
"15475","6b6a6cb623362e2ec48e090f2c5ebf79",97,78,56,12.125,97,0,3,3
"15476","6b6ac30a27c3623686ee6219e2328892",66,50,47,9.82978723404255,66,0,2,3
"15477","6b6bcd68a273a02cf022cfe97eaa72df",6,6,0,6,6,0,1,2
"15478","6b6f1b2cae83b1b46a3bb2eb949dc32c",167,99,66,17.7121212121212,167,0,3,3
"15479","6b6f74acfdd100f884ac827b5060072d",96,43,43,15.6279069767442,96,0,2,3
"15480","6b70e24cd14019e6ddfaae5fb11fdab8",9,3,40,1.575,9,0,2,1
"15481","6b777c8e26ba31ffb7861cb7727e3d63",39,31,61,4.47540983606557,31,8,2,1
"15482","6b77a88af4337083983ec341255335d5",34,34,0,34,34,0,1,2
"15483","6b7b95549bcccfadbb47c2fd2c372710",15,15,0,15,15,0,1,2
"15484","6b7cbee93ad95cf0dc5b81512295591c",19,19,0,19,19,0,1,2
"15485","6b7cdec33563b7524d56fef8e5713ecf",63,63,36,12.25,63,0,2,3
"15486","6b7d474302162d76f372da766fcbbd83",28,28,0,28,28,0,1,2
"15487","6b7dc2777c28ac19744cf413d8366982",78,49,61,8.95081967213115,78,0,2,3
"15488","6b7e17cf40513d8dfc70ea8afb9ea451",47,44,10,32.9,17,30,1,2
"15489","6b801e83f367526d67809efdfe71875e",19,19,0,19,19,0,1,2
"15490","6b80edd13664f301b356036a20060b71",155,70,77,14.0909090909091,155,0,3,3
"15491","6b8104306210dcfc272d519397ba91fc",34,20,66,3.60606060606061,34,0,2,1
"15492","6b8185b636bcf9e50795da33ba66472d",51,51,0,51,51,0,1,2
"15493","6b8937c195d550c27640558de83cfc52",66,52,66,7,66,0,2,3
"15494","6b8a197d80be0a66acf313ecae10995b",52,29,66,5.51515151515151,41,11,2,1
"15495","6b8afb8d0f4a1b80c7aaab9216fa8978",22,22,0,22,22,0,1,2
"15496","6b8e01a76677edfb809bc1a565f15b4e",19,19,0,19,19,0,1,2
"15497","6b91011c07b699cffdc02c5253bd6ec9",5,5,0,5,5,0,1,2
"15498","6b91c3185c25bbffdb22303476ba58ee",195,84,89,15.3370786516854,170,25,3,3
"15499","6b93274ddb343b79b9c7c28eb1640afd",112,93,28,28,112,0,3,3
"15500","6b9532f87922205d4f841e7e56d1556f",16,16,0,16,16,0,1,2
"15501","6b9823b8c4bc73d67468b1bbb99c02ba",54,40,83,4.55421686746988,54,0,2,1
"15502","6b9891b82b36cb44715080734e09fbdb",166,100,75,15.4933333333333,166,0,3,3
"15503","6b9ddba8ec8aa28870d514282f35c162",14,14,0,14,0,14,1,2
"15504","6b9e638b2b3d944a7551b0e973dd0c10",28,23,42,4.66666666666667,28,0,2,1
"15505","6b9f44249690686591b1e8cba85465be",8,8,0,8,8,0,1,2
"15506","6b9f4dcc175ceb7d135e5c595d28f93c",105,84,34,21.6176470588235,105,0,3,3
"15507","6b9f9b65d07f917867c1c942b5663c24",49,37,42,8.16666666666667,0,49,2,1
"15508","6b9fed5a82841326beea495dea726d3a",19,19,0,19,19,0,1,2
"15509","6ba7ab6e8f0a60ebfbab85d1e3327457",219,98,71,21.5915492957746,219,0,3,3
"15510","6ba8857311f7925e6e9c9f1fe8fef9ac",83,71,27,21.5185185185185,83,0,2,3
"15511","6ba975ecc4f603a32bcbcd64a0aa8c06",5,2,61,0.573770491803279,5,0,2,1
"15512","6bac76dbada52f28d9145c0cb07e1f57",98,77,81,8.46913580246914,78,20,3,1
"15513","6bb29b9899b388f677853300c8c62914",26,23,21,8.66666666666667,0,26,2,1
"15514","6bb80b255566564fd6ca6054d39ef6fb",44,35,33,9.33333333333333,44,0,2,1
"15515","6bb98e72c3fe9b0a44e1b0c7debd4be3",19,19,0,19,19,0,1,2
"15516","6bbc762bd5a6d4926d81f6058305fd92",130,86,51,17.843137254902,99,31,3,3
"15517","6bc329870553e8c9a58d39d38bc97dc4",74,70,12,43.1666666666667,74,0,1,2
"15518","6bc6eca9f45b60fcc5e633a76ab4f16a",5,5,0,5,5,0,1,2
"15519","6bc87f882e9c8673553423e35b142edb",168,122,61,19.2786885245902,168,0,3,3
"15520","6bc89f4d252a95eb1927777648f7d297",40,40,0,40,40,0,1,2
"15521","6bc99dbea21f37217b4f75168db3491d",48,37,29,11.5862068965517,48,0,2,1
"15522","6bca2b03905c30b77255d6a875d30681",100,73,68,10.2941176470588,70,30,2,1
"15523","6bca900cf51318aedc12edc88d881062",177,86,63,19.6666666666667,177,0,3,3
"15524","6bcdb32dd8bbbf1b59bef0f48e68ef2e",41,32,42,6.83333333333333,41,0,2,1
"15525","6bce2054e171c86e8c1676dfd7402772",26,26,0,26,26,0,1,2
"15526","6bceb7c5d6ced88c015fd7ade1b7b9fb",20,20,0,20,20,0,1,2
"15527","6bd0edb6f31f75b65b779f9f71bd44c5",29,29,0,29,29,0,1,2
"15528","6bd1414cce6b96dfa3ede456c2bfd6a9",122,63,74,11.5405405405405,122,0,3,3
"15529","6bd157c637d94d23359eb245cfb745bd",62,48,31,14,29,33,2,1
"15530","6bd2bfc836ec474b89e82d9b59c776d3",213,74,85,17.5411764705882,197,16,3,3
"15531","6bd3d3402c86ace80ddc5d0f7da51ee6",89,68,61,10.2131147540984,89,0,2,3
"15532","6bd465d6c1e6de964f026f136390d24f",28,28,0,28,28,0,1,2
"15533","6bd6d4177ca02bb19daccbbd985c5eea",178,98,73,17.0684931506849,134,44,3,3
"15534","6bd91ccc9aa0744e119860623beacd2f",69,58,48,10.0625,69,0,2,3
"15535","6bda33a2a68e96455729de57a62db5e4",44,44,0,44,0,44,1,2
"15536","6bdc161c9ea29d0127a0ee8677dc720b",56,56,0,56,56,0,1,2
"15537","6bdd54d2453f3602e83afcbb99f7208e",15,15,0,15,15,0,1,2
"15538","6bddfaeecad3526c31e8d979b076f64b",83,65,45,12.9111111111111,83,0,2,3
"15539","6be02e11247d1cc0a8fd60a5050d8810",129,83,38,23.7631578947368,79,50,3,3
"15540","6be216730209e310f94a83557b8bc3a4",48,42,74,4.54054054054054,48,0,2,1
"15541","6be3b2530ff2f349b83a2e578495b34f",12,12,0,12,12,0,1,2
"15542","6be5db2da58738c82b2697ab9b4eaf7d",149,95,63,16.5555555555556,131,18,3,3
"15543","6bec136e20cf49b5544a58ac05d51d44",79,66,32,17.28125,79,0,2,3
"15544","6bed2d436e17a7093cfdf81c3c1872b4",53,47,63,5.88888888888889,30,23,2,1
"15545","6bedae89badcf620622b34516838a8f4",52,47,18,20.2222222222222,52,0,1,1
"15546","6bef1212ea5bd5bf93ee56417ae9a19b",2,2,0,2,2,0,1,2
"15547","6bf02f5795e5cd91ef9df4eee5109ece",20,20,0,20,20,0,1,2
"15548","6bf0de276f83abb5ba41d2e6652a668b",128,56,63,14.2222222222222,128,0,3,3
"15549","6bf11697d527dbd7ddadb0d80a839b6a",63,46,38,11.6052631578947,48,15,2,1
"15550","6bf3583eca0d0ccf22503efca5432fd4",24,24,0,24,24,0,1,2
"15551","6bf394acb07eb0c731b18e7136a38025",45,45,0,45,0,45,1,2
"15552","6bf39b4e4979df579dc28d7ad421293f",163,74,88,12.9659090909091,163,0,3,3
"15553","6bf654be9ac67d59ea30940330c03755",19,19,0,19,19,0,1,2
"15554","6bf80d1b0be9b83c67a3a22b4f429807",102,64,70,10.2,102,0,2,3
"15555","6bf82c58b7c939f8bdc45422871218fe",94,56,52,12.6538461538462,47,47,2,1
"15556","6bf922e034955f3d7507036e4ade38f4",46,46,0,46,46,0,1,2
"15557","6bf958c9e2350fd0bbe7bf4ee41f67a6",37,27,29,8.93103448275862,37,0,2,1
"15558","6c00c5b7d963f1d331261bb69fb89619",88,32,74,8.32432432432432,72,16,2,1
"15559","6c021570e90decf4724362e42a1265fc",22,22,0,22,22,0,1,2
"15560","6c027992a61315d0b64d961108f20a55",84,74,24,24.5,34,50,2,3
"15561","6c033764ce0b8ddc486b89ba85404d38",111,46,68,11.4264705882353,111,0,2,3
"15562","6c035568c654826800ed583feee83d01",172,92,63,19.1111111111111,172,0,3,3
"15563","6c03e31668c14f94d58b9f036a0ebd2d",25,15,42,4.16666666666667,25,0,2,1
"15564","6c062b75c13a1ab14b7c374957e4cb3b",18,18,0,18,18,0,1,2
"15565","6c085914e7763e84f1430c26228725f4",46,36,73,4.41095890410959,46,0,2,1
"15566","6c0c3a9c24e7d21b75211c63d7c2c70d",35,35,0,35,35,0,1,2
"15567","6c0deb4514a6f1a0875af95d3e86f2d9",5,3,2,17.5,5,0,1,2
"15568","6c0e9ff8a3e990785485f22ab9e331e4",62,53,61,7.11475409836066,28,34,2,1
"15569","6c0ebd39268f17ba03369602ce53d431",81,60,66,8.59090909090909,49,32,2,1
"15570","6c0ed1920d582ff4cb0ccb19379c700e",11,11,0,11,11,0,1,2
"15571","6c0f225464b9342049f38307031fa69b",16,12,36,3.11111111111111,16,0,2,1
"15572","6c0f4db30d9e82cccb8c4955f258004c",31,31,0,31,31,0,1,2
"15573","6c0fe3d5214baef4353a2a98711eb11e",40,34,18,15.5555555555556,40,0,1,1
"15574","6c1111db28fda043ecf6ad330c7237f3",128,94,70,12.8,128,0,3,3
"15575","6c13d7dce6d8af3134298c47aa8400c1",128,76,47,19.063829787234,93,35,3,3
"15576","6c13daf091808b3eb47e724e9603cd68",82,63,56,10.25,82,0,2,3
"15577","6c14dd6736085c6a09a4ded94add8fa9",27,27,0,27,27,0,1,2
"15578","6c177af3fcd4f114e925609094586efe",31,31,0,31,31,0,1,2
"15579","6c17d0ddb33ba18e5eddc3027359431d",49,34,64,5.359375,49,0,2,1
"15580","6c18866f116b6df64afbdf1b672f716e",19,19,0,19,19,0,1,2
"15581","6c18ac86a7a7762ef64a88cb7c4be58b",32,32,0,32,32,0,1,2
"15582","6c1a1e7060d7eeae1f21d0e8e962c382",53,53,0,53,53,0,1,2
"15583","6c1ef5e55a4320648765f63c94b94ed1",19,12,63,2.11111111111111,19,0,2,1
"15584","6c1f9c957261e0850b9ecc26a1697629",55,41,41,9.39024390243902,55,0,2,1
"15585","6c22378e3809926f4f36a9477c9fa26e",1,1,0,1,1,0,1,2
"15586","6c2cdf487a48dbc4d028dffb4723ff1c",63,42,14,31.5,63,0,1,2
"15587","6c2f9fe577fb08c101afd02ec6f0edf4",25,25,0,25,0,25,1,2
"15588","6c2fb10c43002ddaa2574542404983d6",23,23,0,23,23,0,1,2
"15589","6c2febee9e1111b1f559abc9a5215e66",64,39,83,5.39759036144578,64,0,2,1
"15590","6c3283470d1019d7f273fcdbb787dd07",37,37,0,37,0,37,1,2
"15591","6c330a3475d307036249174eef0093fb",33,25,75,3.08,33,0,2,1
"15592","6c359d4dad7b55baabbbbc74d2f0611b",125,56,74,11.8243243243243,93,32,3,1
"15593","6c366e8a85fb2c1450afc760ee326bf2",45,45,0,45,45,0,1,2
"15594","6c37d9488959c1162371f7fc13bbb8a7",31,31,0,31,31,0,1,2
"15595","6c3909c4a42ecff4a5c8a0ae7af793d1",18,18,0,18,18,0,1,2
"15596","6c396225f7dd997fa9757fc5eefb1676",135,78,65,14.5384615384615,135,0,3,3
"15597","6c3bb7703635c4e5975995a974c58016",24,24,0,24,24,0,1,2
"15598","6c3e2ceeb5f7a5fea38716cbb920f275",58,34,89,4.56179775280899,45,13,2,1
"15599","6c3ec2b4a06ed6916166c14395951042",104,83,35,20.8,104,0,3,3
"15600","6c42619d0eaa57687fa836e9ce434e59",24,24,0,24,24,0,1,2
"15601","6c440fe088233b648782abd1b553a2dc",210,108,58,25.3448275862069,210,0,3,3
"15602","6c4440ac4218cbf8d9590a67340e1a7a",164,77,50,22.96,130,34,3,3
"15603","6c44acf2771b0493ec9b7b443badcae3",39,39,0,39,39,0,1,2
"15604","6c45fc0dcd68769a5680a1cb47f8f39b",41,41,0,41,41,0,1,2
"15605","6c46d0fd4ee7a8853a71dfc18454b12c",16,16,0,16,16,0,1,2
"15606","6c48a3af3a7a48d95a608f20ed542ccc",195,105,89,15.3370786516854,195,0,3,3
"15607","6c4ad9babd87892df766e5b990a11f82",138,111,47,20.5531914893617,138,0,3,3
"15608","6c4b9ddafa5059b43622c713c631bf50",31,31,0,31,0,31,1,2
"15609","6c4d41d26b3e9309b5b0a6f2506460ad",69,55,63,7.66666666666667,69,0,2,3
"15610","6c4eca2c257e77e36eae9db70e603732",152,52,78,13.6410256410256,142,10,3,3
"15611","6c4f961eae87837d609335e93cce447d",11,11,0,11,0,11,1,2
"15612","6c4fe2a604a040c00099341083cd88f3",105,84,62,11.8548387096774,105,0,3,3
"15613","6c54db6011f52d3eb419f9239a508b1e",92,64,30,21.4666666666667,92,0,2,3
"15614","6c56e703649e0a2e2b41a3a0d2973a87",170,86,67,17.7611940298507,127,43,3,3
"15615","6c58b89329915eab60fdd660c2f65bf5",157,120,37,29.7027027027027,157,0,3,3
"15616","6c5b24f742c62f0edb19fe60d9810b32",45,45,0,45,45,0,1,2
"15617","6c5d8f1bf50bc238d4df7ba39e5420a6",126,85,66,13.3636363636364,101,25,3,1
"15618","6c62f6a6a2cd1c0504342c08fabaa186",63,53,51,8.64705882352941,36,27,2,1
"15619","6c62fd23f7322aa27e534dc5818d593a",38,38,0,38,38,0,1,2
"15620","6c660c8230424f18196da3599c905f46",100,53,28,25,100,0,2,3
"15621","6c669efb4ae38f18b5ae9756f936c738",83,52,75,7.74666666666667,83,0,2,3
"15622","6c67353a0aab5376924a9d7073554b6e",110,76,62,12.4193548387097,59,51,3,3
"15623","6c6b8b6cef151536040165af6190343d",23,23,0,23,23,0,1,2
"15624","6c6e1d623cf549c2d7637a43490d8260",137,103,81,11.8395061728395,137,0,3,3
"15625","6c70382fbf035343139c416a3a906b1c",18,18,0,18,18,0,1,2
"15626","6c7067f7a37c853dda3a499eb01826b6",7,7,0,7,7,0,1,2
"15627","6c7071c513199c31127e3fc7a7d11c77",192,109,84,16,192,0,3,3
"15628","6c72d29938682b9198c5d88a017a81de",80,43,49,11.4285714285714,53,27,2,1
"15629","6c743854990c4cafb6d3da78966cd737",33,33,0,33,33,0,1,2
"15630","6c74db0370988901c6bcbd3c6fb24263",50,40,69,5.07246376811594,50,0,2,1
"15631","6c76468bb00b77e289bbde8d03d79a70",11,11,0,11,11,0,1,2
"15632","6c7a4f1c2b865c9f708223a2077db0f0",25,25,0,25,25,0,1,2
"15633","6c7c6e464d9548087cc933fb1753d7ed",207,98,58,24.9827586206897,207,0,3,3
"15634","6c7caadde3b02ebe2c8cfc7075af1085",54,48,27,14,54,0,2,1
"15635","6c7ebae10bce6575505d1c052fb28e14",67,47,52,9.01923076923077,67,0,2,3
"15636","6c7ec0344b4c2fc240cd218dea536930",144,91,58,17.3793103448276,144,0,3,3
"15637","6c82b0d668d7e2584de5f8298e3e8f15",107,74,36,20.8055555555556,107,0,3,3
"15638","6c839d293753b58e0e77de8340d700d7",203,123,80,17.7625,180,23,3,3
"15639","6c884e8cf757d0e5c8a3a064510a01ef",30,30,0,30,30,0,1,2
"15640","6c8b8bb5623397de95715853260814b3",16,16,0,16,16,0,1,2
"15641","6c8cd1d2475096aa11e2e5747d484bce",52,43,13,28,52,0,1,1
"15642","6c8e4a255df44eec0203a8396c69bea2",28,27,46,4.26086956521739,28,0,2,1
"15643","6c8f41826432ff12af6a8937006f7b3b",49,49,0,49,49,0,1,2
"15644","6c8f72ec332703bd06d01ee4c413a4c4",73,49,61,8.37704918032787,40,33,2,1
"15645","6c9185f18fda813c552d53347d0f7765",123,74,80,10.7625,123,0,3,3
"15646","6c93992677bfda26082a099ba492acb4",36,31,63,4,36,0,2,1
"15647","6c9432c962e107a79e9ee0af70b83eb8",44,38,12,25.6666666666667,44,0,1,1
"15648","6c94dd9ab61c7ebf7cee48515f67c301",80,73,35,16,80,0,2,3
"15649","6c952c431da17b1a0ba730f75093c01c",70,58,35,14,70,0,2,3
"15650","6c97eb96bad6e646eb8e7b7160919033",106,82,32,23.1875,88,18,3,1
"15651","6c9a09055a2d1419d6eed9692da22d4c",11,11,0,11,0,11,1,2
"15652","6c9aba8016033548a56376c6a5391fd9",28,28,0,28,28,0,1,2
"15653","6c9d06fc4b12adec436565e17177d7c3",153,102,77,13.9090909090909,123,30,3,3
"15654","6c9e033a872aa7e64d52021bcce4290e",15,15,0,15,15,0,1,2
"15655","6ca01fdcbc2044bb286d709bd4837d8e",91,62,49,13,91,0,2,3
"15656","6ca0d8eb04c66dd85c25bb07b97e5cc1",74,44,29,17.8620689655172,74,0,2,1
"15657","6ca198949633d21e048dc387c6689026",160,137,49,22.8571428571429,160,0,3,3
"15658","6ca7008499f726f87b3024d2820fcd99",53,46,69,5.3768115942029,53,0,2,1
"15659","6ca7109853e718dfccef63525a287892",50,38,35,10,0,50,2,1
"15660","6ca8a5ae65d132d9cf90b5bce86f8a33",15,15,0,15,15,0,1,2
"15661","6caa44dd04a62a9f6c1eddc0953d30de",137,75,77,12.4545454545455,102,35,3,3
"15662","6cac396fbb988f785d479dd27b299bcc",76,52,48,11.0833333333333,76,0,2,3
"15663","6cac449fa6ccc450cfe5ed838b92baaf",22,21,7,22,22,0,1,2
"15664","6cad7109251e14fad05b8847f7c78386",28,19,71,2.76056338028169,28,0,2,1
"15665","6cadc7e73672e14d3928116f34994c63",33,32,5,46.2,33,0,1,2
"15666","6cadc7efb70aeec5a91766cde5514d82",43,37,32,9.40625,19,24,2,1
"15667","6cae3e5f28375e9e0718402995dd3463",150,93,79,13.2911392405063,107,43,3,3
"15668","6cae9a1f52a3ff5edc8cb22cc84a5ba7",14,14,0,14,14,0,1,2
"15669","6cb095abce2daaee5a6cdc42898a6780",105,76,56,13.125,105,0,3,3
"15670","6cb157ccf19873676d406a2d2a494b23",128,81,51,17.5686274509804,96,32,3,3
"15671","6cb47cdd92e0024883609a29eece7d63",55,48,56,6.875,55,0,2,1
"15672","6cba1f206b9c0e4654a67a274592a4b4",92,66,80,8.05,80,12,2,1
"15673","6cbb3d5f3165a74495cb02c06f53c38c",10,10,0,10,10,0,1,2
"15674","6cbd32a95eebd0aaa6e3b98da2ac3cc0",2,2,0,2,2,0,1,2
"15675","6cc0df89bf308f27421e75727670f820",40,40,0,40,40,0,1,2
"15676","6cc194cd7f91742830ded4ce35ff3392",139,113,35,27.8,139,0,3,3
"15677","6cc2114f507ec0f8cea4991a86484aaa",38,33,28,9.5,38,0,2,1
"15678","6cc7500d89502ec8445d51e7664da645",231,100,68,23.7794117647059,187,44,3,3
"15679","6cc8a08636fc591a42ba02fa5a5f21df",2,1,36,0.388888888888889,2,0,2,1
"15680","6cd36d72b1b8da814dee58cba01f01d1",119,66,69,12.0724637681159,119,0,3,3
"15681","6cd4a7deb8443301e2da4caf7d090e1b",25,25,0,25,25,0,1,2
"15682","6cd5d21f06364591c093da0d4da24d47",52,44,73,4.98630136986301,34,18,2,1
"15683","6cdcb1a6c87fd5df0defaad3ecd5339c",38,38,0,38,38,0,1,2
"15684","6cdf716d92911156f008c988a410f4fb",33,33,0,33,33,0,1,2
"15685","6ce00992256e40fd0085a3904928ccbe",110,52,70,11,110,0,2,3
"15686","6ce11d60227099eeb9791f81d8a5e935",17,13,70,1.7,17,0,2,1
"15687","6ce130e91eae07f9ad53d3cc55c394d8",32,19,70,3.2,8,24,2,1
"15688","6ce2a17c3ce2657cec0b872a5309b690",162,88,84,13.5,162,0,3,3
"15689","6ce2bb86084844920027a38082c1fc13",25,16,68,2.57352941176471,25,0,2,1
"15690","6ce472b0ba812b187e0c73d22ae82730",152,67,84,12.6666666666667,152,0,3,3
"15691","6ce75b00a280cad6f78df553d2022d60",65,55,77,5.90909090909091,65,0,2,3
"15692","6ce83ab86a044b6ab61bde7a07bea758",64,50,35,12.8,64,0,2,1
"15693","6ce9876ec7b9e7dca8062cb7c1b00d7f",45,39,46,6.84782608695652,45,0,2,1
"15694","6ceee39a4a0aaba56c5302e268f09656",97,62,65,10.4461538461538,45,52,2,3
"15695","6ceef3ce08a551b61aebbd342e30b3af",30,30,0,30,30,0,1,2
"15696","6cef3a912b873e475bc324288ad7fde2",84,54,35,16.8,84,0,2,1
"15697","6cf02d8b98d1f4b0982288bb1c9f5ed0",31,31,0,31,31,0,1,2
"15698","6cf05464083bbaf5adbdd4c37feb390e",91,71,17,37.4705882352941,91,0,1,2
"15699","6cf25d6a3d4aaf535aa5662337f80d2a",20,11,83,1.68674698795181,20,0,2,1
"15700","6cf278d2cc393529aacd172a5b3e92b1",29,29,0,29,29,0,1,2
"15701","6cf38f7586462400b5ef646aeeb82f4c",116,58,78,10.4102564102564,81,35,3,1
"15702","6cf4dbfdc9065cac5fe00a8e74dba2e7",7,6,22,2.22727272727273,7,0,1,1
"15703","6cf50ca22cb51ee94d37ce605142601d",37,26,49,5.28571428571429,37,0,2,1
"15704","6cf7b553e4510f0c4b95c00a68ae2d9f",26,26,0,26,26,0,1,2
"15705","6cf8c45036b940649e1a3ffbb4833a46",45,42,24,13.125,11,34,2,1
"15706","6cfa6908a07be0b64904789a63c3b17e",154,99,55,19.6,106,48,3,3
"15707","6cfcc8db2e5a13a87839152dcda6fb7b",34,34,0,34,0,34,1,2
"15708","6cfefc11e986be632743c80a2975f35b",73,61,79,6.46835443037975,41,32,2,1
"15709","6d0295de88f0607501105ab9e2098d4c",42,42,0,42,42,0,1,2
"15710","6d085bb71e1450dc6d391a8f9c524548",18,18,0,18,18,0,1,2
"15711","6d0906cbd0511ddbb1cdefec3a441eee",34,34,0,34,34,0,1,2
"15712","6d09d1902f401ff10c67cafc949830a3",62,50,31,14,62,0,2,1
"15713","6d0a5929310acc61f3fbaa4bc292b609",29,29,0,29,29,0,1,2
"15714","6d0a726f722a62741f3b41d8a3892c3f",32,23,73,3.06849315068493,15,17,2,1
"15715","6d0e2340a005ce91dc970331e6b1514a",108,71,64,11.8125,108,0,3,3
"15716","6d0fb368615944149c68f9501e28d8cc",187,95,70,18.7,156,31,3,3
"15717","6d122692f0d2b203eed4de540146db55",15,15,0,15,15,0,1,2
"15718","6d12ca3a0e8b1678fc7409b6c466a4ad",40,21,57,4.91228070175439,24,16,2,1
"15719","6d14e27676f85220db6c089ccc99c533",22,22,0,22,0,22,1,2
"15720","6d18c72cacb14394a1a8c30b2fdfa082",72,51,47,10.7234042553191,72,0,2,3
"15721","6d1f7a638f3f80ea40bc432f3e7eaf76",35,35,0,35,35,0,1,2
"15722","6d2025d9515289f70c191060ff1f0d6a",112,79,61,12.8524590163934,76,36,3,3
"15723","6d267d9ffbab54bce09c01d27e2abd0e",13,13,0,13,0,13,1,2
"15724","6d2a337d4d065347aefcc348eb3276b1",124,93,40,21.7,124,0,3,3
"15725","6d2aed97ea9d10697426160b78037b9a",15,15,0,15,15,0,1,2
"15726","6d2dd0081685f30526bbc11a0df97c29",53,40,10,37.1,53,0,1,2
"15727","6d2e110f3c75f5d3e3dd55b2cea94b37",53,44,77,4.81818181818182,53,0,2,1
"15728","6d2f024f488128972af2a7be2695183c",10,10,0,10,10,0,1,2
"15729","6d2f885aca6daf2120856c17e24f10cb",41,41,0,41,41,0,1,2
"15730","6d347e93fb1c4aff3ae3feb619d8b426",72,54,46,10.9565217391304,72,0,2,3
"15731","6d36a0898c14731739a29af1d5317ffc",177,89,63,19.6666666666667,177,0,3,3
"15732","6d38321c2059cc2bf06ed2b7dad5b3c1",73,61,25,20.44,25,48,2,1
"15733","6d389b15f7543129ede5f8dc55238269",43,34,56,5.375,43,0,2,1
"15734","6d3deebb7d13ef4c5225f7f04156d9f2",198,111,41,33.8048780487805,198,0,3,3
"15735","6d3e4360abdc4a8acdcdb9b129ac7a38",154,76,70,15.4,99,55,3,3
"15736","6d3e8c044e7539b910545413c367202f",105,70,52,14.1346153846154,105,0,3,3
"15737","6d418b471c0d77ddd6e3fd8fdfa85aaf",104,73,52,14,104,0,3,3
"15738","6d41be5837f5e361cb709e7f2d7f1940",200,107,82,17.0731707317073,159,41,3,3
"15739","6d41c78856fa486aec4bc4c88524fb6f",34,33,27,8.81481481481481,34,0,2,1
"15740","6d42f46b463bee2fcf3359457c3597a3",31,19,65,3.33846153846154,26,5,2,1
"15741","6d43f4ab1c5988124f2e05379ac3eda4",196,119,63,21.7777777777778,196,0,3,3
"15742","6d48b020bc1be8711d58325f5c12dd9b",59,52,11,37.5454545454545,59,0,1,2
"15743","6d4ae9343179bbd15b6d83a9f327cfc3",121,87,50,16.94,121,0,3,3
"15744","6d4d37a9b4fdd92d7cc13f3d46c1b976",27,27,0,27,0,27,1,2
"15745","6d508d8f42a4eed644851e33a28a93f5",5,5,0,5,5,0,1,2
"15746","6d55f8573e9b3100b7357855ba631a45",31,31,0,31,31,0,1,2
"15747","6d5755e26467129d02936855bf805c2f",114,68,71,11.2394366197183,87,27,3,1
"15748","6d5a2c19ab8ce291d542657177924918",49,49,0,49,49,0,1,2
"15749","6d5b06d6664c0753b331d2eafffdd26e",34,34,0,34,0,34,1,2
"15750","6d5d7747e8bd8e70f314f2a60b214bd3",193,102,57,23.7017543859649,152,41,3,3
"15751","6d5ed9c41dd81eddba4c890d8780a092",110,58,72,10.6944444444444,60,50,2,3
"15752","6d6040a19fff8fccf383470b937a64bc",116,83,89,9.12359550561798,116,0,3,3
"15753","6d64d62bec9f89f4ec3a3295b382d2bc",20,20,0,20,20,0,1,2
"15754","6d686342aed0906783bf0d339c5df099",15,15,0,15,15,0,1,2
"15755","6d6a81b1c1990ac830c21a516e40ba9d",124,54,42,20.6666666666667,124,0,3,3
"15756","6d6b86f005af1a7956bea51ee4ec6bea",135,93,70,13.5,135,0,3,3
"15757","6d6c3eed272b1e0494b85585e6ecbb33",64,55,68,6.58823529411765,43,21,2,1
"15758","6d6c7b0ab71a70a3fa2442781e8f73a2",37,31,35,7.4,37,0,2,1
"15759","6d6c817992244dc87dd0df541e3aa5c6",20,20,0,20,0,20,1,2
"15760","6d713a1a372fa93b09ede723dd9de711",131,71,77,11.9090909090909,131,0,3,3
"15761","6d72e2770de888cde19e4fa208820ad2",77,63,56,9.625,77,0,2,3
"15762","6d75cc634220ff7641f74019943aba6e",36,36,0,36,36,0,1,2
"15763","6d77311271b42fb7422563346fbc04b5",21,21,0,21,21,0,1,2
"15764","6d78cf0d3b45954c60f6592c51a86158",96,67,15,44.8,96,0,1,2
"15765","6d7997ab4801e01f2a0f73238b71db04",17,12,37,3.21621621621622,17,0,2,1
"15766","6d7a4478b33bbbe8f9ce6c7694b8748d",46,35,89,3.61797752808989,46,0,2,1
"15767","6d7dde9336a7011cee4f83175a4efc04",191,85,84,15.9166666666667,191,0,3,3
"15768","6d7df368731b3c9200292f496abb4a09",157,104,56,19.625,157,0,3,3
"15769","6d7ecf81dc30d8983a41697aa98bec79",19,19,0,19,19,0,1,2
"15770","6d7f36dfe6d747cddb68b8473a411a5b",54,54,0,54,54,0,1,2
"15771","6d7f632d1bfd10684846c8a06560c0b6",20,11,32,4.375,20,0,2,1
"15772","6d808a0fc85f19d45bc635cc8176d83a",85,57,58,10.2586206896552,85,0,2,3
"15773","6d80e3664169279aef6be0379bbc6ac2",28,28,0,28,0,28,1,2
"15774","6d87b662e2ff2dc19610219134d51930",67,63,64,7.328125,13,54,2,3
"15775","6d89645af101b71a15d9ca7b7bea3f38",6,6,0,6,6,0,1,2
"15776","6d8f25ee91522506cb1aad6dbb1d44c6",30,30,0,30,30,0,1,2
"15777","6d911b7eaf7fae686bdf3dae6c858e5e",51,42,42,8.5,51,0,2,1
"15778","6d92d2f2f11951aa0f8fd24481eef166",30,30,0,30,30,0,1,2
"15779","6d93251302f87a0201251d0fd126e0a7",49,38,70,4.9,49,0,2,1
"15780","6d93ad8784432733e41d3c0c41fe9674",56,52,0,56,56,0,1,2
"15781","6d9461b00b8f14a09d559d16a41762e6",47,33,82,4.01219512195122,47,0,2,1
"15782","6d957742145864163750dcb73775cc8c",152,86,33,32.2424242424242,152,0,3,3
"15783","6d9626ad41bdd85b1110784cdce1ca41",216,125,42,36,190,26,3,3
"15784","6d96641868b181653449d71709661276",27,27,0,27,0,27,1,2
"15785","6d979af5c7e8f267c6a9b30aa0bbf027",56,50,20,19.6,56,0,1,1
"15786","6d980a75e23e10f43876fb38041904c6",195,87,65,21,163,32,3,3
"15787","6d983f3e5a25bb2c47bad8d9d83f1588",19,11,55,2.41818181818182,19,0,2,1
"15788","6d9b91d0864c986ea86c7719f3b47a02",65,49,13,35,65,0,1,2
"15789","6d9c09345bfe6a3eb900a19074444a20",92,58,73,8.82191780821918,68,24,2,1
"15790","6d9e00033462bbf91c7476ec4e2a2958",138,82,63,15.3333333333333,138,0,3,3
"15791","6d9e5c8a0314d0ab0ef2bb1f789779eb",26,26,0,26,26,0,1,2
"15792","6d9fa2c34c5ef900b3dbeb24cde55365",35,34,0,35,35,0,1,2
"15793","6da1a3baedad88825682db31c819f44f",124,94,78,11.1282051282051,124,0,3,3
"15794","6da356a00ddcdf399995ca7410c18b95",41,41,0,41,41,0,1,2
"15795","6da6082fd2c2371db1f7a787087f13cb",22,20,42,3.66666666666667,22,0,2,1
"15796","6da728a5a6372ce6a8e020c2e560ec7e",121,87,32,26.46875,121,0,3,3
"15797","6da91827e14c36aaf28cba9b7a521b50",78,76,45,12.1333333333333,78,0,2,3
"15798","6da9f39194c7e81c9c5c98442b5ce773",105,79,28,26.25,105,0,3,3
"15799","6daab00a1ced030b6084952f655f5c20",13,13,0,13,13,0,1,2
"15800","6dab2f952e1f74a7242247dae884c967",97,93,22,30.8636363636364,42,55,3,3
"15801","6dabd55b7a7f2534d926c6372279a58c",87,62,64,9.515625,87,0,2,3
"15802","6dacdf7a0097c7b3e8ca2197bc080e96",102,90,53,13.4716981132075,102,0,3,3
"15803","6dad185a2d9d62faa065b93114b74212",14,14,0,14,14,0,1,2
"15804","6dad5a64f279020a8bfbafdeca8ffafd",21,21,0,21,21,0,1,2
"15805","6dad84cd3995a3ddccfdcb3c69961bf4",26,26,0,26,26,0,1,2
"15806","6dadcb5bbae07af3e6787ffe319ac6bd",35,34,32,7.65625,25,10,2,1
"15807","6dadf45d0c449fa7f66e4607ee8742f3",94,75,24,27.4166666666667,94,0,3,3
"15808","6db2c41a1671b06d5705e3986f6a6d4e",28,28,0,28,28,0,1,2
"15809","6db3ab7c654fb3f04ce4e18e77d546c7",19,19,0,19,19,0,1,2
"15810","6db4ae5ac2a08e472a15f9d2e901f214",13,13,0,13,13,0,1,2
"15811","6db4fe1162fbaed816b9f9be65a6d04b",191,115,62,21.5645161290323,191,0,3,3
"15812","6db71135523ec0e554a404b771daf3d7",72,54,18,28,72,0,1,2
"15813","6db7881ca06239af6c66a2c4546ede05",30,30,0,30,30,0,1,2
"15814","6db8e4e2cae787bd0c35d5a82d7abcba",2,2,0,2,2,0,1,2
"15815","6db927c1da61b3d6ad2a9cf2c0ae18d5",28,26,36,5.44444444444444,28,0,2,1
"15816","6dba1e3a3440eb024227eea3b4b74d1d",63,59,53,8.32075471698113,63,0,2,3
"15817","6dba3aad4ec27e13314942483ad4dded",98,71,68,10.0882352941176,98,0,2,3
"15818","6dbc570fd5192e71f609958b3bb1e505",164,78,71,16.169014084507,164,0,3,3
"15819","6dbde110172ba195d8ffcd46273ae882",26,26,0,26,26,0,1,2
"15820","6dc0d6da1bd0139ddabc4e3fed84e4b0",38,38,0,38,38,0,1,2
"15821","6dc3fc3b78d9f0ebfdc2dd8ad203d04c",40,40,0,40,0,40,1,2
"15822","6dc710bf6fd1bf2a8611d8d5554c7eda",52,27,84,4.33333333333333,45,7,2,1
"15823","6dc7ce4f4bab2110f9e94e4b110c3343",38,31,32,8.3125,15,23,2,1
"15824","6dc7fd838e8ea1d51965701994a7d603",34,34,0,34,34,0,1,2
"15825","6dca1f654c4d6eafc1f35a2fc4f6e105",102,76,23,31.0434782608696,62,40,3,3
"15826","6dcb30fc9b23fcce9ff8f21deeade311",54,34,66,5.72727272727273,35,19,2,1
"15827","6dcfc8813988b1adde6e7478ccbd05b1",86,73,41,14.6829268292683,86,0,2,3
"15828","6dd1c1e4f3b384e6016d1c57debda725",176,72,78,15.7948717948718,176,0,3,3
"15829","6dd35767697b15f13178fbffec1ea41b",27,27,0,27,27,0,1,2
"15830","6dd38a972c75bd6ae51550f66ae768ad",47,47,0,47,0,47,1,2
"15831","6dd47a1dc9e9564c6f90f12a13eadca7",28,22,33,5.93939393939394,28,0,2,1
"15832","6dd5d5d382e8a852d44b9f0bd831dcde",148,105,54,19.1851851851852,148,0,3,3
"15833","6dd613f8baf6cf97702634be0c35c4e8",40,33,74,3.78378378378378,40,0,2,1
"15834","6dd795558beb353f89d95c1a27f0e907",131,69,57,16.0877192982456,131,0,3,3
"15835","6ddb4dc10ae914a7dd139fd652d82159",51,51,0,51,51,0,1,2
"15836","6ddd29723c66d76b582e4628b62f5903",53,48,65,5.70769230769231,29,24,2,1
"15837","6ddd82a1b8902386d65ac1f2eb2bb844",8,8,0,8,8,0,1,2
"15838","6ddf12bd6d878059f7a2f0f905bdd50e",156,61,79,13.8227848101266,130,26,3,3
"15839","6de1552e15e4acafe887052415fed363",45,41,31,10.1612903225806,45,0,2,1
"15840","6de317aab7fb0404cc5f3626e7228f8e",20,20,0,20,0,20,1,2
"15841","6de3a90095e7ee6267400cf3971f2789",15,11,68,1.54411764705882,15,0,2,1
"15842","6de3f079b5d57499336e2143ee6053f0",84,35,72,8.16666666666667,61,23,2,1
"15843","6de4865f41e1876194ef5bd744cb5670",41,41,0,41,0,41,1,2
"15844","6de6cccb857468f9a1ba050409e4f5f5",10,10,0,10,0,10,1,2
"15845","6de7cd466c14b0562744c35e69517652",103,69,62,11.6290322580645,103,0,3,3
"15846","6de9d526c6e0dc8b440d03b016a071c6",80,54,16,35,80,0,1,2
"15847","6ded4790891fa09ecdec6a2154418cad",72,61,29,17.3793103448276,40,32,2,1
"15848","6dedb366579167303ab5942b43e5ac88",31,29,28,7.75,31,0,2,1
"15849","6dee80bc4eb786f2b5d75b97777f1b9e",104,73,68,10.7058823529412,104,0,3,3
"15850","6df0339e2ad6e46357d73c6e43248e5d",77,64,29,18.5862068965517,77,0,2,1
"15851","6df246b96111299f72e2d995622997a1",22,22,0,22,22,0,1,2
"15852","6df3d21ba1025f61c8f7b23e6a784363",33,28,30,7.7,16,17,2,1
"15853","6df7940d5486450920d36313e5d28de8",21,21,0,21,21,0,1,2
"15854","6df946e021dc7a6ea837a368d9bf5f53",213,139,65,22.9384615384615,213,0,3,3
"15855","6dfcd426df297d22b0c2c9533d78bd05",48,48,0,48,48,0,1,2
"15856","6dfe9e827c38a227c6e6b6880cdc61ff",83,56,64,9.078125,83,0,2,3
"15857","6e010559d3fed22759262453fe3c841b",9,9,0,9,9,0,1,2
"15858","6e01510964d9f1cf127c4e28ca3d8340",67,59,21,22.3333333333333,67,0,2,1
"15859","6e04d420fc114306209f1a75357c90cd",18,18,0,18,18,0,1,2
"15860","6e056578ce85d7581b2556769ef3fa51",39,28,41,6.65853658536585,39,0,2,1
"15861","6e07a61943dee3084fcdc651a5eab52f",50,50,0,50,50,0,1,2
"15862","6e12598f11bfeab15a36f68c1f7be529",46,46,0,46,46,0,1,2
"15863","6e12ae65509d837f85677f25b75294fa",55,55,0,55,55,0,1,2
"15864","6e15b1fb17670b60f6ff548bb22d9186",51,47,19,18.7894736842105,34,17,1,1
"15865","6e167f6d486f8cf87a12f0e065ab1fd4",125,79,56,15.625,125,0,3,3
"15866","6e170316edc4a250fab1cd78463932e4",191,104,58,23.051724137931,191,0,3,3
"15867","6e1ab0ca1b1c5086a3393e59cd9408ff",53,53,0,53,53,0,1,2
"15868","6e1b01b6ed499d2935701cb89f492686",30,25,32,6.5625,30,0,2,1
"15869","6e1f4a3bf3d271e84b942cf7954e6266",87,70,20,30.45,87,0,1,3
"15870","6e21e73b81218a6b3036363a3e44414b",56,45,55,7.12727272727273,56,0,2,1
"15871","6e28559a3f2fa25049512d8ec7a04a87",62,45,35,12.4,62,0,2,1
"15872","6e2a12888aa402cdafd6d6a856bd9ed4",19,19,0,19,19,0,1,2
"15873","6e2d6e9a4ee9ea4eb63b79dd8a1a40b7",188,114,71,18.5352112676056,188,0,3,3
"15874","6e2f677f4bcbb61d83336493b8312199",111,96,62,12.5322580645161,111,0,3,3
"15875","6e31cd95b87d74b730ec56362cc3d40b",63,51,78,5.65384615384615,52,11,2,1
"15876","6e32e29235c7a99aebae903a900bfb3e",63,44,34,12.9705882352941,63,0,2,1
"15877","6e346bdf6c5b18c351a02541a0e550a4",9,9,0,9,9,0,1,2
"15878","6e352dc43bdcff1cc161c7874ad48194",46,46,0,46,46,0,1,2
"15879","6e35acbbf54d410e499221dd6b03a7b8",88,68,60,10.2666666666667,88,0,2,3
"15880","6e35fdd2050adab126498c76532d3b84",32,27,30,7.46666666666667,32,0,2,1
"15881","6e381743f1250c7aaed56e38cc37b4fb",145,82,59,17.2033898305085,145,0,3,3
"15882","6e3b0ceeb94d566de20f8b58638ca0c0",69,54,16,30.1875,69,0,1,2
"15883","6e3eab37078860bc1016bce77d302a93",26,25,4,45.5,19,7,1,2
"15884","6e3f275325abf0a5de89e3667f14e069",39,31,50,5.46,13,26,2,1
"15885","6e40409813c5aa9377e03b64873d7cc1",36,32,54,4.66666666666667,36,0,2,1
"15886","6e43c85eec9914316ba4c1320fe39c3d",17,17,0,17,17,0,1,2
"15887","6e460a306de84d2c561441bb2659f754",88,56,16,38.5,88,0,1,2
"15888","6e47bec2bfd6176f84cc03e3b979044f",44,44,0,44,44,0,1,2
"15889","6e4bae8ac0ae1cf87aefb6908ce35f53",7,5,81,0.604938271604938,7,0,2,1
"15890","6e4cab2a0a1b66af7cf6bd927305c794",19,19,34,3.91176470588235,19,0,2,1
"15891","6e4ff7d18242cc39065544658d2d6cf4",76,63,69,7.71014492753623,76,0,2,3
"15892","6e531a4d0734cfd2f24b5d7d397a3c12",89,72,43,14.4883720930233,89,0,2,3
"15893","6e536779426ad4fa5bdaac6f20de1f94",186,87,71,18.3380281690141,150,36,3,3
"15894","6e552999c5c7085cdc0617ad0da4de03",10,10,0,10,10,0,1,2
"15895","6e55d32166acfe3a5ef8ad1f5dadca78",68,58,27,17.6296296296296,68,0,2,1
"15896","6e565624a29a9ffaaf46b2e064049096",4,4,0,4,4,0,1,2
"15897","6e56b9b2ed719de12029fab50cb60514",64,45,57,7.85964912280702,64,0,2,1
"15898","6e56be59928df5c34c773ead9d61bf04",35,24,42,5.83333333333333,35,0,2,1
"15899","6e5844a8b4051615dedf0233c41fb7a3",101,64,55,12.8545454545455,101,0,2,3
"15900","6e597672d0f73c9dc4245edbb8571340",56,47,40,9.8,25,31,2,1
"15901","6e5a327650ac2debd2b417813a7664e5",124,62,84,10.3333333333333,106,18,3,1
"15902","6e5bd5f64a8e4b70330a39ed8136d22f",63,60,20,22.05,44,19,2,1
"15903","6e5c41e03902b8f27c09abb44337855f",38,38,0,38,38,0,1,2
"15904","6e5df4ef7f9a64fb47cbcdf21efafe22",29,29,0,29,29,0,1,2
"15905","6e5e6e7cba4720a9168c3969185f6a3a",157,93,71,15.4788732394366,108,49,3,3
"15906","6e5e92815c18ce1e434375cdfb3abcf2",87,42,84,7.25,87,0,2,3
"15907","6e6540960d93d190fab3b0c19f8da024",38,38,0,38,0,38,1,2
"15908","6e68026069c1c03ddb3ce353027aafad",20,20,0,20,20,0,1,2
"15909","6e6cfdcf045744ddf2592bffdc7dadd0",170,85,84,14.1666666666667,131,39,3,3
"15910","6e6d6714442162f964cffed33e26d44a",136,84,65,14.6461538461538,97,39,3,3
"15911","6e794436b2854b162d92389b8486622a",1,1,0,1,1,0,1,2
"15912","6e7bec8997ff8a1de27879eb18c25e7c",28,28,0,28,28,0,1,2
"15913","6e7cb1bf07a70125625c45b75cbee8a1",75,46,82,6.40243902439024,75,0,2,3
"15914","6e7cb557d9a9535ead85ee5906c835d2",13,13,0,13,13,0,1,2
"15915","6e7d047e3e107e6c3197b91759646c5e",19,15,75,1.77333333333333,19,0,2,1
"15916","6e800babeb74fc18640c51a7c53054f6",36,36,0,36,36,0,1,2
"15917","6e8178dd7100d59d7364c1134f0a3cc4",101,70,53,13.3396226415094,101,0,3,3
"15918","6e81c6f96f8c5d9b35dd68194edb908c",194,80,83,16.3614457831325,150,44,3,3
"15919","6e82575294447b10a670b5045c7e880a",22,18,35,4.4,22,0,2,1
"15920","6e853d6d717538dbe654bcba1becc561",181,66,77,16.4545454545455,181,0,3,3
"15921","6e86331cf24402f74046e2874403c4fe",113,69,67,11.8059701492537,80,33,3,3
"15922","6e865d4d40b37aa384474a49fbcddfc6",173,86,28,43.25,140,33,3,3
"15923","6e867413e0d0af2a69116cbd88648a09",30,30,0,30,30,0,1,2
"15924","6e875678a396b5df7b97536f1c3cc27b",1,1,0,1,1,0,1,2
"15925","6e878243e2489348f65bc7164c192ce2",96,72,31,21.6774193548387,43,53,2,3
"15926","6e8986715a99cdbebfa3fe7561ead4d4",35,19,75,3.26666666666667,35,0,2,1
"15927","6e89feeb07ade8c59c02b460615b6fec",34,34,0,34,34,0,1,2
"15928","6e8bec6d0a63c917d2037cef27365bd7",93,68,48,13.5625,93,0,2,3
"15929","6e8ea1adbe2382aeeea4fd45e3feffd8",31,25,7,31,31,0,1,2
"15930","6e90e7edcfe78787663e800c0b430cd2",133,81,80,11.6375,119,14,3,3
"15931","6e917d1d533848db512955a364ae6ae3",36,36,0,36,36,0,1,2
"15932","6e917f3438f0166c8838a0b42f5e144e",7,7,0,7,7,0,1,2
"15933","6e94b0503846aa438ef3988868d0d1e7",72,53,65,7.75384615384615,72,0,2,3
"15934","6e95e2d086df9d836b72529073fc2a6f",5,5,0,5,0,5,1,2
"15935","6e9731f1d3a1b514e5c47756e123724f",14,14,0,14,14,0,1,2
"15936","6e981e6b187938066bf2df7003065662",29,29,0,29,29,0,1,2
"15937","6e99c15c0eb854a81128199691dd81e8",39,30,33,8.27272727272727,16,23,2,1
"15938","6e9a669e0196a71a4f53725fab78ef46",67,44,77,6.09090909090909,67,0,2,1
"15939","6e9d3a2ea50872a40f13b435ab3068e5",41,41,0,41,41,0,1,2
"15940","6e9d6e7010579e1aa7a6982c4215b700",54,54,0,54,54,0,1,2
"15941","6e9e82c5f4642102079dac03f0e9884c",18,18,0,18,18,0,1,2
"15942","6ea0c0e2dbf6ede50abb48e449f0aeaa",13,13,0,13,13,0,1,2
"15943","6ea2b9757d340a35bbe991cacf2470e5",69,41,67,7.2089552238806,41,28,2,1
"15944","6ea35cbba468e22195f4c2bd2a77fd61",51,51,0,51,51,0,1,2
"15945","6ea4f80ca5e436e9f581eef9466e4665",13,13,0,13,13,0,1,2
"15946","6ea5208a04905a24e855466ed1e09aae",37,37,0,37,0,37,1,2
"15947","6ea543ed34a09700efad13463ccd0e2c",111,80,50,15.54,111,0,3,3
"15948","6ea699910e3d548eeca3fbfa79b88cc9",109,73,51,14.9607843137255,85,24,3,1
"15949","6ea8c4ae0aabb49dd94f2c381e9c79ad",36,32,33,7.63636363636364,36,0,2,1
"15950","6eaa18d12cf6208a52def230e971bab9",55,41,35,11,55,0,2,1
"15951","6eb0b9fabe814497cbf0f69fd2f4ac1b",41,41,0,41,0,41,1,2
"15952","6eb1102b7c533efed4e951c47cf40d04",87,58,49,12.4285714285714,87,0,2,3
"15953","6eb35aaac9744b324beacac05dad272e",154,96,74,14.5675675675676,154,0,3,3
"15954","6eb5bfd80fff9d178d2e53d46029e895",64,51,32,14,64,0,2,1
"15955","6eb5c9d5ddce2504ecacf081b08fab74",81,35,57,9.94736842105263,81,0,2,3
"15956","6eb631de2c8b866aa0cc222780b0fdaf",4,3,48,0.583333333333333,4,0,2,1
"15957","6ebe4267f455933102a548a84ea842cb",33,33,0,33,33,0,1,2
"15958","6ebe7512b4fd0aba5c2aa50ac7a3da15",19,19,0,19,19,0,1,2
"15959","6ec0d744658a6ae6779029d02d40678f",218,121,88,17.3409090909091,206,12,3,3
"15960","6ec348a01fa4421d295e09b2c1a48e55",145,59,74,13.7162162162162,145,0,3,3
"15961","6ec4256e854d935619e832121894a553",37,33,21,12.3333333333333,37,0,1,1
"15962","6ec43f0b491461d28eedf05454f01f38",137,84,70,13.7,137,0,3,3
"15963","6ec73127d2c95ab5c38f237630441a19",76,64,29,18.3448275862069,76,0,2,1
"15964","6ec7c37475e9db9ecbda5efe7ee07705",83,44,58,10.0172413793103,62,21,2,1
"15965","6ec94eefb4cf1d9c69cc2f785ddfc4e4",100,67,81,8.64197530864198,76,24,2,1
"15966","6ecb0e93bbe62e08313356f7a2945c70",16,16,0,16,16,0,1,2
"15967","6ecc759ba62e2602fe61fea0c495dad5",57,48,55,7.25454545454545,57,0,2,1
"15968","6ecf6c2a9e0e19ff9491850de53222ee",138,61,60,16.1,138,0,3,3
"15969","6ed12dae0e06dfa6c2d0e4ac066daf48",47,28,62,5.30645161290323,36,11,2,1
"15970","6ed820461b78496959cb6bed56c53107",16,16,0,16,16,0,1,2
"15971","6ed9386b6bcb78cf3d07a711fc589ba3",94,55,55,11.9636363636364,94,0,2,3
"15972","6eda0cbfd66ea2d27b03853ffb9f586a",20,19,4,35,20,0,1,2
"15973","6ee02daf3237d4e3d82bc42102c49bed",75,50,28,18.75,75,0,2,1
"15974","6ee03d315e9da96f0da1ced2a6c13946",53,40,11,33.7272727272727,53,0,1,2
"15975","6ee26a1f5e32bc49598c64e9d2f67630",11,11,0,11,11,0,1,2
"15976","6ee28c60a1d619cac16a0a37acb6f624",53,53,0,53,53,0,1,2
"15977","6ee433aa8b2d7f231f3286f694d98242",67,46,81,5.79012345679012,67,0,2,3
"15978","6ee5bde608db0c29c2720466781237de",19,19,0,19,19,0,1,2
"15979","6ee5e8ce2a7890e6f36150626e0ff01b",14,14,0,14,14,0,1,2
"15980","6ee840b1540753470a3a4810562b70b6",44,30,79,3.89873417721519,36,8,2,1
"15981","6eea2ee5c127894f080608f09a20cc6c",9,9,0,9,9,0,1,2
"15982","6eea30322ddee1a2d56ee8920282db25",245,121,72,23.8194444444444,207,38,3,3
"15983","6eea3240187359ba07fee537ea80165d",17,17,0,17,17,0,1,2
"15984","6eeb737dc6a34181c0573b988d4a8688",40,40,0,40,0,40,1,2
"15985","6eec54363a93bacea0b3e1ae3e790b90",24,24,0,24,24,0,1,2
"15986","6eec5b05d5e399fe6033f8e552c30147",52,52,0,52,0,52,1,2
"15987","6eec8b5af86a982afec1d196d580e777",93,71,28,23.25,93,0,2,3
"15988","6eed03d63f7e7888850e4aa42a667eed",25,25,0,25,25,0,1,2
"15989","6eed993f26035e08124bed2285bb9437",7,7,0,7,0,7,1,2
"15990","6eee3b46a78b93cfcb98e622b2a2cbb0",170,97,53,22.4528301886792,170,0,3,3
"15991","6eee959916c0addda0d82a0d1d129b0f",125,66,77,11.3636363636364,125,0,3,3
"15992","6ef143793295bd4bbfcb4d4c5e73f0cb",57,49,51,7.82352941176471,57,0,2,1
"15993","6ef72286f1ede72d35c6ba50e10d4e6a",33,33,0,33,33,0,1,2
"15994","6efb619c55038abdb600eb89934e34e2",17,10,50,2.38,17,0,2,1
"15995","6efb79cce2c4367a867ad4cdae8cc5c4",26,26,0,26,26,0,1,2
"15996","6efc79ce18ef85c84ceef1d89cd8f14f",64,46,30,14.9333333333333,31,33,2,1
"15997","6f0127b3480aeaeae83cb4e5b9d6814b",36,36,0,36,36,0,1,2
"15998","6f0253f8caf6604c69d2028b096729da",68,52,13,36.6153846153846,68,0,1,2
"15999","6f02a4637aae00691f1ffe6bc550deae",44,43,6,51.3333333333333,44,0,1,2
"16000","6f03b5390662bec711750529e6557ba5",96,55,61,11.016393442623,96,0,2,3
"16001","6f0477e7e1b30d2f779908f7db6f4f05",119,68,70,11.9,119,0,3,3
"16002","6f064be01644ffb4cce935e56977c037",199,122,84,16.5833333333333,158,41,3,3
"16003","6f08f41d9ae83ba605c27b59559beea1",52,43,59,6.16949152542373,29,23,2,1
"16004","6f0a3d9ef0fcb1360d443f5371a44b63",72,44,72,7,43,29,2,1
"16005","6f0b1ba0128241a51fc6432228e2bc8a",27,27,0,27,27,0,1,2
"16006","6f0d26cb4d8a6899a24e86e01a8f7fda",32,32,0,32,0,32,1,2
"16007","6f0f9fd2323e5c6c1e76ef0a5c15095d",107,91,50,14.98,107,0,3,3
"16008","6f13dd18f9ef265d75d9f16411ffd2ec",27,27,0,27,0,27,1,2
"16009","6f16d6b50c271529778273ba2c9eee23",101,70,31,22.8064516129032,101,0,3,3
"16010","6f19835e9ba61c30f3d63f14965824ca",89,62,29,21.4827586206897,89,0,2,3
"16011","6f19fd3fb531c7e12302d4a83d6c2fd9",43,43,0,43,43,0,1,2
"16012","6f20507abb09c257e8fb30c501d78009",23,23,0,23,23,0,1,2
"16013","6f20632c52ac9fe88c264ac4c7c9c83b",81,66,70,8.1,81,0,2,3
"16014","6f241f1298a4e9a5f66e98f57352bae4",80,54,54,10.3703703703704,80,0,2,3
"16015","6f2465a85ab81bb70814de6bf5a5fe7d",63,50,8,55.125,63,0,1,2
"16016","6f28c67ecdb47f860f6e85fc8ef51c1d",5,4,16,2.1875,5,0,1,1
"16017","6f2aa87413a7cd5caecf929527b24794",123,104,39,22.0769230769231,123,0,3,3
"16018","6f2c0e91c7f728dcdecebe086a3b204b",143,93,83,12.0602409638554,143,0,3,3
"16019","6f2cef0e4b2d879bc4a9b5c71488f308",122,79,57,14.9824561403509,122,0,3,3
"16020","6f2dcd2ecfa41369797574f404e59f05",28,28,0,28,0,28,1,2
"16021","6f2e7e99668f4d650bba5f80fa212507",75,47,77,6.81818181818182,56,19,2,1
"16022","6f2e987f790d787eec70842a3737016b",45,39,36,8.75,45,0,2,1
"16023","6f2ffc8338bdfd6ea928c9718df98fc3",29,20,49,4.14285714285714,0,29,2,1
"16024","6f30c171ce92d7b56e5507e86eb02b28",28,28,0,28,28,0,1,2
"16025","6f34cec3fce423d60cbfbafe9453f59c",41,41,0,41,0,41,1,2
"16026","6f354d3f4dfc584a9ab22f45ad165237",119,80,30,27.7666666666667,119,0,3,3
"16027","6f3561cd0449c49bcd15388f2d72a571",155,98,60,18.0833333333333,155,0,3,3
"16028","6f37dcb8c74dbcbdbd4c09fb85591ca3",200,80,84,16.6666666666667,200,0,3,3
"16029","6f37ee05f5cd9b34fa3d0d9b009bbe02",50,50,0,50,0,50,1,2
"16030","6f39b751ed03030eba42ee0e037f4f00",52,52,0,52,52,0,1,2
"16031","6f39f531982951bef7c28bbe46295af8",35,35,0,35,35,0,1,2
"16032","6f3a9ac7b7dcae2431f021b361de5082",39,39,0,39,39,0,1,2
"16033","6f3c9153d45c1ba6cbb6efee459224f5",27,21,42,4.5,0,27,2,1
"16034","6f4718c0ac607d8eb9c650c99619df6b",28,28,0,28,28,0,1,2
"16035","6f484f5f503338982fec6e08e1c7ccac",21,21,0,21,0,21,1,2
"16036","6f4911d26ae776c17816401dc1733c3b",52,32,71,5.12676056338028,52,0,2,1
"16037","6f4a2ab183a055a41aa831566a29d6f2",48,35,33,10.1818181818182,48,0,2,1
"16038","6f4abcd4a344181ef3d512d6b9a35dfe",48,37,10,33.6,48,0,1,2
"16039","6f4c92142bf042c3048d7a8a435b8480",216,139,81,18.6666666666667,216,0,3,3
"16040","6f515f3bad58ff20b5a0fe14473787ee",28,28,0,28,28,0,1,2
"16041","6f52b5bf1670b6d4c27d21d2cf376adf",8,8,0,8,8,0,1,2
"16042","6f553dac0b57f259a60e271bf1fcc8a9",92,66,49,13.1428571428571,92,0,2,3
"16043","6f597043abe12542118ddb4291933a07",17,17,0,17,0,17,1,2
"16044","6f5ae6c5c27134c60179a3172714e0e2",104,66,30,24.2666666666667,50,54,2,3
"16045","6f5ca8af72346bf40dfca70669c389c9",95,73,21,31.6666666666667,95,0,3,3
"16046","6f5dc7d9c8e4ec36d745767a6cf112cc",95,53,46,14.4565217391304,95,0,2,3
"16047","6f5e9402f208985ce45fe42b0f48c100",10,10,0,10,10,0,1,2
"16048","6f5eafc878e0efad2b67d9f7ca1d4562",156,97,85,12.8470588235294,156,0,3,3
"16049","6f5eb050f051728f198ba0f604d0d43d",38,30,9,29.5555555555556,38,0,1,1
"16050","6f6199edc037ca359680f2b44599de56",117,90,75,10.92,117,0,3,3
"16051","6f62e67c4eb9c113148cc3c860f18790",117,95,43,19.046511627907,117,0,3,3
"16052","6f64115eadd6417d9e14e25bf66f4f0f",17,17,0,17,17,0,1,2
"16053","6f6868fb4ffefbe7b5e031ef301bd1e2",13,12,3,30.3333333333333,13,0,1,2
"16054","6f69174d86840588bc3d52dc256d19a0",42,34,57,5.15789473684211,42,0,2,1
"16055","6f6cfed57dbb7ebd44d5a1d36fa8db83",23,15,56,2.875,23,0,2,1
"16056","6f6db4f176d9673906ea41b5ecb11f95",29,29,0,29,29,0,1,2
"16057","6f6feaa229950be4914d359c8e967251",75,50,30,17.5,75,0,2,1
"16058","6f73a52c2005edcbad564adcc2ce6975",80,46,65,8.61538461538461,62,18,2,1
"16059","6f752d4df2374affde2234b2d7b4cae7",23,23,0,23,23,0,1,2
"16060","6f755496f2476217ce32e08c1f397a18",50,50,0,50,0,50,1,2
"16061","6f765b90f55ceaad73e7c9503a7cfec6",43,39,6,50.1666666666667,23,20,1,2
"16062","6f778afc019236924f26f973a7d587e8",52,52,0,52,52,0,1,2
"16063","6f79ee6f3ec73443d5f30a0909f3ce90",42,25,58,5.06896551724138,22,20,2,1
"16064","6f84ef1e411345cbe0705536039b7a8e",23,19,5,32.2,23,0,1,2
"16065","6f871e43891d326dd591720403f3e033",9,9,0,9,9,0,1,2
"16066","6f876ac3f136b15f2a3692666f5f952a",83,65,53,10.9622641509434,56,27,2,1
"16067","6f88e63f9953131156f1da497b8ca5f1",19,19,0,19,19,0,1,2
"16068","6f88f3c14d177b06f2c399c16d7f1577",129,85,87,10.3793103448276,82,47,3,3
"16069","6f8a591b906cf43168deaf4a676e7d70",37,31,41,6.31707317073171,37,0,2,1
"16070","6f8b1d987af14f9a3ab432cbfee7e960",35,31,45,5.44444444444444,35,0,2,1
"16071","6f8baaa55be593bb79f1bfed365615a7",29,29,36,5.63888888888889,7,22,2,1
"16072","6f8d7bc76f47e796699561293013413b",103,98,38,18.9736842105263,103,0,3,3
"16073","6f8dcef769466bb731222d47fd4ffcfe",22,22,0,22,22,0,1,2
"16074","6f908df6fcc005134bbe9e8d268ea068",256,131,81,22.1234567901235,204,52,3,3
"16075","6f911b8f4791ed58302312d7e408b9af",16,16,0,16,16,0,1,2
"16076","6f93ff46333ff35f4275cb0419fbe4cb",59,44,57,7.24561403508772,59,0,2,1
"16077","6f9492da7ab297eaf6c61deb5c1b681a",172,126,42,28.6666666666667,172,0,3,3
"16078","6f94c0a888c89e6bdd94ebd9aa95ab6a",19,19,34,3.91176470588235,19,0,2,1
"16079","6f9632f3a284859e0c4a3b4bec0f4237",64,42,54,8.2962962962963,64,0,2,1
"16080","6f969c5a55d38c4589c0c986e5bcaae5",27,27,0,27,0,27,1,2
"16081","6f9701976b6dc16c786dfa57d47674f1",33,33,0,33,33,0,1,2
"16082","6f979bb9a1134621c6e2240f4e15e8a9",155,112,74,14.6621621621622,111,44,3,3
"16083","6f97df2fd441222d97bf1c6691b26005",43,35,17,17.7058823529412,43,0,1,1
"16084","6f9d0edfe0661abb6ed991e33c9f1dc2",31,31,0,31,0,31,1,2
"16085","6f9e004e72137a1b1e0de4cd58552cf6",115,76,54,14.9074074074074,85,30,3,1
"16086","6f9f0636c45a83385ce409c1a5610486",16,16,0,16,16,0,1,2
"16087","6fa288026dd57a6ea613930dbeb41553",74,62,23,22.5217391304348,74,0,2,1
"16088","6fa5b08c9dadb85573b21e51114349f4",8,8,0,8,0,8,1,2
"16089","6fa68cc4d153393e257b273970946f30",85,73,28,21.25,85,0,2,3
"16090","6faa2d9f8c998f60fa086a9227f7bb57",36,33,46,5.47826086956522,10,26,2,1
"16091","6faa829e842d0e06c406f3b0d36d52f1",114,90,21,38,114,0,3,3
"16092","6faa9145e7f96848bcb2cd34eabe8a0a",53,53,0,53,53,0,1,2
"16093","6fadbc1253e74bd2826d404b83682159",28,28,0,28,28,0,1,2
"16094","6fae78dc62d83eadc902e43d3118300a",32,32,0,32,32,0,1,2
"16095","6faec98fba7a7fd2345f37a3120dc5d4",83,51,49,11.8571428571429,83,0,2,3
"16096","6faf9d77bd21b1bab9756ae8adb2bc0b",39,39,0,39,0,39,1,2
"16097","6fafbdb8e281b8654f9399c2340a812f",28,28,0,28,0,28,1,2
"16098","6fb00814b94ffd7f8cba62e826668bfb",50,43,12,29.1666666666667,31,19,1,2
"16099","6fb0c9cf11ba0b192fab88b6f94ca4f1",93,57,68,9.57352941176471,41,52,2,3
"16100","6fb1f3c750d907ac85c2a4dd192dc292",15,15,0,15,15,0,1,2
"16101","6fb6c3fe7bf8ec1f5dc4555cb9019f82",32,32,0,32,32,0,1,2
"16102","6fb75ff2fa4a3b5af480e635ea0a6a62",31,31,0,31,31,0,1,2
"16103","6fb85b63a612d1a6a65b14038e3270ad",206,92,73,19.7534246575342,206,0,3,3
"16104","6fba9a2bc90e0453e5dd58d25f98095f",123,92,33,26.0909090909091,123,0,3,3
"16105","6fbb3f4ced2ad884e0de341ed068becd",187,122,68,19.25,187,0,3,3
"16106","6fbf68de5656d1c5d317b64fa79010cb",64,48,63,7.11111111111111,64,0,2,3
"16107","6fc24d4606b83924d576b3d2da18428c",29,29,0,29,0,29,1,2
"16108","6fc32df560c721173fc9f3f6a63b8db5",35,35,0,35,0,35,1,2
"16109","6fc35656554166bbe3f49770e41df0af",17,17,0,17,17,0,1,2
"16110","6fc3e80d27051178b74f971e9cd74651",22,22,0,22,0,22,1,2
"16111","6fc58cdb54a3aff91594bb40c3e5eba5",20,20,0,20,0,20,1,2
"16112","6fc6349c26fae249a73d86abc554e55d",77,67,49,11,77,0,2,3
"16113","6fcac57609c69ecb6498881aaa43cc49",24,24,0,24,24,0,1,2
"16114","6fcaff8a99568b6d076ee77fed8d41c5",39,39,0,39,39,0,1,2
"16115","6fcec856db77fc419dd370a43d6d5d02",53,38,38,9.76315789473684,27,26,2,1
"16116","6fd0361500a47552d27c9b65b9b9a691",48,41,28,12,48,0,2,1
"16117","6fd0ce3a36a139b86054209a9f6c350e",136,89,89,10.6966292134831,136,0,3,3
"16118","6fd6d59562e018dcf440d63875c4b6b1",26,26,0,26,0,26,1,2
"16119","6fd7ee222bb569f4fc651cd61a48e6fc",169,68,69,17.1449275362319,169,0,3,3
"16120","6fd83a639ce345bd67997c31a6309bf2",123,67,68,12.6617647058824,109,14,3,1
"16121","6fdacb22bbad3c0389da832915c0a9cc",120,89,24,35,120,0,3,3
"16122","6fdafa76a6d1cb0f3794da04c4348a4c",13,13,0,13,13,0,1,2
"16123","6fdb02b1ccce64c330cf8a595ce053e1",9,9,0,9,9,0,1,2
"16124","6fdd26119d3855e8049d1392dcd0d278",41,41,0,41,41,0,1,2
"16125","6fdeda86a0e842c22b2f9d2b79ee1574",19,19,0,19,19,0,1,2
"16126","6fe4dc55e273ebde8fb9fcbee2f9ec61",205,114,62,23.1451612903226,205,0,3,3
"16127","6fe521a0ab08ac83f0244478828a112c",106,82,71,10.4507042253521,106,0,3,3
"16128","6fe52d959541c3d47f9b533abdb4b443",75,57,43,12.2093023255814,33,42,2,1
"16129","6fe7ace2097aa615fa6ba38827f08cb8",59,46,37,11.1621621621622,36,23,2,1
"16130","6fe7aff0b2a9615a24344e2399624f40",144,70,77,13.0909090909091,130,14,3,3
"16131","6fe8d4a0f6c05c5cc139e85025b2a34e",17,14,32,3.71875,17,0,2,1
"16132","6fea64493ad2764d17162fde88026ac5",3,3,0,3,3,0,1,2
"16133","6fea8d1e28f43d34dc7f33d0aebd0217",22,22,0,22,0,22,1,2
"16134","6feb06803af935dc712cdc489176bfeb",61,57,88,4.85227272727273,23,38,2,1
"16135","6feb431c2f59f3fecb7a02a18124f6fd",58,47,38,10.6842105263158,26,32,2,1
"16136","6fec20c3d2f7846ba98cd35015ff3775",89,63,58,10.7413793103448,89,0,2,3
"16137","6fed14f998423c4afb5ffa58702c1d20",10,10,0,10,10,0,1,2
"16138","6feec065c8f53dbd9f7fcd9d99753cc0",13,13,0,13,13,0,1,2
"16139","6fef907e41fb2809bdb8a33298b2b4bc",49,49,0,49,49,0,1,2
"16140","6ff09beb83df0473d0d58f9f1187c32f",6,6,0,6,6,0,1,2
"16141","6ff0c2d66f53eae8d57abe5a8cb9c245",167,116,81,14.4320987654321,137,30,3,3
"16142","6ff72ecc092fcb6fba1de566d81ac061",195,65,84,16.25,195,0,3,3
"16143","6ffddc03bc5a34c3d2d5a0807b6bf195",69,66,82,5.89024390243902,69,0,2,3
"16144","70005e3dcc347b979011da7aa0841b39",26,26,0,26,26,0,1,2
"16145","700225adb0c8a94ce6ab6632bc93e9e3",12,12,0,12,12,0,1,2
"16146","700700215fc0808213ea8d6e2c3d97db",155,119,62,17.5,155,0,3,3
"16147","700857138ebf1015f49c953e495be840",31,31,0,31,31,0,1,2
"16148","700946344c54218a15e7dbdb72bdd433",33,22,44,5.25,33,0,2,1
"16149","700b5b0ce7a44187e38c25e655393b6e",210,80,82,17.9268292682927,210,0,3,3
"16150","700c1a494a017e788ba4caea19f9620a",67,57,64,7.328125,31,36,2,1
"16151","700d3e3abe1747207c4a8565642b294a",138,98,55,17.5636363636364,138,0,3,3
"16152","700e3fbb50c429f83553949b050b5791",96,75,43,15.6279069767442,96,0,2,3
"16153","700e5d5a9d924d18d0da357f21e54655",33,33,0,33,33,0,1,2
"16154","700fc04e31725240c965efb2b3627123",21,21,0,21,21,0,1,2
"16155","70111a3c210fbd4223c122153b8a3c4b",150,86,89,11.7977528089888,114,36,3,3
"16156","70120df922fdba765ce293b77a2c0aa3",172,83,77,15.6363636363636,156,16,3,3
"16157","70140cdf931ae0bf0c1a3fe7435cfc07",55,41,21,18.3333333333333,55,0,1,1
"16158","70141187f7b7325bf12b0e0a796d4b0b",16,16,0,16,16,0,1,2
"16159","7019114053b66836a6ee80e951c13b20",22,22,0,22,22,0,1,2
"16160","701be9b5c2f9b2bc187f2485ef49a628",22,22,0,22,0,22,1,2
"16161","701c27071b0d99121704e055d3e054f1",103,70,73,9.87671232876712,103,0,3,3
"16162","701c87f78ba141e9c5c25c550deeefe2",41,30,28,10.25,41,0,2,1
"16163","70206856a6eb8abe39a498a7d2853454",42,32,21,14,29,13,2,1
"16164","70212ad381071425d0dad4dd0c1b42b4",90,63,50,12.6,90,0,2,3
"16165","7026ec6400c63c0f1e0de0d235bffdc4",109,64,61,12.5081967213115,109,0,3,3
"16166","702840c13a651c6a5491cd44c3748dc9",33,33,0,33,33,0,1,2
"16167","702967cff2bcd6f054a73cb5d3004217",72,32,78,6.46153846153846,57,15,2,1
"16168","702b6b77c8bdbd3df841949963472595",120,65,84,10,120,0,3,3
"16169","702bafd9d0954eeedc9e115712c11b8b",44,44,0,44,44,0,1,2
"16170","702be4a6c3ca1dfa2682da2f147b2efd",174,86,60,20.3,174,0,3,3
"16171","702f44c10066e95ec35960ae0c7bd9aa",174,80,48,25.375,174,0,3,3
"16172","702fe020563d5896d3bed28af9063cde",118,75,79,10.4556962025316,118,0,3,3
"16173","7030150915ddab9a7f7f5cfc327e2380",141,45,82,12.0365853658537,141,0,3,3
"16174","70347e1e6cd0abf52b3c5c87783ad1d4",30,30,0,30,30,0,1,2
"16175","703b64fd9f2a85e0d9ecc66fa31d256e",12,12,0,12,12,0,1,2
"16176","703ce4adc1990cfa8eb26037b4b69fbe",113,73,46,17.195652173913,66,47,3,3
"16177","703e8cb31505c77e0487329fcf1588c9",43,43,0,43,43,0,1,2
"16178","7040f76a6d0fb9d217b53c9513e974c0",42,32,62,4.74193548387097,42,0,2,1
"16179","7042313fa1a043a5a3144da5377354f1",34,34,0,34,0,34,1,2
"16180","7042e54694aa6f5cd622e1992eae6be3",196,79,49,28,170,26,3,3
"16181","70430790b4a1945fd21843ff876fbf24",27,27,0,27,27,0,1,2
"16182","7044be8d51785d491c040283cb2e6bce",93,63,63,10.3333333333333,93,0,2,3
"16183","70455703be8d0d7764a95edb46493802",58,33,42,9.66666666666667,58,0,2,1
"16184","70457da73e2ebc0929e780c05a52581a",49,42,53,6.47169811320755,48,1,2,1
"16185","704811936c6ccf51731e98adf223a55c",19,19,0,19,19,0,1,2
"16186","7048bf45bc6dc2fdf16a74168b3c5672",37,37,0,37,0,37,1,2
"16187","7049a370df6dfeb542927cecdfb07705",86,67,17,35.4117647058824,86,0,1,2
"16188","704b5adaef259f4ddc3a8c83bb6d26a9",24,24,0,24,24,0,1,2
"16189","7051a19bb2323b7915d46c68416d01f5",38,31,42,6.33333333333333,38,0,2,1
"16190","7052042047fabcc637ecfae25188e452",76,53,51,10.4313725490196,76,0,2,3
"16191","70520dcc16329c9219aeb1a72efdf953",36,29,62,4.06451612903226,36,0,2,1
"16192","7052e8fcee42b4ecd51078151679d452",49,38,21,16.3333333333333,49,0,1,1
"16193","705310c3e6b4028941a03935dd7a81fd",31,31,0,31,31,0,1,2
"16194","7053d15d1ce238fbdc0f0089d6e6a3fc",39,36,14,19.5,39,0,1,1
"16195","7053db337a6c9b4c7a8ea4eb91a70369",17,17,0,17,0,17,1,2
"16196","7055106b61164066b260ec60f07dc7d1",92,59,71,9.07042253521127,92,0,2,3
"16197","7057d06a3d8a7128ec381c6f380e198c",123,58,79,10.8987341772152,123,0,3,3
"16198","7058441caebedd9d5ae89a754f97f9f3",143,75,79,12.6708860759494,103,40,3,3
"16199","705b42f60c359d0ac46bec231aeb9e53",41,41,0,41,41,0,1,2
"16200","705d6808b1cc4882d3b8b5793c3cdf66",14,14,0,14,14,0,1,2
"16201","705e38f3841c4af4b975221b2ff84c65",18,18,0,18,0,18,1,2
"16202","705fe24c64e2e443989420d0db2ee26a",43,40,21,14.3333333333333,43,0,2,1
"16203","7060125d2a8438147dceefb033448630",155,112,50,21.7,155,0,3,3
"16204","7060699070ad29bd7f115c71d04b5411",21,17,85,1.72941176470588,21,0,2,1
"16205","7061f432235b3c72327ab5eaeb7cb664",49,39,36,9.52777777777778,49,0,2,1
"16206","7063332202dea88db4f42e3c1b4dd0e0",128,100,78,11.4871794871795,128,0,3,3
"16207","7068d57568f5ed907e1d348d56c95621",82,73,36,15.9444444444444,82,0,2,3
"16208","70693c8cad734f8db686434193715bb4",45,45,0,45,45,0,1,2
"16209","706ab74d92c043dccbd4e215a8c30cd7",43,43,0,43,43,0,1,2
"16210","707083b8ca52eccd28a57241a1e04905",12,12,0,12,12,0,1,2
"16211","7073084e6727843d3c13bdc80cc2395a",183,91,79,16.2151898734177,183,0,3,3
"16212","7073757c6fe8007859457660631b9c0e",6,6,0,6,6,0,1,2
"16213","707592acc4a0ffd2f1a6461cbc450823",24,24,0,24,24,0,1,2
"16214","707675e76a04b2fe5990483aea798233",54,54,0,54,54,0,1,2
"16215","707ac32fe1d997097a52796c379289a5",24,24,0,24,24,0,1,2
"16216","707d777d4aceb34f07469a6d59e59069",31,31,0,31,0,31,1,2
"16217","707d7d667561310b03945a2b02b580e6",50,50,0,50,50,0,1,2
"16218","707ef3ce92eb777e3517f14eeb701e59",123,63,59,14.5932203389831,123,0,3,3
"16219","707fcaf119c1e2017c5f7ed4e47046bc",149,96,60,17.3833333333333,95,54,3,3
"16220","708032e77765510f1a80379803f05680",25,25,0,25,25,0,1,2
"16221","70841e01bee35b2b961bdfe0f797bef5",106,75,58,12.7931034482759,63,43,3,3
"16222","7086127fdb86f4a4f7cd756fa85539fe",1,1,0,1,1,0,1,2
"16223","7089bffdfa96c98c3cf13526028b165c",128,99,52,17.2307692307692,128,0,3,3
"16224","708b602b6c5d29b6e4a863c6ff07b26c",24,21,36,4.66666666666667,24,0,2,1
"16225","708b9e98ef4017d372dab170dc53f00d",22,22,0,22,22,0,1,2
"16226","708c48332802d5c7fd35fd4150766eae",23,23,0,23,23,0,1,2
"16227","708d022a45499b73cc5dfa830b9309ca",13,13,0,13,13,0,1,2
"16228","708d31a2e9c338897f16d695dc74d445",40,40,0,40,40,0,1,2
"16229","708e3848d7c2fa2c54eb22a7331d4811",41,41,0,41,0,41,1,2
"16230","70908839574ae9c828713833c49d67ee",21,21,0,21,21,0,1,2
"16231","709476a63ac41e2495d720854257b306",40,30,42,6.66666666666667,0,40,2,1
"16232","7097267c1d06e6764607901736722b67",229,134,81,19.7901234567901,186,43,3,3
"16233","7099dc6a03bc7bbe951630bb47559afe",61,40,50,8.54,61,0,2,1
"16234","709bc19d2b284584dde5ee5dd8a7e069",35,20,58,4.22413793103448,35,0,2,1
"16235","709cb6cdd962410022a06b0d115e858a",23,19,59,2.72881355932203,1,22,2,1
"16236","709f4562b4ac192b8597797460b4d581",126,62,85,10.3764705882353,126,0,3,3
"16237","709f7ba7d2dce52b35a6aa6ee9085eb7",66,48,25,18.48,66,0,2,1
"16238","70a6541f5a16692338f8d5c41e504ec6",33,33,0,33,33,0,1,2
"16239","70a6f230fe1a65b7233771306c4f5a4d",148,58,71,14.5915492957746,148,0,3,3
"16240","70a98efa9ca6c6d14b0381a77efe67e1",116,87,61,13.3114754098361,116,0,3,3
"16241","70aae86612d8545533f0fd61a2b561e6",42,15,81,3.62962962962963,42,0,2,1
"16242","70ac2b556877090b21a6422341769483",23,23,0,23,23,0,1,2
"16243","70ac352def6d35e68fd1a8fa18d6fa02",89,55,64,9.734375,51,38,2,1
"16244","70aebc249627cb2f401784fc08804fbb",61,50,30,14.2333333333333,61,0,2,1
"16245","70b8cd2d419b141d78afe18b0bbe4344",19,19,0,19,19,0,1,2
"16246","70b8d23d0b2a76750af468280fa2ed45",16,16,0,16,16,0,1,2
"16247","70bbca951c86e6f89409e9635725f3ab",22,22,0,22,22,0,1,2
"16248","70bdf0bc02eb9ac3f390a3610dbbb6fc",17,17,0,17,17,0,1,2
"16249","70c21d5f343a5a958ec022e579e2f21c",81,45,42,13.5,81,0,2,3
"16250","70c2871513bf87292ec3c381cd5c6ae4",40,40,0,40,40,0,1,2
"16251","70c59ba13556c091086891a2a614854a",30,30,0,30,30,0,1,2
"16252","70c644380eca4baf22377411a1f7f65e",121,85,57,14.859649122807,121,0,3,3
"16253","70c7486f1ab0c4b8a4ac3e616fc8c36e",21,21,0,21,21,0,1,2
"16254","70c811bc495d38c7ca8a8323f435d622",18,18,0,18,0,18,1,2
"16255","70c881d1df26f557c2bc4119d457a3ae",20,20,0,20,20,0,1,2
"16256","70cad7c69a2fa88b8e1f188ac0d6644a",28,20,13,15.0769230769231,28,0,1,1
"16257","70cc485dd72d81b1ddb4249bf4da1ff8",24,24,0,24,24,0,1,2
"16258","70ccaece249afebad7ca406518853be4",16,11,45,2.48888888888889,16,0,2,1
"16259","70ccbe14b809b24f33da288704cac623",31,31,0,31,31,0,1,2
"16260","70cd8329e975d0f6edbbe2ddd91ec86c",196,96,59,23.2542372881356,170,26,3,3
"16261","70cdca667f763546301122580bfacb7c",147,81,69,14.9130434782609,102,45,3,3
"16262","70d1cac0d96009cf33783769e18fe5d0",37,37,0,37,37,0,1,2
"16263","70d44111bcd2e88c569d430f1a0d5536",125,60,90,9.72222222222222,76,49,3,3
"16264","70d54e7d5389483c720729449c7cd4e9",187,91,77,17,187,0,3,3
"16265","70d59e5f2387a868a58d5aa436125d64",20,20,0,20,20,0,1,2
"16266","70d5b14f5fe0c539807e4255c1de4f39",60,46,52,8.07692307692308,31,29,2,1
"16267","70db38d04aa45f26b18dfe7f75f91736",22,22,0,22,22,0,1,2
"16268","70de0faf396a9d47b0d33ac3c3fb5909",36,27,29,8.68965517241379,36,0,2,1
"16269","70de6ff157efd1b97fc730a090ba7697",36,23,61,4.13114754098361,36,0,2,1
"16270","70deef277225b140fa5939e6d5242225",48,38,32,10.5,31,17,2,1
"16271","70e32cb9b9aebb3d24d681d474a7e280",58,47,33,12.3030303030303,58,0,2,1
"16272","70e403c5a23ce5dfe7e6e76ee3f43261",5,5,0,5,5,0,1,2
"16273","70e4fa639548da5598011a3de0ae0c06",43,15,73,4.12328767123288,43,0,2,1
"16274","70e8710e731b17cd865a0460e25697c2",8,8,0,8,0,8,1,2
"16275","70ed73c7149010f0ab6cbf818d720f95",21,21,0,21,0,21,1,2
"16276","70ee2ea10ab90d19a579a3758b019f5a",95,48,76,8.75,95,0,2,3
"16277","70f00093a0aecf709a51358518e32986",21,21,0,21,21,0,1,2
"16278","70f22c1ec761295ed1a36dcf635719c1",25,25,0,25,25,0,1,2
"16279","70f4447b188b86995a245af45393a142",25,25,0,25,25,0,1,2
"16280","70f6074ae8c89ed5118b6a6a04b21439",30,30,0,30,30,0,1,2
"16281","70f68acafe80e961b45738da84f931bc",59,52,32,12.90625,59,0,2,1
"16282","70f78ddf4ab6ab17e6a30813262f8bdc",16,16,0,16,16,0,1,2
"16283","70f84a669af814322fa5a28d4bc28558",83,57,32,18.15625,83,0,2,1
"16284","70ff733f30b270290e1de9d896b206c8",152,95,73,14.5753424657534,152,0,3,3
"16285","71004d369bf8a60239c6aac643f4d721",98,75,42,16.3333333333333,98,0,3,3
"16286","710196ad586ab127baa52bdd90987c0f",56,36,28,14,56,0,2,1
"16287","71032b1e0f9705aa85435495d27d833a",99,76,62,11.1774193548387,56,43,2,3
"16288","7106af9d1d73607d00cef2f0bc040e05",27,27,0,27,0,27,1,2
"16289","7106d50437d6b21e4426eb5f716dc5f5",103,67,30,24.0333333333333,103,0,3,3
"16290","71080e1749767361083e5d5682308686",33,33,0,33,0,33,1,2
"16291","71086d715809a24ce696dd1514ae2dd3",127,55,56,15.875,99,28,3,1
"16292","7108781949c65ba0542cdb41d89582ee",61,52,23,18.5652173913043,37,24,2,1
"16293","7108e50bfe742329312e8a5b06b4edef",31,28,66,3.28787878787879,31,0,2,1
"16294","710b716a8e8f011bb1cc609530d1d3db",122,97,29,29.448275862069,91,31,3,3
"16295","710cc6cff2b7c568eb13b7a0e08fc204",129,50,87,10.3793103448276,108,21,3,1
"16296","710d50d4fb08c49663b10fb7b2073f8b",22,22,0,22,0,22,1,2
"16297","710d782d494476c629a610fcb536a8cc",58,43,24,16.9166666666667,58,0,2,1
"16298","710d9753cad854ac8c470f77ea5ce725",64,53,63,7.11111111111111,33,31,2,1
"16299","710e1994f576880ba5b1c39cd9f2f27a",34,34,0,34,34,0,1,2
"16300","710ec92d9ddd73954993d64f4333ee4e",24,24,0,24,0,24,1,2
"16301","71159fc860fc47e0c66623b061af08fe",24,24,0,24,0,24,1,2
"16302","71172c2c35a08b43c79a34798c1ed0c0",42,42,0,42,42,0,1,2
"16303","71184e675bc8d9547c7b3067f52e0c6d",200,42,50,28,200,0,3,3
"16304","71193882337202f31c1da013b932114c",24,19,35,4.8,24,0,2,1
"16305","711ad2e94ad2007bc483c48af14398bd",6,6,0,6,0,6,1,2
"16306","711aeb0abbdc35dc49694b22ab8bf198",89,67,24,25.9583333333333,89,0,2,3
"16307","711bd99588e70f245916bff5598bf3c9",19,19,0,19,0,19,1,2
"16308","711db6a3a1ab4c3342f744f9e88578c0",48,38,7,48,48,0,1,2
"16309","7121bd8812bc5e6eebf112397e77a2fa",31,31,0,31,31,0,1,2
"16310","7123b41de1b08d9c9ce8de3c1aee3782",119,89,57,14.6140350877193,119,0,3,3
"16311","7129029ca28a4f3e76f561ea3db364d6",26,26,0,26,26,0,1,2
"16312","712a20d124d2d865afdd83492523fbbf",44,30,62,4.96774193548387,31,13,2,1
"16313","712a5279e3d6ec91bb3ed696ff59d607",97,61,72,9.43055555555556,58,39,2,3
"16314","712c3cbe1304917edd7824bfe06f2c23",1,1,0,1,1,0,1,2
"16315","712dfce84fdbd77d095047f8a10464e4",73,67,21,24.3333333333333,73,0,2,2
"16316","7130aa85bb4c7626387111172549cbfe",2,2,0,2,2,0,1,2
"16317","7135b8f9ee45e8c9b37a8967b2e2e58d",182,106,66,19.3030303030303,182,0,3,3
"16318","71376498a7bacf3baef8e4026c9f242a",103,78,28,25.75,103,0,3,3
"16319","7137c1de7603fc22c08f744694b65ebd",126,105,30,29.4,78,48,3,3
"16320","713c2170e312a93ddaa092e546150430",38,34,52,5.11538461538461,16,22,2,1
"16321","713c9dd7b687c20553928aaf34ea7ce7",202,113,82,17.2439024390244,202,0,3,3
"16322","71417325389f2f6e98ff9936d5979248",43,38,73,4.12328767123288,18,25,2,1
"16323","71442dce6d84c1c0d86bc470a195a75b",177,87,75,16.52,177,0,3,3
"16324","714467cc4e5e3eb1fbc7e6ac05594e14",44,44,0,44,44,0,1,2
"16325","7146472f6e7cc4038a97c02a1f083377",99,71,35,19.8,99,0,3,3
"16326","7146b2e5b74b2691d5f897df1dcdf805",28,27,47,4.17021276595745,12,16,2,1
"16327","71483b54d5bdc52f6d35cc12eed0817c",62,49,27,16.0740740740741,62,0,2,1
"16328","714c762de94a0357a77f57115767ba0d",99,67,50,13.86,71,28,2,1
"16329","71510496ba07c6951a75162fcc32b91e",158,102,42,26.3333333333333,130,28,3,3
"16330","71512b68af1fcd159d5fa5a9989e2803",256,95,53,33.811320754717,205,51,3,3
"16331","7151b730133ee4298e53d2b14e949e6d",88,79,26,23.6923076923077,88,0,2,3
"16332","71543e253a7d27f229d3f1f2b8a7944a",54,37,25,15.12,22,32,2,1
"16333","7156e6a3c489257643950a3f49904742",44,44,0,44,0,44,1,2
"16334","7157a5392714a385cd7767ec24cf67f0",142,87,53,18.7547169811321,142,0,3,3
"16335","7157a6fdeb5ea85a8a731f4402e09804",8,8,0,8,8,0,1,2
"16336","7158364c5eaa5e0c49b53f17c57f586f",87,62,46,13.2391304347826,41,46,2,1
"16337","715f81bc598d3b83eb357392bae02c63",125,95,62,14.1129032258065,125,0,3,3
"16338","715fd3f533e1e564e203dea1d5da8fcd",95,68,77,8.63636363636364,95,0,2,3
"16339","7167f3eefb97cf782a245accfdf91e7e",22,22,0,22,22,0,1,2
"16340","7169c18177752c4c2d98d1e4db0ab91c",21,21,0,21,21,0,1,2
"16341","716f7aac3bee5aff956f4207e803758a",55,44,42,9.16666666666667,0,55,2,1
"16342","716f7eba32d21b4d7561e2e1df62675b",7,4,73,0.671232876712329,7,0,2,1
"16343","71721bd02703c8601f0767bb4fc09e2d",96,83,77,8.72727272727273,96,0,3,3
"16344","717512fc9033ca36254c838c75134200",34,34,0,34,34,0,1,2
"16345","7175e4d17bb34fd7f29c1a5eb439e67c",70,49,80,6.125,48,22,2,1
"16346","7178bd584cec22491ea605cf0aaa491d",115,66,38,21.1842105263158,63,52,3,3
"16347","717944b726e0ab851100018187dee09a",78,49,65,8.4,78,0,2,3
"16348","71795fddf35fcda654c281518959c921",55,55,0,55,55,0,1,2
"16349","717c179d79874e25729c8c47eb7b4417",42,42,0,42,42,0,1,2
"16350","717fdb60d2ed25646bc1547e0a47f37a",39,39,0,39,39,0,1,2
"16351","71811fa42a27f6fa3554141fe448db0f",55,55,0,55,55,0,1,2
"16352","7182ac9f11a937ec9b6f9aa195af5ba0",19,19,0,19,19,0,1,2
"16353","71832e19b50bb8277ad1a8642c4504e3",71,44,62,8.01612903225806,71,0,2,3
"16354","71868c5e237bceace69608a3c61a1a5c",10,10,0,10,10,0,1,2
"16355","718a248ed550b8c0f175329d8bcab07b",136,71,65,14.6461538461538,136,0,3,3
"16356","718ace5ee0c65edd29c0be17ff03ddfe",34,34,0,34,34,0,1,2
"16357","718b8b570d75a03bb0630d594b01b0fa",63,39,35,12.6,63,0,2,1
"16358","718cf2df684df49c1ca82d1532551d68",49,35,83,4.13253012048193,49,0,2,1
"16359","718f583f91a10bbef98d409ebd77fd58",37,29,28,9.25,37,0,2,1
"16360","71950a01d31bc55e949d13100e4dc3be",263,136,69,26.6811594202899,218,45,3,3
"16361","7198c3207cb499aa5b9803b194381861",44,40,15,20.5333333333333,44,0,1,1
"16362","719c78e7e58ff102cfb728d68688bd55",28,28,0,28,28,0,1,2
"16363","719c838c967bbbf41cb4278a5adea4b3",49,44,39,8.7948717948718,34,15,2,1
"16364","719dff9df7dc55ada47b876973a6ed48",24,24,0,24,24,0,1,2
"16365","719e527955f2486fa9e80a9ab6df1bcb",35,35,0,35,35,0,1,2
"16366","719ec015a0a01b303ba1350412a8bccf",15,15,0,15,15,0,1,2
"16367","71a1f90b847f4d933570b1c007f58534",16,14,65,1.72307692307692,16,0,2,1
"16368","71a7e489a64189ec807194fe1726b057",25,14,66,2.65151515151515,25,0,2,1
"16369","71a80285456f3da3a5c51728b24e5d99",123,86,42,20.5,123,0,3,3
"16370","71a905345e62c28d7006606c52a3338c",145,79,20,50.75,111,34,3,3
"16371","71acae26b37f19337c2d7ee29ed974d2",141,51,63,15.6666666666667,141,0,3,3
"16372","71aff7ce17c9763b1788d92824f8bf14",14,14,0,14,14,0,1,2
"16373","71b192af44e15f11ed1da64abba3acb4",83,58,63,9.22222222222222,83,0,2,3
"16374","71b5236bfe523d150db32e879fbdea0b",212,112,78,19.025641025641,212,0,3,3
"16375","71b5f71afc3b0065cb0a7701b04f5703",79,62,78,7.08974358974359,79,0,2,3
"16376","71b85e5d858ad55b4c703851549c92a7",29,29,0,29,29,0,1,2
"16377","71bc5c5a02e0333afc1b8711b64efb64",60,42,72,5.83333333333333,29,31,2,1
"16378","71bdee696db20194b99b61a03eb97aec",113,88,41,19.2926829268293,77,36,3,3
"16379","71bec65448204eae11cc4cbd9ff2b316",187,82,52,25.1730769230769,162,25,3,3
"16380","71becfcca17a02c3346de44d087e4f28",45,45,0,45,45,0,1,2
"16381","71bfbeeef24569e2f63876e4815d5830",32,32,0,32,32,0,1,2
"16382","71bfd39312b923d5662c5b9fa0e75ee2",68,58,38,12.5263157894737,68,0,2,3
"16383","71c3208d0fb98fde77c05e0ceb1eec5f",8,8,0,8,0,8,1,2
"16384","71c44ae4bdbb688cbb9494ff40cc804d",109,53,76,10.0394736842105,109,0,2,3
"16385","71c62fc8adf6cde63bcd28f6f44bffd6",94,57,70,9.4,94,0,2,3
"16386","71c7f3fa083d3bcd323464eeaa582871",8,8,0,8,8,0,1,2
"16387","71c862d55610424a9c466feea0ff7bda",55,55,0,55,55,0,1,2
"16388","71cea866a51d60dbfb0ca44a9e32bb79",244,73,88,19.4090909090909,213,31,3,3
"16389","71cf62ebae623fa46cfd59c23b0ec563",31,31,0,31,31,0,1,2
"16390","71cfafaca3a45784a02f0df6a353d9a3",82,57,22,26.0909090909091,82,0,2,2
"16391","71d0098226b54ecb861e1de0a139d5ce",9,9,0,9,9,0,1,2
"16392","71d0cfe437abba7fe401aea14b38c834",39,39,0,39,39,0,1,2
"16393","71d3432f3582aee426c6aab7bd4152ec",40,30,60,4.66666666666667,40,0,2,1
"16394","71d3f90531c8ca04f9cf06b0d57a9027",30,30,0,30,30,0,1,2
"16395","71d5e5f6dd3d9423edd0a367b81142bf",45,36,21,15,45,0,1,1
"16396","71d80bb22cae11ff58fd3a47b8878bfd",46,39,41,7.85365853658537,46,0,2,1
"16397","71d89168242cd7df23514e0f846165d0",5,4,19,1.84210526315789,5,0,1,1
"16398","71db38147bac1e62e7100685a5fcb82e",76,64,70,7.6,76,0,2,3
"16399","71e236c2ab0073a8e6d2dea2b9601f9a",130,103,46,19.7826086956522,130,0,3,3
"16400","71e25c936436af5f9fc7354361ebaecf",58,47,53,7.66037735849057,58,0,2,1
"16401","71e9d1c0cdaf4929b93d41947e151b47",30,30,0,30,30,0,1,2
"16402","71eb937f92df1cd9ec43448c23570004",104,77,21,34.6666666666667,104,0,3,3
"16403","71ef75fb666ea1697f23cf5d854eaf8e",82,32,63,9.11111111111111,82,0,2,3
"16404","71f3d475005aad01fb95d908498b0fcf",76,48,34,15.6470588235294,76,0,2,1
"16405","71fce9a96a16e85def8576dfa8e069c3",51,42,56,6.375,51,0,2,1
"16406","71ff31a45bddd9a631c33eb2deb6d460",124,72,76,11.4210526315789,124,0,3,3
"16407","71ff4bbf4f4627315cfa0da51585c51d",91,39,77,8.27272727272727,91,0,2,3
"16408","720282c59361e641b2df25311b07b70c",31,31,0,31,31,0,1,2
"16409","72037777093c99bfaafb84facca31a37",35,34,38,6.44736842105263,21,14,2,1
"16410","720cc0b9d1b6cae102763d0ba19fe308",32,29,9,24.8888888888889,19,13,1,1
"16411","720d411b9740cf8759579b50e7387954",29,29,0,29,29,0,1,2
"16412","7211b9cbfdc293c02c39e24f6a3e0159",162,90,67,16.9253731343284,162,0,3,3
"16413","721546b4416eaef783ae88151b33cf7a",26,26,0,26,26,0,1,2
"16414","7219af3ab17a61cc3b37e979807ab230",161,91,64,17.609375,161,0,3,3
"16415","721ccb8b5f006e592b6a1e2854a1d52b",36,24,37,6.81081081081081,36,0,2,1
"16416","721e38ceb5dab2e7ffa057fb794fe672",4,2,48,0.583333333333333,4,0,2,1
"16417","7220d5b2edf70a608dcbbf2ea348aa74",152,75,80,13.3,152,0,3,3
"16418","7221f29e0085acffcd8d2a24589dc385",9,9,0,9,0,9,1,2
"16419","72242b690d0e2638149c155df4593dfe",34,34,0,34,34,0,1,2
"16420","72275c108bff1d33d169274b357d3b36",22,22,0,22,22,0,1,2
"16421","722b692c729b215e2d73bddbb3922709",69,55,51,9.47058823529412,69,0,2,3
"16422","722c42da4698c48167dece9e686f81be",1,1,0,1,1,0,1,2
"16423","722e892985674f1ed76177913d64832a",72,56,79,6.37974683544304,26,46,2,3
"16424","722f11baa7b2844ef1a7fae33308977f",71,61,47,10.5744680851064,71,0,2,3
"16425","722f3dbd513a87e281e42d2bc00e7156",51,40,63,5.66666666666667,51,0,2,1
"16426","722f5500af0bf5f3b36b095ef68a15be",36,36,0,36,0,36,1,2
"16427","723198e566a0fa7778fc4f001bb717f3",82,57,31,18.5161290322581,53,29,2,1
"16428","7232919cda51026888054f2bb0c00925",43,43,0,43,43,0,1,2
"16429","7232ddf82a27c45ece2a1fac3a5622d7",29,29,0,29,29,0,1,2
"16430","723404f934ee011519b0c2136ba497f8",31,20,33,6.57575757575758,12,19,2,1
"16431","72366cc67f0568ad75912e5200f670cc",51,30,85,4.2,51,0,2,1
"16432","723a8eca5fd1916a460ad4d7d9a10da3",55,43,37,10.4054054054054,55,0,2,1
"16433","723b019f97164ee59d227a1ba1ddc020",12,12,0,12,12,0,1,2
"16434","723b7a17db73a4063d09199042003d12",223,124,32,48.78125,185,38,3,3
"16435","723dd90191c147b1c6ae85b36ad73ad0",60,44,48,8.75,60,0,2,1
"16436","723de193050853cd29212880ad5b0ff1",60,43,45,9.33333333333333,60,0,2,1
"16437","723f276bd442249079acb0b746f75cfe",64,49,47,9.53191489361702,29,35,2,1
"16438","724ca937f4d8983b0a9b6049fa25571e",19,19,0,19,19,0,1,2
"16439","724d3fd3342707906c18460e1ff30c33",130,100,28,32.5,130,0,3,3
"16440","724ffdb29e4417d1b5787797402a7709",88,68,29,21.2413793103448,88,0,2,3
"16441","725379baf6154c95bf93f1e55838fcd3",100,86,63,11.1111111111111,100,0,3,3
"16442","7255f52db08f63970712f9e082f90d93",131,85,74,12.3918918918919,113,18,3,3
"16443","725643b3c2ed463c61bb1823eebab5b3",73,60,17,30.0588235294118,73,0,1,2
"16444","7259157eda0593417afc6a90f3997470",79,68,50,11.06,79,0,2,3
"16445","7259893b0035c228c0147238a2950368",10,10,0,10,10,0,1,2
"16446","7259bde6a58ef6308773665e8c142f7a",93,72,67,9.71641791044776,93,0,2,3
"16447","725adf99f84f044b11389a0e42e330c9",34,33,13,18.3076923076923,34,0,1,1
"16448","725ed163e6a0e4f2f5b5250ba18d4da0",14,14,0,14,0,14,1,2
"16449","7261fd670bf4604d5653bfa2a509ed54",99,72,69,10.0434782608696,99,0,2,3
"16450","72633f05855ada65539c82f19d06d138",80,56,36,15.5555555555556,80,0,2,1
"16451","7264058777b721bb006efd1bfc0095c0",28,28,0,28,28,0,1,2
"16452","7265bff1abf90a3dd3d9ae6364db8888",38,20,63,4.22222222222222,38,0,2,1
"16453","7269801a55ccd06485aa3b8efc3c7ff1",38,38,0,38,38,0,1,2
"16454","726a46b9f501a23a37d79d95a24ca721",87,56,66,9.22727272727273,87,0,2,3
"16455","726ae52d5cb1cc7ed8c606ecef2c0ba1",56,41,55,7.12727272727273,56,0,2,1
"16456","726f7d93086cd9b11af70790e2e31d35",18,18,0,18,18,0,1,2
"16457","726fdb34fe5dd44d758d3660ed5bb252",65,55,32,14.21875,29,36,2,1
"16458","7270c5c0bba2dc534fe8e67f7c0a3b5a",167,107,24,48.7083333333333,135,32,3,3
"16459","727155295b0bfca40ecef5f900d153ba",79,45,31,17.8387096774194,39,40,2,1
"16460","7271792146c727e11a01281389974259",1,1,0,1,1,0,1,2
"16461","727289de50ab03feb1736968934bd0f8",57,44,53,7.52830188679245,57,0,2,1
"16462","7276ee40b0d517f1b16d480e786385c1",16,14,41,2.73170731707317,16,0,2,1
"16463","7278066f564371048c2f6967fd244ed0",23,23,0,23,23,0,1,2
"16464","72788917c79e3587683065e4375e70a2",51,47,44,8.11363636363636,19,32,2,1
"16465","7278bf7798b1710fd360de270708fbb5",54,54,0,54,54,0,1,2
"16466","727b7a9f1d526fb1247d09352001014b",49,32,14,24.5,49,0,1,1
"16467","727d85d9049bb8648bffc01bfb9f6bea",19,19,0,19,19,0,1,2
"16468","727e6b6d7f40c0270cd0caab395b553b",56,48,14,28,56,0,1,1
"16469","72807fe7274b8e5d72e87e94dccd6adc",214,86,69,21.7101449275362,214,0,3,3
"16470","728236a4798b18cb502ef6ebe3e1f796",48,48,0,48,0,48,1,2
"16471","72831c692eeef9aa4d743bd8692dd670",69,59,25,19.32,38,31,2,1
"16472","7284f5ea1aa03a2d3e6c6366608fad86",28,28,0,28,0,28,1,2
"16473","7287feb39ac6684574b0047480140cae",27,27,0,27,27,0,1,2
"16474","728cd6e9d217c5203354dea0854c97ae",45,41,66,4.77272727272727,45,0,2,1
"16475","7290e266b83860a6d1e3ae08aa8c2b4a",40,40,0,40,40,0,1,2
"16476","72912df9df106e4ec7639f422921a411",162,103,86,13.1860465116279,162,0,3,3
"16477","72914b79704b5ff0b6ca5d8c2a55359c",115,80,46,17.5,72,43,3,3
"16478","72926aba1651c690f3fd228b1b571664",16,7,56,2,16,0,2,1
"16479","7295fec45fca4a71d8eeedb422809624",42,39,36,8.16666666666667,42,0,2,1
"16480","7298e20661059b0c193fc6d7cca46765",12,12,0,12,12,0,1,2
"16481","729959cb2973f36897578d9f0b006219",89,67,42,14.8333333333333,89,0,2,3
"16482","7299ec726400ad3dee5d4b271023e21b",38,38,0,38,38,0,1,2
"16483","729d545a315b730cd1bfa705ea149cca",54,54,0,54,54,0,1,2
"16484","729e67bf7364e35806953256747181ad",19,19,0,19,19,0,1,2
"16485","72a1a0470220c8cf2953074549ad3bb5",73,46,53,9.64150943396226,36,37,2,1
"16486","72a237b00b9f3474130fb5d25b3bbaa0",25,25,0,25,25,0,1,2
"16487","72a386f23fd6ff3711c30312a59e0696",96,67,54,12.4444444444444,96,0,2,3
"16488","72a3fb4ce2d43363ff3fcb6f86fa9a00",76,46,42,12.6666666666667,48,28,2,1
"16489","72a95d55fb3df2456b4c3de89b1263d2",74,60,45,11.5111111111111,74,0,2,3
"16490","72a96626fc7ce1c9b0da7f8ffca12fae",32,32,0,32,32,0,1,2
"16491","72aaaf4986b26c17fc05cb845b748afa",4,4,0,4,4,0,1,2
"16492","72ab447e95879083aac253fd506eb812",41,22,69,4.15942028985507,27,14,2,1
"16493","72abc424e3d2359253d94e9c1fba1fa1",78,22,74,7.37837837837838,59,19,2,1
"16494","72ae4728943d7efb13a890f9ea1e5133",25,25,0,25,0,25,1,2
"16495","72afcd0297b1c1de5c7ce8bbc90f4598",35,35,0,35,35,0,1,2
"16496","72b0e313dfa1dfb682fded98ea3159f2",24,24,0,24,0,24,1,2
"16497","72b4cbac0b99cf09b56a5ae8c3a7b935",9,9,0,9,9,0,1,2
"16498","72b5aa210e59e081e779155905d719e5",9,9,0,9,0,9,1,2
"16499","72b5bf39afa7f71df9ea12f9b4af86d8",26,26,0,26,26,0,1,2
"16500","72b5c0da3cca896d4ed53d5694703704",106,64,74,10.027027027027,106,0,3,3
"16501","72b7fccd7bece4cfc75a23e85424ed58",31,31,0,31,31,0,1,2
"16502","72b86b03a2203e38a9bfbb83b48a0a36",80,57,37,15.1351351351351,80,0,2,1
"16503","72ba498e64729f04d5ce397a8ca290f2",19,19,0,19,19,0,1,2
"16504","72baaf7c5723f3845153b0010eb14abb",121,66,61,13.8852459016393,70,51,3,3
"16505","72bb5ade0684c378614c656c9b794c50",7,7,0,7,0,7,1,2
"16506","72c0e6d3e044cdbff21d1d29b736098e",28,28,0,28,0,28,1,2
"16507","72c1c5083d0839eee38c70bd6ccbaefc",10,10,0,10,10,0,1,2
"16508","72c2bc8ff673df4e080f65c1dc412f1b",28,28,0,28,28,0,1,2
"16509","72c3e769ca2fb6798663521eae3fcb34",28,28,0,28,28,0,1,2
"16510","72c71b822b4c0969231132dcd32cc0cb",51,35,34,10.5,51,0,2,1
"16511","72ca59814d01535cf53fbf67c4782d7f",29,29,0,29,29,0,1,2
"16512","72cd80a1b055871bdb0ed5c8a29ba9d0",133,85,60,15.5166666666667,133,0,3,3
"16513","72ce1114bdce485b0b6f9523af11dd72",103,54,61,11.8196721311475,68,35,2,1
"16514","72cf09b01880d96efd410644cac3f42d",52,40,51,7.13725490196078,50,2,2,1
"16515","72d309f2711785e48794cb044784984d",21,21,0,21,0,21,1,2
"16516","72d42bde08445358d74ab61901e85505",23,23,0,23,23,0,1,2
"16517","72d5538a539c0aae41f13baab67ab37a",117,96,34,24.0882352941176,117,0,3,3
"16518","72d55c0897d20089fa4fb1b2938bb9bf",19,19,0,19,19,0,1,2
"16519","72e0777f95eecc7c4d487c9fbe54f492",87,68,50,12.18,87,0,2,3
"16520","72e07a9495da671a1c8609b8097b7f80",146,78,63,16.2222222222222,146,0,3,3
"16521","72e103c4b8219006e54fe22b93da210d",119,90,43,19.3720930232558,119,0,3,3
"16522","72e1ac5a4ac8abe717c1a8e26241ed74",42,39,13,22.6153846153846,12,30,1,2
"16523","72e206722d0f6f4c690b1eefaacb5964",102,86,85,8.4,102,0,3,3
"16524","72e21d11bb13964a005b1a56c2c0086d",30,30,0,30,30,0,1,2
"16525","72e2501c1e00f4f6ea69acbae094f03f",49,34,36,9.52777777777778,49,0,2,1
"16526","72e2864387a3fb7bce08e004aff4bf9b",169,100,56,21.125,145,24,3,3
"16527","72e3634d5c2bb1736f640a87ae0fb221",41,32,46,6.23913043478261,41,0,2,1
"16528","72e5510c87747f4ebac3939e43e3552f",70,52,61,8.0327868852459,70,0,2,3
"16529","72e64082919c56193066aa8d7f6320cc",182,66,84,15.1666666666667,168,14,3,3
"16530","72e69fa1ef3195745bf526603d8a1637",10,10,0,10,10,0,1,2
"16531","72eac6a52d99b571836abae445865cf8",149,80,61,17.0983606557377,149,0,3,3
"16532","72ee4c9ccf9fc9179cfbe55d14c238a3",56,39,8,49,56,0,1,2
"16533","72f0bd176de26dd163d4ddc011031f60",21,21,0,21,21,0,1,2
"16534","72f1bd27a33351f4feb691d26c765df4",24,24,0,24,24,0,1,2
"16535","72f2064e7a2ee79416f300311ce12488",27,27,0,27,0,27,1,2
"16536","72f2af636fec1872d66debe232b2c69b",14,14,0,14,14,0,1,2
"16537","72f6668cec5221f02d5a104268927bc4",16,13,49,2.28571428571429,16,0,2,1
"16538","72f86233ee7cb001eb30ecacf7ab4b96",7,7,0,7,7,0,1,2
"16539","72fa0e113ada2f3258824b4b92c8d27e",91,80,68,9.36764705882353,91,0,2,3
"16540","72fcb6d592e5fbddeeea8cc42f2cd3ef",11,11,0,11,11,0,1,2
"16541","72fe9568a3eccbf73e7a36380721e961",13,9,48,1.89583333333333,13,0,2,1
"16542","7301199bd0d7cb63afcd04e7c7ecac8f",35,29,56,4.375,35,0,2,1
"16543","730572a676c0434dec65f6e451dbbaf2",30,13,66,3.18181818181818,30,0,2,1
"16544","7306da803e53aa0016eda2db7f34debf",79,72,75,7.37333333333333,79,0,2,3
"16545","7308c61f38ecf780bb3a3735ce997517",28,28,0,28,28,0,1,2
"16546","730c1e7404583d6823aefda039bfc14e",22,22,0,22,22,0,1,2
"16547","730da60557a35ef8b14b103bdaf039da",81,57,79,7.17721518987342,57,24,2,1
"16548","730fc17b4893e11926ce6b9373368782",116,56,75,10.8266666666667,104,12,3,1
"16549","73101ee898cdc88e308f7b15e85bdb35",34,34,0,34,0,34,1,2
"16550","7310c32aab1841ed1024ef5b890f73da",52,49,60,6.06666666666667,25,27,2,1
"16551","73110aa038677c1fa9ac215d545de304",64,55,42,10.6666666666667,64,0,2,3
"16552","73129599e5fad5cdc927ef58ac4a4a17",29,23,82,2.47560975609756,29,0,2,1
"16553","7313383f6204f9798202bd5621196d54",52,29,80,4.55,47,5,2,1
"16554","731766830af11b2fc30137549a55d58d",59,49,57,7.24561403508772,59,0,2,1
"16555","7317f2e35eba1ba0354192b3efb08f89",186,88,59,22.0677966101695,186,0,3,3
"16556","731c8ae113e5b4bf6eb7eaaaa3eeea14",4,4,0,4,4,0,1,2
"16557","731eb6c290256976b78492a7c5a3635a",19,19,0,19,19,0,1,2
"16558","73224f783f57cb3dc98330cee7057301",146,85,81,12.6172839506173,146,0,3,3
"16559","7324097d2c821fbd5207a32bd5322d71",49,49,0,49,49,0,1,2
"16560","73251b179506d53d62cffc559bab6876",9,8,34,1.85294117647059,9,0,2,1
"16561","7328c4396d5b9a4a5ba8c3936cecdd24",13,13,0,13,13,0,1,2
"16562","732c89c501b6a7362fac1a3d9e7e857f",159,107,65,17.1230769230769,130,29,3,3
"16563","732e3d775c3648424c24f4b74ec8dc58",13,11,12,7.58333333333333,11,2,1,1
"16564","73300532dff6fc627d81308825fbeee5",26,26,0,26,0,26,1,2
"16565","7330cb5af9bd28b976fe7dce162d548c",37,37,0,37,37,0,1,2
"16566","7330ed3165eaefaa4182838c21b94144",15,15,0,15,15,0,1,2
"16567","7333ddaee7d4ca1dab7eb29675996f33",121,86,69,12.2753623188406,121,0,3,3
"16568","7334c219f1e76df8b8f0dce876c8e804",177,119,77,16.0909090909091,177,0,3,3
"16569","733657d629a23ddbdca777e3787dfa1e",24,24,0,24,24,0,1,2
"16570","733990fa43d11361dd6753d440323812",168,94,70,16.8,168,0,3,3
"16571","733aaa3bae38c50b3bf83de7e15e5a5b",29,29,0,29,29,0,1,2
"16572","733b65d1c9547e702d5f1cbfcc858f98",85,65,38,15.6578947368421,61,24,2,1
"16573","733d969ace99b45563adec26120898c5",148,112,64,16.1875,148,0,3,3
"16574","733e3763e6740874b872081ecd9e924e",169,110,65,18.2,169,0,3,3
"16575","734417d169c7e234a542fc3a0dbab20c",24,24,0,24,24,0,1,2
"16576","734cba4a35cb16d692ec3bc9dc160ebd",37,37,0,37,37,0,1,2
"16577","734ec49b19e7b9f4e8f4a9f1e659753d",9,9,0,9,9,0,1,2
"16578","7350d47870de93cf2d8a8cf057024b08",157,80,71,15.4788732394366,157,0,3,3
"16579","7352c20ee810a5c25ad82ac9afca19fb",21,21,0,21,21,0,1,2
"16580","7355117c2b88760450af1324128bb12a",1,1,0,1,1,0,1,2
"16581","735aee0cc7ea858e4d9473a082ec5762",121,100,36,23.5277777777778,67,54,3,3
"16582","735bab3c8d37ca5c4aa2622238dc8bdc",8,8,0,8,8,0,1,2
"16583","735c6ed2e96adea0e84a174da78627d5",17,17,0,17,17,0,1,2
"16584","735f6337c5c6e76c75b287ef2cf3ba6b",43,41,46,6.54347826086957,24,19,2,1
"16585","735f8ca312513d02efdb32fe611955e1",58,50,35,11.6,58,0,2,1
"16586","7361c1e54c05c6d10c9d63751f508587",35,35,0,35,35,0,1,2
"16587","7363877463761c947c3229d8f3f160cb",55,49,36,10.6944444444444,38,17,2,1
"16588","736612c08c61fd75c89612af03cec25d",13,13,0,13,13,0,1,2
"16589","73678744ed11cee5f4ffc0088a638d21",101,66,71,9.95774647887324,101,0,2,3
"16590","73680accf3359e012f980ce5f0c6b465",6,6,0,6,6,0,1,2
"16591","736917a2b4b8e2c75f4af09594b7299e",83,61,54,10.7592592592593,63,20,2,1
"16592","7369a664040655eb7bc4fbde3d39e2f1",15,15,0,15,15,0,1,2
"16593","736ab81e393c999aa5bd035951395512",47,47,0,47,0,47,1,2
"16594","736d8ae85f23a8eebb7e77dfe161b09a",42,42,0,42,42,0,1,2
"16595","737879508eed24eb9541f19bfabbd317",21,21,0,21,21,0,1,2
"16596","737aad21fa21ed5aaadde7432ac04bad",146,69,75,13.6266666666667,146,0,3,3
"16597","737e6923cb1fbb9c699c3c032f54cfc6",24,24,0,24,24,0,1,2
"16598","7380c7fc7741a41f33a83f558f724137",43,40,25,12.04,18,25,2,1
"16599","738563c25d892a812a1e013cc27ca9cf",67,52,51,9.19607843137255,34,33,2,1
"16600","73856eee6cda53174acfdf817946dcb6",44,18,62,4.96774193548387,44,0,2,1
"16601","73876a24da268022512b8a0db29cd874",14,12,14,7,14,0,1,1
"16602","738992bdf03f58fa7bd8a5d57c7a1916",125,44,77,11.3636363636364,117,8,3,1
"16603","7389a151826d8da19623e97895a1d7d5",88,57,32,19.25,88,0,2,3
"16604","738abcdd5e8a3eb382dc3d47209843a5",24,24,0,24,24,0,1,2
"16605","738e71c6df9bdb570af00cb8fa229129",166,105,29,40.0689655172414,166,0,3,3
"16606","738f5b105129f1b1d7747f616e6004d1",1,1,0,1,1,0,1,2
"16607","73904c7fcd930c0dde227a5db315965a",35,35,0,35,35,0,1,2
"16608","7391ac64255cd0c0d0d00611c4a00f51",75,64,71,7.3943661971831,62,13,2,1
"16609","7392395d4aa27c89842823a73696d36d",103,69,29,24.8620689655172,103,0,3,3
"16610","739323b6f29ca7d03bbd4114994a9782",32,32,0,32,32,0,1,2
"16611","739328d4a0cd7df18089e99aceb09e1e",122,85,60,14.2333333333333,94,28,3,1
"16612","7393b3a4c4639000764cdb0342795ac4",2,2,0,2,2,0,1,2
"16613","739adcef3a0d5c28e06d90d2ef298098",137,94,42,22.8333333333333,137,0,3,3
"16614","73a1aded082f528eb61006e437010641",22,22,0,22,22,0,1,2
"16615","73a2172dabf5c00d2dc4b9a59e1bcb92",21,21,0,21,21,0,1,2
"16616","73aad8bb73601e3cf20c68508ad9deea",43,36,21,14.3333333333333,43,0,1,1
"16617","73ae6383837ecf0bdd209631af2d5e10",57,34,20,19.95,57,0,1,1
"16618","73ae7d18d40d097af72ff7256566a056",51,40,80,4.4625,51,0,2,1
"16619","73af9e0059069fb566e5e7c67d76e965",172,92,69,17.4492753623188,172,0,3,3
"16620","73afa6c82af504da57effb614d63525b",30,30,0,30,0,30,1,2
"16621","73b002308e33ac259e551f016cb7e9c3",36,36,0,36,36,0,1,2
"16622","73b007157317c312c5278e047f40ec82",31,31,0,31,31,0,1,2
"16623","73b0d9170dc3281662315d1e2dabbe02",45,42,48,6.5625,45,0,2,1
"16624","73b1b1b9c083250b5e54206b9e598ac8",8,8,0,8,0,8,1,2
"16625","73b2497bf58f9e5be628c1507011e188",33,16,84,2.75,19,14,2,1
"16626","73b30963b3f0f1d655bafe37f5cc89e9",107,76,79,9.48101265822785,107,0,3,3
"16627","73ba7d5ee40c85381e2c42e8917f6a09",38,38,0,38,38,0,1,2
"16628","73bb9a77a2a68ae7c36163ce696f7b29",107,79,37,20.2432432432432,56,51,3,3
"16629","73beb6eb15f79a67fbe626626da19936",14,9,60,1.63333333333333,14,0,2,1
"16630","73c0a0e58c4bf1be5e7e0d129bcef47d",201,84,63,22.3333333333333,177,24,3,3
"16631","73c37b80ee254a70c97c540d2eb564f6",102,66,69,10.3478260869565,102,0,2,3
"16632","73c4cd1840a8d61c18a60180d6f12846",13,6,50,1.82,13,0,2,1
"16633","73c58fd05564b4b9836762cb0a053094",11,11,0,11,11,0,1,2
"16634","73c732e0c377c1dca74dfac6324108c8",20,20,0,20,20,0,1,2
"16635","73c988d4d74df4ab0941c0c6b88f413a",20,16,65,2.15384615384615,20,0,2,1
"16636","73ca45a8044e27d9bc6d6fd1e23fb9db",52,52,0,52,52,0,1,2
"16637","73ca73779ae7b65ce53ea59bcaf02196",3,3,0,3,3,0,1,2
"16638","73cbdcc684c659e7d06ae251a0251a62",9,3,28,2.25,9,0,2,1
"16639","73cf0a45b6186f44b2a52206b5cb11ee",23,23,0,23,23,0,1,2
"16640","73d2e663b964a3894ae41179f4bd0d7c",25,25,0,25,25,0,1,2
"16641","73d31886d2a18a57f8512a604263fe45",34,34,0,34,34,0,1,2
"16642","73d5d2127e522e4e3dbb2589dcc746d1",79,56,61,9.0655737704918,79,0,2,3
"16643","73d94fcef88b15b4db45733cc0ac2e23",38,38,0,38,0,38,1,2
"16644","73d9fb40a551d50a43aa6a2e211465e9",86,53,53,11.3584905660377,52,34,2,1
"16645","73dbadb471db1add2f73c48014b3322e",168,80,70,16.8,140,28,3,3
"16646","73dc5f91733d7a1c687812533ba2f12e",138,76,63,15.3333333333333,138,0,3,3
"16647","73debd7ed73020832a9a0521bdd2614f",20,20,0,20,20,0,1,2
"16648","73e84e3cacc81e4ddb6d710b68a4298d",37,24,76,3.40789473684211,37,0,2,1
"16649","73ea544298181b5c84afa670b1c97b6b",26,20,64,2.84375,26,0,2,1
"16650","73ead9db6a91f055ff052cb4114c5a74",69,53,44,10.9772727272727,69,0,2,3
"16651","73ebb42e3cb03909d53b2225d6930261",139,62,75,12.9733333333333,139,0,3,3
"16652","73ed78cc9f0da2287d3f74c1ffa5be0f",35,24,60,4.08333333333333,35,0,2,1
"16653","73ee3cdc9101a351ec0ed8d11da7aaec",153,85,79,13.5569620253165,153,0,3,3
"16654","73eed64197c932cea1b1f08909547195",57,53,35,11.4,57,0,2,1
"16655","73f119ac71f0ede21e2eb4e5c03f2ae0",87,64,42,14.5,87,0,2,3
"16656","73f2420ab54f06d899dc17bb49450ec6",95,56,50,13.3,95,0,2,3
"16657","73f40019e5f03ca03c6fa1b6a07b195e",29,29,0,29,29,0,1,2
"16658","73f5a654091b2520744ec233438d8d93",120,80,55,15.2727272727273,120,0,3,3
"16659","73f6c686c96cf7a001a679dc24c8c3db",156,59,85,12.8470588235294,156,0,3,3
"16660","73f8c2181b6864817a14b3ab49a1d1df",97,52,74,9.17567567567568,97,0,2,3
"16661","73fa6d1683512064c5eac474d5e826ff",96,67,38,17.6842105263158,96,0,2,3
"16662","73fabfa65cb968dbf3fa13c19f872c4c",72,50,82,6.14634146341463,72,0,2,3
"16663","73fb797405c1fce42a2542e11fdae6c2",16,16,0,16,16,0,1,2
"16664","73fb93b6b765cf8c032e694b096710c0",58,52,39,10.4102564102564,58,0,2,3
"16665","73fc4eca4efb60037848df1122b77f4a",62,47,16,27.125,29,33,1,1
"16666","73fe2440536dbb14bfad7057de847233",75,64,39,13.4615384615385,75,0,2,3
"16667","73fe3dec6b5e85a6777bf51c9ec03a02",18,18,0,18,18,0,1,2
"16668","73ffb3f3349acc6e5bf565a07c815293",94,72,25,26.32,94,0,3,3
"16669","73ffba1e759273c0c94aa06617679d9f",93,72,45,14.4666666666667,60,33,2,3
"16670","7400480cf26f69181bb6f1da290ac827",79,51,59,9.3728813559322,53,26,2,1
"16671","7402bd0be89c393d92091522be35e496",57,53,22,18.1363636363636,57,0,2,1
"16672","7402de247138adcfe00b3a13127c2b8d",11,11,0,11,11,0,1,2
"16673","74048282d57cfce02b1e4b6023bdc67c",67,45,65,7.21538461538461,56,11,2,1
"16674","7404881365f1765a0c98603603595b46",70,45,48,10.2083333333333,70,0,2,3
"16675","7408274156757543739d83e1844c834b",135,63,69,13.695652173913,135,0,3,3
"16676","740b69637cd863bebcbbef263c07d4af",99,69,56,12.375,99,0,2,3
"16677","740d12548679c0c1f1762682ad14863a",40,40,0,40,40,0,1,2
"16678","740e6109297409d9d3fbafd7be1dcc29",31,31,0,31,31,0,1,2
"16679","740e864456767b826b68b9d6f714fab2",62,51,76,5.71052631578947,62,0,2,3
"16680","7411fe2df604a2e0dcedd0bf70898efc",121,85,82,10.3292682926829,121,0,3,3
"16681","741328deab0edbb06a7da577198b3900",30,30,0,30,30,0,1,2
"16682","741409694b8079df55816f559d347fa9",31,31,0,31,31,0,1,2
"16683","7415dfb6aba7fa44a05378ac5ab97764",38,38,0,38,38,0,1,2
"16684","74188f14f499a4611e3ea5f699d431c8",149,110,54,19.3148148148148,98,51,3,3
"16685","741b82f78e7275f9699a6bca26ebcb33",18,17,12,10.5,5,13,1,1
"16686","742032d3fd6edd8498712536611bc811",70,58,44,11.1363636363636,70,0,2,3
"16687","7421f37a13a129cd75973934c733e2bf",53,53,0,53,0,53,1,2
"16688","74223d4c9edb693d1225ea5d0c3909e8",218,125,81,18.8395061728395,201,17,3,3
"16689","7423dcc5179ca8ccbdcefbd6527c3b8f",18,18,0,18,18,0,1,2
"16690","7424e89d2b36a5054ae40dc601205a43",65,54,48,9.47916666666667,65,0,2,3
"16691","742604a9b7dc5c1a11d929af266bde09",33,33,0,33,0,33,1,2
"16692","7427e990be2c19db4d88b57a31e0e44f",46,46,0,46,46,0,1,2
"16693","7428ee7b3044e69a0c4dc8954cee1ad6",1,1,0,1,0,1,1,2
"16694","742b8f75e9c27c0a01a055b941a5630d",24,24,0,24,24,0,1,2
"16695","742cdd9faffcb1702fbd30827a14bac7",233,128,53,30.7735849056604,191,42,3,3
"16696","742ff7191e14b761a8e0a641c27b9b8a",27,27,0,27,27,0,1,2
"16697","7437539465cf63c574bca86cd63be48a",42,40,17,17.2941176470588,42,0,1,1
"16698","7437af59a5c0d83b92d1d61824e49841",84,37,64,9.1875,84,0,2,3
"16699","743803db3312132fa46fec55c0b44d0a",159,129,38,29.2894736842105,159,0,3,3
"16700","7438d4f08a4836c198310e818ea9747b",50,40,44,7.95454545454546,50,0,2,1
"16701","7439bdb4662cc2940dc7812092009012",22,22,0,22,22,0,1,2
"16702","743b14c39fe28fe6b34a98b34825e680",99,53,60,11.55,99,0,2,3
"16703","743d0e2f6aeae79757dc5b7de9276c04",42,40,82,3.58536585365854,42,0,2,1
"16704","743d4bc54bd47bb3f5d7d4af0f130383",71,47,47,10.5744680851064,41,30,2,1
"16705","743d9628074e7e7d5542050b52c118bf",1,1,0,1,1,0,1,2
"16706","743ee2db90c7fbff1ef5ef8562daa2ba",97,59,83,8.18072289156627,97,0,2,3
"16707","7443f71dfb7cf875294651517353eaac",161,114,50,22.54,161,0,3,3
"16708","74455c1b4799150aa938f9a72540e92c",36,32,25,10.08,36,0,2,1
"16709","7446d874d3a03751d35d8986e5c457af",174,97,84,14.5,174,0,3,3
"16710","7448b6a794bc5bb7033034ad365be3f9",165,78,43,26.8604651162791,116,49,3,3
"16711","7449f6897910c60883bd30d70cea0be8",82,62,21,27.3333333333333,82,0,1,2
"16712","744b43ab3ba019b3c9c0f0413e582f45",152,100,56,19,118,34,3,3
"16713","744cbadf67a07c16622fdf3ac8a9fb15",25,25,0,25,25,0,1,2
"16714","744f6202fddc8731b57b679a50687e28",24,24,0,24,24,0,1,2
"16715","745128ae7298fdf2c79d0662f148a03c",22,22,0,22,0,22,1,2
"16716","74513aff50c045d9fdbd9f5a85e7f518",7,7,0,7,7,0,1,2
"16717","7452f71a67c9a0ba3fcb9d1d1f484a7b",57,41,48,8.3125,57,0,2,1
"16718","7453ed579558b0e40338e58e3ea656f3",23,23,0,23,23,0,1,2
"16719","7453f5ddc996f77b99452dd5265d827c",51,43,47,7.59574468085106,46,5,2,1
"16720","7458db50133252a4bdbc79a50706c2db",49,39,64,5.359375,37,12,2,1
"16721","745aa129d450d3bd7e157aea6868dccc",6,6,0,6,6,0,1,2
"16722","745aaf961d498a74093cdc3d35c6f32a",9,9,0,9,9,0,1,2
"16723","745b60aa1b985003e6f09a1ef33ee751",13,13,0,13,13,0,1,2
"16724","745f0e96cb3642a6a3fce4c8a7e412f4",64,52,29,15.448275862069,64,0,2,1
"16725","745f4d45265e038dd2878dbdb0df9b22",48,48,0,48,48,0,1,2
"16726","745f62ed302626561f4a2514a53ff260",40,33,27,10.3703703703704,40,0,2,1
"16727","7460c5a2aa1dce1ce715ef6533ff598f",97,79,27,25.1481481481481,97,0,3,3
"16728","7460fb48f079ab9f9596fb0e57f801e1",37,37,0,37,37,0,1,2
"16729","746139a8657fbc2273ce8d41289e7388",60,45,32,13.125,37,23,2,1
"16730","7461a7c6a13d5f168be208215d470232",87,68,58,10.5,56,31,2,1
"16731","7462ddf7a346df598a525bcae0afab23",160,105,55,20.3636363636364,160,0,3,3
"16732","746339786b13d141204185cfb3e69779",113,73,70,11.3,113,0,3,3
"16733","7463b446371e066e8e7b61dd6fba8be7",30,30,0,30,30,0,1,2
"16734","7463d5d424859662ddaa661d8263a935",92,80,33,19.5151515151515,92,0,3,3
"16735","7467f96631ca1ec5da8a95eacda29887",10,10,2,35,9,1,1,2
"16736","74699ce79b69fe9f2a0ad926fc3ee59e",28,27,7,28,0,28,1,2
"16737","746f39f7b4c98fba201441b9c6e01df9",104,68,62,11.741935483871,104,0,3,3
"16738","7470f2cf5eaab07f70f2a9d69cf2c4d6",40,40,0,40,40,0,1,2
"16739","7472b761e1feb83672c0cebe23d7961e",56,44,21,18.6666666666667,56,0,1,1
"16740","747307101d3dbf7bdeb033809c78e276",17,17,0,17,17,0,1,2
"16741","74751a88d01b8663c96562b22a80186e",26,17,61,2.98360655737705,26,0,2,1
"16742","747628bbe9a60f2ba3f01be41234c1a7",91,60,49,13,40,51,2,1
"16743","74774560124781e1b1cb2ba739f9645d",140,78,60,16.3333333333333,140,0,3,3
"16744","74774a706527deb2f013f984081bba90",15,15,0,15,15,0,1,2
"16745","7477d04e26fb2652777ff780c291de89",63,33,67,6.58208955223881,63,0,2,1
"16746","74782e0d1f87720658aba7e513069c24",16,14,2,56,16,0,1,2
"16747","7478b0981b7896e9740d7233b76e952e",70,51,49,10,70,0,2,3
"16748","747931502ee32ba59f5af3ccce854ccb",20,20,0,20,20,0,1,2
"16749","74829a3b38e470ba45fb48a9a8c04806",38,38,0,38,38,0,1,2
"16750","748307fce128f19f19bb3566b4b6aa8e",63,33,53,8.32075471698113,41,22,2,1
"16751","7485758c32584ad598555894f3c63c98",86,64,18,33.4444444444444,60,26,1,3
"16752","7485f88d71ff99a90f924e572da6cbf9",93,67,14,46.5,93,0,1,2
"16753","748867e1508ab6100a23e2fa05126627",111,80,64,12.140625,111,0,3,3
"16754","74890df807077cd746c9289ea1e70e0a",142,81,78,12.7435897435897,142,0,3,3
"16755","748c574a620e7e3d7525cea6904c9e08",10,10,0,10,0,10,1,2
"16756","748c8b3538e9d5fc615a73d0d3fb4d57",35,35,0,35,0,35,1,2
"16757","748ea8a4182fbf9f571c194cfb4fddc7",57,41,57,7,34,23,2,1
"16758","749074491c658045add3849b9bdfbc9f",19,19,49,2.71428571428571,0,19,2,1
"16759","749294c7fe607dce17ea3bd4fc20b0ce",156,92,55,19.8545454545455,156,0,3,3
"16760","7492a9a52392e4539b341fa2bc21b774",14,10,42,2.33333333333333,14,0,2,1
"16761","749540049ea1f37ef157fe5039224ed8",76,53,61,8.72131147540984,47,29,2,1
"16762","7498198975932b0f031ebe5a03aaabab",34,34,0,34,0,34,1,2
"16763","7499267fb702eddca2d48372b89b34f4",49,49,0,49,0,49,1,2
"16764","7499d20cc74209bc45207fbe1043d30a",82,64,32,17.9375,82,0,2,3
"16765","749b9f8895fed0aedf279d26587641cc",43,43,0,43,43,0,1,2
"16766","749cce59e19be25c352cace878d4ce22",11,11,0,11,11,0,1,2
"16767","749d92b8bdd7097b087543bca7fd6a29",136,85,78,12.2051282051282,136,0,3,3
"16768","74a166f2c3b85a9fc3a8bc0ebe0bcd93",132,75,54,17.1111111111111,132,0,3,3
"16769","74a2756fc09a302b3bb0532f8f8e911e",21,21,0,21,21,0,1,2
"16770","74a28152c7db2e3b9072466ccdbd9626",128,87,74,12.1081081081081,128,0,3,3
"16771","74a44e56db6b4c7dbbd0e95480b5a468",176,83,72,17.1111111111111,176,0,3,3
"16772","74a45d6c4954a57d4277f3380ff32fd8",95,72,45,14.7777777777778,95,0,2,3
"16773","74a481bb49fab15900e0656b2638f2cd",26,26,0,26,26,0,1,2
"16774","74a564144b84d9e54dbaa3afc60ade46",119,107,84,9.91666666666667,119,0,3,3
"16775","74a5f7dffecbcc23a866046aad379087",27,22,48,3.9375,27,0,2,1
"16776","74a9befa15492bfcfcf7c9487687d1c6",40,40,0,40,0,40,1,2
"16777","74aa8182ad5a0201d6cefaaf54ecbd65",42,38,57,5.15789473684211,42,0,2,1
"16778","74aaca3fca0de5013f5f7b99bd4e483d",25,25,0,25,25,0,1,2
"16779","74ab9c395121ebc2e7631bcdfaed8f3b",48,48,58,5.79310344827586,2,46,2,1
"16780","74af38490dc6bb9ef9c8850eaced0d13",36,26,43,5.86046511627907,36,0,2,1
"16781","74afee54cb7a0eece704892fb8f8af1f",126,92,70,12.6,126,0,3,3
"16782","74b6b4a9e24ee692d39166fefd4d39da",226,99,66,23.969696969697,192,34,3,3
"16783","74baf7fafbfdbfb19d27ff835529f394",46,37,45,7.15555555555556,46,0,2,1
"16784","74bb13121b68d2c4fbe4b70993e14344",80,50,54,10.3703703703704,80,0,2,3
"16785","74bc221b40ba34c43a57b78e6777a880",89,67,35,17.8,89,0,2,3
"16786","74bf2e50f80b0b14082a7cbd27650d38",197,73,79,17.4556962025316,175,22,3,3
"16787","74bff60049a5829cd506ba74e74ba9b8",36,36,0,36,36,0,1,2
"16788","74c04818ff82d2c0704d48a354df8037",16,16,0,16,16,0,1,2
"16789","74c23cbfa353bced5c37929d89800da6",36,15,64,3.9375,36,0,2,1
"16790","74c251c02803cf64697bd72f98fd97d0",27,24,83,2.27710843373494,18,9,2,1
"16791","74c3f1d47dfaf5083c04d51f50f1cb6a",19,19,0,19,19,0,1,2
"16792","74c68e0f706b96c874a9d2493301901d",26,25,4,45.5,26,0,1,2
"16793","74c9e1c90765675d3aa8bc60ac13ac0a",189,89,84,15.75,189,0,3,3
"16794","74ca13507663d2b11fb991396d22d236",7,7,0,7,0,7,1,2
"16795","74d19c06e9ff7c26881997862596bcfe",28,28,0,28,0,28,1,2
"16796","74d1ad6cd4c129188a07bd6ee7aae17f",21,21,0,21,21,0,1,2
"16797","74d1c673600701fcdc7d84d0b3b3b6c9",34,34,0,34,34,0,1,2
"16798","74d2fd48868866a76864940a7cbf4c41",15,15,0,15,15,0,1,2
"16799","74d40b56f243f5e795dcd07fd6813af6",29,29,0,29,0,29,1,2
"16800","74d43ef1bbdaeb80560eaaf9ce137018",70,59,69,7.10144927536232,70,0,2,3
"16801","74d508bc8ebea343f0043b8db2f3a356",8,8,0,8,0,8,1,2
"16802","74d82ce47b2fe4fca70710b41c6449da",7,7,0,7,7,0,1,2
"16803","74d893e67a127193ccc08309e57dd87f",49,43,50,6.86,49,0,2,1
"16804","74d8bc77378fd597afca9c5c7cb993dc",3,3,0,3,3,0,1,2
"16805","74dd006cf8f8a95dd52628b8c70a4035",31,31,0,31,31,0,1,2
"16806","74dfb7728a2f55a259cd9b12880d226a",31,17,82,2.64634146341463,31,0,2,1
"16807","74e3c58d5c0cb4fa2894aee86da0c271",101,47,40,17.675,75,26,2,1
"16808","74e4088919adca326400a6d74d0f5729",142,94,37,26.8648648648649,142,0,3,3
"16809","74e76b90d246f7c5bf23fd603630353e",15,15,0,15,15,0,1,2
"16810","74ed04cda08d6ffb150da8a6b39da9ca",129,99,78,11.5769230769231,106,23,3,3
"16811","74ed1c6d96236054b44ae30959eeee47",38,38,0,38,38,0,1,2
"16812","74ed65dfbe65d570392da30dc8bce2c8",121,89,51,16.6078431372549,121,0,3,3
"16813","74f02ef962ea4b1c91c558f4dd6b0959",35,29,49,5,35,0,2,1
"16814","74f0b0ccb283ab2d3ed42254ae0af9ab",15,15,0,15,15,0,1,2
"16815","74f2eea6ae6d444fb24fac4f151ff3d5",49,29,78,4.3974358974359,49,0,2,1
"16816","74f52f46f08a63e7ca8a5ce187fa4dcf",19,19,0,19,19,0,1,2
"16817","74f99043d165cc9610b7c1f204fad868",63,53,16,27.5625,63,0,1,1
"16818","74fc6356c8e286b374200fb2b3ac18ff",31,31,0,31,31,0,1,2
"16819","75008363b52a9de1a95e06dea9eae167",32,24,49,4.57142857142857,32,0,2,1
"16820","750128ed76e1a9d802930408cd4c7d4f",13,13,0,13,13,0,1,2
"16821","7505a3f1caad885f5d67f210c503037a",115,66,50,16.1,115,0,3,3
"16822","7507fe146bc0797905e9b5500fcbff3c",221,98,73,21.1917808219178,198,23,3,3
"16823","750df0c42d0112f1138472355944e008",74,59,65,7.96923076923077,74,0,2,3
"16824","7510009b81bdb75066b301ea115ed45c",23,23,0,23,23,0,1,2
"16825","75110c0189a8def1e4b0084c294d88c8",4,4,0,4,4,0,1,2
"16826","751152c05551d2fc5ded84c60d010b11",74,66,12,43.1666666666667,74,0,1,2
"16827","7512c62469f7de240ab94658de12e7e2",14,14,0,14,14,0,1,2
"16828","75146542ead2a92d499b0c1bab518187",17,14,35,3.4,0,17,2,1
"16829","7515c8c5ec29c3962436e4ea91001330",22,22,0,22,22,0,1,2
"16830","751748356293cde5e8f78d233afb696d",51,45,65,5.49230769230769,30,21,2,1
"16831","751a97c9a62240af6550146b9e9c4571",2,2,0,2,2,0,1,2
"16832","751b853ac89f1abf5a80d8b6f84c111f",35,35,0,35,35,0,1,2
"16833","751e179c2a5876b68b6e248bf0ca02a4",35,35,0,35,35,0,1,2
"16834","751ed526caa8a1f03754dae894a6d888",54,47,18,21,47,7,1,1
"16835","752137a45f9247e041c0c044fac357ac",37,32,72,3.59722222222222,37,0,2,1
"16836","75219562e8379a3569228a64c037beee",79,48,57,9.70175438596491,33,46,2,1
"16837","752520da81b8f435bb84e49af7a6e060",41,33,31,9.25806451612903,41,0,2,1
"16838","7526da9fb6a5cb1f2bb82fa2dc31e2b1",126,95,59,14.9491525423729,126,0,3,3
"16839","7527b64d99e2f0ac54bd2c9f6bd381ef",2,2,0,2,2,0,1,2
"16840","75292841474e467ba8e85a720d5dac7b",34,34,0,34,34,0,1,2
"16841","7529a538aaa3b61c3a8108a8f774321e",19,19,0,19,19,0,1,2
"16842","752a6265937f3adb515cf71646012cbc",41,39,54,5.31481481481481,22,19,2,1
"16843","752c2a265989f74c2276681203c136ed",48,43,25,13.44,48,0,2,1
"16844","752cd137bd4d3e32cdf23ac4dedc915f",25,19,56,3.125,0,25,2,1
"16845","752d78d9d1e81d6ba378f41b95377a8c",59,43,37,11.1621621621622,59,0,2,1
"16846","7531a5edc490ff03385a88b877ee4a0a",106,66,49,15.1428571428571,106,0,3,3
"16847","7531f36f8c2ec9686839e46350b192f9",51,41,48,7.4375,51,0,2,1
"16848","75322934a3a93286a20cb7aec60d906e",82,56,41,14,82,0,2,3
"16849","7532748257c98486d2639f31bd42a602",86,57,46,13.0869565217391,49,37,2,3
"16850","75347394973fc05774740474ad35f63d",55,45,21,18.3333333333333,55,0,1,1
"16851","75368d0ff448ee3eeaa1d4085c1f3b84",84,52,77,7.63636363636364,84,0,2,3
"16852","7538ee9c6d9d561f28543f4370e02440",84,71,22,26.7272727272727,84,0,2,2
"16853","753ad1769e1a001af2f4276f4a95df3e",3,3,0,3,3,0,1,2
"16854","753d17c1c34f3e23a784c785d7489fc8",2,2,0,2,2,0,1,2
"16855","753df1c8ce8145d3298d9de8ffb8ed8b",148,122,58,17.8620689655172,105,43,3,3
"16856","753ead512ed25ac270a59b25b98bfc07",13,13,0,13,13,0,1,2
"16857","753f4404cd11458e014066511f1ae6f6",9,9,0,9,9,0,1,2
"16858","753fdea14b99c25e440abd8dd7961054",20,20,0,20,20,0,1,2
"16859","7540242f9a39728015e14fa74be6bef6",41,41,0,41,41,0,1,2
"16860","7540d139131817cc34210b85edf0008d",96,69,60,11.2,96,0,2,3
"16861","75417161f288faf37d0ca064678505df",24,24,0,24,24,0,1,2
"16862","7542403951fdc60c7970e821239e6fe0",14,11,70,1.4,14,0,2,1
"16863","75426c8ca610ca9026e545297ba0fb67",28,28,0,28,28,0,1,2
"16864","7543a0216d213919d04348e4b91eb7ac",55,45,61,6.31147540983607,55,0,2,1
"16865","7543e4fe33c9e3eede5135f1ca149795",44,44,0,44,44,0,1,2
"16866","754585f2c428de5a135c2e58b5a31622",159,43,73,15.2465753424658,139,20,3,3
"16867","7546db65623635c1a2e0f34662c8106d",1,1,0,1,1,0,1,2
"16868","7547759081536ec06b9d5eeb3f56aafa",16,16,0,16,16,0,1,2
"16869","754acf036616c6eece5d19ed7ce5f958",60,44,44,9.54545454545454,30,30,2,1
"16870","754e559f6f3326d68b7fc78d17cb0cd7",97,45,63,10.7777777777778,97,0,2,3
"16871","755414371adaa5c0abea5bfa94454d25",105,71,29,25.3448275862069,105,0,3,3
"16872","75567bd6c0ae24e55d0215dcec09ad20",178,71,88,14.1590909090909,178,0,3,3
"16873","7557cbc9b35cf6e29a5fc003fef61d72",103,69,28,25.75,103,0,3,3
"16874","755bf2f665701cb3be89627865db2936",18,18,0,18,18,0,1,2
"16875","755dbd1eed76fa181f9de23190fc0d44",117,77,62,13.2096774193548,117,0,3,3
"16876","755f4b111102956d6a57bdb11a51ddc5",88,58,76,8.10526315789474,88,0,2,3
"16877","755fb36b1b55a21d832948d0fe081338",117,69,87,9.41379310344828,103,14,3,1
"16878","755ff62550bb8dbe8049c7134b4bf94f",85,65,32,18.59375,85,0,2,3
"16879","756161865e228280ddca73552524f793",174,81,74,16.4594594594595,142,32,3,3
"16880","75618131f7b98edc43881f075248a221",76,44,56,9.5,76,0,2,3
"16881","756193738997a8fb3d5f8741a2ab0888",199,82,59,23.6101694915254,167,32,3,3
"16882","7565aa1daf431b69053ce9f7b26f0691",34,28,5,47.6,19,15,1,2
"16883","7566929d42e836694dd4e3c6ae823517",22,22,0,22,22,0,1,2
"16884","75682dd23b6c8796e06481eadb6e99fb",49,49,0,49,49,0,1,2
"16885","75696c09c8452e588b2894c3bc588287",111,69,49,15.8571428571429,111,0,3,3
"16886","756a4606a526ffb3bbccdc4e88ff8b26",40,34,30,9.33333333333333,24,16,2,1
"16887","756a5c1d233e25b125a9e8f454e438e6",202,82,82,17.2439024390244,170,32,3,3
"16888","756d054eda566e53f90f44ff64f01a8c",39,39,0,39,39,0,1,2
"16889","756da13d813cf64166fb21ff36ad1bb1",67,41,51,9.19607843137255,67,0,2,1
"16890","756fe893aa47e803eea4cf3728620df0",37,16,77,3.36363636363636,31,6,2,1
"16891","757004838f346af27cfcbf35b63cc4f3",71,59,28,17.75,71,0,2,1
"16892","75700f42c41caaf118398948bb7ddde5",19,19,0,19,0,19,1,2
"16893","757736ea38ddad729bf33f81c2cbb41e",93,76,72,9.04166666666667,93,0,2,3
"16894","75784bf0e403cd692a1005b2a111afdd",121,76,66,12.8333333333333,71,50,3,3
"16895","757a0d997222171dfdcd2b8d6062e757",127,65,79,11.253164556962,101,26,3,1
"16896","757d5900696c3b379294777e05c04fef",31,31,0,31,31,0,1,2
"16897","757e3009a093524868753cb03491b72c",37,37,0,37,37,0,1,2
"16898","757ef5fbae8852934e3cdad2fe4e1bcc",103,60,67,10.7611940298507,54,49,2,3
"16899","75800f4c47532665f08f9b27d9ae660d",50,39,45,7.77777777777778,50,0,2,1
"16900","75806fa4838c334d8e7d87a6f850f218",54,54,0,54,54,0,1,2
"16901","758664d92fe26d71ed15385b00bd5458",30,30,0,30,30,0,1,2
"16902","758ada9660498bbb2379a31d0523f56b",211,125,89,16.5955056179775,171,40,3,3
"16903","758b9ff673dd59d5231e501c9b1b683f",23,17,63,2.55555555555556,23,0,2,1
"16904","758e929432776b6af51bbbe04282233c",70,43,56,8.75,70,0,2,3
"16905","758eaad588fbee10f16316b4c7e4741c",157,81,64,17.171875,157,0,3,3
"16906","759082d71a1dedbb85d8856f4e2d7682",8,8,0,8,8,0,1,2
"16907","7592304e46ce66d675d3a8c0fe81e3ae",135,80,52,18.1730769230769,101,34,3,3
"16908","759321ba7b593297a52abe78c408a46e",92,42,60,10.7333333333333,92,0,2,3
"16909","7593c390f3de91955f6eb191154bb574",34,34,0,34,34,0,1,2
"16910","75946b85a7f0fcde5ef58fb5efce00b9",16,16,0,16,16,0,1,2
"16911","7594fc9855b619a3dfcaf2b059775d48",141,66,62,15.9193548387097,112,29,3,3
"16912","759616c9184ac3e9cc19b04402b5c06c",18,18,0,18,18,0,1,2
"16913","75961cb1e79398c8f8e4b1ec92a61796",18,18,0,18,18,0,1,2
"16914","759bc99673b46a528e3c6a069e5ce53a",144,60,81,12.4444444444444,144,0,3,3
"16915","759e4ab00739c7e7ff42253542b50cb8",82,62,69,8.31884057971014,82,0,2,3
"16916","759f91642f7f386d881ad8833bbc6aeb",12,6,21,4,12,0,1,1
"16917","759f91df5edd9c7529e259e6c9acc7f8",92,67,82,7.85365853658537,92,0,2,3
"16918","759fefbc66a90b6ece106b871bce378a",200,103,63,22.2222222222222,200,0,3,3
"16919","759ff57c39e4268effc808d455a90cd1",98,55,65,10.5538461538462,53,45,2,3
"16920","75a0b5f204f96cb3420b6333c7a2dc16",11,11,0,11,0,11,1,2
"16921","75a1cc732941b62fc25e466269195297",45,33,40,7.875,45,0,2,1
"16922","75a478160807aca9ff004c0aad1df50d",51,45,10,35.7,23,28,1,2
"16923","75a7c57695eff8b2bd3fc57eafb4d1d6",32,32,0,32,32,0,1,2
"16924","75aa5b150e3e24ce4fa3cb82cc265fbc",100,49,26,26.9230769230769,100,0,2,3
"16925","75aa7cb42af88a3bd71e95922c5ba527",84,51,83,7.08433734939759,84,0,2,3
"16926","75ab59230df721cef16f717ff68af0a8",42,42,0,42,42,0,1,2
"16927","75af2c5c470255bea4e4e08fe89168e8",161,89,51,22.0980392156863,161,0,3,3
"16928","75b07e3ace6b493133f64a420b5ac7ce",108,93,34,22.2352941176471,108,0,3,3
"16929","75b3875d66ab14b3a14c622cb77c71bc",1,1,0,1,1,0,1,2
"16930","75b3a7c8bc699e2bfe4a79c469403b54",13,13,0,13,13,0,1,2
"16931","75b5aff479f126a94ef112674db6e5d7",26,26,0,26,26,0,1,2
"16932","75b6f7ff34f62c9dea4791aaefe05144",17,17,0,17,0,17,1,2
"16933","75b89476ce9018c32d28cfc0d5f3e472",16,16,0,16,16,0,1,2
"16934","75bac216795bb28f4671a92cc720a68f",217,115,76,19.9868421052632,217,0,3,3
"16935","75baddb132f77beff96d1325c6acdd82",8,8,0,8,8,0,1,2
"16936","75bc9e0756ead2b2c76dbe94b59bab32",26,26,0,26,26,0,1,2
"16937","75bcb95cf88203ce3289d51f5549952a",29,29,0,29,29,0,1,2
"16938","75bdfff47908ff160af64eea60102395",51,47,11,32.4545454545455,51,0,1,2
"16939","75bfb8031136e554df3d93b88b0b7cc4",27,27,0,27,27,0,1,2
"16940","75bfde4dc6ea46dc8e1296e099be7463",108,89,26,29.0769230769231,59,49,3,3
"16941","75c17f2b15717d2ae596534c484cbd58",184,106,67,19.2238805970149,184,0,3,3
"16942","75c414cbae96dca0dae7ea6ec888cca1",43,43,0,43,43,0,1,2
"16943","75c4db9aef917e3511c5e62aed0bcd94",35,35,0,35,0,35,1,2
"16944","75c4e58e4e1304b8b1b9368ae7975b6f",29,23,84,2.41666666666667,17,12,2,1
"16945","75c754bfc24a34ea0eb969afeec390ef",113,70,49,16.1428571428571,113,0,3,3
"16946","75c7b51487b57a15ee0024338fd77144",19,19,0,19,0,19,1,2
"16947","75c939bbe6db08ebc4f25aeb1a5a2392",108,48,56,13.5,108,0,2,3
"16948","75cae631912d439dbd6c860a1ed1c7e5",80,79,28,20,80,0,2,3
"16949","75cb250e5171cc7edbdd174a4eb9a66d",70,52,30,16.3333333333333,70,0,2,1
"16950","75cb9497b8f21f83fe0e7074545271c9",20,20,0,20,20,0,1,2
"16951","75cc9d8b15a141800ad0ec29058d073e",72,54,19,26.5263157894737,72,0,1,2
"16952","75cccf5dac84f75c7331a3517d2cdb1f",124,84,51,17.0196078431373,124,0,3,3
"16953","75d1b910d70bbe611e92d4ff81d83c46",41,36,36,7.97222222222222,41,0,2,1
"16954","75d237454eb8ede0a7a5b368c0227d35",11,11,0,11,11,0,1,2
"16955","75d40c2b0a39386be474e551515a5dfa",59,52,16,25.8125,59,0,1,1
"16956","75d629a112ee271875b5e5f5c52d7718",142,115,49,20.2857142857143,142,0,3,3
"16957","75d81eed0b3bafa0c2ebaebe877c8129",163,109,78,14.6282051282051,122,41,3,3
"16958","75df70b28696d2346c966025b2d81557",154,73,62,17.3870967741935,154,0,3,3
"16959","75e45d50ecd43e70b74b2f85419ff39e",47,22,84,3.91666666666667,47,0,2,1
"16960","75e6b649a3652c285ecd6a7c84cbe7fa",205,116,86,16.6860465116279,205,0,3,3
"16961","75e87fea50a0e10c8fd9a2f99d10771e",109,69,78,9.78205128205128,109,0,3,3
"16962","75e994f2b9064f387c986528214e3bb8",14,12,52,1.88461538461538,14,0,2,1
"16963","75eba4ac0e57f62bbda824d9fbc7344d",70,56,55,8.90909090909091,70,0,2,3
"16964","75ede4d7a5094d9f4569fa73835962dd",135,73,54,17.5,84,51,3,3
"16965","75f0a970a9716d61934288c0f313d459",46,46,0,46,46,0,1,2
"16966","75f50887d100324ec0fa285dc06ac531",10,10,0,10,10,0,1,2
"16967","75f7acafae122c79354b9a400eb7eed8",24,22,6,28,3,21,1,2
"16968","75f88e331de62bc04a918f7d446396ce",163,101,44,25.9318181818182,163,0,3,3
"16969","75fd1c2c6b9271a583662236d048b4d9",73,56,40,12.775,33,40,2,1
"16970","75fd6fb8d2553ef63ba51b3c7acc3b8a",97,62,81,8.38271604938272,70,27,2,1
"16971","75fdefacc70e9c8bad68eb8a9afbe52b",54,46,14,27,54,0,1,1
"16972","75ffaa1b431d74621cbd8ac78e8e9c62",111,88,61,12.7377049180328,111,0,3,3
"16973","7601bc1260a43c5c5de9e53368c6c744",74,56,29,17.8620689655172,74,0,2,1
"16974","760254372c74f3a66ae7461bf4aa8d07",121,96,28,30.25,121,0,3,3
"16975","7602710d2412fe64218e6f6c93bf0578",30,30,0,30,30,0,1,2
"16976","7602bb870d2666d98b83231affef47f3",34,34,0,34,34,0,1,2
"16977","7602d923950fb662aa370305bc7d7a2d",156,85,70,15.6,136,20,3,3
"16978","76038c9c8d5c61d36927616f0f5df62e",202,107,71,19.9154929577465,202,0,3,3
"16979","76055f45a6e8f4435d463ae5e0b88d99",18,12,9,14,18,0,1,2
"16980","7606aafa0dd3f521e348961a6cfb8cfd",67,51,20,23.45,67,0,1,1
"16981","7606cb5608b2ce9ddf23eaee07a33493",21,21,0,21,21,0,1,2
"16982","7607936761f0285965aa0c62e64c999e",2,2,0,2,2,0,1,2
"16983","760a4187a6efd97591c0cd7613223126",135,90,76,12.4342105263158,107,28,3,3
"16984","760d418187935982c1608a423f0867ba",117,86,16,51.1875,85,32,3,3
"16985","760d8538a038e03896a0c4ef46cdcd85",135,83,44,21.4772727272727,135,0,3,3
"16986","76100b9dd75a2d1f48f8f075b35f6176",49,49,0,49,49,0,1,2
"16987","761012cf0b3d2bfff16780fbae4b6a6c",20,19,5,28,20,0,1,2
"16988","761374797b54ea78ee39764e09387da1",37,36,17,15.2352941176471,37,0,1,1
"16989","7615d73840b55dd0a162539a8fef8c15",15,15,0,15,15,0,1,2
"16990","7615e9ef67ed7e40e3ab9ad975a7dffa",95,78,42,15.8333333333333,95,0,3,3
"16991","761704971ce81b4cbbd281e235e1af3e",17,17,0,17,17,0,1,2
"16992","761ad05c5074ee7ce5a4c9724a4a58d5",7,7,0,7,7,0,1,2
"16993","761b6d7e4cc196b1a5c29e36d9c8cee5",54,51,37,10.2162162162162,54,0,2,1
"16994","761d23ead74b470a13485a8ac84e5f92",46,32,14,23,46,0,1,1
"16995","761fe2fc8637c893cee253e8d4aa10e5",72,52,76,6.63157894736842,69,3,2,3
"16996","7620effbb6f6d52bfd8b5fff9000c4ca",147,81,49,21,147,0,3,3
"16997","76278617d0b8283aabfd942cf969381b",22,22,0,22,22,0,1,2
"16998","762a90b0f44c13add50c2ea6b1880a2f",34,34,0,34,34,0,1,2
"16999","762c0c329e253968903badda99798f72",15,15,0,15,15,0,1,2
"17000","762c9cebc09bb1916c1310322e8f8c8c",12,12,0,12,0,12,1,2
"17001","7630d5608c5151f513288251b07b2ec4",138,92,64,15.09375,87,51,3,3
"17002","763588f65cc64a5a7af9e8406ee67518",20,15,55,2.54545454545455,20,0,2,1
"17003","7635f820f67875adc534d9cabd890897",107,76,39,19.2051282051282,52,55,3,3
"17004","76366c37ecdf96969134aa5f8649c988",69,54,78,6.19230769230769,66,3,2,3
"17005","76383f1527702c825d975e7390855a15",66,52,48,9.625,66,0,2,3
"17006","763a7318a060e43643b3d7bba03a6f51",73,61,55,9.29090909090909,73,0,2,3
"17007","763d725ae6d44be10ecc1133c4843c8c",2,2,0,2,2,0,1,2
"17008","76403b15454b185010e1be16ff020894",93,81,63,10.3333333333333,93,0,3,3
"17009","764408c5f134bf59d4cfb95420f2262b",38,36,10,26.6,19,19,1,2
"17010","7644681a5eaca1fa7c1df15de9867c77",23,23,0,23,0,23,1,2
"17011","76483b917150c9177d490e5d7438f794",83,59,63,9.22222222222222,83,0,2,3
"17012","76489bed70e3073cb0fbc92ceef529da",7,7,0,7,7,0,1,2
"17013","7649035fae9ac3c56443b766dd928ad3",25,25,0,25,25,0,1,2
"17014","764ab557a66ed8a97e0bebb0c27050d3",86,55,82,7.34146341463415,86,0,2,3
"17015","765297f1f2a7aeb7c243a7151129be7d",38,36,33,8.06060606060606,20,18,2,1
"17016","76539562121fec9d4c4b467b36678ed8",14,14,0,14,14,0,1,2
"17017","76543206e00fc8fea6c97c657f68c363",12,12,0,12,0,12,1,2
"17018","76545867d865e2290d6c639c36a19ee1",13,13,0,13,13,0,1,2
"17019","7656266035583aa6b0c49aa4adb79971",129,106,59,15.3050847457627,129,0,3,3
"17020","76565dec61c4585cf39002e4b4f69e46",76,67,11,48.3636363636364,61,15,1,2
"17021","7658cea546bff531aa8a5bf820b8ce51",59,44,24,17.2083333333333,59,0,2,1
"17022","76596a5b8da1628e427ec9dddc64e9c1",8,8,0,8,8,0,1,2
"17023","76598f2a3d0ee9f674a4780e76aee01a",140,97,61,16.0655737704918,140,0,3,3
"17024","765bab04e80d6e87737d547a3e34422d",134,79,77,12.1818181818182,134,0,3,3
"17025","765e03894af9eda1a36f2f2b7309f818",18,18,0,18,18,0,1,2
"17026","76602190038773af3fc453b457d45cbf",12,7,61,1.37704918032787,12,0,2,1
"17027","76607479c42e4d9651173a7dbff47c13",21,21,0,21,0,21,1,2
"17028","7661999a4f37a21e6bdcf04cca35236e",99,80,60,11.55,99,0,3,3
"17029","7662dcd24e922a73e64b60d3931e74f1",13,13,0,13,13,0,1,2
"17030","7663a56d31d6a224083dcffc78c170a2",31,31,0,31,31,0,1,2
"17031","7664d78e64e72b6df123df4e79e75672",76,62,14,38,76,0,1,2
"17032","7666da22717eefef98afbddcc21df218",11,11,0,11,11,0,1,2
"17033","76674cdc234b84a9cdfb8f2d390b0fb2",43,43,0,43,43,0,1,2
"17034","76679bcc18c60d88e0e7730ae1bc261a",37,29,44,5.88636363636364,37,0,2,1
"17035","766844223cd1242fc45b26bf7bd4cdf1",82,69,51,11.2549019607843,82,0,2,3
"17036","7668ca6d170a39992e0bc08ed83146b9",43,43,0,43,43,0,1,2
"17037","766b1db78b99f3efcc38bcc24db3b885",197,120,76,18.1447368421053,177,20,3,3
"17038","766e901e5b719123f13ef5b7bf23e9e1",39,28,45,6.06666666666667,39,0,2,1
"17039","7670c1b2f79a54ad972e90acc3999a99",171,100,56,21.375,171,0,3,3
"17040","7675844adf14022b10e2d62bb18dd8f0",109,89,43,17.7441860465116,56,53,3,3
"17041","7675b1475bac15b29bc83e9ade648d3c",23,23,0,23,0,23,1,2
"17042","767652171e743158fa7f5889462d267a",40,34,7,40,0,40,1,2
"17043","7678756068d0df54abf594a7f5afbceb",116,92,57,14.2456140350877,116,0,3,3
"17044","767914580fe7151cbe67329529b648a6",192,80,72,18.6666666666667,162,30,3,3
"17045","7679d853ae8a45adf9893b1da04f7750",54,46,21,18,54,0,2,1
"17046","7680920fb18bd311ea2d24d6b9d9d7e4",97,77,49,13.8571428571429,97,0,3,3
"17047","7680a64a9bca36cbf2d0b6b12f4796b2",11,11,0,11,11,0,1,2
"17048","7681b99c95ab4e6d3369d96f723faef9",5,5,0,5,5,0,1,2
"17049","76838281702ccd59ad8b37a3c3ea1db4",114,79,67,11.910447761194,65,49,3,3
"17050","768b70c8801c43736271efcbcb716773",82,75,36,15.9444444444444,82,0,2,3
"17051","768bdda0d28358a80b0929455459f1e4",118,75,63,13.1111111111111,118,0,3,3
"17052","768d0f930e83a8b7db499338711bf0f9",77,69,64,8.421875,77,0,2,3
"17053","768ec6205271f0270d3cd6e9ee0a586c",30,30,0,30,30,0,1,2
"17054","768f2eb99b130832be71406eb0cf6ad0",39,39,0,39,39,0,1,2
"17055","76900acb2111d2540d6dec83fae9c269",3,3,0,3,3,0,1,2
"17056","76929fee7a3784fe485d7e2d709d682a",44,35,18,17.1111111111111,44,0,1,1
"17057","7692f5ba171942f04d9bfa8686f74e72",42,42,0,42,42,0,1,2
"17058","76939a21f3c69c4854b7dcd10917a180",30,22,37,5.67567567567568,30,0,2,1
"17059","7694d6f88be8871418789ee390ea6ebc",142,111,31,32.0645161290323,142,0,3,3
"17060","769815afc144144fdeedaffb2af1de7e",44,29,36,8.55555555555556,44,0,2,1
"17061","769878fd98bc82086f0ddecb90e64e8f",119,61,55,15.1454545454545,81,38,3,3
"17062","769f900786571ffb477477cb68cffe48",46,46,0,46,46,0,1,2
"17063","76a1dbf6acb4ba3f616c340b0b0ebb20",130,81,79,11.5189873417722,130,0,3,3
"17064","76a2f5f0c04c829b8a24461761c6d72e",27,27,0,27,0,27,1,2
"17065","76a35292e70bf4fcd783f7fdc807780b",78,59,59,9.25423728813559,78,0,2,3
"17066","76a36ae0329ba4dd2a3cd18bbb2908ff",166,84,61,19.0491803278689,166,0,3,3
"17067","76a4312aef20df52a92fbe27ae75d4da",7,5,20,2.45,7,0,1,1
"17068","76a43275b64abc9768a207af7dc0d1c6",67,53,42,11.1666666666667,67,0,2,3
"17069","76a54c26955652b30e38066f90d455ff",88,61,47,13.1063829787234,88,0,2,3
"17070","76a66c170f30677b6a1d7e72f4a61d39",37,37,0,37,37,0,1,2
"17071","76a6f423cb01d40a9fb029b6b454d71f",13,13,0,13,13,0,1,2
"17072","76a72043bdf57e92e65847752185b255",122,53,73,11.6986301369863,122,0,3,3
"17073","76a8166c073e472075dace1fd4b86562",81,64,14,40.5,81,0,1,2
"17074","76a8a4ee5edadd61a1ee2ea1bd84d4f8",9,9,0,9,9,0,1,2
"17075","76ad8cbd2b8ba1abd8b88cd072a913dc",31,27,29,7.48275862068965,13,18,2,1
"17076","76af4b4230389daa41cecb966a1ff0f2",95,67,65,10.2307692307692,95,0,2,3
"17077","76b12f3faebf49b31bd485aa2f079808",52,44,7,52,52,0,1,2
"17078","76b16f38f0e220027c57d82f4c52697d",130,25,84,10.8333333333333,130,0,2,3
"17079","76b24c4dec7c7bba0bc0fc555bfec286",55,37,64,6.015625,29,26,2,1
"17080","76b28d3bce41eac6891836a4bb163b8e",31,25,56,3.875,31,0,2,1
"17081","76b2c54230dba13554fdb5c1d59c9c16",30,30,0,30,30,0,1,2
"17082","76b2ff83549a7b0bae36fae043c7c0e1",76,65,68,7.82352941176471,76,0,2,3
"17083","76b5177a9888157f68e3718e0a78fa33",18,18,0,18,18,0,1,2
"17084","76b597b16e893db2984532d16b6100b6",172,102,57,21.1228070175439,172,0,3,3
"17085","76b6bfb97ce648412dc7b2a923749b2e",26,26,0,26,26,0,1,2
"17086","76bce43f275e937c84c0443e137d9882",127,90,55,16.1636363636364,113,14,3,1
"17087","76bd5ec89915aaa8690c13ab53704b43",20,20,0,20,20,0,1,2
"17088","76bfa0bc4529ceddd86d00371babc947",131,86,59,15.5423728813559,131,0,3,3
"17089","76c163e917a0fde77d5b6f4fb14df675",16,16,0,16,16,0,1,2
"17090","76c328c99f72a540bd2e77f797c35575",39,27,56,4.875,39,0,2,1
"17091","76c33d336424725a9735b094facc0552",110,63,61,12.6229508196721,110,0,3,3
"17092","76c40ca9cdecd2777a43c87da46d1b02",24,23,62,2.70967741935484,7,17,2,1
"17093","76c8174b1cc87f3f2b83618b69021c78",236,87,66,25.030303030303,199,37,3,3
"17094","76ca3657c1fe887b4a00717597d52c0e",200,101,72,19.4444444444444,200,0,3,3
"17095","76cbe00b2dc6c6cad6a203a1d372f551",28,28,0,28,28,0,1,2
"17096","76cbe7c2b94b3c1e5d9094f9d4cf8122",57,48,63,6.33333333333333,57,0,2,3
"17097","76cd276765ea3e0de78b54393a070a16",15,15,0,15,15,0,1,2
"17098","76cef4317b65e1dacbf33b3d5965a34c",152,116,31,34.3225806451613,152,0,3,3
"17099","76cf8d1fa5d509f010bb5dc672c18e60",11,7,47,1.63829787234043,11,0,2,1
"17100","76d0ad369e3612c9991abd9901e444e1",73,52,25,20.44,36,37,2,1
"17101","76d17e7c08767d6b1850664c3efce5ad",3,3,0,3,3,0,1,2
"17102","76d74ec10aa549bec26e406e8171934d",25,25,0,25,25,0,1,2
"17103","76d9a0bb4a2bef8937bbef3529f962da",80,43,83,6.74698795180723,80,0,2,3
"17104","76d9d8ad0d40c1dd90e7e82615f073b8",215,141,64,23.515625,215,0,3,3
"17105","76e158bc1ed1d1da84f48fbf6ab12faf",62,41,67,6.47761194029851,14,48,2,1
"17106","76e23da9f4dda67008d7bae1e08ce6ec",15,15,0,15,15,0,1,2
"17107","76e2a675cbabeb7407c6ae4ce85bbc96",58,53,31,13.0967741935484,58,0,2,1
"17108","76e4efb18439af4e3b56b3f0eb9ad12f",32,32,0,32,32,0,1,2
"17109","76e5b2fd63cade291c11b50edd2ae8f2",126,93,49,18,126,0,3,3
"17110","76e90bc07aac484d45f2c98182a130c7",46,43,42,7.66666666666667,46,0,2,1
"17111","76ec0aae81d37f647378d163464af2c7",30,26,24,8.75,30,0,2,1
"17112","76ece1d4eb700ae1ca6668fd42ab30e9",209,102,70,20.9,166,43,3,3
"17113","76ed9f0bf46488dcc10e97800cb32596",35,35,0,35,35,0,1,2
"17114","76eea0dc7d0f6b4e34f58d140063b9ff",33,33,0,33,33,0,1,2
"17115","76eec2666667d9301434635ab22479a5",190,114,88,15.1136363636364,190,0,3,3
"17116","76f0cbeab9255369a437a5edb247766d",100,85,43,16.2790697674419,100,0,3,3
"17117","76f3a38014d2680b7d90fc47120e1cb5",14,12,4,24.5,14,0,1,2
"17118","76f3f533c520696b5ddca84b0495e294",55,45,44,8.75,27,28,2,1
"17119","76f4bc721b14b992c26bb197a869e6c7",27,27,0,27,27,0,1,2
"17120","76f4ecad415d4a012c850a56d1da46f5",48,48,0,48,48,0,1,2
"17121","76f690b63a519da4b1e7e78dd8faea03",37,37,0,37,37,0,1,2
"17122","76f6b58ad2f1ee340e1e67254287a121",25,24,49,3.57142857142857,25,0,2,1
"17123","76fdc1b4fb01aaf74ca61763f2081d79",155,120,32,33.90625,112,43,3,3
"17124","7700a6c59a1df48106745560d412f740",86,60,61,9.8688524590164,70,16,2,1
"17125","7706974f25382179da14fed94ba8b753",88,58,32,19.25,38,50,2,1
"17126","77079520f03174101f57b06373594273",149,101,58,17.9827586206897,149,0,3,3
"17127","7709a098afaf20544940fe1fece8891a",13,13,0,13,13,0,1,2
"17128","770c7499cb63df6257c0337ca01a86cc",17,17,0,17,17,0,1,2
"17129","770cd017facb2cac2c39997460a57696",30,30,0,30,30,0,1,2
"17130","770d51946eedf1054d5336fa29445b59",65,58,27,16.8518518518519,65,0,2,1
"17131","770e51443d5a99f0aba55357d411e5ff",179,108,49,25.5714285714286,179,0,3,3
"17132","770ec8458ce71c4695fa09a7673da3cf",24,24,0,24,24,0,1,2
"17133","770fadf25aba69a93f63e8546f49d199",67,53,72,6.51388888888889,67,0,2,3
"17134","7710aa2a1cd565baab26d03e9a6309f0",32,26,9,24.8888888888889,32,0,1,2
"17135","771214c748671b774eeb0f0c5e0b85c0",110,73,41,18.780487804878,110,0,3,3
"17136","7713a058636052e1e7469101a2e75f5c",9,6,59,1.06779661016949,9,0,2,1
"17137","771c17dedae7f1aa93e4d23806ec7a41",98,76,54,12.7037037037037,65,33,2,3
"17138","771ca1f8bd12e7403038fa3dcfee2a1a",14,14,0,14,14,0,1,2
"17139","771d5cd0cdab83a0484bf15cbf2b153a",103,79,28,25.75,103,0,3,3
"17140","7720aa3832d90a88a677a497c32e8a54",157,102,78,14.0897435897436,157,0,3,3
"17141","7721a58b5f0ef876528473b58fa47eed",37,29,39,6.64102564102564,17,20,2,1
"17142","77224c0741afd80674f5b49b772ef4fd",48,48,0,48,48,0,1,2
"17143","772685230a349835345c7ed243560e27",32,32,0,32,32,0,1,2
"17144","77292a6f7c01634e7c414f84eeded38a",7,7,0,7,0,7,1,2
"17145","7729776a4dc170ce7f3461190ebfe4b5",31,31,0,31,31,0,1,2
"17146","772a1399a4a55f5a5bda6a4655b60bb1",27,27,0,27,27,0,1,2
"17147","772beb9b2d318166e4a0f67655ea4f8e",32,32,0,32,32,0,1,2
"17148","772e69a8b22a9bd74f8f364569862a17",69,58,63,7.66666666666667,69,0,2,3
"17149","772f606247c79d3ca1f6844666969690",178,77,71,17.5492957746479,178,0,3,3
"17150","7733d5f5f7dcfaa1b4ad38fe944fbbe6",39,39,0,39,0,39,1,2
"17151","7733fd25f8bd58d1681681477201e938",90,52,42,15,90,0,2,3
"17152","77397541b56181048d89d04f7ca3dc3e",19,19,0,19,19,0,1,2
"17153","7739bad96eb699849a5b4b90beb489ee",89,74,47,13.2553191489362,89,0,2,3
"17154","7739d29d0d823a8d34db7dfc3439a048",48,33,76,4.42105263157895,48,0,2,1
"17155","773a6cd59746d5418f14ca8efbbe8c46",65,47,60,7.58333333333333,65,0,2,1
"17156","773ca93d2385f656c785144920502ac8",73,59,25,20.44,73,0,2,1
"17157","773cfc3ceda6c952aeab6993b4acafa7",26,26,0,26,0,26,1,2
"17158","773ec4115c0f5da2b92f646c79995910",44,44,0,44,44,0,1,2
"17159","773fb6946569a1cce51ee9ad29febb38",24,24,0,24,24,0,1,2
"17160","774803b637198d4d1dad9d5c24c72f4c",151,117,49,21.5714285714286,151,0,3,3
"17161","774a95f6384a19efcb0bfc41c6d037ee",106,82,77,9.63636363636364,106,0,3,3
"17162","774c5bde8a7d5969e22e3ea26adbf3fd",35,35,0,35,35,0,1,2
"17163","774deac7d8ac5c28b8b57252d6b6cfc7",7,7,0,7,0,7,1,2
"17164","774e0c013d15701687ef8f5dd42945ae",31,31,0,31,31,0,1,2
"17165","774e2d26f3b06e49548abc305a21529e",7,7,0,7,7,0,1,2
"17166","774fa4f99b8ea241594cacfeaca812ba",21,21,0,21,21,0,1,2
"17167","77553ffd9f085a0daff01a7174f4be84",113,83,27,29.2962962962963,113,0,3,3
"17168","77565d6cb0df0faa72dfc55cb8dee351",81,70,42,13.5,81,0,2,3
"17169","7759db94dc00b115ed47334070d41377",23,23,0,23,23,0,1,2
"17170","775a1a82d007eae9dd2e7915b6f7cc0e",116,86,81,10.0246913580247,116,0,3,3
"17171","775ac4db4f3cb32fb9c36d6051b058aa",61,33,63,6.77777777777778,61,0,2,1
"17172","775b0285c67266a481021f1bed5362e2",18,18,0,18,18,0,1,2
"17173","775c18e75ef380260bf952c22da7e8a4",133,63,53,17.5660377358491,81,52,3,3
"17174","775f7c994cb50ec260645c572b09461a",115,89,47,17.1276595744681,115,0,3,3
"17175","77624629792c0502c5bd3beab0173bf0",72,51,57,8.8421052631579,72,0,2,3
"17176","77639d597143771c0b357cdd0d957db7",5,5,0,5,5,0,1,2
"17177","77664f098f5846db1e310567ba7bc711",135,109,41,23.0487804878049,135,0,3,3
"17178","7767961fcf909f84543827f83c59fb8b",153,82,68,15.75,131,22,3,3
"17179","776931fec44df0b20e2dd7582d3c32ee",99,55,57,12.1578947368421,99,0,2,3
"17180","776aa9be3ef69b7aec009136955da904",59,50,17,24.2941176470588,59,0,1,1
"17181","776cb59089386f07dd3cea30220fc458",34,34,0,34,34,0,1,2
"17182","776db0e6944ef3b298cddb9aa67edf2c",61,48,77,5.54545454545455,61,0,2,3
"17183","776f99160ec8e6131552e3c71f59e4bd",22,22,0,22,22,0,1,2
"17184","7772082a819c96cc2d7e68668ed134f1",61,58,14,30.5,61,0,1,2
"17185","777405eb032607adfefae97cc8f241bf",45,45,0,45,45,0,1,2
"17186","777452b60a6dbe6b117209dc54fc8a9d",35,35,0,35,0,35,1,2
"17187","7778589948e5542c0db63d5f6e6129f6",216,116,77,19.6363636363636,216,0,3,3
"17188","777b0e3ac510420fe0aefa8d834b9b20",42,36,51,5.76470588235294,42,0,2,1
"17189","777b4985ed9c1c1034a6e736aa65d4f6",80,65,21,26.6666666666667,80,0,2,2
"17190","777caaa505ea64f629519cad8bc88900",106,81,70,10.6,106,0,3,3
"17191","777cd78e73ead054a1c11885f10a86e5",18,18,0,18,0,18,1,2
"17192","77811942c465c6c6d2b0cee53adff92b",82,60,29,19.7931034482759,82,0,2,3
"17193","7785b3f29571cd19842d48893c78f011",44,44,0,44,44,0,1,2
"17194","7787647049b77a09c101300a89c0ea1f",7,7,0,7,7,0,1,2
"17195","7787def4aaeae9b44e47e312c4a02fef",166,114,80,14.525,166,0,3,3
"17196","7788425ec6c85e7c821d9ae8c0e69786",26,26,0,26,26,0,1,2
"17197","7789ffc49968b1d4fb3cb3260af77704",40,40,0,40,40,0,1,2
"17198","778b610989a7f9adbd0241ef10e79528",37,37,0,37,37,0,1,2
"17199","778bb325cf67adc54a042f822bcf7079",58,47,47,8.63829787234043,58,0,2,1
"17200","778bf4b8ddb2b8eed5a39e8a05d77c9f",3,3,0,3,3,0,1,2
"17201","778d732b9f86dc80758742cad5e3a3bf",37,37,0,37,37,0,1,2
"17202","7790a20ed6a07bdc6d30f1d655983a8f",131,82,66,13.8939393939394,111,20,3,3
"17203","7790f820141c1d807127cb42920b3f6c",148,95,50,20.72,148,0,3,3
"17204","7792a06cdbe33cdb471c5887da8bba55",32,23,19,11.7894736842105,32,0,1,1
"17205","7793a98def4bee631ed56d921409636a",15,15,0,15,15,0,1,2
"17206","77965da2f516d3e5a89e856a41d292dd",121,66,76,11.1447368421053,121,0,3,3
"17207","779775f3c59948af4267565068dd21f6",23,23,0,23,23,0,1,2
"17208","7798e44ab4ace48eb3a349bd8a856629",35,32,42,5.83333333333333,0,35,2,1
"17209","7799034592248347cb86964f8320eeb1",82,54,46,12.4782608695652,82,0,2,3
"17210","779c09122e8ec3643f181bc30ff698ca",9,9,0,9,9,0,1,2
"17211","779e2348889d19386c65850542222c9e",81,61,39,14.5384615384615,61,20,2,1
"17212","779e2c0115d6d8b558a3d2cf9c455740",42,33,30,9.8,42,0,2,1
"17213","779efdfbe0ac5581436f6eab71bcf0a3",81,44,71,7.98591549295775,81,0,2,3
"17214","77a3506743144e515e634faa52147db1",97,81,49,13.8571428571429,97,0,3,3
"17215","77a3ed43648f33393ec4b8bd1311c15b",71,57,33,15.0606060606061,71,0,2,1
"17216","77a4330e0f3eb76dd66d34081e030622",202,48,84,16.8333333333333,190,12,3,3
"17217","77a43875c64882adfed799901d3c79c6",2,2,0,2,2,0,1,2
"17218","77a4d51113037ec4433889af116defe8",109,85,55,13.8727272727273,56,53,3,3
"17219","77a59d5e89f6ab26c9cbc931e5549837",25,25,0,25,25,0,1,2
"17220","77a79764a91a4cfe4cb310f63caa1704",18,18,0,18,18,0,1,2
"17221","77ab8b66ddc2447a481a145361915bc7",1,1,0,1,1,0,1,2
"17222","77ad21c7dcf8d5d06874bea2e941253c",32,32,0,32,32,0,1,2
"17223","77ad2cbdee7253da08373eb9ea296c8f",194,82,74,18.3513513513514,145,49,3,3
"17224","77b112a6c1f05efbad4b3ddc152b8bad",22,22,0,22,22,0,1,2
"17225","77b135585f7cda06f9eeca67d18e9fbf",48,38,56,6,48,0,2,1
"17226","77b1b8d22282d97c51c6c41ebca09889",70,57,36,13.6111111111111,70,0,2,3
"17227","77b21414082d15d8ff9884a533975e6a",55,47,7,55,0,55,1,2
"17228","77b3b5ced6e31a9c60029a48926b361e",65,39,28,16.25,65,0,2,1
"17229","77b7f445f8ed1a1752a5d99690d07b5c",163,116,65,17.5538461538462,124,39,3,3
"17230","77be0de089a69462f14d4bcccdc75a9d",11,8,40,1.925,11,0,2,1
"17231","77be64a358c0d951f282fab7b59f0794",21,21,0,21,21,0,1,2
"17232","77c25737028f7155536689ea7cc9af62",155,66,70,15.5,155,0,3,3
"17233","77c350c035b5dd5a47c8f0fc0aa85bf3",43,33,56,5.375,43,0,2,1
"17234","77c37de3a6d14c8fcbffd08f65b146c8",10,10,0,10,10,0,1,2
"17235","77c420f35687c1b7c8885e8036b6779c",204,143,80,17.85,204,0,3,3
"17236","77c7ae57825f86a7e1e4409fc804bbd8",74,48,59,8.77966101694915,74,0,2,3
"17237","77c92163f745528a01f044c4985912c8",32,32,0,32,32,0,1,2
"17238","77ca98ee084d58843a05e048843c0969",11,11,0,11,0,11,1,2
"17239","77cb648ab762604f63866f608ade82aa",43,43,0,43,0,43,1,2
"17240","77cd0b871b719290072e6b58e61c088f",102,79,59,12.1016949152542,102,0,3,3
"17241","77cd5e7cf007e23f785995b678f46eea",125,101,30,29.1666666666667,88,37,3,3
"17242","77d474942f829254c8ee58890bf83e1f",103,49,54,13.3518518518519,103,0,2,3
"17243","77d6bb0f67a7a819ff43d0b96bc0bcb4",22,22,0,22,22,0,1,2
"17244","77d75c497ffad7c3a6de2609d5e9b989",150,80,77,13.6363636363636,150,0,3,3
"17245","77d8d7b0d4cad6d2102527d86abada61",41,33,21,13.6666666666667,41,0,1,1
"17246","77d8ea80dc93023f4127b1410fc74ead",43,37,17,17.7058823529412,43,0,1,1
"17247","77d9d4c114e86be12183b0ddd776d883",213,130,67,22.2537313432836,213,0,3,3
"17248","77dfbb35cff84a537f99a4529f5b3cfa",19,19,0,19,19,0,1,2
"17249","77e474f8a29b13295f890ee0b99d761d",19,19,0,19,19,0,1,2
"17250","77e74d138fc62caff9587a669f443d56",186,104,34,38.2941176470588,155,31,3,3
"17251","77e98f45410fcf509c5d14cd1b93a4a0",22,22,0,22,0,22,1,2
"17252","77ea559952979444bb9bb58a74279511",78,43,74,7.37837837837838,78,0,2,3
"17253","77eaeeef5b101d8930093c69bb6e104a",135,98,28,33.75,135,0,3,3
"17254","77ed0bd61e0f0cb954e65c84f6a891aa",58,50,18,22.5555555555556,34,24,1,1
"17255","77ed87aff9b33233fd1493af0a4c46d2",17,17,0,17,17,0,1,2
"17256","77ee317123e3e86f80d2e5fe4a1ff2ff",38,38,0,38,38,0,1,2
"17257","77ef8ed747a661309d2141c446887187",45,45,0,45,45,0,1,2
"17258","77f392b80f5264bce049dc661ae16780",107,65,67,11.1791044776119,107,0,3,3
"17259","77f69c4f504110a37cc84975b68eb40d",53,53,0,53,53,0,1,2
"17260","77f7c863444d684171b6668cb1980ce5",6,6,0,6,6,0,1,2
"17261","77f8d8c94ef0a7ade459826aead1e3d6",60,51,21,20,60,0,2,1
"17262","77fabe6ee58c238bd74a27481f5fb8d6",30,30,0,30,30,0,1,2
"17263","78016e7fdfcf7f9870ebd76d9fc36096",68,61,56,8.5,68,0,2,3
"17264","7802522d822f992fb38716f98e3109ea",99,73,73,9.49315068493151,99,0,3,3
"17265","7804bb9c8bccdac6ffdca954156cc5ab",18,18,0,18,18,0,1,2
"17266","7807ebce6161ead182b22402324cf796",119,69,67,12.4328358208955,88,31,3,3
"17267","7809b6249cb4e6ce6002fe259451fc48",32,32,0,32,32,0,1,2
"17268","780b5701305a42adfc1901a78fa04797",154,44,82,13.1463414634146,154,0,3,3
"17269","780f78163949f66008a693377d462ec2",91,67,50,12.74,49,42,2,3
"17270","780f78b9d9e88327058d0137698ce986",68,61,38,12.5263157894737,68,0,2,3
"17271","781159862d360843674b27cf2edf072e",53,32,69,5.3768115942029,51,2,2,1
"17272","78127030ad5d9fbd81bacc118f8bda84",53,53,0,53,53,0,1,2
"17273","7812f447c711748d309314dfdced6c44",90,67,50,12.6,86,4,2,3
"17274","7813a39edcb07d97a2192e74128c5a49",199,57,85,16.3882352941176,199,0,3,3
"17275","781c9e578ccca85345218953233e2481",82,72,43,13.3488372093023,82,0,2,3
"17276","78203812774e683292e270766e3f2a61",53,43,14,26.5,0,53,1,1
"17277","7821497d12cc3cdc2def4dbae5a74b41",36,36,0,36,36,0,1,2
"17278","7821e7647cdd938289910f06aa0f37fd",150,105,67,15.6716417910448,101,49,3,3
"17279","78221ccfa94bf93c678a158f425c271b",23,23,0,23,23,0,1,2
"17280","78222d5a3c4ca27e26e9af0a2612853e",39,33,8,34.125,39,0,1,2
"17281","7823680f768f4e7391936bdae80faf1f",12,12,0,12,12,0,1,2
"17282","7823937df3aa602e49cacd12292d72ba",43,43,0,43,43,0,1,2
"17283","78240fc7190e166e5e39cfa6bfa31c65",1,1,0,1,1,0,1,2
"17284","78249e7e95113c3af765365ef1ce8744",204,124,90,15.8666666666667,204,0,3,3
"17285","782633f1143cf1b4754d459efe60ef04",114,74,36,22.1666666666667,114,0,3,3
"17286","78267ee64cf22af716727b2240508a85",1,1,0,1,1,0,1,2
"17287","7828aed5d9d5ec99e3eef9f9e505ba74",11,11,0,11,11,0,1,2
"17288","782ce4e52f0d9da210ece4512f8a352b",96,72,43,15.6279069767442,96,0,2,3
"17289","78331764c4939755f52a1dc9ab43501f",17,17,0,17,17,0,1,2
"17290","78344c8b28f564b3c61a16fc9e6212c4",66,58,14,33,66,0,1,2
"17291","783502c88c178c076cb86fc9abd50b6c",9,9,0,9,9,0,1,2
"17292","78350de0d01ff3c6e28ac6211a9d834b",13,13,0,13,13,0,1,2
"17293","78354c93770bdf3ff5745c5b60cb19c1",23,21,25,6.44,23,0,2,1
"17294","783665cfed5d6ebd76981443bcc3741f",25,25,0,25,25,0,1,2
"17295","7836e599edd4ec48a9ea551618f1314b",154,101,85,12.6823529411765,116,38,3,3
"17296","78371c4ced16f81bbfbb813ce6b3ae8e",17,17,0,17,17,0,1,2
"17297","7838a700b3560111f2ff1491998874e6",83,46,62,9.37096774193548,83,0,2,3
"17298","783dc9e1c2380c974718843d641e4d0f",30,24,63,3.33333333333333,30,0,2,1
"17299","783e0e459efe63da049cce59b6def10f",192,97,68,19.7647058823529,192,0,3,3
"17300","783eb65e28cda1cf44ee14cd47b8cbaf",131,70,32,28.65625,131,0,3,3
"17301","78419e2028deb993a4bd10b5d12a2d44",87,56,64,9.515625,49,38,2,1
"17302","78467f84d979cdf05c5d423f65dcede5",50,40,33,10.6060606060606,50,0,2,1
"17303","7847a78dec84b5936c2a2e4b20b39545",108,77,53,14.2641509433962,108,0,3,3
"17304","784b63ed7e6aebf7d6c8ed78fb5ae6f0",11,11,0,11,11,0,1,2
"17305","7851244ceb64d8b374c14189ae0ea281",153,72,81,13.2222222222222,102,51,3,3
"17306","785271dc31ec63c271c9dfa15a865ec1",100,58,85,8.23529411764706,100,0,2,3
"17307","78535cf09b03ed2528511bbc1d8297aa",12,12,0,12,12,0,1,2
"17308","78554176190240c5a1fbad4742e431e1",23,23,0,23,23,0,1,2
"17309","78572ee4d5d470183a1e144c93a5f3d8",163,108,79,14.4430379746835,140,23,3,3
"17310","7858949422ee75ac6b00952ffd872af2",187,97,56,23.375,187,0,3,3
"17311","7859c8b03c8d99a01d49600ac0b60a71",190,124,43,30.9302325581395,190,0,3,3
"17312","785c06ea45ffd36bd7d6db9dad4a39d0",12,12,0,12,12,0,1,2
"17313","7863a98c72c1959a54adabe30dc30090",55,47,9,42.7777777777778,55,0,1,2
"17314","7863ce5c1c5e64f2d74b51b83af55ad2",70,51,89,5.50561797752809,70,0,2,3
"17315","78668232cb5a0733dae82951f66369a0",49,49,0,49,49,0,1,2
"17316","7868a3324eb899716e05ad1854fb9d58",105,61,54,13.6111111111111,68,37,2,3
"17317","786e8dbc6ba57e5f4c25c8223bbcb9e4",13,13,0,13,0,13,1,2
"17318","786eb04fe7fd7b8697ca4183182ef343",60,53,24,17.5,60,0,2,1
"17319","786f13d0b5293324cbafa20d05055d5a",161,76,68,16.5735294117647,161,0,3,3
"17320","7870cde394cee7d21d992ef0ac5e9331",31,31,0,31,0,31,1,2
"17321","78730081a7e0f3eb657e87ecec6065e7",72,44,89,5.66292134831461,72,0,2,3
"17322","787710d3dda44ffe98547b6e408972d4",28,28,0,28,0,28,1,2
"17323","78773e97e4c3a8b12ac7d35ad1ea5599",148,114,68,15.2352941176471,148,0,3,3
"17324","7877697f85713d935022d7cce44ec499",103,60,39,18.4871794871795,78,25,2,1
"17325","78792d3790964e32d2e2a4aabb9175b0",147,65,77,13.3636363636364,124,23,3,3
"17326","787adb49c634661bd94779e5248bfdc9",154,91,46,23.4347826086957,121,33,3,3
"17327","787b7fa81e1a46a231382d93a5d04764",78,49,56,9.75,78,0,2,3
"17328","787bc3ac54126b5702a79a895c09d44c",49,27,83,4.13253012048193,49,0,2,1
"17329","787c37b48c610b1266f98c674b629966",9,9,0,9,9,0,1,2
"17330","787d2ca7be2db4f660729e9161c16abe",30,30,0,30,30,0,1,2
"17331","787eac249b21af83df25ceb8246e218a",41,41,0,41,41,0,1,2
"17332","787ec11c336183a52e5426d511488a3e",161,94,62,18.1774193548387,161,0,3,3
"17333","787ed9d8345fba1c56f31a1c58869d27",48,48,0,48,0,48,1,2
"17334","787f5971c3accb768b58c55d95da09cb",39,39,0,39,39,0,1,2
"17335","7880281c4457fe172fd1a89f52775b1c",38,32,47,5.65957446808511,19,19,2,1
"17336","788238e47b3d39b5e5c98ee4d77af5dc",9,8,4,15.75,9,0,1,2
"17337","788272f3e2944eb18a59c4bc60260e60",37,37,0,37,37,0,1,2
"17338","788289142c1726dcd9c7480daf7a6153",93,66,59,11.0338983050847,93,0,2,3
"17339","788512f1bf79ed76aed1d1f22bcdb6a9",56,44,49,8,48,8,2,1
"17340","7885e7199190e26acdc29adf5c297c93",210,69,84,17.5,183,27,3,3
"17341","788b35c2a07995c294c1c3a90021b0ce",116,91,64,12.6875,116,0,3,3
"17342","788ce3c908d86ba8a44b7186b52fe8d0",58,48,41,9.90243902439024,58,0,2,1
"17343","788d66b1d98cf439cacc44efe44687d2",101,65,69,10.2463768115942,74,27,2,1
"17344","7892043ccf879aa22faf9f90db30665a",74,63,78,6.64102564102564,74,0,2,3
"17345","7894aeee7fe3cbd3369953ffaf06fa4c",50,50,0,50,50,0,1,2
"17346","789777222c1ec628474152db5c70713c",24,24,0,24,24,0,1,2
"17347","78984e145c560ba4ae890701da8081df",216,56,81,18.6666666666667,198,18,3,3
"17348","789d525195a5c7befc4677a05a10f2b5",67,53,28,16.75,67,0,2,1
"17349","789e78156802400004addef9f2e7b6f9",88,60,50,12.32,57,31,2,1
"17350","789e98987fa473d33ff1220e9f7964e5",89,74,73,8.53424657534246,52,37,2,3
"17351","78a02006309d5cc8d150d144fd714b01",22,22,0,22,0,22,1,2
"17352","78a2166afaebe1440e1020f5601438c1",36,36,0,36,36,0,1,2
"17353","78a26370b9235bb9ff09891fde90b8be",16,16,0,16,0,16,1,2
"17354","78a5eb2d4d16cafa3a34d3a909909f05",61,51,72,5.93055555555556,61,0,2,3
"17355","78a8851b644d621f68f813bfb6b228fc",39,39,0,39,39,0,1,2
"17356","78a93e7e686edbb6c0681f8a9da7198a",32,32,0,32,32,0,1,2
"17357","78a9887b1aaec63cb4b2213cf147f24c",11,11,0,11,0,11,1,2
"17358","78aabe43928948f22da2fb8157fe7eef",7,7,0,7,7,0,1,2
"17359","78aae9b514a76a9b1edc3fa7a1d36e08",8,8,34,1.64705882352941,8,0,2,1
"17360","78abfa8fdc3bc66c5ae273619027f82e",30,30,0,30,30,0,1,2
"17361","78adfdc1fadffd885c3706e08a4ece3a",187,117,68,19.25,187,0,3,3
"17362","78ae9bc0b0ad2a7079991282764184a1",95,41,57,11.6666666666667,95,0,2,3
"17363","78aeba4e3744b92d4de986e6ce98eeb5",138,84,63,15.3333333333333,138,0,3,3
"17364","78b11d06b174f9416583259aa30cfac9",23,13,68,2.36764705882353,15,8,2,1
"17365","78b3f7975dec3a678634b7d074833e8c",15,15,0,15,15,0,1,2
"17366","78b4af4d60ea9fc6c7e88c884b63a5e9",72,56,77,6.54545454545455,72,0,2,3
"17367","78b54c1b7cb9aa4005e6680c055b216e",35,22,65,3.76923076923077,17,18,2,1
"17368","78b79c4dccbf29b7f2f944b321046673",97,75,31,21.9032258064516,45,52,2,3
"17369","78b927a0bbdcefc9873d1487b31969ab",7,7,0,7,7,0,1,2
"17370","78b9c98a015fbd495be94986b609e70a",4,3,53,0.528301886792453,3,1,2,1
"17371","78bb762a4e85dd91a35f549d86c6896b",80,72,18,31.1111111111111,43,37,1,1
"17372","78bde4bd3c6641537fb9224c4676096e",79,64,27,20.4814814814815,46,33,2,3
"17373","78be844b37aeea15571b6b5915007366",12,12,0,12,12,0,1,2
"17374","78bec50478dffb0d5da5d58511354d9a",20,20,0,20,0,20,1,2
"17375","78bf59e97ab6d2bdd2907c84c81a5d9f",124,73,84,10.3333333333333,99,25,3,1
"17376","78bf65c03d243ddaa3c3ac2866f3b4e5",24,24,0,24,24,0,1,2
"17377","78c042f6e8431ee6afe1c5d21604e9b2",15,15,0,15,15,0,1,2
"17378","78c0786c1966ff3dc92fc62f1ffb53f7",38,33,77,3.45454545454545,19,19,2,1
"17379","78c2526f85f666e8d67faf52e1e05c48",92,64,59,10.9152542372881,58,34,2,1
"17380","78c43a4f3d267aed31bb50cd9b7003f3",49,49,0,49,49,0,1,2
"17381","78c54678ce22da63cc15d130d138ad8e",32,32,0,32,32,0,1,2
"17382","78c6ef1d17c6e6f65e6cbc6dfa129fc1",152,82,66,16.1212121212121,114,38,3,3
"17383","78c7369eccae6bb7ff11f0dc0967dd71",58,41,28,14.5,58,0,2,1
"17384","78c997e5b9756f16700a2355fbb78deb",36,26,28,9,36,0,2,1
"17385","78ca067b2507090c90eedfd36b001275",204,90,60,23.8,173,31,3,3
"17386","78ca6a9a5e403022af7874d17455f96d",52,52,0,52,0,52,1,2
"17387","78cac4dfb3bfef0c8b2177a145b980cd",118,73,57,14.4912280701754,118,0,3,3
"17388","78cbe7e99b493e42a14edddc34499ef3",40,36,38,7.36842105263158,22,18,2,1
"17389","78d0b055e646872d6b719d0944c2d278",44,28,69,4.46376811594203,44,0,2,1
"17390","78d16ba1a9ad4cea8efe204592eff6a3",87,51,61,9.98360655737705,87,0,2,3
"17391","78d31e4686ea7d70d7edba496d6b9e03",10,10,0,10,10,0,1,2
"17392","78d5a56d8ab2256f457198b95dc898af",53,27,66,5.62121212121212,53,0,2,1
"17393","78d6468751f89b6f1d1e7db6dd0c6f0c",24,13,28,6,4,20,2,1
"17394","78d649f615782b1fe01aa1d618a7c1c5",107,32,51,14.6862745098039,107,0,2,3
"17395","78d86b6d97887ab61a7dfe279eadddca",29,29,0,29,29,0,1,2
"17396","78dad3bfe43a0695ca2b7c362c59b3c0",45,38,37,8.51351351351351,45,0,2,1
"17397","78dcc7fc5545cd38bb7acf7031f25e7a",183,72,83,15.433734939759,161,22,3,3
"17398","78dfa9615b8e339c741affa8720bdd17",27,27,0,27,0,27,1,2
"17399","78e23bfec8d0bf6fb506c0b23b02fbdc",80,58,55,10.1818181818182,80,0,2,3
"17400","78e2a5e04678d0bd56c4195d0901f9e2",68,47,88,5.40909090909091,28,40,2,1
"17401","78e308695bbf1337150ba57f14cc1c20",19,19,0,19,19,0,1,2
"17402","78e4399cf70053d6f2284292a3148d1c",40,40,0,40,40,0,1,2
"17403","78e645015c33639b17f0fa4b32659d48",78,52,25,21.84,78,0,2,1
"17404","78e9ac7c42775328a20fd2cf1c6d02b2",38,38,0,38,38,0,1,2
"17405","78eb4b96ff5de276f6ba2da07df3385b",21,21,0,21,21,0,1,2
"17406","78eb6c51b915ff30e4a4b85c6219d170",105,61,64,11.484375,86,19,2,1
"17407","78ecbeed3f7f4d51ed940908829c526b",51,51,0,51,51,0,1,2
"17408","78edb7ad4a3a2bcdb2a5e215c217083c",168,91,61,19.2786885245902,127,41,3,3
"17409","78ef02e4a9fd0c60fcc7a3af6546f364",10,7,45,1.55555555555556,10,0,2,1
"17410","78f08b8a2ee44846039925f2052f18ef",30,30,0,30,30,0,1,2
"17411","78f507ced6d46c35007fdb5e8edad6cd",28,28,0,28,0,28,1,2
"17412","78f66dd37c1002498507aea282704b6e",43,43,0,43,43,0,1,2
"17413","78f6fa2bcb1e51f47a7362a0b6297398",18,18,0,18,18,0,1,2
"17414","78f83ccbd5c19b2c94ce57454dce881e",50,41,45,7.77777777777778,50,0,2,1
"17415","78f89b79b5c6f54732521641b1801bf8",35,25,61,4.01639344262295,35,0,2,1
"17416","78f94a22d13f98479befd63d25ad433f",90,60,46,13.695652173913,51,39,2,3
"17417","78fae10576b9f2739a51c029fa5b5ba2",59,51,25,16.52,38,21,2,1
"17418","7900921a3886978555372106f586fabc",98,58,61,11.2459016393443,98,0,2,3
"17419","7902bf1c42e35536d3006970857bea3b",31,24,33,6.57575757575758,31,0,2,1
"17420","79033eedc193fb87bc70da9daeb1e53e",23,23,0,23,23,0,1,2
"17421","79048128f2cf2fb13556e521a251573a",38,36,70,3.8,0,38,2,1
"17422","790590ba0be90b56d71a98fb2691a8d3",38,38,0,38,38,0,1,2
"17423","790617636024a962171f48c08f85ecc3",36,33,47,5.36170212765957,36,0,2,1
"17424","790849e2616e4bead5b2002cdbc2435e",56,46,38,10.3157894736842,56,0,2,1
"17425","7908688e2be9f5a391fd5c8aeb026963",55,49,10,38.5,55,0,1,2
"17426","79090705aa00a9507104b3f04dd6fd6f",49,49,0,49,49,0,1,2
"17427","79090a926550f59f9ab2cd07713c4e78",49,43,51,6.72549019607843,30,19,2,1
"17428","790b3ebdcb6aa4bcd678a8e7e2806f15",25,22,23,7.60869565217391,25,0,2,1
"17429","790bb871756efab90512b323a928a5de",7,7,0,7,7,0,1,2
"17430","7910786a2be4bbecfeab3f0382e0df94",36,32,41,6.14634146341463,18,18,2,1
"17431","791274effeb2a3e484ded20373ccb126",102,57,49,14.5714285714286,102,0,2,3
"17432","791285a00bcdba197b3f3c4ca45bdc85",14,14,0,14,14,0,1,2
"17433","79160f9b52d6cb687358077e100d7b70",93,66,34,19.1470588235294,93,0,2,3
"17434","791d4b06400779c9a387feed8e092527",61,26,65,6.56923076923077,38,23,2,1
"17435","791ed3f0f889ca1047450f24f545f9b0",24,24,0,24,24,0,1,2
"17436","791ee597261e78f7006a9ffd945f116e",40,34,34,8.23529411764706,14,26,2,1
"17437","792192b8ab9b1c209870b15fcaae3490",1,1,0,1,1,0,1,2
"17438","79231967f6252780c8ea479dab578522",152,119,75,14.1866666666667,152,0,3,3
"17439","79238464c0382c2a052721db3a6a4361",139,100,48,20.2708333333333,139,0,3,3
"17440","792642b24cc9404612924c42ec4e09fe",64,57,38,11.7894736842105,64,0,2,3
"17441","792b3def23747e69a694b834af6c0f77",56,36,36,10.8888888888889,27,29,2,1
"17442","792b8a8efe0881549dd99b280c4c3233",23,14,57,2.82456140350877,23,0,2,1
"17443","792bfc64d97f2562c098a276ce025a8f",14,14,0,14,14,0,1,2
"17444","792c764d148772ce48d13f8a0c71a728",23,23,0,23,23,0,1,2
"17445","792d07c5198aa79225e2f9c30bd74590",84,67,54,10.8888888888889,39,45,2,1
"17446","792d709998c51c95b2476ded4037261b",40,35,5,56,40,0,1,2
"17447","792ff733698b23d38d2e9591363e8b2d",158,83,55,20.1090909090909,123,35,3,3
"17448","79353a43ead66c23f0d943c230a4e7a0",211,104,77,19.1818181818182,211,0,3,3
"17449","7935a01cf6a9bd0bd5864e50a20ab846",34,29,25,9.52,34,0,2,1
"17450","7935fdea6d0364e7c07f29b503382f55",7,7,0,7,7,0,1,2
"17451","79388009c754202e37ffda54f353b050",34,34,0,34,34,0,1,2
"17452","7939e0d00952849997692cb9211df696",52,52,0,52,52,0,1,2
"17453","793eba89b8769a17426920fc321c5d15",20,20,0,20,20,0,1,2
"17454","793fd816e8f308a122ed41255a3077ff",52,52,0,52,52,0,1,2
"17455","7940eca8769db162640aa642099ff9ef",27,27,0,27,0,27,1,2
"17456","7945d40a5a7024e82882af787ff823bb",43,43,0,43,43,0,1,2
"17457","7948504908bf3b541c1a356d4d5e8b04",41,41,0,41,0,41,1,2
"17458","7948815436db78040bcbee79a0ebd28f",37,34,29,8.93103448275862,37,0,2,1
"17459","795060433a8095f2077b6c6ac75faaa8",29,29,0,29,29,0,1,2
"17460","79510d121ff6c2eb812ead2995c21429",34,34,0,34,34,0,1,2
"17461","7955e2811ab8726f38c4125da790b27e",189,92,71,18.6338028169014,156,33,3,3
"17462","79569f0ba2f93f20a4e9f32953b0e9ee",128,98,71,12.6197183098592,98,30,3,3
"17463","7958f00879db68936edd5e4ae960298f",60,52,53,7.92452830188679,60,0,2,1
"17464","795981c42095cbab4539036302cd2ac2",54,53,28,13.5,54,0,2,1
"17465","795a1bd26afce4cdcdac6f7587384ba3",67,50,35,13.4,67,0,2,1
"17466","795e13afe15faa86ee15f2368b969744",29,29,0,29,0,29,1,2
"17467","795ecdd3c460e75a936ea4c9b9566489",2,2,0,2,2,0,1,2
"17468","79640b79057c0f69c30b9807076b7511",87,28,82,7.42682926829268,87,0,2,1
"17469","7968a69bf144cebb6a9ed1187d8d18a1",52,39,45,8.08888888888889,29,23,2,1
"17470","796a4279e2f710bb7dd0dbe3c637ae8b",211,71,71,20.8028169014085,183,28,3,3
"17471","796b7e8f6f14675344c2e1fdd4257742",70,54,36,13.6111111111111,70,0,2,1
"17472","796c5c0985cb65305119a528a5d5d005",36,36,0,36,36,0,1,2
"17473","796dbf0787fef4bac15c9e5ab7804474",131,108,61,15.0327868852459,95,36,3,3
"17474","796e596662a7dcc92f251d43dffa6cc5",92,70,42,15.3333333333333,92,0,2,3
"17475","796ff8e3cbf3c8c87fc8d0e0a0def57d",46,46,0,46,0,46,1,2
"17476","797046984c046c8660d148ebbeacf7f9",32,32,0,32,32,0,1,2
"17477","797059e64faa420f29f130c0f6074639",7,7,0,7,7,0,1,2
"17478","797758dcdada12cabef0e5cb15793927",19,19,0,19,19,0,1,2
"17479","79777eb275b5213234ad869b5070edbc",61,36,50,8.54,61,0,2,1
"17480","79784a997991ff47d3cfe9f0296c23fd",37,37,0,37,37,0,1,2
"17481","7979240b1eead332f79c67ac10bc100c",22,22,0,22,22,0,1,2
"17482","7979acc200bbed45e1dbf76763208391",35,35,0,35,35,0,1,2
"17483","797bb499b280fe1e0173db3b9568a62c",35,35,0,35,35,0,1,2
"17484","797d89ee0efec110668e77b0dedeb4d6",17,17,0,17,17,0,1,2
"17485","79817dfc088a075b39adb853e7013340",32,32,0,32,32,0,1,2
"17486","79828f4aa0a8501e58c8deb9a53b9267",40,40,0,40,40,0,1,2
"17487","798561c01bc12c9ef5c79f5611ef6310",49,49,0,49,0,49,1,2
"17488","798746b12ceff93d0455b3d0b3c7aa68",74,50,23,22.5217391304348,74,0,2,1
"17489","7989aa5c7fbae3648cb86b99bb03f860",46,30,62,5.19354838709677,46,0,2,1
"17490","798b345965e7f392a76e1f96000c5282",189,109,70,18.9,189,0,3,3
"17491","798d70ae8967de76bdbd5b549c1b52a9",47,41,34,9.6764705882353,47,0,2,1
"17492","798d92bf753e9f2924e061057eeb9d62",28,28,0,28,28,0,1,2
"17493","798e9b873d90a7c8406e1828ff2e5da9",215,131,57,26.4035087719298,215,0,3,3
"17494","7992460baddf35289b5c40e5ab575224",29,29,0,29,29,0,1,2
"17495","79927d7837a90d3c24d7893841efdc77",51,43,26,13.7307692307692,51,0,2,1
"17496","79932522cd149e1223fe46eae1723389",142,56,87,11.4252873563218,126,16,3,1
"17497","7995ba11e9371259988e1bbc24ddf382",143,76,85,11.7764705882353,118,25,3,3
"17498","799a2f24eb74e40c8d355dc34f5dc4ff",1,1,0,1,1,0,1,2
"17499","799c64796c4f215dfbe0522193d273be",39,36,35,7.8,39,0,2,1
"17500","799ddf964288d8ae08bd0c51ccff29d6",96,76,25,26.88,51,45,2,3
"17501","799e7a43237c09405bd905289f29361b",99,72,61,11.3606557377049,99,0,2,3
"17502","79a1a12cb5ba34d708f412f08c95e4e4",38,38,75,3.54666666666667,23,15,2,1
"17503","79a211b9bb2ab8424889f9afea075de4",72,60,14,36,72,0,1,2
"17504","79a52d62e0ec318eb72cf7e6c8df626e",85,68,51,11.6666666666667,85,0,2,3
"17505","79a55bb6db02eb920c0d661b47a5b0ea",121,76,55,15.4,69,52,3,3
"17506","79a81accf735f114ee09a77671e94df7",137,88,55,17.4363636363636,90,47,3,3
"17507","79a8bf6eccd2b6c587e47b9596739282",23,23,0,23,23,0,1,2
"17508","79a8c77e840b7cf67b1935c4649a6df5",9,9,0,9,9,0,1,2
"17509","79a9b4c5619bc0bcdff4f90e54f7b4f1",112,90,31,25.2903225806452,112,0,3,3
"17510","79addbc444eb10dc0033056de2ee26bf",10,7,36,1.94444444444444,10,0,2,1
"17511","79ae0c5f8af04b7a34428d4a89bb47e9",192,91,56,24,192,0,3,3
"17512","79b192eff18f1682dc631fabe7d2b1a3",108,73,49,15.4285714285714,108,0,3,3
"17513","79b2369b57bf119633e4effab3393164",37,30,49,5.28571428571429,0,37,2,1
"17514","79b482e8433cafcb7026a95f9acd9913",49,36,38,9.02631578947368,49,0,2,1
"17515","79b9267a679d59b3910eb1e958a8b8f0",28,28,0,28,28,0,1,2
"17516","79befcd0731a11dcc9431a0ab6ec7571",35,35,0,35,35,0,1,2
"17517","79bfde531aa27d4ae3b949600095d702",117,62,42,19.5,117,0,3,3
"17518","79c0b4ba4fac346d8d48fc74814e6dff",83,64,41,14.1707317073171,83,0,2,3
"17519","79c1b46694caed0ea6f8ec75542ef9fb",16,16,0,16,16,0,1,2
"17520","79c1c1c057acbfc698dcd781d631d0d0",31,31,0,31,31,0,1,2
"17521","79c66677bafa8e25bb5c75ecbe22fa20",4,4,0,4,0,4,1,2
"17522","79c9bb91da69c213d09a89aac0e7bad3",69,64,35,13.8,69,0,2,3
"17523","79ca1c8f6278591497f3ed5e8a5edbbd",207,73,71,20.4084507042254,171,36,3,3
"17524","79cb1eaa1407eb4e637abf5eee52b0c9",28,24,78,2.51282051282051,28,0,2,1
"17525","79cc51d050dcdbf460de185e80a7f109",40,40,0,40,40,0,1,2
"17526","79cca132d4ed0027df395380e41ec0cf",77,39,70,7.7,69,8,2,1
"17527","79d001f7eb18a9e9ee2bfe765bc85990",26,26,0,26,26,0,1,2
"17528","79d34cab0a16d49a219e36e231219216",16,16,0,16,16,0,1,2
"17529","79d59dc48f8048fa9fe06847c36da1db",7,7,0,7,7,0,1,2
"17530","79d661e6df398318f18cca295bf84296",28,28,0,28,28,0,1,2
"17531","79dac47464cefe6dcf782abdaa417a51",119,67,81,10.283950617284,94,25,3,1
"17532","79dd46a801a2f7298ae26e2702fce261",132,86,88,10.5,107,25,3,3
"17533","79dddac2b4339543084a147e029469a0",186,89,44,29.5909090909091,186,0,3,3
"17534","79de8e4572103439d7093c2d62b8fbf1",151,109,70,15.1,151,0,3,3
"17535","79ded613badd7a2104fc7a13bef395da",170,96,70,17,170,0,3,3
"17536","79e02dc7797f4ab62076e2952ca0dc90",164,81,71,16.169014084507,164,0,3,3
"17537","79e05d94597947a45797a379bf484300",112,56,70,11.2,112,0,3,3
"17538","79e0a7426580b9f2a7afeebd2c6dc589",39,36,15,18.2,39,0,1,1
"17539","79e223912276a38c514529fba32d7c57",19,19,0,19,19,0,1,2
"17540","79e22dbf31f50bb42e645cf349cb4bd2",8,8,0,8,8,0,1,2
"17541","79e240653cf2d55b94772b7664c31461",13,13,0,13,13,0,1,2
"17542","79e3f4995869c12461be455bb8e6b122",48,35,63,5.33333333333333,48,0,2,1
"17543","79e6bd0fdad0c5b6aefab0af9c973be2",30,30,0,30,30,0,1,2
"17544","79eb524151124b6f5921ef8e62f34dae",27,26,19,9.94736842105263,11,16,1,1
"17545","79ebe9e2941c0c54bc3c1ed8094f082b",77,62,78,6.91025641025641,77,0,2,3
"17546","79ec989c03f530b8ea242185931a1709",100,65,77,9.09090909090909,100,0,2,3
"17547","79ecf13b181d75c56b52011b3fd645c9",76,64,14,38,76,0,1,2
"17548","79f06b5d57db01abe0639f3e34bf3d57",110,83,61,12.6229508196721,110,0,3,3
"17549","79f188958eb0da510a6a54730f97f723",65,49,46,9.89130434782609,65,0,2,3
"17550","79f3017e26df947354fa68210bc47cb5",32,32,0,32,32,0,1,2
"17551","79f386ac82817f3b8285a5b463d7a9f8",29,24,35,5.8,29,0,2,1
"17552","79f3a9196bb5c11021572def38ca3629",107,70,78,9.6025641025641,91,16,3,1
"17553","79f4c4279b4254194228ad17c765d97e",37,37,0,37,37,0,1,2
"17554","79f4f42a7812ecf3a1cfccfaa84d27ed",38,38,0,38,38,0,1,2
"17555","79f9b69f71ee9a76f5102126a4535111",39,39,0,39,39,0,1,2
"17556","79fa2586ac35f3e073e7379fdb6088b0",200,88,69,20.2898550724638,200,0,3,3
"17557","79fe82642bc09b4af0f1ee556b624315",18,15,35,3.6,18,0,2,1
"17558","7a0045efe7f77ff75056b5d1a3c07e70",127,71,65,13.6769230769231,127,0,3,3
"17559","7a00c087cfb8ba6f896d82282f9f2614",189,96,71,18.6338028169014,165,24,3,3
"17560","7a0217e4be6a199ac2e46df356f2d1ca",149,89,68,15.3382352941176,149,0,3,3
"17561","7a02d8dcd2efa1cbb560453ae4f0e11d",95,62,67,9.92537313432836,95,0,2,3
"17562","7a0486f5cb28e07b3c3683f5df549857",33,33,0,33,33,0,1,2
"17563","7a049b350f320443b2707719e6c3700c",22,22,0,22,22,0,1,2
"17564","7a050640114606286b0a1b079de83123",1,1,0,1,1,0,1,2
"17565","7a05b841eedafc1ee60b64e13cf5cd59",67,52,75,6.25333333333333,50,17,2,1
"17566","7a05f08314543b22b9d773a36aef34fe",48,35,45,7.46666666666667,48,0,2,1
"17567","7a05f533689adf627eba479eca09b9eb",47,47,0,47,47,0,1,2
"17568","7a0764e724b76c6e9c0310e72ee14649",152,88,63,16.8888888888889,152,0,3,3
"17569","7a09231f3a8a54f9892fd2246a6f002f",29,29,0,29,29,0,1,2
"17570","7a0a4e01435edb8cf190572223129ef5",138,87,50,19.32,138,0,3,3
"17571","7a0aa89f82f9f975453c6aac2c8f9ad9",30,30,0,30,30,0,1,2
"17572","7a0de3726e14a053b6061afbb6974a4c",36,36,0,36,0,36,1,2
"17573","7a0ecf28d9b71899e160b76253a0b75c",48,48,0,48,48,0,1,2
"17574","7a159aa46d3f4e7267a9c5758699fbf5",36,36,0,36,36,0,1,2
"17575","7a15cc8832b558b4776c03d5853f3472",29,29,0,29,29,0,1,2
"17576","7a176bba5d3182fc371058fd02ffaab7",99,41,87,7.96551724137931,90,9,2,1
"17577","7a189a028e77d05890afa37acbeaabc7",87,60,50,12.18,87,0,2,3
"17578","7a1b4d879ae8f66ef5092af1e5443876",57,48,49,8.14285714285714,57,0,2,1
"17579","7a1da8ed2caabd450438fa3508fd57e1",18,18,0,18,18,0,1,2
"17580","7a1f240eb1117634479d3e335190202d",50,42,52,6.73076923076923,24,26,2,1
"17581","7a225f583cb3b5d03955d7402df044c4",172,90,63,19.1111111111111,172,0,3,3
"17582","7a22a297d3c5a86c09c886b3b1dc2521",25,25,0,25,25,0,1,2
"17583","7a25178a205d086bc1696c59273a857b",90,72,50,12.6,90,0,2,3
"17584","7a2ce1733204d9efd0b90ab78025ddc3",77,56,32,16.84375,35,42,2,1
"17585","7a2e82d9351d07b6bfec87210b3ea8f2",41,41,0,41,41,0,1,2
"17586","7a308924c1b2ebccf27d48a7d78ccad8",16,16,0,16,16,0,1,2
"17587","7a31426d36167f7b036c71919790f822",26,26,0,26,0,26,1,2
"17588","7a317f6eb858192a96a4c00a21731cae",11,11,0,11,11,0,1,2
"17589","7a321fce1de9e6e5a217b9bbb0b95ce0",63,34,60,7.35,28,35,2,1
"17590","7a322e2be4cd0c3a35865d4ca7b7640d",27,27,0,27,27,0,1,2
"17591","7a32b1ffbc725ceb2f1d53fb85dfe3a3",45,45,0,45,0,45,1,2
"17592","7a3416f0ac55adb78831bb2e5afca4e0",26,26,0,26,26,0,1,2
"17593","7a3bbe31382c017ab9cfb48f1cc23049",39,29,31,8.80645161290323,23,16,2,1
"17594","7a3cb072cdbbbe490af37992f740940c",28,28,0,28,28,0,1,2
"17595","7a3d03260bc162eb8727a1945986a1bf",30,30,0,30,30,0,1,2
"17596","7a403e227fb1b1971a95945a47686769",107,50,78,9.6025641025641,107,0,2,3
"17597","7a412041511caabe709f8ccac74a24c4",48,48,0,48,48,0,1,2
"17598","7a41b228697678f3c8fa8104703a3ab2",34,34,0,34,34,0,1,2
"17599","7a41e454653c9813b475136b9155985a",155,82,77,14.0909090909091,129,26,3,3
"17600","7a43968f74a29a4bff945ac4fd7d3da0",8,5,10,5.6,8,0,1,1
"17601","7a47e53679f4b466ffb2848d64d26254",35,35,0,35,35,0,1,2
"17602","7a483ab41ed80a263537ea0640f31c19",27,21,9,21,15,12,1,1
"17603","7a4a199755fc3723f0e489cce536c68e",119,91,65,12.8153846153846,119,0,3,3
"17604","7a4c57fc37f25a7219cdbfd493c55c95",25,23,85,2.05882352941176,14,11,2,1
"17605","7a4d96b1090c61710caa959f5ee3e9d0",50,24,56,6.25,15,35,2,1
"17606","7a4e7e97c2c0643f6b8a210ac12a4afd",21,21,0,21,21,0,1,2
"17607","7a4ec3ef34bf866ecc8a6ba64bd1fc68",41,41,0,41,41,0,1,2
"17608","7a4f17194667917e69d7d4dbe096fefd",64,53,61,7.34426229508197,64,0,2,3
"17609","7a5122f0a1f1e92ecb598b4bbb8d3be2",217,120,73,20.8082191780822,190,27,3,3
"17610","7a517e383eda03d7b60c30aa9521c2c0",164,70,84,13.6666666666667,123,41,3,3
"17611","7a536dd64f154bb79e8e4a50e4995a32",31,31,0,31,31,0,1,2
"17612","7a5393bb2eb756c515b63b6f9a299c10",110,80,68,11.3235294117647,110,0,3,3
"17613","7a5456c0686c32914385aa8dae0dd172",31,31,0,31,31,0,1,2
"17614","7a54e493334da89fc2b4ea4a032901df",61,45,20,21.35,32,29,1,1
"17615","7a57a4f7450c3719fccd372c5fa2e487",122,60,82,10.4146341463415,122,0,3,3
"17616","7a58f38180e8f908df51cd0c745b30cf",210,65,85,17.2941176470588,171,39,3,3
"17617","7a5b007b2641d68c468ec405f1138592",31,31,0,31,31,0,1,2
"17618","7a5b709965c8a1c4f29e62a991567a9b",25,25,0,25,25,0,1,2
"17619","7a5c789d27a609942b65d4113832a374",31,31,0,31,31,0,1,2
"17620","7a5f68af53990c612a8c639cc2d6dbbb",83,57,47,12.3617021276596,33,50,2,1
"17621","7a5f8e9e28d23ab859f3db87fb852bda",16,16,0,16,16,0,1,2
"17622","7a636f406f2fddf3969cfd527a1dc9c9",92,75,26,24.7692307692308,92,0,3,3
"17623","7a64a6c18e76ee9ca41136bcc5a7d9f8",94,63,74,8.89189189189189,55,39,2,3
"17624","7a65b336932923675fca9e93fd1ff18d",8,8,0,8,8,0,1,2
"17625","7a696b70a7de24d0082495923c4cf6c8",175,136,77,15.9090909090909,175,0,3,3
"17626","7a6b8bec02966788ea23a4ca17197119",26,26,0,26,26,0,1,2
"17627","7a6c60177cac9956bbbb452438e3fa1d",47,35,50,6.58,47,0,2,1
"17628","7a6cb8458f0839577aa0dec0e34c0d8a",27,27,0,27,27,0,1,2
"17629","7a6cdfe8edb33bd1750f4f3190cb1def",124,74,70,12.4,124,0,3,3
"17630","7a6f677e06ae036d6cf1bf296f176384",63,44,29,15.2068965517241,63,0,2,1
"17631","7a6f7ff186d451929ef7aa529157b23e",12,12,0,12,12,0,1,2
"17632","7a6fbd2bf8682353a81d4b31c953f0bd",25,25,0,25,25,0,1,2
"17633","7a728cf84ec0405277a6e43e36f83c3d",23,22,4,40.25,23,0,1,2
"17634","7a73944d8b42cd93d12f931ac2211e2e",15,15,0,15,15,0,1,2
"17635","7a73eb5155aeb2f012cd9c1d27f46f4f",56,47,59,6.64406779661017,56,0,2,1
"17636","7a757e97fb20d1788a3463eb27ec1ff6",51,41,49,7.28571428571429,51,0,2,1
"17637","7a792b6b057ef410cbaf7a3a2816ef5b",105,80,43,17.093023255814,105,0,3,3
"17638","7a797a2de62cc2e2940919a7287649c8",188,91,67,19.6417910447761,188,0,3,3
"17639","7a798fd9455e90854d826bf2d8ccc379",28,28,0,28,28,0,1,2
"17640","7a7a95a6e7c52a272e243975693c174c",117,69,76,10.7763157894737,81,36,3,3
"17641","7a7d4960f28c10ccde6d22f8c37cdb13",139,105,69,14.1014492753623,125,14,3,3
"17642","7a84bf66efbdc59787df22814616def1",144,96,59,17.0847457627119,144,0,3,3
"17643","7a85b30a33a76e54fbd3aebb03ef57e6",18,18,0,18,0,18,1,2
"17644","7a89ebcd5a9254a016139470ed312ba8",22,22,0,22,22,0,1,2
"17645","7a8a5aee71288811ed739a8c58d339e7",48,40,14,24,48,0,1,1
"17646","7a8ae1a8596735e074dd49c06e2626d5",200,152,33,42.4242424242424,200,0,3,3
"17647","7a8e2ac808835ef832741376555791c2",68,59,46,10.3478260869565,68,0,2,3
"17648","7a9153620fac64b80f88e279483b56c6",114,69,70,11.4,114,0,3,3
"17649","7a9196dacba8cc16e6c9e667cf2fcf86",62,48,76,5.71052631578947,62,0,2,3
"17650","7a91c42c3374e8a922911fe9585d3612",101,79,43,16.4418604651163,101,0,3,3
"17651","7a92bc9a75ebb434dce7a9282d3d446c",227,83,80,19.8625,205,22,3,3
"17652","7a95d1f5dbd40e5468b694a9d86122ec",37,37,0,37,37,0,1,2
"17653","7a9ca0cd08ab76a7f190d74251ed25b1",180,97,62,20.3225806451613,180,0,3,3
"17654","7a9d993cdb735e94f68e595ef7bd3c29",71,59,27,18.4074074074074,35,36,2,1
"17655","7a9f61302e29ee2baba9c7ec919c2f8d",15,15,0,15,15,0,1,2
"17656","7aa0e59ed284a95c85ac569080d58714",28,28,0,28,28,0,1,2
"17657","7aa2d5b29a20948be2ccdc7d6e3e7c8b",41,41,0,41,41,0,1,2
"17658","7aa95b1f4f6cf2408269fc3e804bb52a",102,85,76,9.39473684210526,63,39,3,3
"17659","7aa961dd53ae2984121a248cf95adb22",189,86,78,16.9615384615385,135,54,3,3
"17660","7aa98af77b1bcc6b8a7765fe8bb5e8f8",21,17,42,3.5,21,0,2,1
"17661","7aa98d961f409878340c07fb6010d376",5,5,0,5,5,0,1,2
"17662","7aa9e14a75b44ef899499bf339d59bf8",26,26,0,26,26,0,1,2
"17663","7aac17e14df9042e112059ea766aa3f4",36,23,47,5.36170212765957,36,0,2,1
"17664","7aad19904737bd824d17dfdc5690c99b",34,34,0,34,34,0,1,2
"17665","7aad5520933ce905723b7694721a66c9",61,45,75,5.69333333333333,61,0,2,1
"17666","7ab39030e0108845f0132efa5e517c3a",76,64,63,8.44444444444444,76,0,2,3
"17667","7ab3c6a96faabf1bb3985b1d4ecb342d",24,24,0,24,0,24,1,2
"17668","7ab4e165e3550212bf7ca419f214a464",5,3,43,0.813953488372093,5,0,2,1
"17669","7ab61c55bf1ad8a677d2c9b0ec1f3ac1",93,75,37,17.5945945945946,55,38,2,3
"17670","7abf745de6ad5f652010cce4cfc1e4fc",21,21,0,21,0,21,1,2
"17671","7ac02ac4f572d68d4aaf09ecde8fc670",18,18,0,18,0,18,1,2
"17672","7ac03d2abc132877a99dfd2e184ea2e3",144,84,63,16,144,0,3,3
"17673","7ac0e491b30c7004838501f00fd63be2",14,14,0,14,14,0,1,2
"17674","7ac44b8dd55a8bf5a18c286fa1cea2fb",35,35,0,35,0,35,1,2
"17675","7ac810ad280956c664f19a678cc8abf3",34,34,0,34,34,0,1,2
"17676","7acc0a0c252216213152ac0dbfe13956",61,52,14,30.5,61,0,1,2
"17677","7ace9fce0fac8ee22e443b48fd6850f0",30,24,28,7.5,30,0,2,1
"17678","7ad2da058b1f283b734956299785084e",22,22,0,22,22,0,1,2
"17679","7ad48ddc4cb48a91a265c52a65809c90",16,16,0,16,16,0,1,2
"17680","7ad839aa1294bfa728daf6d176dd4511",70,51,35,14,25,45,2,1
"17681","7ad856860a068a6c487583ccf96c3ddf",7,6,38,1.28947368421053,7,0,2,1
"17682","7adb30053478c8a2c34e41ae23ab5524",125,92,79,11.0759493670886,125,0,3,3
"17683","7adbb0be981d71a0eba189a2dc97f65e",18,18,0,18,18,0,1,2
"17684","7adf5654e3699711c210183d34c65622",160,99,53,21.1320754716981,116,44,3,3
"17685","7ae03d86368a667e43a0a02a3361a19e",12,12,0,12,12,0,1,2
"17686","7ae36a0b702dfb27641263c5d892284b",3,3,0,3,3,0,1,2
"17687","7ae4bc636a235024eb083b65bb5c9b5e",30,30,0,30,30,0,1,2
"17688","7ae7b8b08de803a6de541e19f39e3b19",25,25,0,25,25,0,1,2
"17689","7ae9863fbc481f1dc1d8fb1dd957b6bf",110,88,34,22.6470588235294,110,0,3,3
"17690","7aea69e830fd8b4875039534e2c635e3",38,38,0,38,0,38,1,2
"17691","7aeac21f6628b543e64dbce2aef4f03e",57,48,77,5.18181818181818,57,0,2,1
"17692","7aec3a25708d4006a0409399bd40930b",18,18,0,18,18,0,1,2
"17693","7aec92a023c377fce929d4c1ea6a8a1b",163,87,77,14.8181818181818,163,0,3,3
"17694","7aed647191c86549d1ebe56453e1dd6a",73,44,49,10.4285714285714,73,0,2,3
"17695","7aefe8894c04d1783b5f04c8edde950e",23,23,0,23,23,0,1,2
"17696","7af00da3337b322d0dc9b37bcd2985a5",99,78,66,10.5,99,0,3,3
"17697","7af2b413e49496268b997910290143a1",50,50,0,50,0,50,1,2
"17698","7af345933d23348486711b3b021bdc49",30,30,0,30,30,0,1,2
"17699","7af53b01150dc40bc4a492acc5bf76a2",50,50,0,50,50,0,1,2
"17700","7af55cca3c00b9350c3b5d892dd7b9c3",199,116,49,28.4285714285714,199,0,3,3
"17701","7af6d3f1b21c8cbc101b472459e28de6",1,1,0,1,1,0,1,2
"17702","7af728fba9bba014cd0662bb64928952",19,19,0,19,19,0,1,2
"17703","7af834bcb3a6582e947ce84d678612a3",103,77,84,8.58333333333333,103,0,3,3
"17704","7af8704c59c33afd305fe11924cbe306",2,2,0,2,2,0,1,2
"17705","7afc596e7730e9f2dae2b871f70b3bda",76,49,50,10.64,76,0,2,3
"17706","7affb6da57fc47bc043c05b6edbef039",18,18,0,18,0,18,1,2
"17707","7b02d2ddbe8926edcf77f60635f32d64",50,42,55,6.36363636363636,50,0,2,1
"17708","7b0333470a953a69b7cb6c89b2c0a3fa",105,78,59,12.4576271186441,73,32,3,3
"17709","7b047c3e94e7c361b4376de7e3c3f23b",9,9,0,9,9,0,1,2
"17710","7b066eb5c033e2e507de64a4dc8d2520",55,40,42,9.16666666666667,55,0,2,1
"17711","7b07b74be54a922b56e8b9999ff3b41b",101,57,59,11.9830508474576,101,0,2,3
"17712","7b0b501e7e04a4f3e1f07e944988252a",15,13,43,2.44186046511628,15,0,2,1
"17713","7b0b93c12f77cb22810ffe70e05941f7",9,9,0,9,0,9,1,2
"17714","7b0c73aab680592970ec34a6508f4b41",81,73,41,13.8292682926829,81,0,2,3
"17715","7b0dc2ea72a8e6bec89bf8fee3e663d7",76,74,12,44.3333333333333,48,28,1,2
"17716","7b0e749745feced6f082f10e5325761d",40,40,0,40,0,40,1,2
"17717","7b0eb6a5e674c21d9c8a16c1c2b0a7e4",42,27,28,10.5,28,14,2,1
"17718","7b0ec05fdfe387dcefcdfb0899417cf2",20,20,0,20,20,0,1,2
"17719","7b116916ef8261762355a77f448f09e5",82,66,53,10.8301886792453,82,0,2,3
"17720","7b12fb3b40bd15a8081ab878f8fe5a4b",71,54,38,13.0789473684211,43,28,2,1
"17721","7b1490893c6a67d4387673e76cfa1c38",35,29,21,11.6666666666667,0,35,2,1
"17722","7b14ad572410a217f021fa5bb87482d0",15,15,0,15,15,0,1,2
"17723","7b14c4dab3183634877c318620f62bd3",182,119,46,27.695652173913,182,0,3,3
"17724","7b14d8c65d0f027c459592130913f3bf",29,29,0,29,29,0,1,2
"17725","7b16c54d1e9a64eb237efcfedad1c6e6",51,46,26,13.7307692307692,28,23,2,1
"17726","7b17b88ccdc0a21d2741eecff151b5d6",29,29,0,29,29,0,1,2
"17727","7b1a4129cab8770821668e6caa5d66c1",26,26,0,26,26,0,1,2
"17728","7b1c744e848d0b7b45de8e6f1794dd7d",35,35,0,35,0,35,1,2
"17729","7b1d01e72a49b65b7167a809c51168cc",18,17,5,25.2,18,0,1,2
"17730","7b1efc3ae198a1e253483b579ac6e1b8",3,2,53,0.39622641509434,3,0,2,1
"17731","7b200cc6a7d070f34cd81e9c9786af66",68,53,36,13.2222222222222,68,0,2,1
"17732","7b2220c712f6d932ac9bf1018024dbf6",33,33,0,33,33,0,1,2
"17733","7b2307e58615250211a7ce52de0d20be",39,39,0,39,39,0,1,2
"17734","7b25a42fa3ee4431eac762bef97ba242",39,39,0,39,0,39,1,2
"17735","7b266aa8ec7e71522f1e83fea357c146",1,1,0,1,1,0,1,2
"17736","7b26a829ab5ce19ff9b42647e2db8486",98,77,30,22.8666666666667,69,29,3,1
"17737","7b27e5a0abb1ff318e427d28f4d5a50a",51,42,56,6.375,51,0,2,1
"17738","7b27ea6543a84ef7b2adf692e620943d",31,31,0,31,31,0,1,2
"17739","7b2a6bc758063d82f8bb6f0a5bba59ab",24,24,0,24,24,0,1,2
"17740","7b2aaaf68a6c86621e17feb967d14093",96,64,34,19.7647058823529,96,0,2,3
"17741","7b2bf838de372e5f727cf624cba5bda7",101,56,67,10.5522388059702,101,0,2,3
"17742","7b2def7db381a8037c00ecbb705fd984",26,26,0,26,0,26,1,2
"17743","7b30c1d772e1155e0a4e4a6b512084fa",59,47,36,11.4722222222222,26,33,2,1
"17744","7b345273e73b3d50c7c4be5bc6f6bd54",26,26,0,26,0,26,1,2
"17745","7b359becce12e8cd8f16e5c5cb874a41",14,14,0,14,14,0,1,2
"17746","7b35bd1b8bf805e42a01465455e773d3",19,15,46,2.89130434782609,19,0,2,1
"17747","7b35ed5b83b52174baf76800af27f1c6",6,6,42,1,6,0,2,1
"17748","7b37c7d2e2a2ab3cb9b89d842cf66759",20,20,0,20,20,0,1,2
"17749","7b37cfe55caceebfc25139921609ba61",100,52,81,8.64197530864198,100,0,2,3
"17750","7b39c88bce886ed010e2b142bd5f8c84",36,36,0,36,36,0,1,2
"17751","7b3ab08c607c9b91d736e31c826cc625",112,85,52,15.0769230769231,84,28,3,3
"17752","7b3ba59544313e39d4dabd8f7e24308a",131,82,54,16.9814814814815,131,0,3,3
"17753","7b3c5202d25756d7d43e610f96b6953c",15,14,58,1.81034482758621,15,0,2,1
"17754","7b3f1d7b4575fbc200b4069f706f124a",214,105,77,19.4545454545455,166,48,3,3
"17755","7b3fb23f66339825762d74205d6e82e9",27,27,0,27,27,0,1,2
"17756","7b4058804f8cab879000fc43847f4be2",25,25,0,25,25,0,1,2
"17757","7b45d94342017d35095f43da5001f616",38,38,0,38,38,0,1,2
"17758","7b486794c8bccd214d894a07264e805f",18,18,0,18,18,0,1,2
"17759","7b4b493b15578ac547638dff725fd0f3",42,38,7,42,42,0,1,2
"17760","7b4c8fe3688d6203a54800ecace24d60",27,25,9,21,27,0,1,2
"17761","7b4d6955690a82296399afdfa66b07ca",26,26,0,26,26,0,1,2
"17762","7b5133e7965029fff78b2cfc822999f0",182,104,83,15.3493975903614,152,30,3,3
"17763","7b57d4c42e6ac103f8585dc15b029e15",48,31,84,4,43,5,2,1
"17764","7b5b12fe6211aaa2214cf640b683ca90",7,4,63,0.777777777777778,7,0,2,1
"17765","7b5b1c1a80339f93bf576dff53e6cac3",87,51,63,9.66666666666667,87,0,2,3
"17766","7b5d9f4b7d986f9c1e1833a95c1c1e62",1,1,0,1,1,0,1,2
"17767","7b5e23400bb0f689b234007d8978ef54",16,16,0,16,16,0,1,2
"17768","7b5e2fa8c180750079d61483a45482a5",30,30,0,30,0,30,1,2
"17769","7b5f6333c9deef90f02dd7e9c24f321a",41,31,62,4.62903225806452,41,0,2,1
"17770","7b5f938d02850bb8b13fa8a0d92e094a",149,115,34,30.6764705882353,149,0,3,3
"17771","7b614bca1e83507240810c0dd1150554",46,38,29,11.1034482758621,46,0,2,1
"17772","7b61b967ff709420489724fc1f3b1cf7",13,13,0,13,13,0,1,2
"17773","7b63ee84c914da7868fac425b4263dd1",18,16,47,2.68085106382979,18,0,2,1
"17774","7b684e571fe7fcd715bfa45ab6ac9945",43,34,65,4.63076923076923,20,23,2,1
"17775","7b68fe2f57cf0047a7ff0697568f3f37",139,71,63,15.4444444444444,139,0,3,3
"17776","7b69b953935612f7af556c27398b69b5",26,26,0,26,26,0,1,2
"17777","7b6a6c9f031bf5685bbc52c664b24065",118,86,38,21.7368421052632,118,0,3,3
"17778","7b6af0d07f3c81ce8e3315a3491e3267",24,21,41,4.09756097560976,24,0,2,1
"17779","7b6d4ddc6c78d46d586040639d4f6956",82,40,82,7,82,0,2,3
"17780","7b6f91d456fd279767b5aef204f0076c",36,29,69,3.65217391304348,36,0,2,1
"17781","7b7170784ccbc27236332a611171c484",207,141,86,16.8488372093023,207,0,3,3
"17782","7b749ba2c430db12a8df94ac0bb09bb1",139,83,59,16.4915254237288,124,15,3,3
"17783","7b7671a8a06f590c25ab77c493492ad2",48,38,42,8,48,0,2,1
"17784","7b775590eaafd36ed205bf15bb492161",28,28,0,28,28,0,1,2
"17785","7b79c731780d618cec943b1c0b755925",13,13,0,13,0,13,1,2
"17786","7b7b6eab09fb32b83a77e1a6f1f3199c",20,20,0,20,20,0,1,2
"17787","7b7c4cb45e68f3251db5efe9ba968bf6",3,2,42,0.5,3,0,2,1
"17788","7b802df7d51ceb578fa52241e6e6baa7",31,31,0,31,31,0,1,2
"17789","7b80cad24bf3fe41a33cd5dd7c8b1324",43,43,0,43,43,0,1,2
"17790","7b8193c32af87d8d56113aa77afd410b",46,44,6,53.6666666666667,46,0,1,2
"17791","7b820ccfadac4afb0b07759cc713e9ae",41,36,45,6.37777777777778,41,0,2,1
"17792","7b83be58c49eea99b7e4e92b21b69872",55,44,56,6.875,1,54,2,1
"17793","7b84595c323d42931549ea082ba33ea8",16,16,0,16,16,0,1,2
"17794","7b875bbbaa61ccf2e08e4769a2517279",42,36,55,5.34545454545455,42,0,2,1
"17795","7b8a49a9b7593c646bd2041d2a1b786e",15,15,0,15,0,15,1,2
"17796","7b8bb0d968e38504fabb9cb145e8403f",36,36,0,36,0,36,1,2
"17797","7b8f9514905c12ee0afa90e0b14148df",117,75,63,13,117,0,3,3
"17798","7b9187c2b0c132c6b71a181cd531f838",10,10,0,10,10,0,1,2
"17799","7b977918f29fb3797163479e0ef3f3ff",25,25,0,25,0,25,1,2
"17800","7b9aed7976b3dc863839b4e9753580e7",66,40,56,8.25,66,0,2,1
"17801","7b9dd68879694acc36d1c345c73762ea",41,41,0,41,41,0,1,2
"17802","7b9f4c1f018fcbd45a513d10a0ca1243",96,74,55,12.2181818181818,96,0,2,3
"17803","7b9f8c246b54a7ae961ac1ea7b6b7a26",28,28,13,15.0769230769231,28,0,1,1
"17804","7ba1d64561efba6b006f70dad2b72bb8",34,34,0,34,34,0,1,2
"17805","7ba4fef81903d1900359af56704d2104",3,3,0,3,3,0,1,2
"17806","7ba9442507daec1aac51fec1d69182af",132,72,60,15.4,132,0,3,3
"17807","7baa7421f028ced8aec7be68be35b132",167,109,68,17.1911764705882,167,0,3,3
"17808","7bae7b94f05ac96f45eff2f9e721176e",33,33,0,33,33,0,1,2
"17809","7bb08a2a32c2cac1a36c2bf6510c35bf",28,27,6,32.6666666666667,28,0,1,2
"17810","7bb29e1b6ddf04c6bf27d72ffc1bc803",145,35,85,11.9411764705882,145,0,3,3
"17811","7bb40e6d4f248dfbdc8b28ca15f83033",118,66,47,17.5744680851064,75,43,3,3
"17812","7bb8affb18398b7d86ca59ec9e56ec8f",1,1,0,1,1,0,1,2
"17813","7bbc40d591ae89562c8b53ed6289c671",149,97,67,15.5671641791045,149,0,3,3
"17814","7bc2fc0dbc1524f1f0e0916b5d59b05f",48,48,0,48,48,0,1,2
"17815","7bc343903c5cbb34779efd1e7067ef3b",4,4,0,4,4,0,1,2
"17816","7bc6bae7384d58824fb0aed0c2f76374",30,25,65,3.23076923076923,5,25,2,1
"17817","7bc7298f02d12551d61488d72d65c056",185,55,70,18.5,134,51,3,3
"17818","7bc981a405bc370da345e5824300096d",36,36,0,36,36,0,1,2
"17819","7bca871bd80b0d973d239d993723473d",16,16,0,16,16,0,1,2
"17820","7bcb15ae9c5ad5f4182dd992e6541076",74,53,26,19.9230769230769,74,0,2,1
"17821","7bcc45faec220652868cedd5708d39b9",26,26,0,26,26,0,1,2
"17822","7bcca6dc036701b3eed6b128cd597d72",68,44,77,6.18181818181818,23,45,2,1
"17823","7bcd1aced749fd1b97223c6f21e279ea",148,107,77,13.4545454545455,127,21,3,3
"17824","7bcee25ab331ceb645afecee926f000e",39,39,0,39,39,0,1,2
"17825","7bd17fc5af7b426e3427bb8026a04cd6",7,7,0,7,7,0,1,2
"17826","7bd2ba9bc8d9dcfd8240cbf7366cdf6b",186,89,83,15.6867469879518,173,13,3,3
"17827","7bd49ae859a4b1c56c0afb718fa96d68",147,75,61,16.8688524590164,147,0,3,3
"17828","7bd6bc4c48ab694dbf57c902afbffbae",92,44,56,11.5,72,20,2,1
"17829","7bd6ef7af277cde02fec9addcc0fdb9b",30,30,0,30,30,0,1,2
"17830","7bd772bf168b6c811046285c1996c385",34,34,0,34,34,0,1,2
"17831","7bd8bd1e70924d2cd2a8570ddb3fbb13",146,74,63,16.2222222222222,146,0,3,3
"17832","7bd943f3a08c365b049d9df82bba0003",49,30,28,12.25,0,49,2,1
"17833","7bd964a775f3da8907234ead36e9eab9",219,85,77,19.9090909090909,219,0,3,3
"17834","7bda564d0eed73fde133ab4e3e77ba72",26,26,0,26,26,0,1,2
"17835","7bde27fb108f2d0f53aa164ebe8be4fe",14,14,0,14,14,0,1,2
"17836","7be1707239235d6ca09c47a102638ac8",65,52,39,11.6666666666667,65,0,2,3
"17837","7be339f5909bcc11911ef6c2745e1cdb",96,68,35,19.2,96,0,2,3
"17838","7be4826f0df4b78dc9f05f8526faff7c",111,77,39,19.9230769230769,111,0,3,3
"17839","7be5813a3fbd5fac1eb2dde84049d03e",105,87,35,21,105,0,3,3
"17840","7be77d6cd73221d40d6ddbe7896e7ce6",89,68,59,10.5593220338983,89,0,2,3
"17841","7be98196bd2dc5a3229a3b8cb1c13b15",96,76,28,24,96,0,3,3
"17842","7bed715a2735f83f5ed48006dcd0cd7c",116,96,24,33.8333333333333,116,0,3,3
"17843","7bf23bf78037777f7e767dbefa99392e",114,82,77,10.3636363636364,114,0,3,3
"17844","7bf240f895284903d81ba340cc003fc8",93,71,32,20.34375,93,0,2,3
"17845","7bf3ac56ee6adc82f87f541c77f6509b",27,27,0,27,0,27,1,2
"17846","7bf501bb57a69ea1aba6b33eb641054a",8,8,0,8,8,0,1,2
"17847","7bf7335e143b1e6d2dd33d84bcce9020",37,37,0,37,0,37,1,2
"17848","7bf9e81ea1599c720fce1a14e78409fa",79,39,77,7.18181818181818,79,0,2,1
"17849","7bfb0730388ac0777b2a6b70a3fdb111",51,43,36,9.91666666666667,51,0,2,1
"17850","7bfb198f80d4a1b6770b032b794b1a72",37,37,0,37,37,0,1,2
"17851","7bfc7361c774a2ff3768bb4f5306d52a",90,64,66,9.54545454545454,61,29,2,1
"17852","7bfff26c0bd68127d47c30b47cc49fbb",2,2,0,2,2,0,1,2
"17853","7c01bf94085d814b458dbf1f959a332d",4,4,0,4,4,0,1,2
"17854","7c02fd8de6b808fc5f66aa5c7f81cddf",44,44,0,44,44,0,1,2
"17855","7c041fd89c0ecd5f7197be5bec24f8de",15,11,37,2.83783783783784,7,8,2,1
"17856","7c08076e9dee2bdac275fb31c0ba8d09",46,46,0,46,46,0,1,2
"17857","7c09cd9cd9f49975add073e77600d84e",3,3,0,3,3,0,1,2
"17858","7c0e7bb19292debe8ffd3a3df2d585ec",20,20,0,20,20,0,1,2
"17859","7c0ec99b54a6bceb9bb09c132fce5241",130,86,49,18.5714285714286,130,0,3,3
"17860","7c0f86ecd9cf305463a6b446def4c493",88,44,66,9.33333333333333,88,0,2,3
"17861","7c0fda903db37ff71e50fc64cecc6632",23,23,0,23,23,0,1,2
"17862","7c108f826bf21fec67ac3c9249104aab",84,63,50,11.76,84,0,2,3
"17863","7c12a4ea92c63ac821b4106c4584b064",22,22,0,22,22,0,1,2
"17864","7c14ab710b0ff658871c43a2b3ad00c8",52,39,57,6.3859649122807,26,26,2,1
"17865","7c15359229e9b7bfa7f9515d2b70f1ce",19,19,0,19,19,0,1,2
"17866","7c167f567e67720c5b45637e0f6105a0",19,19,0,19,19,0,1,2
"17867","7c174789bad67e1e331d7cbb335a4250",34,34,0,34,34,0,1,2
"17868","7c189ee95bb692a789f03b1711c7789c",111,73,78,9.96153846153846,111,0,3,3
"17869","7c193c58c543442be12dc93eb70b955e",68,45,77,6.18181818181818,68,0,2,1
"17870","7c1b458b94d53e2603e3a12463637540",15,15,0,15,15,0,1,2
"17871","7c1ba897324a652e268d4b22570a771b",128,91,65,13.7846153846154,95,33,3,3
"17872","7c1eb0703e05e30519005131dcfef1a5",115,74,69,11.6666666666667,73,42,3,3
"17873","7c20037eb4ca7694b9b7f2fdf72a4584",22,22,0,22,0,22,1,2
"17874","7c20cd49c25b4427dfdfe5cd591febd6",7,7,0,7,7,0,1,2
"17875","7c20f1bc1c164eef61689ff0edf2c382",46,46,0,46,46,0,1,2
"17876","7c2213bca4e1dc66ab6d7dc3e8075f67",50,47,63,5.55555555555556,50,0,2,1
"17877","7c221f3a4ace6c63f10601238e36af78",36,36,0,36,36,0,1,2
"17878","7c22ab9f520a751938b228e786253cac",83,65,69,8.42028985507246,30,53,2,3
"17879","7c22e30055c07e07e8ae6e83179e96c6",88,63,31,19.8709677419355,88,0,2,3
"17880","7c28fbeb3381a1dbf929cf69ac37a61c",1,1,0,1,1,0,1,2
"17881","7c29055dd158f0e2e9977dd300be88e8",74,59,26,19.9230769230769,45,29,2,1
"17882","7c2d64cf7ef55d7d34cb2ad566911770",44,34,46,6.69565217391304,44,0,2,1
"17883","7c3297dad6bca0ad5f53cc202c5d2d53",62,33,70,6.2,62,0,2,1
"17884","7c32d3e42fbd1e469aba716547b0d301",40,40,0,40,40,0,1,2
"17885","7c34b4d07cec9fc21f3d64d51ea7151e",34,32,15,15.8666666666667,15,19,1,1
"17886","7c35afddcd90fd7a18c24d9fc156551c",35,35,0,35,35,0,1,2
"17887","7c365baa082ae9b4abd9442a17e5ae86",47,47,0,47,0,47,1,2
"17888","7c36b69ac8c7b79397c1a60d5106c7bc",79,65,44,12.5681818181818,26,53,2,1
"17889","7c378e2ae033c23eca7c78a1c176dda7",102,78,30,23.8,55,47,3,3
"17890","7c39adf957a7da7deeed38ba80eac185",2,2,0,2,2,0,1,2
"17891","7c3de90935d81bd78fd3fd2888601afa",2,2,0,2,2,0,1,2
"17892","7c3f56cc62f294990d87f54f318447f6",19,19,0,19,19,0,1,2
"17893","7c41af0c6b30ee3e7775e52eda13d73f",247,127,70,24.7,212,35,3,3
"17894","7c42b841118850cb3287f056caecdf0d",43,34,36,8.36111111111111,43,0,2,1
"17895","7c4380f48de0bddf9144918ca9e4c1ce",35,35,0,35,35,0,1,2
"17896","7c460eefa24cb7ee76e36f2969260643",87,57,50,12.18,87,0,2,3
"17897","7c47070d97a9dc5ab6ef520cfadca780",48,25,32,10.5,48,0,2,1
"17898","7c476d9720a0db7b457a4f992d7178b7",14,14,0,14,14,0,1,2
"17899","7c4897f485af5e768bd4c241b977f3d1",202,110,70,20.2,202,0,3,3
"17900","7c49a7efb64a4e25bbbd20f6776db0a0",14,14,0,14,14,0,1,2
"17901","7c543d9d39037986ed686ef58d5e37dd",159,74,76,14.6447368421053,159,0,3,3
"17902","7c54eb0203b971036b73651d319959a4",125,91,57,15.3508771929825,102,23,3,1
"17903","7c555029fc46479342d1b5b3c3c12cdb",78,59,47,11.6170212765957,44,34,2,1
"17904","7c56b48a09f8285b076cf750186f7829",19,19,0,19,19,0,1,2
"17905","7c57609071fa5706264c6dac9e97f1a4",61,46,13,32.8461538461538,61,0,1,2
"17906","7c57681cde21d9291c527b87a576c786",37,37,0,37,37,0,1,2
"17907","7c5b2b6bbc58fb6152922ac5010d0a97",20,20,0,20,0,20,1,2
"17908","7c5da85421df27de81aebaad1fb9be90",37,37,0,37,37,0,1,2
"17909","7c5e16ef0c5641746888ebc081ee212e",80,60,59,9.49152542372881,32,48,2,3
"17910","7c600347818cbc988fa3ebee5da08f62",38,38,0,38,38,0,1,2
"17911","7c6607705a3dc3b96d5974f3a6b323f1",20,20,0,20,20,0,1,2
"17912","7c6646e66356a0f68efa2be2fb94a17e",55,55,0,55,55,0,1,2
"17913","7c6a642f88e54a9efb4007408f17803e",2,1,7,2,0,2,1,1
"17914","7c6dbccc285f44810a44fcf8496a41a4",10,10,0,10,10,0,1,2
"17915","7c7525a7c3f9f870e593e66015925635",37,37,0,37,0,37,1,2
"17916","7c78ab76346f0937b574963c5b5e4cb1",33,33,0,33,33,0,1,2
"17917","7c78f3fecfd0d351999571f5f0ab4e17",47,35,47,7,47,0,2,1
"17918","7c7987a555b0ea499d01db4660c74de9",6,6,0,6,6,0,1,2
"17919","7c7a106fbbbff7a6f4bd7153d0843cef",12,12,0,12,0,12,1,2
"17920","7c7b499b38494b32bc04190909d71228",25,25,0,25,25,0,1,2
"17921","7c7dbc20e67d50cbbc48494d318592b2",148,89,89,11.6404494382022,109,39,3,3
"17922","7c81517d70fb934f0d57b75055a4da9f",30,27,73,2.87671232876712,30,0,2,1
"17923","7c820cab6203a19f0646f2b85a2af1a8",47,47,0,47,47,0,1,2
"17924","7c853ff84d03fcd434fdb2bf0e716b05",21,21,0,21,21,0,1,2
"17925","7c865e6cabb0a068ed1463f412b6c3e9",30,30,0,30,30,0,1,2
"17926","7c86a501ad5a6661849202f3987c2caf",19,19,0,19,19,0,1,2
"17927","7c86b8709dec176e1200926886be46dc",231,100,82,19.719512195122,217,14,3,3
"17928","7c8979c2104f67d70ce133d9c93f9db6",78,54,80,6.825,30,48,2,3
"17929","7c8996b4d1ae1eab5a8de653b8e7ac13",19,19,0,19,0,19,1,2
"17930","7c89b49d19572862903319daeee184d5",22,22,0,22,22,0,1,2
"17931","7c8c97f7c7e08b563b0808c8c380efda",26,26,0,26,26,0,1,2
"17932","7c8d14c62fede8ad385448e3d4cf8909",33,33,0,33,33,0,1,2
"17933","7c8d6e39acecff5320e84828f39eaf88",35,32,28,8.75,0,35,2,1
"17934","7c8e88df04e0845acdd0e625646a1f4d",25,25,0,25,25,0,1,2
"17935","7c8ead6bc03c9543ff372d13e084dd26",10,10,0,10,0,10,1,2
"17936","7c9243d92e5a39224320fdb9cb22bfc6",2,2,0,2,2,0,1,2
"17937","7c95d91abee795bde036be8a49f8eeb1",162,77,76,14.9210526315789,136,26,3,3
"17938","7c9a14b1249c9a66d8266603cadaeb70",42,42,0,42,42,0,1,2
"17939","7c9de4f1f19b506448c16afb5c085512",12,12,0,12,12,0,1,2
"17940","7c9eb40831c573576d0d04ec6257b400",125,76,80,10.9375,96,29,3,3
"17941","7c9ee172d8308947c53248411cfb0387",93,69,56,11.625,93,0,2,3
"17942","7ca0e5284a8e2541877c88654b365259",20,20,0,20,20,0,1,2
"17943","7ca13d8ac43c52757f65788059b7803c",23,23,0,23,23,0,1,2
"17944","7ca6c54fbe548f7492afed13b3261e4b",33,33,0,33,33,0,1,2
"17945","7ca70567ec9055fb54361c495f2816fb",38,38,0,38,38,0,1,2
"17946","7ca90db2c3bc15b4272793d3129663de",26,26,0,26,26,0,1,2
"17947","7caa0987dd6a119f7710c86895d84365",145,88,74,13.7162162162162,145,0,3,3
"17948","7cb11cd24dbb1d2ed3d25f0115cc1805",4,4,0,4,4,0,1,2
"17949","7cb15045862443bfa10362d48b15cffc",13,13,0,13,13,0,1,2
"17950","7cb24b2592755c5b75f4d2ca53af84d1",103,56,66,10.9242424242424,83,20,2,1
"17951","7cb2925629bb9eca4080d5b3f2a43f24",179,83,83,15.0963855421687,179,0,3,3
"17952","7cb513ac6bf65ce9aa8f08fe4b96a9d8",110,90,42,18.3333333333333,110,0,3,3
"17953","7cb744576bb89a3ee668c43571be96eb",46,46,0,46,46,0,1,2
"17954","7cb875d5bba49966d3812f1789773894",61,40,52,8.21153846153846,61,0,2,1
"17955","7cbced7eba92cc2810d98c678edd5028",162,101,67,16.9253731343284,125,37,3,3
"17956","7cc0f2fb81b6178fe017ccd93271b58a",16,16,0,16,16,0,1,2
"17957","7cc0ffae07cc8e58050cdf523302d1c4",28,28,0,28,28,0,1,2
"17958","7cc10122c8f682f5f75ff087d39cad86",18,18,0,18,18,0,1,2
"17959","7cc26a5df739cc4a5ff5729d7dea2c64",79,53,53,10.4339622641509,54,25,2,1
"17960","7cc4c700191f5ac2b011e89c7ffb44d0",181,127,77,16.4545454545455,135,46,3,3
"17961","7cc8419146635969e52560a51e7a56a8",29,29,0,29,29,0,1,2
"17962","7cca0af58f81d4814a7429059f0e6ade",36,36,0,36,36,0,1,2
"17963","7ccea4b9904274dcd3c94fe5d3f3508f",30,30,0,30,30,0,1,2
"17964","7ccedeaa93668f26730a2fb36e9f1f2f",180,115,63,20,140,40,3,3
"17965","7cd29d4535f8378b9a18eaa33112bb40",110,56,29,26.551724137931,110,0,3,3
"17966","7cd345437e9b0481551633edb87ae105",39,39,0,39,39,0,1,2
"17967","7cd639d648de96db4d578e00ca83bab5",20,20,0,20,20,0,1,2
"17968","7cd7a76804da535f87990892a6083347",115,80,36,22.3611111111111,115,0,3,3
"17969","7cda20e5322e8edb2437e713ebdd54a7",31,31,0,31,31,0,1,2
"17970","7cdd5ec6a24d2d9e490b1ddd0b9b9d5a",46,46,0,46,46,0,1,2
"17971","7cded73f00270534b74695dfdd7b36ea",39,28,81,3.37037037037037,39,0,2,1
"17972","7cdf0e9c471578c0aa8aa500517eada9",105,75,55,13.3636363636364,105,0,3,3
"17973","7ce0c9fc41d04516c43ec46271639ec3",41,36,69,4.15942028985507,41,0,2,1
"17974","7ce1c50abc98315fa9c923d759f32072",118,85,38,21.7368421052632,118,0,3,3
"17975","7ce1c5735f5d3013818544c26afd4b41",58,50,46,8.82608695652174,36,22,2,1
"17976","7ce46c2fb06e1b3e847eb210d2603cfb",5,5,0,5,5,0,1,2
"17977","7ce48644476220e1a67425241bdb23ac",41,33,35,8.2,0,41,2,1
"17978","7ce65595c01fd7c09b6de9cf5cba8494",103,62,51,14.1372549019608,103,0,2,3
"17979","7ce771604b11ecfb289e351d7783acdb",110,94,40,19.25,56,54,3,3
"17980","7ce987bc69f5ab83b16247922811ff74",47,47,0,47,47,0,1,2
"17981","7ce9ca3cca8ff9e88f15e4bee305f3ea",31,22,83,2.6144578313253,31,0,2,1
"17982","7ced9844e8a79b65f857667c4d657c07",40,40,0,40,40,0,1,2
"17983","7cedafa21b0393d97a746ddf43a38d27",152,117,67,15.8805970149254,128,24,3,3
"17984","7cedeeaeb5c002e2ae41ec038c5d235e",56,44,35,11.2,56,0,2,1
"17985","7cf058f06c95de0527a55a5f3dc4ff8b",18,18,0,18,18,0,1,2
"17986","7cf40a51a6f1cda7b55ae71ff8c4279b",86,64,43,14,86,0,2,3
"17987","7cf5285b5c128c64705211765392522c",101,69,46,15.3695652173913,101,0,2,3
"17988","7cf5dd51aee184b5fe8c805dbc41dc61",39,39,0,39,39,0,1,2
"17989","7cf756f2c7de5705e1d532c161085b86",75,58,62,8.46774193548387,42,33,2,1
"17990","7cf82c404f53f9ea0e60569680bf96e9",121,72,71,11.9295774647887,97,24,3,1
"17991","7cfabc83fe748f12b735c31931ae10e7",206,115,77,18.7272727272727,193,13,3,3
"17992","7cfb80173236557c788c928024ce2fd6",37,37,0,37,37,0,1,2
"17993","7cfda51aaaef8ac014a338c5664dd677",64,48,24,18.6666666666667,64,0,2,1
"17994","7d030637802e5f6e5b5ce77fd5bcfdc0",20,20,0,20,0,20,1,2
"17995","7d036f89c0a58ac9ddf908ecf03a7bd3",33,33,0,33,33,0,1,2
"17996","7d0655874da5c9ae96067de8b0f6a487",23,23,0,23,23,0,1,2
"17997","7d08720573058a73a9eeb039e6c4d283",37,37,0,37,37,0,1,2
"17998","7d08f0e2a42426f014ed1741a91b87be",34,19,40,5.95,34,0,2,1
"17999","7d0ac3a4c7ab89018de7c12c3bbe426b",24,23,4,42,24,0,1,2
"18000","7d0c24a15866e5197a1d7f2d6675c098",96,79,24,28,96,0,3,3
"18001","7d0c5b87ae160a8a6352bcaccafb0e5b",18,18,0,18,18,0,1,2
"18002","7d0f280fbe7c0dceb8bcc3733ab1a27c",160,106,48,23.3333333333333,160,0,3,3
"18003","7d0f49cf87fc79beb9892af930cfc670",76,38,20,26.6,76,0,1,2
"18004","7d0f53f6ccb2b736e80fefb517711b14",29,29,0,29,29,0,1,2
"18005","7d101b61027b6341142b68c558620325",68,54,45,10.5777777777778,68,0,2,3
"18006","7d11a1146b9ec06480be320ee9dcf38c",30,30,0,30,30,0,1,2
"18007","7d12ac9755ff3b2548cb5a8596cc144b",40,40,0,40,40,0,1,2
"18008","7d1606453cb898989ed31f0ef7c6f45c",27,27,0,27,27,0,1,2
"18009","7d211f708630535ed7cc7fad2ff39649",37,30,86,3.01162790697674,15,22,2,1
"18010","7d220df8cfe6d510a386088dd1198e52",91,49,59,10.7966101694915,67,24,2,1
"18011","7d231c32fd0800b48efbaef5ca90a48f",70,56,40,12.25,70,0,2,3
"18012","7d25ef67a929ab1b9f1a5b108dea8be2",29,19,43,4.72093023255814,29,0,2,1
"18013","7d2672eed6289edbaf3fd4f40ac058d4",43,38,50,6.02,43,0,2,1
"18014","7d26df551c761b1082bd1de9004c7b09",219,149,79,19.4050632911392,219,0,3,3
"18015","7d27277b65aaa9b9b4a8d948b3520235",113,90,49,16.1428571428571,113,0,3,3
"18016","7d2af2af0b438562e6839fe2552fd02a",25,19,34,5.14705882352941,25,0,2,1
"18017","7d2be7b56754e682c805fc7655b15a5c",60,46,51,8.23529411764706,36,24,2,1
"18018","7d300b3ed1b0dc3d279f7c743b77fb59",23,23,0,23,23,0,1,2
"18019","7d30840099f8064fbb8d1a1b225a073a",60,45,28,15,41,19,2,1
"18020","7d33b1b240b54f272d599db406e805b0",151,96,55,19.2181818181818,151,0,3,3
"18021","7d3505e80fe53a4ef2e352d68b624ef2",92,58,76,8.47368421052632,92,0,2,3
"18022","7d35e8dd76962db1ba923e39c546d7b3",14,14,0,14,14,0,1,2
"18023","7d39a21b288f5f04b7b24100a1e61f6e",74,53,60,8.63333333333333,74,0,2,3
"18024","7d3a37bbde33ffa07bb2c4576d9457b9",15,9,44,2.38636363636364,15,0,2,1
"18025","7d3d613a9e3d79b66274f69f14ce5635",29,29,0,29,29,0,1,2
"18026","7d3e398b4e9b2b698f1bd51469391bcc",40,40,0,40,40,0,1,2
"18027","7d3e63877d2ebeccb9fac29b9d93d5f8",29,24,66,3.07575757575758,29,0,2,1
"18028","7d3ebba20c22388fea134ec37aa70465",42,26,70,4.2,30,12,2,1
"18029","7d4093abb7e8045b67a548249f7b29b3",15,15,0,15,15,0,1,2
"18030","7d43586b88575dcb3c2bc4e2a7419033",47,30,46,7.15217391304348,47,0,2,1
"18031","7d435aebefeb77f5d72c26db02e5ad9e",25,25,0,25,25,0,1,2
"18032","7d4912ebd8f78a091aeaaa3fb1ef8db1",40,36,37,7.56756756756757,40,0,2,1
"18033","7d4a34b64e0a492a838b250d20e3d18d",56,44,12,32.6666666666667,28,28,1,2
"18034","7d4aaf49822b7afbed2d3d9d0020b297",124,75,71,12.2253521126761,96,28,3,1
"18035","7d4d0e16752c08b8867d2827f6a40a06",47,40,28,11.75,0,47,2,1
"18036","7d4dc09059467a0526b54be44256e14c",17,14,49,2.42857142857143,17,0,2,1
"18037","7d503135ea12b67a709a49c09a18f74b",52,33,18,20.2222222222222,52,0,1,1
"18038","7d5126f47fdab573816b4d2cc7a40276",14,14,0,14,14,0,1,2
"18039","7d52195df49557128158fd69e11f6815",94,57,79,8.32911392405063,94,0,2,3
"18040","7d53a6f44026912398ae8ea0eb5af3b7",57,48,11,36.2727272727273,26,31,1,2
"18041","7d53f2999d1650c28ceb3f13ddb68142",66,57,84,5.5,66,0,2,3
"18042","7d54bb9380067db95d681a7ce0f1aecc",30,30,0,30,30,0,1,2
"18043","7d56fcc630c7cdaeb47ce53ddf1f8905",9,8,53,1.18867924528302,9,0,2,1
"18044","7d59126517986c568a28c845259bacd1",200,89,69,20.2898550724638,200,0,3,3
"18045","7d5a05bd30debc4fdb0ede87df5b4a57",29,29,0,29,29,0,1,2
"18046","7d5affa8a5dfcc61666c1ec61feb4ec3",41,41,0,41,41,0,1,2
"18047","7d5b17c8fced06ca70c65dbb36c41279",230,115,85,18.9411764705882,200,30,3,3
"18048","7d5f3c291a5e6ae935d4b139683553c2",38,38,0,38,38,0,1,2
"18049","7d5f766a1343e4a4274c3c9cc4cd1fe8",24,24,0,24,0,24,1,2
"18050","7d6023df2e0de92583dc957a7080a403",26,26,0,26,0,26,1,2
"18051","7d632f9ea8eac8f24b694fa023e0f8e5",28,28,0,28,28,0,1,2
"18052","7d69c658e944558ac2f6b2084480505b",35,35,0,35,35,0,1,2
"18053","7d6a594dffd47fe46c325da0c16c0887",15,15,0,15,15,0,1,2
"18054","7d6b2b298486720894e060a69bf7d4b8",172,90,84,14.3333333333333,172,0,3,3
"18055","7d6f35133fd8f33de2e04667e25d746b",28,28,0,28,28,0,1,2
"18056","7d7116d8071397732e3c1da536c639d8",21,21,0,21,21,0,1,2
"18057","7d726ec45072ed0ff94e4bf9f84e686f",11,11,0,11,11,0,1,2
"18058","7d786f20ad1d7a5936b0de6154806826",33,33,0,33,33,0,1,2
"18059","7d7a263a1c071bbc7608780af906d591",91,67,28,22.75,91,0,2,3
"18060","7d7b67f2dd45486ed14ec787c8d9808e",85,44,70,8.5,85,0,2,3
"18061","7d7cbd6336d0f36090f65ff32a57124b",38,36,55,4.83636363636364,20,18,2,1
"18062","7d7d8f64e82b9544d85791520189b01e",47,35,43,7.65116279069767,47,0,2,1
"18063","7d7dc9f77a77616d4c792db9a3ac94a7",11,11,0,11,11,0,1,2
"18064","7d820fc6782c4430d54cb35353de9015",6,6,0,6,0,6,1,2
"18065","7d8326e386f020c08beac30479f5795f",158,93,68,16.2647058823529,158,0,3,3
"18066","7d84030ad976776df610248e1e7a037a",15,15,0,15,15,0,1,2
"18067","7d8575440622a1d74bdd65521122a8bb",60,53,12,35,60,0,1,2
"18068","7d85d7ee304587798cb3c0276e2d8c65",128,69,58,15.448275862069,98,30,3,1
"18069","7d878a72ccb9c389cf66ee51c8725284",52,52,0,52,52,0,1,2
"18070","7d8813d16d023efbfd64ed684dfde2e6",22,15,59,2.61016949152542,22,0,2,1
"18071","7d8a1aba8ffc61ec2144e7f63b3f154a",34,31,28,8.5,34,0,2,1
"18072","7d8bbd5f37701d4a00a4e4ea096c3f7d",22,22,0,22,22,0,1,2
"18073","7d8da53b0e566eef661da41546972ffd",15,15,0,15,15,0,1,2
"18074","7d9405d244dda23fac3952aca8d05917",112,49,76,10.3157894736842,112,0,2,3
"18075","7d9653c0377d55a44dd12193a43b1e34",41,35,46,6.23913043478261,25,16,2,1
"18076","7d9a880959754a9efd98e97de3cf7462",29,29,0,29,29,0,1,2
"18077","7da06ff868a723c3179be25688e64716",113,82,58,13.6379310344828,67,46,3,3
"18078","7da14cd4a39cb0f9954f2c17bc5f4682",162,82,84,13.5,125,37,3,3
"18079","7da360c5d973ce1cba3c594ff7d2789a",18,18,0,18,18,0,1,2
"18080","7da433b9cdf28bfd87195633ea19e8bb",82,58,60,9.56666666666667,43,39,2,1
"18081","7da553de6ff2bf0b499c46d32b665ca5",173,70,73,16.5890410958904,154,19,3,3
"18082","7da6c783628551c4165b2b377c387175",37,37,0,37,37,0,1,2
"18083","7da7fc84f61410a035ab0d9c0e647d30",89,56,52,11.9807692307692,89,0,2,3
"18084","7da845232e6031c5f5721a8e564ec134",46,46,0,46,46,0,1,2
"18085","7da897a8e1f4e79d576ca5cc65fb27b6",176,91,63,19.5555555555556,176,0,3,3
"18086","7da8fd570163409f73690a937328fd32",49,49,0,49,49,0,1,2
"18087","7daa8b18cf6360328b157f740c8a3929",11,11,0,11,11,0,1,2
"18088","7dab8ff9bb4c77a6c318e39a301e9bdc",26,26,0,26,26,0,1,2
"18089","7db364ad5943c0fdc96eed621ae57266",57,40,20,19.95,57,0,1,1
"18090","7db676e13e6a276a41c5bc12e041461f",79,64,43,12.8604651162791,35,44,2,1
"18091","7db7e4fe8cf52ee1383314654edd1045",192,91,60,22.4,162,30,3,3
"18092","7dbd0d7a603cc98cee767d5a6aabc983",189,66,72,18.375,157,32,3,3
"18093","7dc1236c32613d2d29108d1cdacead0e",38,38,0,38,38,0,1,2
"18094","7dc146a58b8bece1e87ace181adf1b38",41,41,0,41,41,0,1,2
"18095","7dc29295b6d4a39e82f3ce6d173b3e1d",37,37,0,37,37,0,1,2
"18096","7dc352eb1862adedda19d3227af9e46e",180,116,53,23.7735849056604,135,45,3,3
"18097","7dc644217f3c5210824404dff503158a",74,50,74,7,65,9,2,1
"18098","7dc912482a06680d735734caceb1f38f",95,80,39,17.0512820512821,95,0,3,3
"18099","7dc958ef9296244e1c17db6b240da47f",42,24,68,4.32352941176471,32,10,2,1
"18100","7dca3a89209c99aece8827d8a03298d6",46,35,51,6.31372549019608,46,0,2,1
"18101","7dcbaade800ad55054b278e8270a7c43",91,71,55,11.5818181818182,62,29,2,1
"18102","7dcd3d1fe999b93365d9b36cb4db8b12",13,13,0,13,13,0,1,2
"18103","7dcd9c038bd7987eb4cb8543c1d9cfec",38,20,56,4.75,38,0,2,1
"18104","7dcdd6b52c001f7faf44fcea3df88f1e",171,90,70,17.1,171,0,3,3
"18105","7dcff9a9609e11eaaf706693db438829",15,15,7,15,15,0,1,2
"18106","7dd1bb181da7b941a42692bf63c5270a",6,6,0,6,6,0,1,2
"18107","7dd31094715fdd5f96178758fd0b938e",55,55,0,55,55,0,1,2
"18108","7dd5b5c972ada4b8a4832831c60af9c0",35,31,29,8.44827586206896,35,0,2,1
"18109","7dd69b4979ed9e5d5fef6079dbdc5a62",140,61,56,17.5,140,0,3,3
"18110","7dd6d24e54616e6189e12e1c461b01a3",40,35,60,4.66666666666667,40,0,2,1
"18111","7dd82721d5dbb92dbb7db32f2cd7dbd1",30,22,51,4.11764705882353,30,0,2,1
"18112","7dd844adfb92eee3c7c99e8888eca243",58,53,35,11.6,58,0,2,1
"18113","7dd88553d5e2bcb26f08bd4abe5a7215",19,19,0,19,19,0,1,2
"18114","7dd897742fd4e63b3494366a44478f01",25,21,17,10.2941176470588,25,0,1,1
"18115","7dd9fb379335c717e4138b5c7855b691",81,36,48,11.8125,81,0,2,3
"18116","7ddb2e1b89f93bd50cb490aaf63ba3ab",129,89,77,11.7272727272727,129,0,3,3
"18117","7ddd64f4e62306808d5358db6c02096f",42,42,0,42,42,0,1,2
"18118","7de00f562d90e383637d0af9ec09453d",222,119,61,25.4754098360656,179,43,3,3
"18119","7de1d6c1cfd9a15ecc775c494ec05cfe",43,43,0,43,43,0,1,2
"18120","7de1eb75bc8705f94f2a30c05f7cb62f",109,74,85,8.97647058823529,109,0,3,3
"18121","7de4a5951fa095842f4523fde707dfa6",33,33,0,33,0,33,1,2
"18122","7de4a5fc8b0ac3c6ab93c3bdd7480733",10,10,0,10,0,10,1,2
"18123","7de56bc1106c8c46b15da01ff8be0ea8",25,25,0,25,0,25,1,2
"18124","7de60e41a766d0ca3543e87edf87dc0a",14,11,42,2.33333333333333,7,7,2,1
"18125","7deb6444e71bea5805c77fb8593111c7",76,52,35,15.2,76,0,2,1
"18126","7debaf02920d5696c66ed4a3bfc6157e",32,32,0,32,32,0,1,2
"18127","7ded67e0fd81ea59e25c4ad36774a071",120,73,82,10.2439024390244,120,0,3,3
"18128","7dedd5c26a6b336e8a5484c2470866b8",16,16,0,16,0,16,1,2
"18129","7dee65ba01fc6a7985cd0ce715ae4388",34,34,0,34,34,0,1,2
"18130","7dee8be8ef03b0c85855946883ec1677",6,6,0,6,6,0,1,2
"18131","7df32ba44064a654662605420c65ecf9",96,43,42,16,96,0,2,3
"18132","7df45d36c3d4abfa707173609bcd746c",130,91,57,15.9649122807018,130,0,3,3
"18133","7df77261bea4eee1d07637e9b8ac5901",49,34,56,6.125,49,0,2,1
"18134","7dfeaaeba101dca9e6a25ee0b6c3f4d8",31,26,75,2.89333333333333,31,0,2,1
"18135","7dff523b73f6a5d87683db8306b8ead1",108,71,77,9.81818181818182,54,54,2,3
"18136","7e002cb343ea7e183902b7c7f73339f9",173,90,61,19.8524590163934,132,41,3,3
"18137","7e0516c48d154b6f7a01a05397356268",112,56,51,15.3725490196078,74,38,2,3
"18138","7e0aed6aa5fc08e072b31c67393d26b7",15,15,0,15,15,0,1,2
"18139","7e0d3898a5d21945d5eec688ccc43c29",43,43,0,43,43,0,1,2
"18140","7e0d3b2ef312969e0aa69a6cd4981811",5,5,0,5,5,0,1,2
"18141","7e0ee3ea23095d9eab877e5586fb94dd",233,119,72,22.6527777777778,190,43,3,3
"18142","7e11059bbac8df54e0ed97a3024ae2a0",191,49,84,15.9166666666667,191,0,3,3
"18143","7e16abe205501621baa2dce868454ec5",64,42,76,5.89473684210526,64,0,2,1
"18144","7e16c53b7789e242f3cc031844a4f941",48,48,0,48,48,0,1,2
"18145","7e17a3e47d812aebc79053ff57cb1f87",111,89,72,10.7916666666667,111,0,3,3
"18146","7e17e657ef5122b6148b04df3d3e9d15",38,38,0,38,38,0,1,2
"18147","7e19184bbf38f2da3ba7be1abd9cbb73",71,59,72,6.90277777777778,16,55,2,3
"18148","7e1c6ffd6f7ec025271f715bc8fc9217",163,90,66,17.2878787878788,132,31,3,3
"18149","7e1caa094d10cd08bd6532701fe5dd15",11,11,0,11,11,0,1,2
"18150","7e20cd5b0b581114e5dc4a1563eaef9a",184,118,67,19.2238805970149,184,0,3,3
"18151","7e21092e6f4c90a4e1097ec03b3ac8d8",26,26,0,26,26,0,1,2
"18152","7e23a0dd5a197928c9b0bf58ed8df071",29,29,0,29,29,0,1,2
"18153","7e25f15473bfbabd0e5cb46a65cb7257",20,20,0,20,20,0,1,2
"18154","7e26085fd67e031451ea52d547d10c7e",77,56,89,6.0561797752809,77,0,2,3
"18155","7e28906133bf9422cc9d29788590665b",6,6,0,6,0,6,1,2
"18156","7e29df65a4e603139e0d488bdf567664",107,54,84,8.91666666666667,107,0,2,3
"18157","7e2b13fbcd7b288f116eddd19c27529b",50,50,0,50,50,0,1,2
"18158","7e2ca7f1a88f31ce04b17de3920f1b3c",37,30,73,3.54794520547945,37,0,2,1
"18159","7e2df0435dcc1579b8fee3b866a4e8d0",47,34,49,6.71428571428571,47,0,2,1
"18160","7e30a48e4962c16cd4e2ce6a81cbedf8",13,13,0,13,13,0,1,2
"18161","7e31c2fa7b2bf36df4560588bae4dce6",194,78,73,18.6027397260274,194,0,3,3
"18162","7e332a7660abda09654247c58f4a2cb6",8,8,0,8,8,0,1,2
"18163","7e34a411b6ca2c6a55abb5c912bd8033",176,140,64,19.25,176,0,3,3
"18164","7e37c13bda038cf07a4c510f6a0bc139",49,18,65,5.27692307692308,49,0,2,1
"18165","7e37c8902caf9090c076f00501be6138",41,39,50,5.74,41,0,2,1
"18166","7e3b55a834094eed7a54153a9b88afaf",65,34,74,6.14864864864865,65,0,2,1
"18167","7e3dd017cfb7d9cf51345f1351ef2679",40,40,0,40,40,0,1,2
"18168","7e3ffb29fe49143519087f186eb08d21",19,19,0,19,19,0,1,2
"18169","7e41836c10e85208514380fbcebaf9d8",27,16,64,2.953125,27,0,2,1
"18170","7e4648106fc383fcc08215ac5cd9f3c4",106,74,44,16.8636363636364,106,0,3,3
"18171","7e48d21a9be65117207f3e082c8764f3",32,32,0,32,32,0,1,2
"18172","7e4a40cec823fdfa81f4b0c8201c2dd5",47,47,0,47,47,0,1,2
"18173","7e4b0d6cc6a60787fd4b2faa35af80ef",40,40,0,40,40,0,1,2
"18174","7e4b86c29a2b1ed79c28743d2f354301",141,94,77,12.8181818181818,141,0,3,3
"18175","7e4ba35b19f31560623022dce0ad1896",20,20,0,20,20,0,1,2
"18176","7e4fddeaaacd194f8aeb538c7177ab36",205,122,88,16.3068181818182,172,33,3,3
"18177","7e50172db8a2542acb2e94e737c1f503",29,29,0,29,29,0,1,2
"18178","7e51d31312ee52114f196ea57d4953f9",3,3,0,3,3,0,1,2
"18179","7e52a637f7e115decbaefcadaadc2d92",27,27,0,27,27,0,1,2
"18180","7e5382f23129ec90807beb7173684690",170,150,63,18.8888888888889,170,0,3,3
"18181","7e5450db521f65304191e4a251c62f96",19,19,0,19,19,0,1,2
"18182","7e56686264c4a6a94f758705a5d33257",66,51,22,21,66,0,2,1
"18183","7e56ea00e1f5e92515b361e6a9199c0e",46,38,70,4.6,0,46,2,1
"18184","7e5caf9d42310db3a334f9390d4f62b6",60,37,52,8.07692307692308,48,12,2,1
"18185","7e5d8a080880b1b9a10b8ac75f06a890",40,24,19,14.7368421052632,40,0,1,1
"18186","7e5f68ab7b37e9a67e97b25ff48207df",15,15,0,15,15,0,1,2
"18187","7e5f946c8a47ac0b173fd842a57e06c7",43,43,0,43,43,0,1,2
"18188","7e5ff5ee2c46ed437d9547c9a53109e0",66,52,73,6.32876712328767,53,13,2,1
"18189","7e6079e9410d9ba8d883ee73bb2c3de7",203,123,74,19.2027027027027,203,0,3,3
"18190","7e6097578df1c96953cf5de4e2b4dcdc",30,25,64,3.28125,30,0,2,1
"18191","7e60dfa07b972443e01ec83b5313d4ad",26,26,0,26,26,0,1,2
"18192","7e61aea42954ebd40768da9b580f17cf",52,42,41,8.87804878048781,52,0,2,1
"18193","7e63b3a74ef12b00dc0e6d987ae21164",130,97,47,19.3617021276596,130,0,3,3
"18194","7e65265b01ff3cf67dd82aa3b78a8125",40,40,0,40,40,0,1,2
"18195","7e6724f3e968816f6e815120cdc406b2",25,25,0,25,25,0,1,2
"18196","7e67d84a22cb6516c2a545befc91fd3c",70,49,30,16.3333333333333,70,0,2,1
"18197","7e69559ece8fcabccfedd4f49d10de74",91,76,43,14.8139534883721,91,0,2,3
"18198","7e69ff6f1259ae273d9e965296b84ed3",46,27,63,5.11111111111111,46,0,2,1
"18199","7e6a0f5f589c8d37166de304f112f725",34,30,16,14.875,14,20,1,1
"18200","7e6c4ba76e01b622f8d626c25fb959ce",127,104,26,34.1923076923077,78,49,3,3
"18201","7e6c75d81de30e2e1a334694d32698f9",94,80,73,9.01369863013699,94,0,3,3
"18202","7e6c9f72bfdda734dcd96337f636cc3f",15,15,0,15,15,0,1,2
"18203","7e6ce396f3589ac49b2c59f72e245789",52,52,0,52,52,0,1,2
"18204","7e6ced06b68508a1a5a77293eebf12d9",13,13,0,13,13,0,1,2
"18205","7e6e6c5bf850b102ad80eef41b8d8ccf",20,20,0,20,20,0,1,2
"18206","7e6ed69588d1cbf4d3761319348a40df",64,39,51,8.7843137254902,64,0,2,1
"18207","7e7303ddbe32d8f195db8240e61771f0",37,37,0,37,37,0,1,2
"18208","7e77229f3c4140419c1af400e64e2cad",21,15,29,5.06896551724138,21,0,2,1
"18209","7e7804c15218d337d5aa24eb2ca046f7",44,44,0,44,44,0,1,2
"18210","7e792017b17e168d0993ce0111a82194",19,19,0,19,19,0,1,2
"18211","7e7b0673e73a8cb8622eea62f0996121",55,46,55,7,55,0,2,1
"18212","7e7c3c4d55ce4df9cc60923b5d6ca722",191,112,67,19.955223880597,191,0,3,3
"18213","7e7dca8cbc087c0152f3809b27045e7d",61,46,62,6.88709677419355,61,0,2,3
"18214","7e807aa4e300c8dd388fee55027bacab",11,10,22,3.5,11,0,1,1
"18215","7e8143f24d3c8d7f0a979f1a517fdcfc",12,6,67,1.25373134328358,12,0,2,1
"18216","7e81bae930f1c7f1e931731e7fc42606",117,29,80,10.2375,117,0,2,3
"18217","7e850bcbaaff7c995ce11540012f25e4",15,15,0,15,15,0,1,2
"18218","7e85286db1a602b8bd2477f938493056",26,26,0,26,26,0,1,2
"18219","7e88729a675dc54ef792df2d7776c3eb",173,97,70,17.3,172,1,3,3
"18220","7e8d3b0443c7caa33a8ebd1414f0b357",23,23,0,23,23,0,1,2
"18221","7e8d3ea4064a79677a0f00b9421a3e70",67,57,55,8.52727272727273,67,0,2,3
"18222","7e8fcb27f3bf4b4f654dfc556d3a315e",65,56,42,10.8333333333333,65,0,2,3
"18223","7e91e948e9259a83c4ba863a2fac2ce7",149,102,72,14.4861111111111,149,0,3,3
"18224","7e940c722e327c048995d2fd8ebbe238",40,40,0,40,40,0,1,2
"18225","7e9723cf8022773382008c63e5a6e2fd",2,2,0,2,0,2,1,2
"18226","7e9b24b18aa5d3161dfd2fe39ce9e2a9",3,3,0,3,3,0,1,2
"18227","7e9be20759b65d3e61a301df4a4a283f",27,27,0,27,27,0,1,2
"18228","7e9dad2289f5b05df871fac1bf42a4a6",102,64,60,11.9,102,0,2,3
"18229","7e9e29140d82604be9cea80b31bebb3d",126,81,88,10.0227272727273,126,0,3,3
"18230","7e9fb601c11d86d9e031b7a15587cb4b",16,16,0,16,16,0,1,2
"18231","7ea05e5d950750bf9081ee28ecdafe25",30,24,59,3.5593220338983,30,0,2,1
"18232","7ea125705b3eabe9ffeaa6b882bee51d",121,79,82,10.3292682926829,77,44,3,3
"18233","7ea2183bd4da20228d9407d3a2c17a37",27,27,0,27,27,0,1,2
"18234","7ea315700e199e1a27b8d708b8ef7668",6,6,0,6,6,0,1,2
"18235","7ea36b91f339c718696ae60a5be72020",28,28,0,28,28,0,1,2
"18236","7ea3a834806c47a0897897f74530e28d",96,72,43,15.6279069767442,96,0,2,3
"18237","7ea4649a68b029b5c82e9d4b2e544331",35,35,0,35,35,0,1,2
"18238","7ea51183a3649ebf78f5a620ad1b128d",24,24,0,24,24,0,1,2
"18239","7ea7aaadcfecf82a128816e4afe441fa",46,46,0,46,46,0,1,2
"18240","7ea90e36e2e928f1ac0f54465836f40c",185,88,61,21.2295081967213,185,0,3,3
"18241","7eab908a5a204fd8a85c0f66f00b67cc",125,84,50,17.5,125,0,3,3
"18242","7eacf5aea43d54c9f21299fe5a85b480",43,35,27,11.1481481481481,43,0,2,1
"18243","7eae5bf45832b53cc49190c12eefa3e7",11,11,0,11,11,0,1,2
"18244","7eae8b952d3f575d7fa9ca15d372c1ff",33,21,72,3.20833333333333,11,22,2,1
"18245","7eb0f2ef58a98c4f909ea23ba2eabebd",134,89,83,11.3012048192771,134,0,3,3
"18246","7eb65fff75170d5f88611a1f7eacb47a",18,16,73,1.72602739726027,3,15,2,1
"18247","7eb694c0c204cca31e18501d8e8e1929",29,29,0,29,29,0,1,2
"18248","7eb7fce85907d5e07be4048a23a734d7",61,56,69,6.18840579710145,61,0,2,3
"18249","7eb9a0f0e0a6eca80e92bf5c64a56f8a",20,15,70,2,20,0,2,1
"18250","7eba84e69757435868110817d8577540",158,62,79,14,158,0,3,3
"18251","7ebe24f9a7781dda5c3cda0415733157",22,22,0,22,22,0,1,2
"18252","7ebeef77501934c0ddc33228f2bcc466",15,15,0,15,0,15,1,2
"18253","7ec1f3e66ae34fa2e83fdea3116be30b",3,2,48,0.4375,3,0,2,1
"18254","7ec2d3baf480546db33d264eae4c82e0",66,55,19,24.3157894736842,66,0,1,1
"18255","7ec3fffb4b11ca5c52b0d1207c7ccd2d",153,52,81,13.2222222222222,109,44,3,3
"18256","7ec47f78b1084038dccd50555629025f",70,48,26,18.8461538461538,70,0,2,1
"18257","7ec71bc8843906afa6671ecc0deb6449",40,40,0,40,40,0,1,2
"18258","7ec74c3326c4b9b75a1cd5d8a764f4be",68,58,54,8.81481481481481,44,24,2,1
"18259","7ec8161a12cfa33f523f752e588dfb73",76,57,45,11.8222222222222,76,0,2,3
"18260","7ec96393d9861f51499df41d1d855048",15,15,0,15,15,0,1,2
"18261","7eca6a86b03ed2a9078a6715a596c518",25,15,21,8.33333333333333,25,0,1,1
"18262","7ecd365b0de5bc7c1d08af3bc5dc524d",53,44,42,8.83333333333333,53,0,2,1
"18263","7ecde6aeb815e8f8a00ab606d9b0b272",164,95,77,14.9090909090909,137,27,3,3
"18264","7ed00ce155307dcd3c4136252ca46b4c",53,53,0,53,53,0,1,2
"18265","7ed237cdc6ef1a6c1cb7c64824093fd6",129,76,64,14.109375,98,31,3,1
"18266","7ed27bb1d0158130d18400e2b3d309cf",52,47,43,8.46511627906977,35,17,2,1
"18267","7ed6f2749cb652eeef56195d6784f295",98,71,32,21.4375,98,0,3,3
"18268","7ed76a52f19e018ea51857ec90b4bbef",54,54,0,54,0,54,1,2
"18269","7ee023ffb27dab43c4d189d8b37af307",8,8,0,8,8,0,1,2
"18270","7ee12eacbdd2a9682041cc683bb52231",98,81,17,40.3529411764706,98,0,3,2
"18271","7ee37741ea5630b4c332f0de8908ab84",21,21,0,21,21,0,1,2
"18272","7ee5739318805a1ef341df56e79e2f93",20,19,3,46.6666666666667,1,19,1,2
"18273","7ee6abb708a486a7f37d3b52eadfb8ce",29,29,0,29,29,0,1,2
"18274","7ee7530b0f1e6eee2572fcf8845b9055",28,28,0,28,28,0,1,2
"18275","7ee869aad6f2f7a42116fd4d4b2719e1",27,27,0,27,27,0,1,2
"18276","7ee9a47ab6a0abdbbc387aa08c7f61b3",1,1,0,1,1,0,1,2
"18277","7ee9c59a830ddd646a760aa8724109a1",25,22,31,5.64516129032258,25,0,2,1
"18278","7eec107c2ea11271b73e6238e17ac4eb",31,31,0,31,31,0,1,2
"18279","7eed6700bc89042c6c74e00847e5dd18",8,8,0,8,0,8,1,2
"18280","7ef03a517d5077a224c46a3c053ad0ae",91,63,44,14.4772727272727,91,0,2,3
"18281","7ef1cc2b482e780a36432f3129fdec2f",16,16,0,16,16,0,1,2
"18282","7ef1d912a364b9ff327ae4818fa95da7",145,80,65,15.6153846153846,108,37,3,3
"18283","7ef20da8fd4c694d5ac27e5adc50e199",96,76,68,9.88235294117647,96,0,2,3
"18284","7ef3e404ae72e93fae00f8bc6e0066c1",24,24,0,24,0,24,1,2
"18285","7ef72c4ada8a9f664d4cb12aabd1f6a6",43,40,32,9.40625,43,0,2,1
"18286","7ef78ba206ef7e508df3a45fde75a2a8",75,71,36,14.5833333333333,75,0,2,3
"18287","7ef796e9fa1563beb6be79321dcef34f",36,36,0,36,0,36,1,2
"18288","7efb5c1673ecca59d3ab59e4eac57211",4,4,26,1.07692307692308,4,0,2,1
"18289","7efb956602ca12148b140e5eb9da7450",1,1,0,1,1,0,1,2
"18290","7efefbca733ff78af99b39bf8334b3cd",14,14,0,14,14,0,1,2
"18291","7f0046603babe9fe391c05f901631567",26,26,0,26,26,0,1,2
"18292","7f05741a7649baab9d0a46570a998c7d",64,56,14,32,64,0,1,2
"18293","7f06f59d3b9476bfc4c56492eddc1c3c",35,32,43,5.69767441860465,35,0,2,1
"18294","7f085b75ff0a2bd532a3829556756665",12,10,50,1.68,12,0,2,1
"18295","7f0a37ee0a6c218e4f34d679a34d9906",109,58,58,13.1551724137931,108,1,2,3
"18296","7f0a3cd5b4eb89d0546971de69b309aa",14,14,0,14,14,0,1,2
"18297","7f0c671a2a952735964b4c498e5be7f7",18,18,0,18,0,18,1,2
"18298","7f0db151adfb4131a1711e6ba1ab85da",16,13,26,4.30769230769231,16,0,2,1
"18299","7f0ea1a8222fa27404e2114f56f53867",27,27,0,27,0,27,1,2
"18300","7f0ec61cf68ee5ce967b2cf9ed68e56d",34,34,0,34,0,34,1,2
"18301","7f1042692d43bc54e1e93ad44f5a60c5",151,77,63,16.7777777777778,117,34,3,3
"18302","7f1435bb7ea2b98e120d9f26d2de7eb5",29,29,0,29,0,29,1,2
"18303","7f1491cddc19f06d77c9b41fa39d9b34",17,9,61,1.95081967213115,17,0,2,1
"18304","7f151d972d075dea5db03eff03018f2a",43,38,9,33.4444444444444,26,17,1,2
"18305","7f15ff31a0002100996e6446464bfe58",31,27,40,5.425,31,0,2,1
"18306","7f172d44a5d6785d106b65aba6b3ddb3",36,36,0,36,36,0,1,2
"18307","7f17bda5ce48c2aaf94f74bf3dce4d93",106,72,43,17.2558139534884,57,49,2,3
"18308","7f18db1d47d06e9748fc284928e89c2a",11,11,0,11,0,11,1,2
"18309","7f199a2ac09ea87f2c5a49da8dd2ff99",19,15,70,1.9,19,0,2,1
"18310","7f1a7ad713320e9db8b01a7d57c473b6",45,31,63,5,0,45,2,1
"18311","7f1ab17096a2d18decca4cd71d57fe49",25,25,0,25,25,0,1,2
"18312","7f1cd448a7c3c1f6a62cc8b64eb59e4b",84,38,78,7.53846153846154,67,17,2,1
"18313","7f1dbe40469cbcb2270a2378990d0f82",38,38,0,38,38,0,1,2
"18314","7f206533623d810196984141e1e3d5ed",26,26,0,26,26,0,1,2
"18315","7f255faae1eb3699eb87d6683a6f9a10",126,110,41,21.5121951219512,126,0,3,3
"18316","7f259589acaf932b780c3f690f7f9e57",41,41,0,41,0,41,1,2
"18317","7f2987636908bd8a798cc619a0cef927",23,23,0,23,0,23,1,2
"18318","7f2a189cf69065f5aa29ceda847282ea",72,55,33,15.2727272727273,72,0,2,1
"18319","7f2a1bda829a8ff6fbd9129be17850b6",23,23,0,23,23,0,1,2
"18320","7f2b3339774ef14777f91339a4968b2b",49,49,0,49,49,0,1,2
"18321","7f2ffbc11c8aa4fcdb32ce4e03da6adb",181,81,88,14.3977272727273,181,0,3,3
"18322","7f32cbccb59f6a793dad7826b860fcaf",73,57,40,12.775,73,0,2,3
"18323","7f3321bf3ad950e485986df7390d55e7",26,26,0,26,26,0,1,2
"18324","7f366d5f328bcddd5289f848ad4dd9d9",33,33,0,33,33,0,1,2
"18325","7f39d54ec345d414e3cab3a6247b3ac9",105,55,60,12.25,105,0,2,3
"18326","7f3ac68c7bb79dfe25fc4fcdfb0e9261",5,5,0,5,5,0,1,2
"18327","7f3ecc3bc0a3fadcba58b47fae6b7f0a",166,90,63,18.4444444444444,130,36,3,3
"18328","7f3f74c438d8ac43997d08e136015f07",23,23,0,23,23,0,1,2
"18329","7f3fef34298b49cfb8db25500bf6ccfa",127,81,62,14.3387096774194,127,0,3,3
"18330","7f40d24c705f8d87fce56fa2f58d0ac3",39,39,0,39,39,0,1,2
"18331","7f41206bcc5310e48482e5dbde484cae",36,36,0,36,36,0,1,2
"18332","7f42bb110c3f9f404df7cb742f3be442",30,30,0,30,30,0,1,2
"18333","7f440185197530301a6e9ebb30994e26",9,9,19,3.31578947368421,5,4,1,1
"18334","7f44f1818caa18adb754c41c63acd2ff",132,60,84,11,101,31,3,3
"18335","7f4526afbf78081d8b905e05ba188f01",41,36,41,7,41,0,2,1
"18336","7f459f2bf61c86148e6583eb99e8dc48",14,14,0,14,14,0,1,2
"18337","7f47369ccfa68ddfc3d54e64cdc4ab04",8,8,0,8,8,0,1,2
"18338","7f47723dbda8c9bd64820bc1157a2dc0",7,7,0,7,7,0,1,2
"18339","7f4958fa8122e08da42c36e28e5c5496",66,63,74,6.24324324324324,66,0,2,3
"18340","7f4d05db35bf55dc0a71b1e5f1137c60",55,55,0,55,0,55,1,2
"18341","7f4dd1673b0218021a388bac3e591921",82,60,83,6.91566265060241,82,0,2,3
"18342","7f551ccd895ab5ab1523d8cac17c02fc",241,94,84,20.0833333333333,200,41,3,3
"18343","7f55529ccd020bfd44317174e9989213",158,103,62,17.8387096774194,107,51,3,3
"18344","7f55c0a26457532b1f94f9b812faa773",55,48,30,12.8333333333333,27,28,2,1
"18345","7f56533cce6c2a9b6e242121b872695b",91,79,75,8.49333333333333,80,11,2,1
"18346","7f567e559a11a94d90a6cbba349518db",50,50,0,50,50,0,1,2
"18347","7f58d4e05908db131ebaa3deabee666b",188,107,70,18.8,188,0,3,3
"18348","7f60a85201227e9b039e017a5be2650a",22,22,0,22,0,22,1,2
"18349","7f614a492c0113e7fad90bc780795b98",74,56,80,6.475,40,34,2,1
"18350","7f62329632b837a6d60f1cac27a8a211",91,58,56,11.375,91,0,2,3
"18351","7f625130ca494540cded3f47a8f54c6a",55,55,0,55,55,0,1,2
"18352","7f6381cd973696b98fbf9360f3f4864c",56,45,23,17.0434782608696,56,0,2,1
"18353","7f689d12b660d5e3f1286cb44a3237f8",77,44,82,6.57317073170732,53,24,2,1
"18354","7f6b181de3ab39cc5b635a0ad15796bb",56,54,10,39.2,56,0,1,2
"18355","7f705079a8580bb870c443c1c5cb70ff",17,17,0,17,17,0,1,2
"18356","7f71a6f4b9765e44b1307a40588029fc",20,16,14,10,0,20,1,1
"18357","7f723ece85ccac45dd1e4534122cc8bc",61,28,57,7.49122807017544,61,0,2,1
"18358","7f72963d58038c9178e1ef24c282396a",8,8,0,8,8,0,1,2
"18359","7f76988ba66ecde6444ebbd9666e8948",137,106,63,15.2222222222222,137,0,3,3
"18360","7f77b9166f5c68707327d534a582c866",5,5,0,5,5,0,1,2
"18361","7f782cef8f14946a01ef60374bdbc5d6",12,12,0,12,0,12,1,2
"18362","7f7852c87e20331d710b4481847294e7",18,18,0,18,18,0,1,2
"18363","7f7897443259f03ccaca80f8af38b0ab",17,17,0,17,0,17,1,2
"18364","7f79b82f159c4d57ee3457c73e9e7b9f",8,8,0,8,8,0,1,2
"18365","7f79e0fb263e49d167df23dfdc26e303",70,42,60,8.16666666666667,48,22,2,1
"18366","7f7ff9afa77b2cff788f61585aa5cb4b",25,25,0,25,25,0,1,2
"18367","7f80980f9ff6da6bf4a8f1302acd145e",37,37,0,37,0,37,1,2
"18368","7f81bc1c71c988c4f73c802ba9ae54b9",41,35,23,12.4782608695652,41,0,2,1
"18369","7f820f80677ecf32f040851321d7161e",37,37,0,37,37,0,1,2
"18370","7f8253c25b3bb39f4e085fa4e8821536",58,51,37,10.972972972973,31,27,2,1
"18371","7f825662e98a1da9d7032cc10c13cecb",4,2,38,0.736842105263158,2,2,2,1
"18372","7f83313bf121fb4a2f788ace76324f4d",30,30,0,30,30,0,1,2
"18373","7f8552dcfe5b6a06cc7fd73e5118f57a",119,78,69,12.0724637681159,91,28,3,1
"18374","7f85f149c1a3ac6fe9647b6be99e5de2",33,32,46,5.02173913043478,23,10,2,1
"18375","7f895609797ea1bbe73f8ec864e1d683",88,58,43,14.3255813953488,88,0,2,3
"18376","7f89772820b79d1eb0b41857a027fafb",200,93,71,19.7183098591549,200,0,3,3
"18377","7f8be972ef5c39fa6b72ce6b88670992",153,126,34,31.5,153,0,3,3
"18378","7f8cd512f5664d071cc476dcd89200af",7,7,0,7,7,0,1,2
"18379","7f8df9033a5f81c4fa80fff1e2361f89",42,30,56,5.25,42,0,2,1
"18380","7f9169eb4b86c2f105017c252343ee82",158,104,78,14.1794871794872,105,53,3,3
"18381","7f9306bbd01dce15116098ef4e3453fd",175,74,55,22.2727272727273,175,0,3,3
"18382","7f93ca58616151c0473f9d0850753d1a",31,26,39,5.56410256410256,31,0,2,1
"18383","7f97fb32a476d00021e2bb8630359260",78,58,62,8.80645161290323,78,0,2,3
"18384","7fa1c5260102a83bde74a0d4671c6081",39,39,0,39,39,0,1,2
"18385","7fa1f841f674372b9f4341e06ca67d3b",63,40,62,7.11290322580645,63,0,2,1
"18386","7fa607a93d90f47f3b88a9301eb54235",96,66,42,16,96,0,2,3
"18387","7fa62c16f9f95c5ae6cd191e0838cc6a",1,1,0,1,1,0,1,2
"18388","7fa93e32e91f7b488577ac66408110f7",153,128,41,26.1219512195122,124,29,3,3
"18389","7fa9d215c75f6a4348216a27b6da2c54",109,73,64,11.921875,86,23,3,1
"18390","7fab687462d6f2142a5818171766939d",56,49,31,12.6451612903226,30,26,2,1
"18391","7fac3b414caea8ed4e9c4521a654e64e",30,23,25,8.4,19,11,2,1
"18392","7fac86cc3a73361492756181dddb7e3a",53,53,0,53,53,0,1,2
"18393","7facdb765c26346bd7c18119cfd1b4aa",37,37,0,37,37,0,1,2
"18394","7fb0ad80f27cc8c4b19983fb1cfd1909",65,45,74,6.14864864864865,65,0,2,1
"18395","7fb10cc67b2f667094467a31575e6aec",45,35,33,9.54545454545454,45,0,2,1
"18396","7fb11d2bf488450b5b36e354fa87b771",45,34,72,4.375,30,15,2,1
"18397","7fb22e763bb853ba56d11eaeff123352",50,36,28,12.5,0,50,2,1
"18398","7fb2e44c298e2679cad4d38e990eef02",20,20,0,20,20,0,1,2
"18399","7fb3ba5ec8de701066bcc8b250d06387",59,50,62,6.66129032258065,59,0,2,3
"18400","7fb74525bbe15474b0ddb7da4f371bb3",181,82,75,16.8933333333333,181,0,3,3
"18401","7fb7cc956f132fe03daa1cbf760e5087",38,35,42,6.33333333333333,38,0,2,1
"18402","7fb8211eedcc772594d04b1b9f399831",16,16,0,16,16,0,1,2
"18403","7fbb2220908a35c0faeb4a1a6f941ce6",114,90,69,11.5652173913043,114,0,3,3
"18404","7fbb75184e86bbceb1e5c7aaf3496c8a",51,41,29,12.3103448275862,51,0,2,1
"18405","7fbc06fa8c582b8853f7b909b5b0edc8",120,91,63,13.3333333333333,120,0,3,3
"18406","7fbfe8e32a43ae313e3ab347c8aafda5",32,32,0,32,32,0,1,2
"18407","7fbffc22589b60275597ca5f9b87c6ab",43,32,27,11.1481481481481,43,0,2,1
"18408","7fc1254f0920fb990e1fd9dfec2beaeb",24,24,0,24,0,24,1,2
"18409","7fc26109ec5c1013187d4c39e674d20e",28,16,88,2.22727272727273,28,0,2,1
"18410","7fc48db52d15d11efa6ee1bcd8e32c67",30,30,5,42,7,23,1,2
"18411","7fc544b62e1d124fad4b23e33b5b79c1",47,44,65,5.06153846153846,47,0,2,1
"18412","7fc5531f4501436feebcfa744ace7291",49,49,0,49,49,0,1,2
"18413","7fc7d50ec22de4b3f05d6f07a9617924",51,42,38,9.39473684210526,24,27,2,1
"18414","7fc802824505d603559a8e01bd3da944",95,73,77,8.63636363636364,95,0,2,3
"18415","7fcb09222dac5f2e458144ce07749c32",105,65,54,13.6111111111111,105,0,3,3
"18416","7fcee0df2bbc19efd7ebee3ccabfc920",30,30,0,30,30,0,1,2
"18417","7fcfb881bcfbc7d713f9abc14f4994b6",145,94,31,32.741935483871,145,0,3,3
"18418","7fcfeafe046673599b08a1487052a8e2",31,31,0,31,31,0,1,2
"18419","7fd3977ad48542cad97f24d0a134bdd3",36,36,0,36,36,0,1,2
"18420","7fd4dd81578756005c244c9ce2402d3a",97,57,62,10.9516129032258,97,0,2,3
"18421","7fd5ba3d9e09a1b16cbff94c71145d9d",61,51,52,8.21153846153846,60,1,2,1
"18422","7fd9d02c01b3bba7a1799a94866af93d",17,17,0,17,0,17,1,2
"18423","7fda9a38f9e517beeb54fb00423c8ffe",68,39,35,13.6,68,0,2,1
"18424","7fdc130ac34364aa3b9e0d1557930e79",37,37,0,37,37,0,1,2
"18425","7fdd6271b656cc3296bae9113733c851",29,29,0,29,29,0,1,2
"18426","7fdeaa1c48e0f10970ec15d4dac86e3b",34,34,0,34,34,0,1,2
"18427","7fe256574b8f54fc104c0445ad03e99a",15,15,0,15,15,0,1,2
"18428","7fe2a95a8ac6c5626d95a48eea9ce298",127,63,63,14.1111111111111,127,0,3,3
"18429","7fe49219ad57b0ea506358d2e17d4b3e",23,23,0,23,0,23,1,2
"18430","7fe5ed9066e0c708540de0c5b88f2b21",37,37,0,37,0,37,1,2
"18431","7fe687b2ff96a770cd8f5a4cb042c6c7",211,131,66,22.3787878787879,211,0,3,3
"18432","7fe74da886eadf4ee2a31e44972c4516",43,43,0,43,43,0,1,2
"18433","7fe84f3c92fb65637a30efbf241261ef",24,24,0,24,24,0,1,2
"18434","7fe9a45689ef1b202bbe8d85897ee74e",89,72,62,10.0483870967742,89,0,2,3
"18435","7feb75ae83513131c0c9e908f22f5f5c",21,21,0,21,21,0,1,2
"18436","7feda5f270f26f56a24b9b63249351d0",33,33,0,33,33,0,1,2
"18437","7fee6a57db1ca46a154615ceda8e4c07",14,14,0,14,14,0,1,2
"18438","7feee019820a6c4ae7d8621b437d3bf2",72,62,21,24,72,0,2,2
"18439","7ff2293e61b285c41d8311e59c4321c6",24,24,0,24,24,0,1,2
"18440","7ff5d6bc5df6755d4519f3477fbd0cc8",209,104,70,20.9,175,34,3,3
"18441","7ff81d8e7eb60a99ac23dba9815dfb9b",23,23,0,23,23,0,1,2
"18442","7ff8c50e57258e15032eea969d95930c",49,44,26,13.1923076923077,49,0,2,1
"18443","7ffb2f7ad2a4096c3b8e62f14d8d9a31",28,25,41,4.78048780487805,17,11,2,1
"18444","7fff4b75f0eb40a6ac5792e17a12635c",97,85,37,18.3513513513514,63,34,3,3
"18445","80018aa8fffb02aaf35935d531ca9b1e",23,20,17,9.47058823529412,23,0,1,1
"18446","800478fbf022b1275c2ee6042db338b5",18,18,0,18,18,0,1,2
"18447","8004c385e2943794c32c6e3b81045ce3",16,16,0,16,16,0,1,2
"18448","8005220d229f0cca1a7cd61c216e4e5f",30,30,0,30,30,0,1,2
"18449","80080e4d5b6dee09ddec70c8d9a6fde1",76,52,66,8.06060606060606,29,47,2,1
"18450","800812bdcd3c7e0f13e33d2ce622f670",41,41,0,41,41,0,1,2
"18451","8009453acd886ccc8eaa05bac06c0c95",26,26,0,26,26,0,1,2
"18452","800a41f33248c620f5677e8e43b9967b",29,28,5,40.6,29,0,1,2
"18453","800d9134df17d413bdbedac408961dd1",93,65,36,18.0833333333333,93,0,2,3
"18454","800e808d1d93a59651032f521c484cf6",100,73,30,23.3333333333333,100,0,3,3
"18455","80117a618766948fad3cf6f01fe2b875",136,101,57,16.7017543859649,136,0,3,3
"18456","8011c20b8234052ae38d45706b3b53d1",27,24,23,8.21739130434783,27,0,2,1
"18457","8018cf6ecb36019f2a063acbfc9448bc",11,10,18,4.27777777777778,11,0,1,1
"18458","80195e8ab3bc1619d5e1c053ee62059f",23,23,0,23,23,0,1,2
"18459","801bbb986a19d65371477f9a9f7a95c2",88,35,70,8.8,88,0,2,3
"18460","801e7bb73340659d89584c9e9746382d",15,14,24,4.375,15,0,2,1
"18461","8022e192edb97057382a55e307237492",34,32,24,9.91666666666667,34,0,2,1
"18462","80237e2e2ffc9bf98fd1f908f9e5580b",24,24,0,24,24,0,1,2
"18463","8024c8c4398ddc1ae1ee7a9dd2c020be",24,24,0,24,24,0,1,2
"18464","802bf16f7bb99637391f279a0041f080",107,69,31,24.1612903225806,70,37,3,3
"18465","802c3629f66a6d20e3dad669ffa7b489",27,27,0,27,27,0,1,2
"18466","802fcf894fbcbace19702e9b128a8096",42,42,0,42,42,0,1,2
"18467","8031fc8232cb6bee45cbca65971d8eb1",170,117,62,19.1935483870968,170,0,3,3
"18468","803405abaaffccb6357ef39f3f58797f",37,32,14,18.5,37,0,1,1
"18469","80359d45686aa7a0781853427dcd09f2",18,9,57,2.21052631578947,18,0,2,1
"18470","8035ba1c23489c1246dd42e37f829596",43,43,0,43,43,0,1,2
"18471","8036db5678d4f53a36c3fd55f5b795cc",103,74,55,13.1090909090909,103,0,3,3
"18472","8037cf7194eb21b97adfd110bbcc6043",24,24,0,24,24,0,1,2
"18473","803b85d2d0a7969ae735ccf59a3362df",37,37,0,37,37,0,1,2
"18474","803e8ac2ef5d1d9c8cadf1688c3abe04",157,59,85,12.9294117647059,157,0,3,3
"18475","8041d0be38a684ff08c6784d850159c7",46,46,0,46,46,0,1,2
"18476","80422dbc582b7f3ec4b08b129f9315d5",119,70,49,17,119,0,3,3
"18477","8043e61d66940d506fbfae0b819e33bf",126,89,33,26.7272727272727,88,38,3,3
"18478","80477609e2a5fa6d34f323ee0452a211",111,73,70,11.1,111,0,3,3
"18479","8047d509f276f2c74a43bd5c668cd0cf",4,4,0,4,4,0,1,2
"18480","8048b844a113a2f3d16a6fd25962f268",109,66,61,12.5081967213115,109,0,3,3
"18481","804d0bfbf66d6c9b27f012c3ff620c5a",161,96,49,23,161,0,3,3
"18482","804d5ff6ef82aea9a98e7a187ce8d3d6",141,111,46,21.4565217391304,89,52,3,3
"18483","804de49673bff1bf2952d858c99ceb5a",6,6,0,6,0,6,1,2
"18484","804de86e4507b9304c0efdc23e15d726",199,131,89,15.6516853932584,199,0,3,3
"18485","804fb46bb5e29c4e0d63ca5f3a6f94cf",22,22,0,22,22,0,1,2
"18486","805084a37d1c91a0595a062a807820ee",41,41,0,41,41,0,1,2
"18487","80540d61679c14c87adb8db838718066",156,74,76,14.3684210526316,156,0,3,3
"18488","8057a720ced3033787930c2c8f66e65a",41,41,0,41,41,0,1,2
"18489","805884aec6167f5ad43d4e7a3b8b8400",12,12,0,12,12,0,1,2
"18490","805a208a0110440c9094d03bbd3eec4f",32,32,0,32,32,0,1,2
"18491","805cebbbb4ac658678b8e03016c534b9",15,15,0,15,15,0,1,2
"18492","805fe6fa055c2a7eac77a76e1fd7ccba",42,42,0,42,42,0,1,2
"18493","8060458a16beea9c718cd68e350a936e",33,33,0,33,33,0,1,2
"18494","80612e37419b7b409a4f8866a0729f9c",29,29,0,29,29,0,1,2
"18495","80633ef484b64dab5d904e7e74508f80",32,32,0,32,32,0,1,2
"18496","806a00114317f1f3a3f0cc695e6f073a",29,29,0,29,0,29,1,2
"18497","806be8339746df8e2a358a47078ddb9a",35,35,0,35,35,0,1,2
"18498","80717894ef5496fe208fedd3a7cb095a",36,36,0,36,0,36,1,2
"18499","80731276d5995354b05b8d7c03c326c0",12,12,0,12,12,0,1,2
"18500","80742c18b3a5a9850c654441f93bd111",75,63,47,11.1702127659574,75,0,2,3
"18501","80744e4d34d6fa185c1daa7dbe0db287",13,13,0,13,0,13,1,2
"18502","80760660f79059be35fe8d2572534533",35,35,0,35,35,0,1,2
"18503","8078f8ad635d772a269c33d866d0d377",34,34,0,34,0,34,1,2
"18504","807c444da054665692d427e089043ccb",56,51,38,10.3157894736842,20,36,2,1
"18505","807f662295c66b748c8fe1e70165124b",20,20,0,20,0,20,1,2
"18506","807f675c58da08c0554adffcc5ce4e4f",9,9,0,9,9,0,1,2
"18507","808155de35b43a265d7c8019f1fe1588",103,41,83,8.68674698795181,103,0,2,3
"18508","808165350eed38f9b321699ece1d89d7",31,27,32,6.78125,31,0,2,1
"18509","8081c97064d0140520f25735cd0f0b44",42,32,21,14,42,0,1,1
"18510","80879ba6a0a8f4b5f15d0467a4d4f9c5",133,104,65,14.3230769230769,133,0,3,3
"18511","808808524ac5ee82c6a10c6cc7a7490a",26,26,0,26,26,0,1,2
"18512","808858d31def759f4c91b198795429ab",32,22,56,4,32,0,2,1
"18513","808d30658ccac3e6ff4a9bb4d3debce8",53,34,37,10.027027027027,53,0,2,1
"18514","808e2ff96bf0bd9d7865c1f6e2ac327f",33,33,0,33,33,0,1,2
"18515","808e3dc645945a1b15afc235fc281a22",23,19,12,13.4166666666667,23,0,1,1
"18516","80902972ee860922c094f496c6b17c3c",17,15,59,2.01694915254237,10,7,2,1
"18517","8090cd40caf85005025e5c5b112e3d02",24,21,7,24,24,0,1,2
"18518","809306430c30afa732b4af652a966c3b",50,36,32,10.9375,50,0,2,1
"18519","8093fb52e982ff70c529dead3a4c2988",21,21,0,21,0,21,1,2
"18520","80947ef94147d041cda323386bbccb5c",31,31,30,7.23333333333333,21,10,2,1
"18521","8095d35d9fc548cde09760073f7cda03",51,34,58,6.1551724137931,34,17,2,1
"18522","809840db940bc3aa206c0ff19e0382b5",48,48,0,48,0,48,1,2
"18523","809936d97606624475f7cda808592d37",16,16,0,16,16,0,1,2
"18524","809979fb3a5b5d3b01dd8e0a22f7313c",4,4,0,4,0,4,1,2
"18525","809a9a2fdc0f627a2d4cf5cfb4111e4a",53,40,29,12.7931034482759,53,0,2,1
"18526","809ad50bfe814eb395b7e193d9bbf3e6",37,37,0,37,37,0,1,2
"18527","809f0b0f6922c6507e8051c158a9eb90",34,34,0,34,34,0,1,2
"18528","80a11d7c29113d9147d733dd9fbd8ae4",27,27,0,27,27,0,1,2
"18529","80a170bfae196c66134acedaae5fce38",1,1,0,1,0,1,1,2
"18530","80a7aa74d9350c614d43ff89d9eb7ac7",4,4,0,4,0,4,1,2
"18531","80aaff100896869073240e072df7cd37",16,15,41,2.73170731707317,16,0,2,1
"18532","80ac849815683b1a077a4464e3d40d34",53,53,0,53,53,0,1,2
"18533","80acc69d54786facf6d29b701bca6450",29,29,0,29,29,0,1,2
"18534","80ad61d9a500e072d8164272f6f48b9b",107,85,55,13.6181818181818,107,0,3,3
"18535","80b1f00a7042cf664a7c19f60e1cb935",67,59,63,7.44444444444444,67,0,2,3
"18536","80b4820f0178fafaedf6f64971933e6e",26,26,0,26,26,0,1,2
"18537","80b492e20e351f53dde9f6133efde9ca",44,44,0,44,44,0,1,2
"18538","80b6ea091aa3e069bd40980f1ed053cb",86,63,84,7.16666666666667,72,14,2,1
"18539","80b7269a2a22e95c797f13d7f9663e5b",13,12,4,22.75,13,0,1,2
"18540","80b8d20d3c193e6085d55cbe0ade9284",33,33,0,33,33,0,1,2
"18541","80b951963b9a0e114221c973462c15df",71,48,55,9.03636363636364,71,0,2,3
"18542","80bb15114661905a5381f8518269dc86",40,38,6,46.6666666666667,40,0,1,2
"18543","80bbaa292fc8a2e220fd63b9bf3bf324",22,22,0,22,22,0,1,2
"18544","80bbd32cb57cc26dd97ae8ec2f9ce868",181,107,84,15.0833333333333,181,0,3,3
"18545","80bc02d26f6fbb4612162e0ca8a9e229",96,59,62,10.8387096774194,66,30,2,1
"18546","80bd1fd144fefcaf13154417c21f2280",140,96,54,18.1481481481481,140,0,3,3
"18547","80bd5e948282fb363687398c161485ca",14,14,0,14,14,0,1,2
"18548","80bee75251f3ff3d3e2e2d80f6779982",79,47,74,7.47297297297297,54,25,2,1
"18549","80bf0e59887bd6ffcb518697fbcf9138",9,6,53,1.18867924528302,3,6,2,1
"18550","80bf38630eb87943970e5cb183db725b",24,23,62,2.70967741935484,24,0,2,1
"18551","80c0b23dbcbf39046814fabeff7f4c1f",11,11,0,11,11,0,1,2
"18552","80c11ce8f3d12d164d58ed80a40201bb",86,52,13,46.3076923076923,86,0,1,2
"18553","80c38513a8b969a8d1d4d839cb2cade3",31,31,0,31,31,0,1,2
"18554","80c72f55120e7f705e087af99307ce5d",17,17,0,17,17,0,1,2
"18555","80c7e6dc44a6f244a1588dac504d2365",13,12,21,4.33333333333333,13,0,1,1
"18556","80c839083d1a74acc532f03705d8ca34",207,106,74,19.5810810810811,207,0,3,3
"18557","80d44c591c21634574bc52ede4ca891f",19,19,0,19,0,19,1,2
"18558","80d57d9b511e0bd8396f577133f7a28c",28,28,0,28,28,0,1,2
"18559","80d6f36d722bd16ea38f09b3a745fbfd",96,78,41,16.390243902439,96,0,3,3
"18560","80d7424276caea43cf206472a7b91a99",153,59,39,27.4615384615385,153,0,3,3
"18561","80d8af433236b2e45d460d262426ac77",38,21,71,3.74647887323944,38,0,2,1
"18562","80da7d7ea455b4a8ede448ef5ae0ddb9",20,20,0,20,20,0,1,2
"18563","80dba9279b2ffe54b9742a3397ceda54",14,14,0,14,0,14,1,2
"18564","80dc17c4378efefcf7a1ced9eb12d16d",13,13,0,13,13,0,1,2
"18565","80dc5e426c1116702ad9049ec8ce2d26",207,59,84,17.25,175,32,3,3
"18566","80df2a049f60fce08dfa476eb039b6b8",67,53,77,6.09090909090909,67,0,2,3
"18567","80df48a186d77846f178140d25aceb6f",87,74,12,50.75,87,0,1,2
"18568","80e0085af83ecba29ac3f3755fc09d3b",109,83,50,15.26,109,0,3,3
"18569","80e093929856fd5bc58a11811827eae3",25,25,0,25,25,0,1,2
"18570","80e20355e841d3dde8af4050440ea1c6",54,39,41,9.21951219512195,54,0,2,1
"18571","80e3100a5184a6e068837b13dff27b71",93,88,27,24.1111111111111,93,0,3,3
"18572","80e447c0ed070d15261fb5f2a5bf53e5",99,67,66,10.5,99,0,2,3
"18573","80e4fa2d8ed0c574fdf2b7c40c972476",1,1,0,1,1,0,1,2
"18574","80e6cf2d6f214ca0f764aa8ae6b7435e",87,53,70,8.7,66,21,2,1
"18575","80e840d5cf320593f782843eef642cd0",102,70,51,14,74,28,2,1
"18576","80e8fa47b7c23adc46099e2f3960c656",13,13,0,13,13,0,1,2
"18577","80eb4a9165d1c42e38b7160ddb272a54",54,54,0,54,54,0,1,2
"18578","80ed355e9094f94702ca0c445aa909f4",22,22,0,22,22,0,1,2
"18579","80edccb67fe40752ba3b15d7f7554af6",50,38,65,5.38461538461538,1,49,2,1
"18580","80ef135f915cd71f6b2f581b3c388237",98,60,61,11.2459016393443,98,0,2,3
"18581","80f0c2ca8541ade35cc526e4143a3f6c",19,16,25,5.32,19,0,2,1
"18582","80fb284927854d07bc0e76d26bc67306",31,31,0,31,31,0,1,2
"18583","80fdea2994af9cb8575daaea14d51b25",2,1,52,0.269230769230769,1,1,2,1
"18584","8101a8dc8c445b7a5ec17a42d1124932",143,115,58,17.2586206896552,143,0,3,3
"18585","81035029fd4ee18fb695425a57fd3d9c",124,102,34,25.5294117647059,124,0,3,3
"18586","81053b411237882f867d62bd960a36d0",131,64,52,17.6346153846154,118,13,3,1
"18587","810a22f6ba3488bbc14b180b833629ea",19,19,0,19,0,19,1,2
"18588","810af023db99d519d1ab415e0fe654b9",39,39,0,39,0,39,1,2
"18589","810bb01720127efc7380a7a7e144b75a",68,48,62,7.67741935483871,68,0,2,3
"18590","810e306c3f7247edb378e75defdaabb5",37,37,0,37,37,0,1,2
"18591","8112b33c1a9b769418abc829c8a347b8",173,70,84,14.4166666666667,173,0,3,3
"18592","81132eb50003ac5b9fd279d11880b6a6",203,92,84,16.9166666666667,203,0,3,3
"18593","81157aa9594707d40e383ba4e583585a",31,31,0,31,31,0,1,2
"18594","8115d7d590ead0c9e9dd6cb5ff266840",34,34,0,34,34,0,1,2
"18595","81167c4ed2f461501d0045adb13298fd",58,43,29,14,58,0,2,1
"18596","8118b365706bd4f0c308b628f993427d",17,17,0,17,17,0,1,2
"18597","811b119853550b3cce5e8932d8d8f78a",137,106,67,14.3134328358209,112,25,3,3
"18598","811d1cc7473fa00791db0ceff8b65c42",31,13,55,3.94545454545455,31,0,2,1
"18599","8120a991d2c1ad306acc2cd0e6f3d4a6",46,40,78,4.12820512820513,46,0,2,1
"18600","81211d4b5fb16c0c659a461271b98efa",57,45,18,22.1666666666667,57,0,1,1
"18601","8125b7b07fd1f9c7ca3e134d24e1cfab",58,49,26,15.6153846153846,58,0,2,1
"18602","812652095a69bf58cf3cc6bcf582729e",19,19,0,19,19,0,1,2
"18603","812753b656ff04b663016ffdc45b1970",22,22,0,22,22,0,1,2
"18604","8129d5bb8421fe88ace521e4aed02674",49,40,12,28.5833333333333,20,29,1,1
"18605","812ad3f546127611db343cec5ea915d1",54,45,30,12.6,34,20,2,1
"18606","812d6c59ee8e7f00770c28ead83f6944",100,63,44,15.9090909090909,70,30,2,1
"18607","812dfd6aac88eeb083d3bf37b218195b",7,7,0,7,0,7,1,2
"18608","8130184de187828580e7f6ae8c40701e",107,61,39,19.2051282051282,88,19,2,1
"18609","81310c7e4bd08235d862ba574e42b014",7,7,0,7,7,0,1,2
"18610","81327f2ca42a29ab68607e3c4ae5462e",20,20,0,20,20,0,1,2
"18611","8137c43894993e087495937c1e0ddb8c",135,78,27,35,94,41,3,3
"18612","813824aaf2971b386a09c38862bd3a70",65,63,55,8.27272727272727,65,0,2,3
"18613","8138c34bcd423f0971a6d04728fc7fdd",21,21,0,21,21,0,1,2
"18614","8139c0c7a5bec49d663f7843cc55068b",59,51,21,19.6666666666667,59,0,2,1
"18615","813bdc06c990793a292b05fe9c2cfbe6",112,83,43,18.2325581395349,112,0,3,3
"18616","813c0911e8633e6b008a7beb74ade198",36,36,0,36,36,0,1,2
"18617","81413497f1b48376a7826f043d350142",5,5,0,5,5,0,1,2
"18618","81486c5a4f36bb23af8ee6c245bf32dc",4,4,0,4,4,0,1,2
"18619","8148ec189fc643d0274112832c01402c",146,96,82,12.4634146341463,146,0,3,3
"18620","8148f988606e4d54c9ce6173e48048de",200,72,78,17.9487179487179,178,22,3,3
"18621","814ad94f0441c4f3dd8435d40cf43b2b",32,32,0,32,0,32,1,2
"18622","814d44872efd26d517b2a0f37683ef76",64,46,18,24.8888888888889,64,0,1,1
"18623","815003e70771ae492d79a10dd9d59a93",30,30,0,30,30,0,1,2
"18624","8151066bef741040d11c113283f23a9b",80,39,81,6.91358024691358,53,27,2,1
"18625","81539bcbc350332c8668f67b3c5c8c81",36,36,0,36,0,36,1,2
"18626","8154f73e6b127390f48be0fbb6163c3e",65,53,29,15.6896551724138,65,0,2,1
"18627","8155db0d48cc10a86d18444e424a1f52",60,54,42,10,8,52,2,1
"18628","815a627118863660ac9ec17831bcdb7b",15,15,0,15,15,0,1,2
"18629","81602d79a43963410ebb4410971d2e94",119,94,72,11.5694444444444,119,0,3,3
"18630","81620cfbf7d334d835a1071bb296dde0",154,94,61,17.672131147541,154,0,3,3
"18631","8162864ba6d0763585a2100539b3cc7e",69,59,31,15.5806451612903,40,29,2,1
"18632","8164d6ab9d8e6be83274354e1f29513f",116,78,42,19.3333333333333,116,0,3,3
"18633","8166f4d550a2795b73dd0f4926381a94",60,49,59,7.11864406779661,30,30,2,1
"18634","816736b1ba3688e38fd94a14c69d7c92",35,35,0,35,35,0,1,2
"18635","816afa18f2c9d40b4f25c2937a1e7cef",12,12,0,12,12,0,1,2
"18636","816e46a0ea9017e238c580099b45ca0e",106,85,63,11.7777777777778,60,46,3,3
"18637","816fba6f8121aff7c89973566adf0dd8",87,63,44,13.8409090909091,87,0,2,3
"18638","81708c4c18a988780fb2deb7a403b881",80,61,36,15.5555555555556,40,40,2,1
"18639","8172f0a58bcf034a298b3c9d44d3fb90",60,57,23,18.2608695652174,33,27,2,1
"18640","8176bfa60851281bdcf3886d10b63eb6",19,19,0,19,19,0,1,2
"18641","8177234768429bf0b1e335b0b40a8722",37,37,0,37,37,0,1,2
"18642","817ef4ac9e3636f614537532e919f460",38,38,0,38,38,0,1,2
"18643","817fea5793ed211bdd41cbc27669d0f7",54,33,56,6.75,54,0,2,1
"18644","8184d6c77f14a33e574d4d4e12162b3e",29,29,0,29,29,0,1,2
"18645","818884bb809efa0f1e9f347238abe3ce",116,43,54,15.037037037037,68,48,2,3
"18646","818964ae3efc6bac12a4ffa2975e8ce4",24,8,76,2.21052631578947,24,0,2,1
"18647","818a4f3c9ec60001d531e5a0d580456a",129,79,68,13.2794117647059,129,0,3,3
"18648","818d7d4bf689512e7d4568cfdbda6e37",23,13,76,2.11842105263158,19,4,2,1
"18649","8193ee39697efca98b1846d685de5c10",27,27,0,27,27,0,1,2
"18650","81946e85f57bf2a27c07b296e64c8fbc",37,32,76,3.40789473684211,18,19,2,1
"18651","8194ed5476db6d37c09571e28e2f2117",23,23,0,23,23,0,1,2
"18652","8196beb0a77f07a9c2f7fb4224e3bc0a",15,15,0,15,15,0,1,2
"18653","8198010041fcc9e6322624e0b8bf1747",75,9,81,6.48148148148148,67,8,2,1
"18654","8199c7246c2feebff749fac5277f9cc3",27,23,61,3.09836065573771,27,0,2,1
"18655","8199dda3a3a2cce3eb678fcbed50207c",200,141,81,17.283950617284,200,0,3,3
"18656","819e3463b246ac7c5fb1cd9853159f48",203,73,78,18.2179487179487,170,33,3,3
"18657","819eb3ea52f6d078be7060edce469fa7",2,1,55,0.254545454545455,2,0,2,1
"18658","819f82d88ccf36d521a260916ae4f690",36,36,0,36,36,0,1,2
"18659","81a09ef0894bffec3bff5e4508724404",23,23,0,23,23,0,1,2
"18660","81a32bf0097d28a5d419bf58160aab8a",108,48,59,12.8135593220339,81,27,2,1
"18661","81a3990700141ba62fe171df5bdbebc7",161,112,46,24.5,161,0,3,3
"18662","81a3a37a2f04c349702e74e4bc710b55",18,17,18,7,18,0,1,1
"18663","81a3a6d9564b128e2be0c3d77063e235",56,38,74,5.2972972972973,56,0,2,1
"18664","81a3e076a477e4d7edc100dd20b42cf7",181,112,44,28.7954545454545,137,44,3,3
"18665","81a49160c5663e07b0180f2263d73726",9,9,0,9,9,0,1,2
"18666","81a5bdb18a483a598eaf297b49660121",23,23,0,23,23,0,1,2
"18667","81a63f2446c50f874a313c62098c879f",23,23,0,23,23,0,1,2
"18668","81aa07e02b43c118b6e6b64de114590f",26,26,0,26,26,0,1,2
"18669","81aa4e62fdccfd99038881b92127275d",26,26,0,26,26,0,1,2
"18670","81aa526bbf49ce03c138e2ae57fe3fe8",206,113,74,19.4864864864865,167,39,3,3
"18671","81b03749860bd34140b5bd52458c0cc8",8,8,0,8,8,0,1,2
"18672","81b20270a3cd8f834f2b73468da32c3d",23,23,0,23,23,0,1,2
"18673","81b257db18113755f4d9c7e58a0fd2a8",28,28,0,28,28,0,1,2
"18674","81b576d3c9de3eab939bf61e1a088032",16,16,0,16,0,16,1,2
"18675","81b7293fd3043c2500d7c5dd8b7fe995",58,44,57,7.12280701754386,58,0,2,1
"18676","81b8d4ac245582c7697936bde384f8d7",47,40,41,8.02439024390244,47,0,2,1
"18677","81c2342dc7cd270fd456ed92eeb2f2e4",99,71,32,21.65625,48,51,2,3
"18678","81c4d241ea01efe73981821896afcd89",69,44,29,16.6551724137931,69,0,2,1
"18679","81c53c90faaffb44ebbd6c9dc6a89326",23,23,0,23,23,0,1,2
"18680","81c6e04d49dd59d59922498e0cfb3cbb",52,52,0,52,52,0,1,2
"18681","81c9c8818e6d346b16291764a3b8e2cc",19,19,67,1.98507462686567,19,0,2,1
"18682","81d14b98e0af31416eebfa34dca8f247",227,149,75,21.1866666666667,214,13,3,3
"18683","81d2487fc868a1814f20beefcba6306c",51,44,67,5.32835820895522,51,0,2,1
"18684","81d5234c318db2ea476549bad883500c",120,66,51,16.4705882352941,120,0,3,3
"18685","81d64300fb31d53aecfa04aacd5f7b54",43,43,0,43,43,0,1,2
"18686","81d793dd7864e362c4d216868300e475",15,15,0,15,15,0,1,2
"18687","81d89016c700f4fbadcba96576339bf4",24,24,0,24,24,0,1,2
"18688","81d9e9c5998344139efb459186fa7968",16,15,36,3.11111111111111,9,7,2,1
"18689","81da8c0f7aa3782c5ccd669c5b24330c",17,17,0,17,0,17,1,2
"18690","81dcda47c921da3b133b4db7c97c75c4",57,55,50,7.98,45,12,2,1
"18691","81ddbb8644f8bc1aec22213705d5b262",88,46,60,10.2666666666667,88,0,2,3
"18692","81e127f56eb3942b32c9ecdca160c69c",37,37,0,37,0,37,1,2
"18693","81e18fe67f341567fbde53af9e6cf399",207,91,50,28.98,207,0,3,3
"18694","81e24e6ac0ebc792ce266480100459ce",44,44,0,44,44,0,1,2
"18695","81e7805a52f1ed7a6231fac30aea9e1d",26,26,0,26,26,0,1,2
"18696","81e7cbeefad4c6530b9209546c0be763",29,29,0,29,29,0,1,2
"18697","81ed16cd4f41e1b66f08778917c38ebc",147,101,70,14.7,147,0,3,3
"18698","81edf5046bc13c48609970e01c8bb4df",26,26,0,26,26,0,1,2
"18699","81ef8a4a82a38c5309e9355baa2bfa5e",4,4,0,4,4,0,1,2
"18700","81efc69981202a5247f48eceee40a295",83,55,35,16.6,30,53,2,1
"18701","81f254b73fafe1b0bab038fce1fb30c3",3,3,0,3,0,3,1,2
"18702","81f36a66aa13257da33b567dadba4df0",7,7,0,7,7,0,1,2
"18703","81f3bac202030a9b6ef52b804836bee0",168,126,36,32.6666666666667,116,52,3,3
"18704","81f41f7f95efc2d4c1095322de875973",77,45,56,9.625,44,33,2,1
"18705","81f5d70ba0138401383aca52e987dfb8",79,65,47,11.7659574468085,79,0,2,3
"18706","81f6ae534a1699038e0147fda4d1155c",89,55,20,31.15,44,45,1,1
"18707","81f77ba3d9ac0c3efe72d4c2454188fa",24,20,33,5.09090909090909,24,0,2,1
"18708","81f8599656fc580c835f6192f43036d7",145,84,77,13.1818181818182,145,0,3,3
"18709","81f8bb5c82539ecd77f3d84699b88d2f",73,49,55,9.29090909090909,73,0,2,3
"18710","81f9d2a25f7e7258e5f6594fb797f192",50,46,36,9.72222222222222,50,0,2,1
"18711","81fa543b8f99c25d7fe229fcb3827583",165,88,66,17.5,130,35,3,3
"18712","81fac41b381c41343ef93f779f36a0f3",24,23,25,6.72,24,0,2,1
"18713","81fafaf88be7e5210bedfcf80cfd2cc6",55,55,0,55,55,0,1,2
"18714","81fb66299f4ae1a63d36068f501863fb",31,25,36,6.02777777777778,31,0,2,1
"18715","81ff34d35c21624ee02d175b7947c68a",50,50,0,50,50,0,1,2
"18716","81ff36a4aae3c4527eb934c05efbefea",27,27,0,27,27,0,1,2
"18717","81ff3de11a874d422ffefbb3f07aee8d",107,64,61,12.2786885245902,53,54,2,3
"18718","82001815815bbdb15fdc48faeaf56a70",16,16,0,16,16,0,1,2
"18719","82048116e07c75595edae7689934c58a",182,111,77,16.5454545454545,182,0,3,3
"18720","8204d55c98ad7599c0a7221adfc2aff5",21,21,0,21,21,0,1,2
"18721","8208afae1610cdf7abe459a769696dce",29,29,0,29,29,0,1,2
"18722","820a30d1bfb87d5e17cb7b3963326efd",17,17,0,17,17,0,1,2
"18723","820a6ee4c03cd4b9d93046bd07f56351",9,9,0,9,9,0,1,2
"18724","821075b99a3f391d8a3c4be5aef2f7b5",83,75,32,18.15625,83,0,2,3
"18725","821155ff3eb5a35d4eaa273ab4686e55",82,53,42,13.6666666666667,82,0,2,3
"18726","8212fef7b2a41e1ad7d22d7e0eb4d7fc",106,91,16,46.375,106,0,3,2
"18727","8214414ecb498e6ae3d098e53e96328a",50,50,0,50,50,0,1,2
"18728","82146b5e464012f511ac206995021529",42,42,0,42,42,0,1,2
"18729","821560698b38656691b20f281aa41a08",63,43,41,10.7560975609756,63,0,2,1
"18730","8219a5a347437a351c6a7e47167022ae",38,38,0,38,0,38,1,2
"18731","821aabd9322924826eeed0e0d61b5d0c",31,31,0,31,31,0,1,2
"18732","821ad81bf9697393ba45318a66d69c30",73,49,80,6.3875,73,0,2,3
"18733","821db477325ec1cf3a9f0d4571ce2195",41,41,0,41,0,41,1,2
"18734","821e206f6e58bbc56047e7b35725ea7b",123,109,49,17.5714285714286,123,0,3,3
"18735","821f48913bd8e8cb62881be02e5ced09",15,9,55,1.90909090909091,15,0,2,1
"18736","82250c2f577e8fdb68d050d07fd84713",12,3,77,1.09090909090909,12,0,2,1
"18737","822511492e69b6c7d699c7205ca7073f",12,12,0,12,12,0,1,2
"18738","822515c23dbc3dea45a43a3040865d4d",137,97,75,12.7866666666667,137,0,3,3
"18739","8226bee39343f4b5a37e9129db259d11",25,25,0,25,25,0,1,2
"18740","8226ca684c51524d8c2be89edf50c255",19,19,0,19,19,0,1,2
"18741","8227167f79d0934622f0f04070394b45",28,28,0,28,28,0,1,2
"18742","822992284298431b1644682f9a7b44a5",72,51,60,8.4,72,0,2,3
"18743","822a86b808ae357018dd7440dc44be5a",59,48,33,12.5151515151515,25,34,2,1
"18744","822af36eafa696f13935bc8d751ff610",45,36,65,4.84615384615385,23,22,2,1
"18745","822d9b9ca65ab34cdd4612fc8fe42281",23,23,0,23,23,0,1,2
"18746","8235b8a6aa2635f80079663dd8d6409b",64,39,39,11.4871794871795,64,0,2,1
"18747","8237043b25a1d9eae0ce474072ed1ee1",48,48,0,48,48,0,1,2
"18748","8237c2a9fd825383eafb640e40598950",24,24,0,24,24,0,1,2
"18749","8237f3594c0988e66e645b2412e15657",56,41,70,5.6,56,0,2,1
"18750","82380cf0991c9d4d115c42d0647979cf",14,14,0,14,0,14,1,2
"18751","823ea78acd3a93b8aab52ed6196b77bb",200,102,77,18.1818181818182,165,35,3,3
"18752","82429d62ffaa9621109ad9b1bec36d64",66,56,44,10.5,41,25,2,1
"18753","824450505fe317aed6f33a9b2b8bf971",18,18,0,18,18,0,1,2
"18754","82465887a890af6a965524f416e686db",15,15,0,15,15,0,1,2
"18755","824918888204ed7c24f87881480e9271",167,87,64,18.265625,167,0,3,3
"18756","824a90cedf7d6c129552e40fd0c37230",25,25,0,25,25,0,1,2
"18757","824b41fbc849365e080f5e0e4484d6c3",68,54,63,7.55555555555556,68,0,2,3
"18758","8254b5ab0bed29dcb7107f1acaf3955f",128,97,57,15.719298245614,128,0,3,3
"18759","8254fc962b0aacf8fd22bd87b7046036",25,25,50,3.5,25,0,2,1
"18760","82562ed447baa15e26369bd4f2417329",26,23,56,3.25,26,0,2,1
"18761","825838df36086cfe36661c7f91fbb753",79,69,43,12.8604651162791,79,0,2,3
"18762","825995667ef845b6dc796f5b07f67a26",69,39,63,7.66666666666667,48,21,2,1
"18763","8259b87fc8155e8b6f4288df2e3ed15f",36,29,56,4.5,36,0,2,1
"18764","825a0e8e2c4945608deac7c7719f14ae",132,60,43,21.4883720930233,101,31,3,3
"18765","825b0f8eb03c59373c3c76e75a27c2f2",226,123,61,25.9344262295082,194,32,3,3
"18766","825f031fc0142477c7355f1761489c86",46,31,41,7.85365853658537,46,0,2,1
"18767","8260de211abbb91eac5c5dac372ed485",29,29,0,29,29,0,1,2
"18768","82649e2d43db65e9684d2724e5fa0504",52,44,34,10.7058823529412,52,0,2,1
"18769","826614e8b3ab3b157a91f0df9111695b",88,57,63,9.77777777777778,88,0,2,3
"18770","82663099b7f4434557fa4732bde0f6e3",41,41,0,41,41,0,1,2
"18771","8267174724679212adec77620b907805",24,24,0,24,24,0,1,2
"18772","8268394a9bd0fa6c812d3784dbdd7425",234,95,63,26,206,28,3,3
"18773","826889e08fb4be39d1c20b5e61a2f29d",41,41,0,41,41,0,1,2
"18774","826c213df1b188f2df9cbcf94c94a276",31,31,0,31,31,0,1,2
"18775","826c4327a5d2bad08b05c1f9bea37406",2,2,0,2,2,0,1,2
"18776","826cbfc391d92b9cc364095a652c13ce",87,72,23,26.4782608695652,33,54,2,3
"18777","826e3443bc0a9308f2283dd7ac24f2b5",138,68,57,16.9473684210526,138,0,3,3
"18778","8274affaf0e3ceeb1dff763028f338ca",37,37,0,37,37,0,1,2
"18779","827fe466dcbfb35939503f11c5fed09d",68,25,83,5.73493975903614,68,0,2,1
"18780","8281ae3eb9a35d9283880b32aca0069d",67,58,47,9.97872340425532,42,25,2,1
"18781","82827f8fba39d2b67ca012c706285553",32,32,0,32,32,0,1,2
"18782","82841403fe854d8911a3102872126b64",141,56,89,11.0898876404494,130,11,3,1
"18783","82845832c36d588a6024b10a6f4cd8ef",13,13,0,13,13,0,1,2
"18784","828517ca8e7750ac0da834020e55d50c",210,56,88,16.7045454545455,210,0,3,3
"18785","82851cf2582524a17355413d209b5fc3",1,1,0,1,1,0,1,2
"18786","82858f2bb2684a2f2eaeec588a6868be",178,93,75,16.6133333333333,178,0,3,3
"18787","8288ec6906dfcf3404e2a40c361fef1d",49,38,74,4.63513513513514,49,0,2,1
"18788","8289e7f51c1e182387ac8b24b9807632",30,30,0,30,30,0,1,2
"18789","828afe7ad27c9f6334aaae3e3cc0b88b",21,21,0,21,0,21,1,2
"18790","828b1274d109ac2e710f9edbc3bd1912",43,43,0,43,43,0,1,2
"18791","828b4de7fb0d460a47061e282d4fa554",73,63,37,13.8108108108108,27,46,2,1
"18792","828ca35689164f0bcb0b42e2a6d44c7c",124,83,87,9.97701149425287,124,0,3,3
"18793","828dc93af170a26f8161863afaf095ba",55,52,49,7.85714285714286,55,0,2,1
"18794","828de4e98c664ea162b4eaa12dbf20d8",17,17,0,17,17,0,1,2
"18795","828ed0a7c4b869839b2a0dc7becf6275",34,29,74,3.21621621621622,26,8,2,1
"18796","8290f0182dbabf248fdd4764c2fcd27c",27,27,0,27,27,0,1,2
"18797","829344e768657c109ddaf776455a1e6d",93,52,56,11.625,93,0,2,3
"18798","8293ce6baa42b804eeff953509871ce8",28,28,0,28,28,0,1,2
"18799","829474dcd929d0b4282d9175d17576ba",31,26,48,4.52083333333333,31,0,2,1
"18800","8298e9487ffad7a1ae7e477bd6b0a6ba",35,35,0,35,35,0,1,2
"18801","8299135d6129b30d2e495d47e5b6cab0",28,28,0,28,0,28,1,2
"18802","829a16f9ef0267778f8a26e157dd5223",28,28,0,28,28,0,1,2
"18803","829a58cfe7fbe671132f5ebcd895e3dd",48,48,0,48,48,0,1,2
"18804","829dff29b2fd617f957d592ec8ef9c81",11,11,0,11,11,0,1,2
"18805","829e88d762a54ad259fbee210164a8c5",44,44,0,44,44,0,1,2
"18806","829f33fbef37a09456cb35b42b50cab8",35,35,0,35,35,0,1,2
"18807","829ff3f6ef5806657e46c7029df345fc",144,51,84,12,128,16,3,1
"18808","82a1cd4e442432adfdadb20b6874435b",87,54,56,10.875,87,0,2,3
"18809","82a32da00c0b52caf9440b0ce8034c8d",202,121,83,17.0361445783133,202,0,3,3
"18810","82a761cd1e67698ad7696835c0309f22",97,66,46,14.7608695652174,51,46,2,3
"18811","82a8ace6919d26600b38ba1bf8f68dc1",28,18,35,5.6,28,0,2,1
"18812","82a9cd3df6d905df3ef9ac78b0568b81",160,108,73,15.3424657534247,130,30,3,3
"18813","82b0a6111c34f5cb66fe87357beedced",39,39,0,39,39,0,1,2
"18814","82b3fe56386e2a474c405baf9840d8b1",19,19,0,19,0,19,1,2
"18815","82b4e3d5cae7cfd8d9d313165b77eaf9",1,1,0,1,1,0,1,2
"18816","82b63908a34d4675f60ec8cdcdf574c6",50,37,23,15.2173913043478,41,9,2,1
"18817","82b65dcd1bb4f0de3b325d0387714027",201,94,83,16.9518072289157,201,0,3,3
"18818","82b7bef19f1cb31f3275bc093750421a",17,17,0,17,17,0,1,2
"18819","82b803f6b1ad2f3c850d8f66c3aa840e",164,88,74,15.5135135135135,164,0,3,3
"18820","82b81d263a1345dc63ea5edd7d7795d1",39,39,0,39,39,0,1,2
"18821","82bacc489ac09ff1ac4f7f292adc6010",15,15,0,15,15,0,1,2
"18822","82bca9a006f24c4cc64e0f7cda040006",32,32,0,32,32,0,1,2
"18823","82bdcb029e5bab49fbedfea18b3b6833",3,3,0,3,3,0,1,2
"18824","82bf6e983afec5a285e1ad4680078c87",49,34,36,9.52777777777778,49,0,2,1
"18825","82c00dcee2b22561828e30b95589361c",65,60,74,6.14864864864865,65,0,2,3
"18826","82c01cd5e31db38c6f0f451216c199a7",83,66,57,10.1929824561404,48,35,2,1
"18827","82c05596bc211a3a3299a370d12b9110",165,94,55,21,165,0,3,3
"18828","82c2add92b8bd4b4279ad598732ce1da",40,35,29,9.6551724137931,17,23,2,1
"18829","82c2d979e725a7a1f4bf11450c16c0dd",28,28,0,28,28,0,1,2
"18830","82c40719367a738495beafcf02522c37",62,48,18,24.1111111111111,62,0,1,1
"18831","82c5f5d8735ca4f9b47d977959487c47",84,56,49,12,84,0,2,3
"18832","82c68b9ff706861cdc3cdce1c0a01b32",50,35,36,9.72222222222222,50,0,2,1
"18833","82c68ba337639c87d8be5b5678334d7a",22,20,24,6.41666666666667,22,0,2,1
"18834","82cd20556f18be08f7aba4c72b370a21",138,90,70,13.8,106,32,3,3
"18835","82ce40755467d64f00536d0596dcec46",13,10,65,1.4,13,0,2,1
"18836","82cfd3abdfc461b0e0e450ea77a35c38",141,77,62,15.9193548387097,141,0,3,3
"18837","82d1d47024676a583dec617d9b00b9a1",52,45,20,18.2,52,0,1,1
"18838","82d1f277aec25c3882ecfe3c45da78ab",131,83,80,11.4625,96,35,3,3
"18839","82d23f17e90707833d150fd31c9b1a11",22,22,0,22,22,0,1,2
"18840","82d28bc8530ae9b518bdfa4b3d4ee5f4",4,2,17,1.64705882352941,2,2,1,1
"18841","82d6d1c4154b60d346277e7afdae26fe",11,11,0,11,11,0,1,2
"18842","82dbdf6b9957a865a331055239db20c5",94,55,76,8.6578947368421,65,29,2,1
"18843","82dcf07fb555278919e836e6555c1138",90,73,36,17.5,53,37,2,3
"18844","82dd9d0365e60c61172413bfb6761bf9",23,23,0,23,23,0,1,2
"18845","82e1c019663bb7472c5466d30fbfa13a",14,13,4,24.5,1,13,1,2
"18846","82e24c2e12b163030caabaf16f28c800",205,94,73,19.6575342465753,205,0,3,3
"18847","82ea71bd7dba05989fa8b198c9f70e34",85,50,58,10.2586206896552,85,0,2,3
"18848","82ea90d7081db05900459b021d7b9b5d",54,54,0,54,54,0,1,2
"18849","82eb99c344893682d8fc0b29bac67651",99,68,64,10.828125,99,0,2,3
"18850","82eb9c2fc77fa8c4e5414724520d5177",147,83,57,18.0526315789474,147,0,3,3
"18851","82ef022c4a1a140edbcae4aa6c8d6cdc",20,20,0,20,20,0,1,2
"18852","82ef87fda65bb1857e775933191e76ea",44,44,0,44,44,0,1,2
"18853","82f2029cfd58e5744deec524dbcc7772",150,84,70,15,131,19,3,3
"18854","82f2e53edf23127d7ea17fe5ef286745",25,25,0,25,25,0,1,2
"18855","82f408950f78eb491b78666bf3b0d836",100,72,44,15.9090909090909,100,0,3,3
"18856","82f5d6d2483249d8725ed1a28fbfdf20",21,21,0,21,21,0,1,2
"18857","82f67a21e55cd13b4f61e4d8f1792e96",89,69,59,10.5593220338983,54,35,2,1
"18858","82f72b892cccfc3437a8a92d40d8bf99",85,54,49,12.1428571428571,62,23,2,1
"18859","82fa9128b27a71b8f7f4ac16d6891f34",6,6,0,6,0,6,1,2
"18860","82fcfa3e84af2771c9810091f58a9e85",90,61,44,14.3181818181818,90,0,2,3
"18861","82fdaa1b6ae04f032af0b817c8659514",45,45,0,45,45,0,1,2
"18862","83016134c2d53cb3d2931a2d82b30301",118,110,58,14.2413793103448,118,0,3,3
"18863","8301dbd0e990407754cbecf6e713ca41",114,78,63,12.6666666666667,69,45,3,3
"18864","83076ac1dd099d3f624b3ac075425047",73,60,56,9.125,73,0,2,3
"18865","830bb0a23815fdf9605061416872202a",72,53,19,26.5263157894737,52,20,1,1
"18866","830bbb6ea533d8b2ce301d16210e397e",13,13,0,13,0,13,1,2
"18867","830ca2cd303b33c3fe4bcfcf7913272e",18,18,0,18,18,0,1,2
"18868","830ceccd802cccfa8a5a2e34711f9e64",49,45,12,28.5833333333333,15,34,1,1
"18869","830dee57c16b3551f16c5bc9d634763a",39,39,0,39,39,0,1,2
"18870","83107d38fce303534238085e5e61b0ee",183,116,51,25.1176470588235,183,0,3,3
"18871","8310cb9d6da73036227af798bbb0eb56",37,26,19,13.6315789473684,23,14,1,1
"18872","8313c6e2e972067321d29491a35948dc",28,28,0,28,0,28,1,2
"18873","831fcc846c0f1573d626f0c835fb8af4",93,75,15,43.4,93,0,1,2
"18874","8320ca893b50247b3a2fcae9e65989f7",11,11,0,11,11,0,1,2
"18875","8322ff7c2c14e3393979bc134ee71a18",12,7,76,1.10526315789474,12,0,2,1
"18876","83250d7958aad6370bec34da4f22f87b",48,42,65,5.16923076923077,25,23,2,1
"18877","8326268342065e3cf9b6cb3b35808ab8",18,18,0,18,18,0,1,2
"18878","832869f580f8872812453993a8ba29ff",94,77,56,11.75,94,0,2,3
"18879","8329e033ce2173c55a251561dbfedf0a",49,45,50,6.86,23,26,2,1
"18880","8331e4df61564f8b65a5710d6eb7c99e",176,84,71,17.3521126760563,176,0,3,3
"18881","83327993341e50629c84eb8e3363a276",38,38,0,38,38,0,1,2
"18882","83327b56c050558e8760842758d08e4f",143,84,78,12.8333333333333,143,0,3,3
"18883","8332eb8570e30979a4762562aba799fe",26,26,0,26,26,0,1,2
"18884","8333addaa7a13d374cf8c5ba314fae58",33,33,0,33,0,33,1,2
"18885","8336414ac7507d82459b6e5913f9c149",79,46,44,12.5681818181818,46,33,2,1
"18886","83378c10b5feb25b629b660cba805e2c",111,78,71,10.943661971831,111,0,3,3
"18887","83381c3ca2070f8dbfbb1898e8dbf279",27,27,0,27,27,0,1,2
"18888","833891b995140cb56770e1b7a940edef",106,91,37,20.0540540540541,106,0,3,3
"18889","833951da5e17e5ecd46459b4f7115b74",124,85,27,32.1481481481481,124,0,3,3
"18890","8339816452fce777e36aebd4cfe00d5c",37,37,0,37,0,37,1,2
"18891","833b5d5dcaf502516b95f26e618f81a0",19,19,0,19,19,0,1,2
"18892","833b7c58578b89ea30cac2490d773538",18,18,0,18,0,18,1,2
"18893","833c171235fb51a615a02a9a10df5910",6,6,0,6,6,0,1,2
"18894","833cfe058aed53db9af09e7095b93090",26,26,0,26,26,0,1,2
"18895","833d710f3de4be1d8ad410e70c5871b2",98,65,57,12.0350877192982,79,19,2,1
"18896","8341190ba378249bf76af172f2d9e4b2",175,139,62,19.758064516129,175,0,3,3
"18897","83414b22cf84b4ea3d14ab8215b63e77",55,53,73,5.27397260273973,41,14,2,1
"18898","8343de2149cb4ae23b3e9e7e4a4a5e1b",87,47,77,7.90909090909091,87,0,2,3
"18899","83454dcd4076488e42810538ed445374",14,14,0,14,14,0,1,2
"18900","834631eea05cba6ea0a6ff8bc36de3e4",68,58,56,8.5,68,0,2,3
"18901","8347ad53ab41022c7e7026e80aa3b291",29,24,12,16.9166666666667,29,0,1,1
"18902","83494dcb76c3e1ef16c77bb6ec412934",28,22,28,7,28,0,2,1
"18903","834aebdf3507e7ccc04e45d18ab5345d",38,31,36,7.38888888888889,38,0,2,1
"18904","834ca4ee8dcea5b445586acc10327346",75,63,82,6.40243902439024,75,0,2,3
"18905","834dc896fa34e0a0052b5e5b2a4c5566",50,42,43,8.13953488372093,50,0,2,1
"18906","8350854946b5f0ae2fdf35b5d87c732b",86,73,18,33.4444444444444,86,0,1,2
"18907","8351026e2f3f3935c794bb3188f2c717",8,8,0,8,8,0,1,2
"18908","8351476a3731686df12d0d95498300aa",17,17,0,17,17,0,1,2
"18909","83522ac06137fe16ed82bcf507980c10",132,76,56,16.5,91,41,3,3
"18910","8353e36934a12e989ac884431295f8b7",123,65,49,17.5714285714286,103,20,3,1
"18911","83551e44dfd8dec4f9ebb929afb614f0",115,60,67,12.0149253731343,89,26,3,1
"18912","83558089dcb078cb633eb38b8cf3fb93",184,51,79,16.3037974683544,184,0,3,3
"18913","8355eb7cef00a4259a2a91c445521614",66,52,69,6.69565217391304,66,0,2,3
"18914","8356385d0cf7f61bea8473bba43f9b22",9,6,44,1.43181818181818,9,0,2,1
"18915","8357da95cebe8eaeb93f7f9159bb6fa8",57,46,11,36.2727272727273,23,34,1,2
"18916","8357e6ce15bafe2bc1591099ff19f0e4",37,32,61,4.24590163934426,37,0,2,1
"18917","835c4f92cf6ff27476c19a84fd33d6f7",77,60,57,9.45614035087719,77,0,2,3
"18918","835d0ac3ffb7e59e20e21a2440391580",25,17,21,8.33333333333333,25,0,1,1
"18919","836009c59458db9601776a907ecdd578",15,15,0,15,15,0,1,2
"18920","836354c0e9cdf2f2037ce5017e5c28e1",100,81,55,12.7272727272727,71,29,3,1
"18921","8365c288cef2c96e87b4db702e87b7ad",55,50,11,35,55,0,1,2
"18922","83674d4964822e10caa827b1a98f6c74",28,28,0,28,28,0,1,2
"18923","836c5902ba7d74444615730d3eacbb67",58,41,36,11.2777777777778,58,0,2,1
"18924","836c59cf8a977e623213f2652aee3da9",20,20,0,20,20,0,1,2
"18925","836d9553de1399858fd86fd53ad9209f",63,54,52,8.48076923076923,63,0,2,3
"18926","836e9258c61bad221a5958359f058922",60,50,26,16.1538461538462,60,0,2,1
"18927","836f8db60f4184686b61fc4f279b7f8a",1,1,0,1,1,0,1,2
"18928","83700c18c8131313cdf51f80b96a5303",25,25,0,25,25,0,1,2
"18929","837215d1afc8f30b19c105558764f8f6",122,81,68,12.5588235294118,122,0,3,3
"18930","8378eb3418c62cfc1e7863eabe10de56",176,98,82,15.0243902439024,176,0,3,3
"18931","8379bf29e713b72e0a0f5e1de753855c",26,26,0,26,26,0,1,2
"18932","837a589ac522e3c2ea72a2b824b095ea",166,107,38,30.5789473684211,166,0,3,3
"18933","837bae37a5e006b859bf784631e7f116",139,83,68,14.3088235294118,139,0,3,3
"18934","838084a427a08f484ccd9523f4d3632a",24,24,0,24,24,0,1,2
"18935","8383afc80f76643a21e72d89c6b5f7db",131,77,48,19.1041666666667,131,0,3,3
"18936","838a47c240bb2065b4369307a9cbe0d2",62,48,56,7.75,62,0,2,1
"18937","838c212b45b2453d9318181251b0bc21",88,68,56,11,88,0,2,3
"18938","838c2657ac65da20207cfa887e6e4e3f",150,71,84,12.5,150,0,3,3
"18939","838d2ecac1fa3e0c192d7488397efe9a",105,76,63,11.6666666666667,105,0,3,3
"18940","838d53282adcad76dc158055201ae4fb",50,39,40,8.75,50,0,2,1
"18941","838e470b9d4e5c48e043f8f0deb9c74a",110,75,51,15.0980392156863,110,0,3,3
"18942","838e92c3944014ffc41f753a848d5a20",46,36,28,11.5,0,46,2,1
"18943","8390035b628ebbd30cd80a0fbdd04dc6",110,85,63,12.2222222222222,110,0,3,3
"18944","83908cfed12244a404d30bb86ca0194d",22,22,0,22,22,0,1,2
"18945","839427972d4fba11c02d874cfb67f29a",48,44,10,33.6,27,21,1,2
"18946","83956ff589e317743ccccc4bb61732d1",55,47,28,13.75,55,0,2,1
"18947","8395bf7fc00a08a820e071ab9ecff23d",58,50,28,14.5,58,0,2,1
"18948","83988b012cfa0b40e5b12b7a5cc1a6a1",6,6,0,6,6,0,1,2
"18949","8399d92913acc237edc7bb655d8e7ccf",21,21,0,21,21,0,1,2
"18950","839e51709a6b66c847a40c5280bd334b",20,20,0,20,20,0,1,2
"18951","839eda14fd65e9f22a7949458c5383a9",14,14,0,14,14,0,1,2
"18952","839f716e31deae2f1de195cb9bcbcfd8",45,45,0,45,45,0,1,2
"18953","83a02f10ab3f34f41aeffae5b9cf2b9d",96,78,38,17.6842105263158,96,0,3,3
"18954","83a4c58b1de62a29606b0c53af54586e",22,22,0,22,22,0,1,2
"18955","83a662dde4c73b913600a1e13919022b",3,3,0,3,3,0,1,2
"18956","83a788d51da33be0daa765a0d126f81f",71,48,41,12.1219512195122,30,41,2,1
"18957","83a88fe865fb82b25055b9964564ce88",48,40,61,5.50819672131148,48,0,2,1
"18958","83aa43223d4f36932f078c04ed0e74e9",255,125,78,22.8846153846154,205,50,3,3
"18959","83aaea5b085b4c32550fd881e1be72af",18,18,0,18,18,0,1,2
"18960","83ab3079860be41ee8d054cdf6acc5a1",99,57,56,12.375,99,0,2,3
"18961","83abda85af018bb301c48295984767af",155,76,64,16.953125,155,0,3,3
"18962","83ac0394476af6a54493be61012dfd2f",46,46,0,46,0,46,1,2
"18963","83ad867456790a61ed17d88a0be1c7b4",9,9,0,9,9,0,1,2
"18964","83b34c4367bc39b5506b501fd1aab57c",7,6,35,1.4,7,0,2,1
"18965","83b5ed717228f6639e6c0c2a383824df",104,77,63,11.5555555555556,104,0,3,3
"18966","83b6d38c37dc0c16d005f517b9d74f05",45,45,0,45,45,0,1,2
"18967","83b6deec57f6eeb528466cafe38847b6",49,32,77,4.45454545454545,49,0,2,1
"18968","83b6e92d61c434717d24a02b0cd6a61c",76,53,26,20.4615384615385,32,44,2,1
"18969","83b7eba63ce5aaf48dc61387e40947ec",31,31,0,31,31,0,1,2
"18970","83b9c8e62c9007c33ec320ebd36ac4aa",28,28,0,28,28,0,1,2
"18971","83c07c096bd6b6640e290040e3101afc",75,59,56,9.375,75,0,2,3
"18972","83c16b5eb60b0e3f97d31eed8b3ada71",77,65,39,13.8205128205128,77,0,2,3
"18973","83c184a6f8d1f6aedf04a1999aa97cd9",28,24,66,2.96969696969697,21,7,2,1
"18974","83c2dff4fe08cd6cba16e20d15acc988",37,37,0,37,37,0,1,2
"18975","83c3f51f37f47c7d6860bf537d2b1a72",120,103,32,26.25,120,0,3,3
"18976","83c4bd98c3966001ea9ee13f5e0ca076",41,35,14,20.5,41,0,1,1
"18977","83c62c04d56e4b3bd64321d1521d07d3",8,6,41,1.36585365853659,8,0,2,1
"18978","83c779d7fdfd1a56f8474c59ddb50704",212,124,71,20.9014084507042,212,0,3,3
"18979","83c7d6a3d28d03e6d2c390950d379ee2",19,19,0,19,19,0,1,2
"18980","83c8063b320efbb63d426782f62d673f",25,25,0,25,0,25,1,2
"18981","83c8853f5baf3019b3007e651100ea66",85,53,63,9.44444444444444,85,0,2,3
"18982","83cb61ac9f1bbd77e247e676ed53e2d8",43,25,25,12.04,43,0,2,1
"18983","83cd03198eefb3a7903cf4c7a1774c14",21,21,0,21,21,0,1,2
"18984","83cdc849e263bba1998e4f23f07fd738",99,72,52,13.3269230769231,64,35,2,3
"18985","83ce0bf78cdebdd1e566f67218407cff",47,47,0,47,47,0,1,2
"18986","83d0990d16cc161cdac81c06afa4440f",18,18,0,18,18,0,1,2
"18987","83d17d904c48c2ffd8a5de504b83e43c",43,38,35,8.6,43,0,2,1
"18988","83d370a7c8950cf4d0c606d398caf0e1",20,20,0,20,20,0,1,2
"18989","83d39d6d72ec9e298e33f157cf5c8db6",90,80,45,14,90,0,2,3
"18990","83d731fe063d5bca5b5f56a90ca4ab44",151,89,84,12.5833333333333,151,0,3,3
"18991","83d9c98ec237dcc1d2d931b29a6d23e6",45,38,38,8.28947368421053,45,0,2,1
"18992","83db06be5ca010ca2a99b7eb2a9d49d3",180,85,69,18.2608695652174,158,22,3,3
"18993","83de327fc9920e3c1400d6530ac2104e",16,16,0,16,16,0,1,2
"18994","83de8a543b28df179efdc6617b2ea0f9",10,10,0,10,10,0,1,2
"18995","83e10275f0fff6f764bba53b4bc96024",43,34,41,7.34146341463415,43,0,2,1
"18996","83e10a8b1244b541d6da19b447d1f331",17,17,0,17,17,0,1,2
"18997","83e6c6d8e3b543fe3f3491077493465d",256,126,60,29.8666666666667,212,44,3,3
"18998","83e9646be79a128eba171e39e6444205",113,70,58,13.6379310344828,76,37,3,3
"18999","83ef109584d02ccd134f3cd742f836b8",131,83,47,19.5106382978723,131,0,3,3
"19000","83ef6e851bc7bf2570f360af067771ea",75,46,63,8.33333333333333,75,0,2,3
"19001","83f205d207102032ea37bd147ae8e9da",82,67,81,7.08641975308642,45,37,2,3
"19002","83f2ea1018eaf48ef60c2eb3e74a553d",23,23,0,23,0,23,1,2
"19003","83f4f7b527e95740e9af5fae73d38f9b",28,28,0,28,0,28,1,2
"19004","83f563d97ad684a4346369345234c94f",11,11,0,11,11,0,1,2
"19005","83fbad5ea914de8b280f704ed3823cef",17,17,0,17,0,17,1,2
"19006","83fc8ade7b97f6eb2f73c65ec8810a9f",44,44,0,44,0,44,1,2
"19007","840033294bac6e7ae6a17f00b389946b",36,36,0,36,36,0,1,2
"19008","8405e573cbea33ce8cfbaafa8891bd7a",59,52,25,16.52,59,0,2,1
"19009","84070ab622129bf6ca9c9dcb7de28e49",95,62,77,8.63636363636364,95,0,2,3
"19010","8407a5dac91e713b3e71e7dc46ba253f",38,38,0,38,38,0,1,2
"19011","840acb899990dd086e747c0c5dc40d4f",61,54,42,10.1666666666667,61,0,2,3
"19012","840fdf6604a7d36070e7b46ca597ddcb",46,39,31,10.3870967741935,46,0,2,1
"19013","8415f3699cfee306676719f1832a13ab",82,60,13,44.1538461538462,57,25,1,2
"19014","841837a0132dc46fe5a20a3cca09e7ac",15,15,0,15,15,0,1,2
"19015","841f46081d14e29e7754aac528e786e5",46,41,84,3.83333333333333,0,46,2,1
"19016","84210149f1619fd1adc91961208afd9d",50,43,18,19.4444444444444,50,0,1,1
"19017","8421a7d50ad9109fdf1f1e0f35b39867",24,24,0,24,24,0,1,2
"19018","842411c171fdcf086701f1f2b3bd463c",48,48,0,48,0,48,1,2
"19019","842b8f91db2a4b311112885caa1dd6da",15,11,30,3.5,15,0,2,1
"19020","842de95f49abaadf8cfc9b96e726e3a0",14,14,0,14,14,0,1,2
"19021","842e5b851eb68b4c106095205896c6a6",15,15,0,15,15,0,1,2
"19022","842ea6c21a1d044028add1290dd9a12a",35,35,0,35,35,0,1,2
"19023","842fc5e441609d7ce864a079839ce5e2",63,56,48,9.1875,30,33,2,1
"19024","843160c4b520fecf5797c9b9255d6e75",9,9,0,9,9,0,1,2
"19025","8431710313cd554ba2a7de4ee6cc080a",37,37,0,37,37,0,1,2
"19026","843379039b40b4d720bb56b7345619c3",95,88,45,14.7777777777778,95,0,3,3
"19027","84343de7462267ce04acb3b3890ddae9",25,25,0,25,25,0,1,2
"19028","84354d94624d52c81002ea4d2e45c838",42,42,0,42,42,0,1,2
"19029","8435c43ac33c5fb189312bbb98a825a0",55,55,0,55,55,0,1,2
"19030","843950be9f42e99ac9fd94c235d848b6",36,36,0,36,36,0,1,2
"19031","843bb5174dd23bffa9a4fb42d1b2303d",36,36,0,36,36,0,1,2
"19032","843bbfefa92758223def6c1ae9998a77",85,70,16,37.1875,85,0,1,2
"19033","843c1b2aa061fa70f5bfb7ff00808e68",87,82,37,16.4594594594595,64,23,2,1
"19034","843ca321031e6426ee500d4ebf9d4f10",11,7,54,1.42592592592593,11,0,2,1
"19035","843cd1d56d03574330c20622a4dfb386",11,11,0,11,0,11,1,2
"19036","843d440e92b0dcc34c8be2b3df0ef5e2",41,26,50,5.74,41,0,2,1
"19037","843e67d838b6cc7908c5ea20d52caf2a",24,24,0,24,0,24,1,2
"19038","84405d04f9569d14ceac92c8152305a7",93,53,75,8.68,69,24,2,1
"19039","8440c60d6eba49414efd4b250b1e3b01",69,52,30,16.1,32,37,2,1
"19040","84417b4c99a06636426488902a2f42b9",31,27,4,54.25,31,0,1,2
"19041","8445098500196aea38627c2654b8b729",22,22,0,22,22,0,1,2
"19042","84452920dab908d9dbb9eee4f3b32533",51,51,0,51,51,0,1,2
"19043","844ad5542b731c491dce890c9c2824a3",46,39,64,5.03125,39,7,2,1
"19044","844b5efaea28c40a972b058073bd03bc",47,41,38,8.6578947368421,47,0,2,1
"19045","844b6c2f55d81d6c48a829bd457f0d28",33,32,9,25.6666666666667,33,0,1,2
"19046","844e0fb91baed3eb994d510b8ceeedaa",46,46,0,46,0,46,1,2
"19047","844e1afdcf7cf620eb46df134b3a8620",199,116,65,21.4307692307692,175,24,3,3
"19048","844e27074df0ea7d0202759699387ce9",36,36,0,36,36,0,1,2
"19049","844ef101857ae922e4500008c3739dc9",42,42,0,42,42,0,1,2
"19050","844f413fd6cb9e05b018f8d30e4e5f8e",27,27,0,27,27,0,1,2
"19051","844fd840a91a6696b312384315378c1d",32,32,0,32,32,0,1,2
"19052","8450d3242d475c0727ca712a437d1919",14,14,2,49,14,0,1,2
"19053","84518f2505e36ce5ebed32d648cf6867",69,61,42,11.5,69,0,2,3
"19054","8452fd5a010cfbb2f429e9e5ef8c9696",18,18,0,18,0,18,1,2
"19055","8456a1d9d8b7583af68800d38d87e499",165,93,76,15.1973684210526,165,0,3,3
"19056","8458ec0979e29708229875c5933ed5fd",138,101,35,27.6,138,0,3,3
"19057","845a466f2e0b3cf02d0099ce7a4b3a17",15,14,35,3,15,0,2,1
"19058","845a5ae729961efe9723abffc9e9251e",35,35,0,35,35,0,1,2
"19059","845cb8768842f897fc59aaeca98ca1c3",22,22,0,22,22,0,1,2
"19060","845efced50e36b739a3092e20d3ca4a7",131,89,61,15.0327868852459,102,29,3,3
"19061","84602ce0405082f9b2bbfb9d76eb69ce",27,27,0,27,0,27,1,2
"19062","8460a6f593785472de3ec183cd9300a1",70,26,70,7,70,0,2,1
"19063","846341b34999e48ee421d37a0a2b02bc",35,35,0,35,35,0,1,2
"19064","846836494ed99c1c4ec8dc4f11b515f7",43,43,0,43,43,0,1,2
"19065","8469168494c1fcdaac686edfa944ddb7",11,11,0,11,11,0,1,2
"19066","84696459093b0dffce1135d721c35220",87,49,41,14.8536585365854,87,0,2,3
"19067","8469b0b4771b6bc97ec1e96ff9db5893",187,77,79,16.5696202531646,187,0,3,3
"19068","8469f381624beb4f796c47ea1ba2700c",15,15,0,15,0,15,1,2
"19069","846a7d7b89d8321b69a3e55b151e433f",20,20,0,20,20,0,1,2
"19070","846faeb753dfa7d9fe59fbd9881ed907",79,43,78,7.08974358974359,79,0,2,3
"19071","84721ec2e841f62b4ccef8be7804ddd1",30,24,32,6.5625,15,15,2,1
"19072","847323beeb9bbc58b6f5c30bc82c2695",19,19,0,19,0,19,1,2
"19073","84766e2ae4232be05dc3884d2e8eb8ae",137,83,59,16.2542372881356,137,0,3,3
"19074","847688fb4fe933ed5d940fd07537e216",67,34,70,6.7,42,25,2,1
"19075","84787cd666e0ec14b38fd7d3f4da8888",249,82,77,22.6363636363636,205,44,3,3
"19076","847cd9c6fb78512c75f8e2bfb855f0fe",30,30,0,30,30,0,1,2
"19077","847df7f943c3fd779eddbeecbdf5674c",30,30,0,30,0,30,1,2
"19078","847f86b1c2354ee579524b486e15ee08",59,50,33,12.5151515151515,59,0,2,1
"19079","848140116723983716c483a1351be5c1",164,119,44,26.0909090909091,164,0,3,3
"19080","84821bb814e55f37334a9bbd5a06290e",28,28,0,28,28,0,1,2
"19081","84828133be2ed908948ed83a678ebda4",18,18,0,18,18,0,1,2
"19082","84829c7a380f931e896c0daf329c94cd",5,5,0,5,5,0,1,2
"19083","84831f3ff8092d61a4001537eb5e68ee",23,23,0,23,23,0,1,2
"19084","8483a521f232fcc079ae644c8eefd451",45,26,67,4.70149253731343,45,0,2,1
"19085","8483ffec9e67d716a137d6a0ffdb7024",13,13,0,13,13,0,1,2
"19086","8484933f5eb811f836d7a0d281a55b87",33,23,26,8.88461538461539,33,0,2,1
"19087","8486ddd3f7d573f82ed0bf0ab2c7d472",15,15,0,15,15,0,1,2
"19088","848760645374b823546b4e51ace8d91b",35,31,34,7.20588235294118,35,0,2,1
"19089","84882f5897799d43361de8383ecd4dea",32,32,0,32,32,0,1,2
"19090","8488ae38897017dc902508d2b065b650",115,60,68,11.8382352941176,102,13,3,1
"19091","848ad83c32a5ab8066e0d77a05a11938",26,26,0,26,26,0,1,2
"19092","848d26bd613144e6d8b6fca18284315f",62,39,33,13.1515151515152,62,0,2,1
"19093","848d30744988673a34f662d3841425a1",41,34,23,12.4782608695652,41,0,2,1
"19094","84903ef999f412cc2cec6fac3d8262f7",47,45,41,8.02439024390244,47,0,2,1
"19095","8490d20cb11d9b236db7223072cb1297",26,26,0,26,26,0,1,2
"19096","8491ce752c0160c82e292d8daf654eba",16,16,0,16,16,0,1,2
"19097","8491eb79d311068fb9765a923827b951",130,51,87,10.4597701149425,112,18,3,1
"19098","84924cca61e17deeb651ea8add866769",179,86,75,16.7066666666667,179,0,3,3
"19099","8495119227c476b0be8856f431060a2a",21,21,0,21,21,0,1,2
"19100","8495671ef62833f23a97adbd1a29a6eb",82,63,68,8.44117647058824,82,0,2,3
"19101","849833ccc93d13b25b5799890307e3ea",56,56,0,56,56,0,1,2
"19102","849a0de90ed327b67233a3b768adf791",85,57,60,9.91666666666667,47,38,2,1
"19103","849b2a274387e5a845610a4cdab6754c",63,40,69,6.39130434782609,63,0,2,1
"19104","849c481af1837944de56ddeb906e5365",100,67,46,15.2173913043478,100,0,2,3
"19105","849cbaaed9c448d3a4c4f4d55a304452",74,64,72,7.19444444444444,74,0,2,3
"19106","849e367ffb28e058d073e433a20194fe",47,47,0,47,47,0,1,2
"19107","849e94ecc5a54e3f8bdde82f95a21ef0",1,1,0,1,1,0,1,2
"19108","84a045fa452e7002d84bf2a963ffaf20",13,13,0,13,13,0,1,2
"19109","84a3310d2e6ab50c646dcd0366d8100b",49,49,0,49,49,0,1,2
"19110","84a9565949a7c2698bc291f201931e35",26,26,0,26,26,0,1,2
"19111","84ac683abb6025d927d39b44250fcd3c",26,26,0,26,0,26,1,2
"19112","84ae2004326a7b27777997eac0758693",163,91,56,20.375,140,23,3,3
"19113","84b1c150f0e994886bf3d2e6f7e4485c",81,55,12,47.25,81,0,1,2
"19114","84b468ed6adb70ca096a61f82a9ed7af",112,43,84,9.33333333333333,112,0,2,3
"19115","84b5ab95f3a0a58b4b3318a9177004b2",41,23,59,4.86440677966102,28,13,2,1
"19116","84b5b178f0b36aa82e68409b3523355a",48,41,56,6,48,0,2,1
"19117","84b745a97f61153940913c22958d7ea3",102,76,31,23.0322580645161,51,51,3,3
"19118","84b8a740eeae900c7bdce9aa438912c2",13,13,0,13,13,0,1,2
"19119","84bbb06cc3fa0afc71fcb1de3d1f2772",46,46,0,46,0,46,1,2
"19120","84bdff08908978dfdec039017e168e94",63,55,29,15.2068965517241,63,0,2,1
"19121","84beafaafe465398422940ab4a010cf7",49,49,0,49,49,0,1,2
"19122","84c2ebc2f06421aa553ca2a671afee25",166,58,70,16.6,145,21,3,3
"19123","84c3095dfc87cc857f47d2799edd00f4",47,40,13,25.3076923076923,47,0,1,1
"19124","84c45d3884346ef78f92eacd665931fd",22,22,0,22,22,0,1,2
"19125","84cd26191592b9132af9135bd9d99e80",35,23,53,4.62264150943396,31,4,2,1
"19126","84ce2bbc85eaa852680358237621d19b",124,89,78,11.1282051282051,124,0,3,3
"19127","84cf326444378ebf912392538251e334",11,10,4,19.25,11,0,1,2
"19128","84cf41235756697cb023274d444f47ac",235,124,81,20.3086419753086,208,27,3,3
"19129","84d2651132c297ee5a828ae4b082d9c8",26,26,0,26,26,0,1,2
"19130","84d4736420c78bc4795d880939789a98",36,36,0,36,36,0,1,2
"19131","84d4f589368fc3f09fd044c93a16b8d6",34,34,0,34,34,0,1,2
"19132","84d8b000512c19348ab279f73693b995",61,52,77,5.54545454545455,61,0,2,3
"19133","84d8b0ba727cec887f3462064b732f2f",89,51,63,9.88888888888889,89,0,2,3
"19134","84dc0719922289d89c3bdbfdfcfdf033",104,53,64,11.375,104,0,2,3
"19135","84e075c15c090fc8de3e8fd1e66ea124",37,37,0,37,37,0,1,2
"19136","84e07aea8a99ac5d85260821ed46f230",188,75,76,17.3157894736842,188,0,3,3
"19137","84e12c57e85e096799799df5ec13f9df",166,94,72,16.1388888888889,145,21,3,3
"19138","84e4ba015b655ba645f4bac7cf70869a",88,58,32,19.25,41,47,2,1
"19139","84e520f138e629139a39b86144f496c2",40,40,0,40,40,0,1,2
"19140","84e648acb786dd66e5e8a2ac434d0084",87,49,44,13.8409090909091,61,26,2,1
"19141","84eaf2faa60d5c11724cee1a6806072c",178,109,66,18.8787878787879,178,0,3,3
"19142","84ec6304905d41a54b0673d684b561db",22,22,0,22,22,0,1,2
"19143","84ee2513c5dd500f7ea57bab39c39503",22,22,0,22,22,0,1,2
"19144","84ef2fd152c2ee33e09792337e017a2b",5,5,0,5,5,0,1,2
"19145","84ef87812883298b914954cfa86769af",164,102,72,15.9444444444444,164,0,3,3
"19146","84f03047f939c2a006dd6f5af82a77ec",39,39,0,39,39,0,1,2
"19147","84f6aecf6f110f4b0b17265d27014e73",86,66,69,8.72463768115942,86,0,2,3
"19148","84f90ad974c71dc5a59d33301bec19ca",25,25,0,25,25,0,1,2
"19149","84fbc50b457a038e187473f7ab636515",80,53,82,6.82926829268293,80,0,2,3
"19150","84fcde7e8abba919c4519fd62ff3323a",17,15,49,2.42857142857143,17,0,2,1
"19151","84fd6a2e2e16ef12eb4eb94b6835841a",65,49,21,21.6666666666667,65,0,1,1
"19152","84fddaea6c2260a1f89476ff1bc6d413",10,10,5,14,10,0,1,2
"19153","8502a62a999c1883e9857b3f6a46f548",38,38,0,38,38,0,1,2
"19154","8505059b597b6d2a27b3ba1a61986d3f",23,20,8,20.125,23,0,1,1
"19155","850a2c34d18365e793dfb669a029c4cd",224,125,67,23.4029850746269,194,30,3,3
"19156","850c3d12890f35be96e740984dc9d73c",175,72,83,14.7590361445783,175,0,3,3
"19157","850c8a552f91a6e95b178b9dc851e61d",109,89,71,10.7464788732394,69,40,3,3
"19158","850d4ddb9bd34b0c88fe3d655a889e2b",31,31,0,31,0,31,1,2
"19159","850d8d43d46cd7670dbc11d0a747b036",120,89,80,10.5,80,40,3,3
"19160","851086dfb63a071279073fd2046e4da6",6,6,0,6,6,0,1,2
"19161","8515657849f3b9dba8739dda8b4f014b",35,35,0,35,35,0,1,2
"19162","85174fe6cfefa062916fc56a56cfb4e1",149,115,35,29.8,149,0,3,3
"19163","851a9be2c2be7242bd81e00e13b60a20",82,66,26,22.0769230769231,82,0,2,3
"19164","851c8c5fa075e3278185856723766101",7,7,0,7,7,0,1,2
"19165","851cb39347ba0753cd251e6f3ebb013d",11,11,0,11,0,11,1,2
"19166","851cce5b3b0ee3aa24a22d358c919015",68,54,13,36.6153846153846,36,32,1,2
"19167","851d07d393c53c8610981833e125c16b",49,34,33,10.3939393939394,49,0,2,1
"19168","851f79139fd154e7123b15fcdd4fb271",51,47,61,5.85245901639344,51,0,2,1
"19169","852048053bd4fe0fe46b979e984687c4",22,22,0,22,22,0,1,2
"19170","8520d9b21fe0d4e27fbf1f8ab7675b5b",130,91,28,32.5,130,0,3,3
"19171","8521e0a21fd634205d63c20e0297a655",40,29,66,4.24242424242424,40,0,2,1
"19172","85224fff7dcdd0a05a01bd9c072d8bb9",161,93,62,18.1774193548387,161,0,3,3
"19173","8522d1cf202a689ad200217408fedb95",55,44,32,12.03125,28,27,2,1
"19174","85277df2a98881c3cee4d0000984b110",14,14,0,14,14,0,1,2
"19175","85284b809639d1b355bebda53d2d179c",77,54,83,6.49397590361446,77,0,2,3
"19176","852e3baed3e5557dae7c383dfc2cacfe",33,33,0,33,33,0,1,2
"19177","852e4ec463326026699d447dd79b3334",26,26,39,4.66666666666667,26,0,2,1
"19178","853018e2325ea98986c6a6edd8269dec",33,30,21,11,33,0,1,1
"19179","85324efa02855e21cd329a86293e32da",41,41,0,41,41,0,1,2
"19180","85326fa52d092501c43b52ac501af0c0",154,121,53,20.3396226415094,154,0,3,3
"19181","85332b4c4036714ce2c19cba63166413",9,9,0,9,9,0,1,2
"19182","853563ff442383039509a9639cf498c6",159,113,63,17.6666666666667,159,0,3,3
"19183","8535b837fbcf947d5d00099d5bd0fbe5",26,26,0,26,26,0,1,2
"19184","853753d68e9fffb1c330989719dde9cb",56,56,0,56,56,0,1,2
"19185","85376c7b24099286f7b2bca60e54e4f3",27,27,0,27,27,0,1,2
"19186","8538c4c05d26f2e038a17c931478e941",85,63,31,19.1935483870968,85,0,2,3
"19187","853cb204e75d56db629682bed580f8c7",42,35,51,5.76470588235294,15,27,2,1
"19188","853da864414aa2fee83bbcd69d3ba836",44,39,81,3.80246913580247,44,0,2,1
"19189","853dfc90780447f09d0ee255635e1c84",78,66,61,8.95081967213115,78,0,2,3
"19190","853e5cb90c8193f56092f1aadbab3df5",18,12,42,3,18,0,2,1
"19191","853fbd35d262f7ea5dd53aa699819d06",29,29,0,29,29,0,1,2
"19192","85463d976da0719c583f2661f24c7bf5",176,97,74,16.6486486486486,128,48,3,3
"19193","854834e1ab19050e9b99556ebbb73d5a",59,48,35,11.8,59,0,2,1
"19194","8549c1d907d4be08e51a0e7e564685da",183,101,85,15.0705882352941,183,0,3,3
"19195","8549eba7f34c7beddb4f141109e8e52b",137,79,54,17.7592592592593,137,0,3,3
"19196","854e2eaf3eaf9ede347124e7240c955f",194,91,80,16.975,150,44,3,3
"19197","854e91d0c8aed54faf0a169578002eec",76,57,75,7.09333333333333,76,0,2,3
"19198","854e92598f5e3a870f1b3bc8a6423d09",27,27,0,27,27,0,1,2
"19199","854eab88544bd3098d9abdc3ce08821b",51,35,12,29.75,51,0,1,1
"19200","854f3c15fec6b32a07dde6ecda2f0f35",138,100,34,28.4117647058824,138,0,3,3
"19201","8554462b88b97b3b7b27219d728fd981",31,31,0,31,31,0,1,2
"19202","855653a9799f689ea5575bd5a8368c23",82,60,37,15.5135135135135,82,0,2,1
"19203","855d0beba6cc1f0a336b8b6cc57d5993",76,56,56,9.5,76,0,2,3
"19204","855d876eb1334bddc12f4476482beecd",29,29,0,29,0,29,1,2
"19205","855e9d5c76fad3a21f590e5447c287ef",28,28,0,28,28,0,1,2
"19206","855f2f7e07b652da4815b0f3bc25ea4b",25,25,0,25,25,0,1,2
"19207","855fc225695e0b7f5877d2b0d3da7705",5,3,49,0.714285714285714,5,0,2,1
"19208","856073513f5c65d1f7d0648a62f23411",13,13,0,13,13,0,1,2
"19209","85645c2299b9961918d25cab0da73dc1",204,98,77,18.5454545454545,204,0,3,3
"19210","8567c7d2eb7d277c248ba57329aab329",92,65,57,11.2982456140351,54,38,2,1
"19211","8568545151bb45ff9a71e381d479d204",20,20,0,20,20,0,1,2
"19212","8569c5e546e63e1aec35ad6e347602f7",31,31,0,31,0,31,1,2
"19213","856c4c116286f05b0f9530f41038c9fe",11,11,0,11,11,0,1,2
"19214","856c678a271af41b29bb8ce79fdd1284",17,17,0,17,17,0,1,2
"19215","856e63e45623879f5e2565229f207845",36,36,0,36,36,0,1,2
"19216","856ee0a6646013f3c0af1a7169193ccf",49,37,29,11.8275862068965,49,0,2,1
"19217","856fb35a3e0a96d2e8288db795e16d27",9,9,0,9,0,9,1,2
"19218","856fd675d570c2ef75f2ac047dd19d9d",47,47,0,47,47,0,1,2
"19219","856ffd8824c7eda8d0c78c938730726c",121,55,69,12.2753623188406,74,47,3,3
"19220","8570b2dd3746f2020d5d6e91c0cbe7f6",63,45,57,7.73684210526316,63,0,2,1
"19221","85729e432456c1a5348b2b4ec628b5b5",177,45,89,13.9213483146067,177,0,3,3
"19222","8574ccc40a9f74f76f467a46d85549be",174,105,64,19.03125,174,0,3,3
"19223","857750b7d41dce890f4265da1dab0f68",20,20,0,20,20,0,1,2
"19224","8577e18648939e5c3b34d46d0eff94e1",114,52,62,12.8709677419355,114,0,2,3
"19225","857803ea133a401a590af4f562627842",40,40,0,40,40,0,1,2
"19226","8578656f5474411532ad879b407f8bb5",42,42,0,42,42,0,1,2
"19227","857961a3443b5cf55ba3655fa63327ca",25,23,5,35,25,0,1,2
"19228","857a8d4fc22cd1a486446c5c36188d73",23,23,0,23,23,0,1,2
"19229","857b8531e1e187f34f29a9f8899d39f1",155,103,63,17.2222222222222,155,0,3,3
"19230","857c26fc94d2cda19122005990701902",12,12,0,12,12,0,1,2
"19231","857ebb4305746482793121118439ed58",73,51,38,13.4473684210526,27,46,2,1
"19232","857f7a068c80b1bf6dba955362e32088",66,61,27,17.1111111111111,66,0,2,1
"19233","857fad3197fcaa8387dcd1c126785401",77,68,31,17.3870967741935,40,37,2,1
"19234","85823dade29a2d4accf03e9eb6484247",27,27,7,27,27,0,1,2
"19235","85840cc10b23b5b8d39da41ad5c3fa8e",18,18,0,18,18,0,1,2
"19236","85856df16f9dfb7df9775b466790803a",31,31,0,31,31,0,1,2
"19237","8585b17d3b0f54ebd207dac73aea1d17",79,67,74,7.47297297297297,79,0,2,3
"19238","85872077676c116ea54d06a91a1e4d66",60,53,11,38.1818181818182,50,10,1,2
"19239","8588e67a8faee6ddeade237387faece1",51,46,45,7.93333333333333,51,0,2,1
"19240","858e1beed186c96724d8ee2273c01f30",150,67,69,15.2173913043478,131,19,3,3
"19241","858ead618306512d714b7709f13a4b2f",238,124,87,19.1494252873563,192,46,3,3
"19242","858ef92e0662fb4685d69017db065164",72,49,78,6.46153846153846,27,45,2,1
"19243","858f322fc4425831f1f8afa5aa137f19",22,22,0,22,22,0,1,2
"19244","858f861fd0a08ee255247f36acea0406",78,49,58,9.41379310344828,78,0,2,3
"19245","8590c27934ff09841fe6283cb8b4e59f",95,57,50,13.3,95,0,2,3
"19246","85921c3835c9ba5a9db3a4f3f7a8d60a",103,76,60,12.0166666666667,103,0,3,3
"19247","859293b7be594f9b7671862d78bcc280",29,29,0,29,29,0,1,2
"19248","85939cc41c3c1a9ada09f50cd6209857",43,43,0,43,43,0,1,2
"19249","8595083afb181b38fec34d9e9e2f8b2d",171,108,79,15.1518987341772,132,39,3,3
"19250","8595194d3f5e3aca986e5917449e422f",14,9,52,1.88461538461538,14,0,2,1
"19251","85952557a9adb16f0146fcbd082b2a48",20,20,0,20,20,0,1,2
"19252","8595b894440732dc1d4bbcfc7a07c137",45,39,63,5,45,0,2,1
"19253","8595e2d2b859054f3fea380a09dc9ad3",16,16,0,16,0,16,1,2
"19254","85967430a71cbc937213072fd7adeed2",28,28,0,28,28,0,1,2
"19255","8596f0932bd5ce5fab333a0bb775c8c6",45,31,55,5.72727272727273,23,22,2,1
"19256","859a67a0e03b762e6dfa0ad52d291504",99,77,80,8.6625,62,37,2,3
"19257","859af484d8c2f7649c2d04c455c890d8",99,41,79,8.77215189873418,99,0,2,3
"19258","859cfbbff0244e6e004bf81093d57e1a",24,24,0,24,24,0,1,2
"19259","859e2c2799762ff7e4e19ea03d801da6",75,60,16,32.8125,37,38,1,1
"19260","859f77d2dbb021192e5220e5bd9bab1c",121,72,83,10.2048192771084,91,30,3,3
"19261","85a0a7a2216089b2264580fb2d32f5f9",121,50,78,10.8589743589744,102,19,3,1
"19262","85a0cfd379eb30ea4026be320e90eb7c",34,34,0,34,34,0,1,2
"19263","85a4393640bc331bb591e62c2d8b31c4",38,26,56,4.75,10,28,2,1
"19264","85a46411ffd7636e38712310743da8c2",11,11,0,11,11,0,1,2
"19265","85a708a93c3bc7342df7a8b97ad8ee7f",25,25,0,25,0,25,1,2
"19266","85a7a82567eaa828709373cbe18dca72",72,45,57,8.8421052631579,37,35,2,1
"19267","85aa823f5186c007cf080b0e750191fa",227,121,71,22.3802816901408,181,46,3,3
"19268","85ad81b397fae6a72c7cdab1343ce648",114,92,48,16.625,114,0,3,3
"19269","85ade2177de570d8ce03eba48a6a1f3c",61,55,77,5.54545454545455,34,27,2,1
"19270","85aef6afe4eef8ba8a5c3956f88581f9",34,24,5,47.6,17,17,1,2
"19271","85b17b54d599de4a43d4d52258226016",38,24,72,3.69444444444444,38,0,2,1
"19272","85b2c516b1d4f54cb663949103e6a122",36,36,0,36,36,0,1,2
"19273","85b311f84c197861d72eef0a51218372",13,13,0,13,13,0,1,2
"19274","85b4755181d29de82633e5117c2762e6",14,14,0,14,14,0,1,2
"19275","85b4ab2512d85b0d923ca93639326e0c",6,6,0,6,6,0,1,2
"19276","85b4f64cd47be6d343f818437855b123",45,42,64,4.921875,35,10,2,1
"19277","85b654dd837b908f02f6044fbdd27c10",36,27,21,12,36,0,1,1
"19278","85b9f504b376fcb6851a2051672b75d0",26,26,0,26,26,0,1,2
"19279","85bd3896c78c316408740475333acee6",8,8,0,8,0,8,1,2
"19280","85bdac21dd6059fd27617cf3f34da8c2",159,101,61,18.2459016393443,159,0,3,3
"19281","85c030b01d346d60bd7e10a8674784a5",13,13,0,13,13,0,1,2
"19282","85c161c63d3c51b888b021be72273917",20,20,0,20,0,20,1,2
"19283","85c19968456b92fb7cb1c06365af3691",32,29,49,4.57142857142857,32,0,2,1
"19284","85c435d4e2fe7e960f26a5b473784f25",55,43,12,32.0833333333333,34,21,1,2
"19285","85c5f6b5d131557c3a07ff8eda68b546",16,16,0,16,16,0,1,2
"19286","85c6b34787685f9070396e6876a95a95",175,104,65,18.8461538461538,175,0,3,3
"19287","85c6f75fc1f8b046c855fc07f6576600",23,23,0,23,23,0,1,2
"19288","85c71aa5a0186381cd1cf95ae2808b56",26,26,0,26,26,0,1,2
"19289","85c793c001a883f1fe89550e3464e65e",15,15,0,15,0,15,1,2
"19290","85c7c125df45fa06b0df8a1e315ebb39",49,49,0,49,49,0,1,2
"19291","85ce2c4db1deb259c6c202cd54c7a5eb",43,36,37,8.13513513513514,43,0,2,1
"19292","85cf4b70740158a4f1af0b423480c131",210,140,70,21,210,0,3,3
"19293","85d22242a82b6491091f24c6cca5c0e9",32,32,0,32,32,0,1,2
"19294","85d3502fc69ad0ec74a75753e3d2afa8",42,28,74,3.97297297297297,42,0,2,1
"19295","85d73473b9ca4afb276c45e264620b8d",41,41,0,41,41,0,1,2
"19296","85d7f8170aa418ee70393fdeb09a73dc",32,32,0,32,32,0,1,2
"19297","85de96538de40798cfcc2ad85d2f0ae2",235,90,53,31.0377358490566,203,32,3,3
"19298","85e05cffe97fb72ff468f74b493fc3e7",130,88,75,12.1333333333333,77,53,3,3
"19299","85e074d9cf14171e18fb71f549d3f9fc",121,93,40,21.175,121,0,3,3
"19300","85e18599f0441562c76fd0cab6ff64fd",165,96,75,15.4,165,0,3,3
"19301","85e1ee70150f182ea0d18053749f4663",33,33,0,33,33,0,1,2
"19302","85e3088344c0068bfd0217bcb17757ad",149,88,85,12.2705882352941,149,0,3,3
"19303","85e30b690ed3a7a5021f69498504ce6b",102,55,52,13.7307692307692,102,0,2,3
"19304","85e346a57a5e1c0f243b5c107640084a",40,25,64,4.375,26,14,2,1
"19305","85e350d753fb76cfd5d0adebe97b6db7",124,102,83,10.4578313253012,124,0,3,3
"19306","85e5001abfc48255981a5e02b4bce73c",27,27,0,27,0,27,1,2
"19307","85e55dae9bbd8edcf1b871ed4f5361fe",190,126,37,35.9459459459459,190,0,3,3
"19308","85ea627489157443924cab617e8f7d10",60,32,70,6,60,0,2,1
"19309","85ead75dc3383c6b2b08e0157f3e4904",18,18,14,9,18,0,1,1
"19310","85ee04bfaa56978c3b4f49d60d23440a",59,28,65,6.35384615384615,59,0,2,1
"19311","85f0492b83d0612cc269651d3beaf50d",14,14,0,14,14,0,1,2
"19312","85f24a9fcadba7ede6a95e9dd524a276",28,21,17,11.5294117647059,15,13,1,1
"19313","85f35d19668e1df493f9a6aea09ffed3",109,79,81,9.41975308641975,71,38,3,3
"19314","85f95e4bc0c801d58583e73a1e653d50",155,105,68,15.9558823529412,155,0,3,3
"19315","85fa3269d334dbbb1a66a830c028cc9b",96,61,70,9.6,96,0,2,3
"19316","85fca6f876b867b7a6e5674ce24685c2",22,11,75,2.05333333333333,13,9,2,1
"19317","85fe82ffb69523a6ba5489663021e3ce",87,27,71,8.57746478873239,87,0,2,1
"19318","85ff2df06269d59fb3b51c05e692fc61",73,57,27,18.9259259259259,38,35,2,1
"19319","8602fe5729ca7f012326540a33aebc69",41,29,75,3.82666666666667,41,0,2,1
"19320","8604109ac6a533161960fe00412f3f11",46,39,25,12.88,46,0,2,1
"19321","86059f788a94abb1c799770d0a46277b",89,65,65,9.58461538461538,56,33,2,1
"19322","860ac1ac1447260b786b3810c7be5251",56,39,43,9.11627906976744,40,16,2,1
"19323","860d6547e8efdae0d6d5c107288b4737",17,17,0,17,17,0,1,2
"19324","86109c4e717e7f6040a9d204933c0510",15,15,0,15,15,0,1,2
"19325","86116024a909429749eb998fb3a3ae3a",42,42,0,42,42,0,1,2
"19326","8613612f2029d1bd422d318b60a47ca9",21,21,0,21,21,0,1,2
"19327","861400c3fb6c7561d8da37668dc53dca",198,117,72,19.25,154,44,3,3
"19328","8614651764c1aa2fdf2177a585240363",76,40,77,6.90909090909091,76,0,2,1
"19329","8615e664b5da1260a85d16da6b769beb",27,27,0,27,27,0,1,2
"19330","8616340ed09a25d358d41e6ef08f42f9",200,117,62,22.5806451612903,200,0,3,3
"19331","86167ed483e4fd4991cc634bad04a054",1,1,0,1,1,0,1,2
"19332","8616a4c56443d50f994448d653d0bbb4",60,40,55,7.63636363636364,37,23,2,1
"19333","8616d7c2f109b460e07fb36ed561edda",64,57,22,20.3636363636364,64,0,2,1
"19334","86172ce9f014b48f2e912bc8f601a8bf",29,29,0,29,29,0,1,2
"19335","861b81f3562d63789ec7c2bb9eafc5ea",12,12,0,12,12,0,1,2
"19336","861f6e9743bf7396d81e74cda33d3cd5",82,41,69,8.31884057971014,82,0,2,3
"19337","861f9690af8ba3f355396826513c7f75",73,60,34,15.0294117647059,73,0,2,1
"19338","861fef500dd9905e1d7bcc8e2e8524e7",38,30,14,19,38,0,1,1
"19339","8620339b418f1d08f6c74a9206d51955",15,15,0,15,15,0,1,2
"19340","862144b62ef385cf6439d3ae554939bc",93,68,28,23.25,93,0,2,3
"19341","86220aee05dc00d13017d1fb92d9eb40",19,19,0,19,19,0,1,2
"19342","8623126c90717ec1ece80b3f3e49e276",134,67,81,11.5802469135802,99,35,3,3
"19343","8624097fda1cd145dc6df3e3b344e655",19,19,0,19,0,19,1,2
"19344","8624731b35eb7d2aea5f0460f40fc7b5",24,24,0,24,24,0,1,2
"19345","862a55d2965f2cf7a6e2e3d2a640b46f",42,24,78,3.76923076923077,25,17,2,1
"19346","862a6ee67b418da6c80bc59b0f9acfc4",137,77,69,13.8985507246377,112,25,3,3
"19347","862a7f5102a61a2dc9e8217b906fc218",171,127,90,13.3,153,18,3,3
"19348","862ac656f2998ae9a1da683d8b95c832",22,22,0,22,22,0,1,2
"19349","862cc77ca4d209a7e82cdd3cdeba59e0",161,78,56,20.125,134,27,3,3
"19350","8631a37639ecda38d0fa9f6bce2d7885",127,80,63,14.1111111111111,127,0,3,3
"19351","8631fe2c1fd3d7f68f304e53496042be",24,24,0,24,24,0,1,2
"19352","8636119b03e8ae610c87dba75a5285dd",99,75,39,17.7692307692308,99,0,3,3
"19353","8636261c94269d05f4a3d34da6f08ce7",39,39,0,39,39,0,1,2
"19354","863bfa18281e9b8b38c3301eca781a3e",20,20,0,20,20,0,1,2
"19355","863ee3f05a867c62aadca542e43903af",33,33,0,33,0,33,1,2
"19356","863fad0b09ac38b00e087fe7dd389305",22,22,0,22,22,0,1,2
"19357","86403f34bedb9ed69930cffd99a246f1",47,33,38,8.6578947368421,20,27,2,1
"19358","86433ed2afa83c630cd718984329a8dc",15,15,0,15,15,0,1,2
"19359","86440c6b8776cc3e857a1b25c65e622e",29,29,0,29,0,29,1,2
"19360","864475f1d384943a0b99184164d562c3",162,82,54,21,122,40,3,3
"19361","86447cbf2181cc03c724fdebd1a46934",52,52,0,52,52,0,1,2
"19362","864676e7441b5ac20b54abd3ff8eb4a4",57,46,74,5.39189189189189,57,0,2,1
"19363","8647a34ce130005bc1bdf1a0fb371116",33,33,0,33,33,0,1,2
"19364","86485d8270d7bcef2cca5b1dba983215",27,27,0,27,27,0,1,2
"19365","864a31c2bf3ad4dd7cb4ee7e27fe9e05",33,33,0,33,33,0,1,2
"19366","864b36d3d76ce0604a0a49eb3a5575f1",19,19,0,19,19,0,1,2
"19367","864d08bdef715a7348087497ae5d92a2",61,32,68,6.27941176470588,61,0,2,1
"19368","864d8adfd81d6595d9e5d4965f67d51b",122,94,59,14.4745762711864,122,0,3,3
"19369","864e61930a56ab1046fb3a8ad8ccc3ec",12,12,0,12,12,0,1,2
"19370","8650547cb336c81d9c7fe1eea07218c7",185,133,74,17.5,151,34,3,3
"19371","8650a5998e21af0d385093fbafef8b17",34,34,0,34,34,0,1,2
"19372","8650f3f401ed801853f9c595b987bfcb",32,32,0,32,32,0,1,2
"19373","865232d3b26bf0e33c68d2681e589fa3",38,38,0,38,38,0,1,2
"19374","86545fea017a18b25f4af03cec7bf95d",43,29,61,4.9344262295082,43,0,2,1
"19375","8656a8976e584110655725bfa4ee2429",19,19,0,19,19,0,1,2
"19376","8656aabe4604b35577196d354c3bff8a",34,34,0,34,34,0,1,2
"19377","865a1ed023d7a804b58140dea3b8b46b",69,53,61,7.91803278688525,69,0,2,3
"19378","865a73f26e9f590804c626d36af4c7a8",16,16,0,16,0,16,1,2
"19379","865d1707a69d81c6cd94bdc127b9421d",121,83,75,11.2933333333333,121,0,3,3
"19380","865e8caa74822d6df35434ef242d028d",47,47,0,47,47,0,1,2
"19381","865f4728af21a337642860d989d5f172",32,32,0,32,32,0,1,2
"19382","865f5ff757b1f1c54de026187c492abc",26,26,0,26,0,26,1,2
"19383","86607036abc802304069e169a9d4eb75",8,8,0,8,0,8,1,2
"19384","86609aae197bcba184f641055f716ae6",112,88,31,25.2903225806452,112,0,3,3
"19385","86639394e700fc0e89b553f1d45399b7",132,85,63,14.6666666666667,98,34,3,3
"19386","8663b1b522465a4951521dfcec849fdb",33,33,0,33,33,0,1,2
"19387","86654976f3a35a2e5106941c845e8f56",36,36,0,36,0,36,1,2
"19388","8665558ca84dba0c10665859cfde9c16",25,25,0,25,25,0,1,2
"19389","8666047c7d7ab64a9f36565a5beaf5e0",28,28,0,28,0,28,1,2
"19390","866a90b27f14abd500b33612f5e080e7",143,85,77,13,143,0,3,3
"19391","866a9b5b017459d50c368586145bb96e",89,60,41,15.1951219512195,89,0,2,3
"19392","866c598bd911eb19791888e78b0daf38",109,61,28,27.25,109,0,3,3
"19393","866dbb06db1f4e4e0349075eece3cab1",118,69,79,10.4556962025316,118,0,3,3
"19394","8670f625a9a3e0acc679ac0a04840d15",28,28,0,28,28,0,1,2
"19395","86721c44e883c18ab1549bb17ac0838f",62,53,54,8.03703703703704,27,35,2,1
"19396","8672abac1485e9e505172fa55b3e6f79",46,28,57,5.64912280701754,46,0,2,1
"19397","86734d3922aa84599caa9fda362a497d",3,3,0,3,3,0,1,2
"19398","8679e174fa5a88bad9c3cb68ed2d7e83",13,13,0,13,13,0,1,2
"19399","867a5a6caa4ad8b4bac05dadc18e0714",42,42,0,42,42,0,1,2
"19400","867e97305a0de7216abff6d280f00f0f",11,11,0,11,11,0,1,2
"19401","867fb7d8bfeab67ea8af020613d68ee8",48,41,32,10.5,32,16,2,1
"19402","86811a15784c5de2a7de56b6fef711c1",89,46,85,7.32941176470588,89,0,2,3
"19403","868250bd093c120582984d4d093d3432",86,66,55,10.9454545454545,44,42,2,1
"19404","8686b4cf16f80e24254ac1c2fb66baa4",83,56,75,7.74666666666667,83,0,2,3
"19405","8687e43e728eaf6a7d4de10b35f4d4a8",34,34,0,34,34,0,1,2
"19406","86881d49b562e722a0fd99359b617002",50,23,74,4.72972972972973,30,20,2,1
"19407","86882a658da7793787abb239d25ee1a7",24,24,0,24,24,0,1,2
"19408","868b45071d6ec1451de54155baba39aa",33,33,0,33,33,0,1,2
"19409","868f4011431f6833209d22caae007b66",33,33,42,5.5,33,0,2,1
"19410","86908d7c633ee06d95b836b203603b48",45,45,0,45,45,0,1,2
"19411","86916f5c765f10f436ec5914eb3f9d84",70,60,72,6.80555555555556,70,0,2,3
"19412","869360c7aabb1ed6d7b08da7b0e9fbd6",73,57,66,7.74242424242424,73,0,2,3
"19413","8693b00eaf7513b4530290c1bfb5a839",28,28,0,28,0,28,1,2
"19414","8696c4d10a43604f6dc51b1c8825ab5a",8,8,0,8,0,8,1,2
"19415","86991a68afb74abc77e810ad3bdc75d1",125,85,24,36.4583333333333,76,49,3,3
"19416","86993cd303ae8aa8a530e8ae65c13e42",52,36,50,7.28,34,18,2,1
"19417","8699b63ba5c7fa3466f9732cb121105a",73,61,14,36.5,73,0,1,2
"19418","869b488a1759e7ea6e91e56421f61f2f",43,43,0,43,43,0,1,2
"19419","869bd82073f02a279c86e3c39c2b837c",59,54,36,11.4722222222222,59,0,2,1
"19420","869d50d1e5a806919360b81971c84915",56,39,77,5.09090909090909,56,0,2,1
"19421","869d84e31d1feb6d8154ebb7d2c7eabf",18,18,0,18,18,0,1,2
"19422","869ea0b34e8f2cee646c8d3d25239025",68,60,42,11.3333333333333,68,0,2,3
"19423","869f256d6521023180b4c0b92ce6d475",7,7,0,7,7,0,1,2
"19424","86a22a89c80ddc7e7b7fa3cc648c697d",92,72,21,30.6666666666667,92,0,3,3
"19425","86a424eb6a7a435322d44eabbace2fad",4,4,0,4,4,0,1,2
"19426","86afa4b84c27aeaa8a42f95aa991ed72",114,88,56,14.25,114,0,3,3
"19427","86b09c56ad70fba0b2a23b584aaf861d",36,36,0,36,0,36,1,2
"19428","86b0b39425527a04c00bd1cb52f53043",112,77,77,10.1818181818182,112,0,3,3
"19429","86b1942c4a5e264639472c75f4907e7e",176,103,67,18.3880597014925,145,31,3,3
"19430","86b1a6ec124402af362061475cf5057e",27,27,0,27,27,0,1,2
"19431","86b2e8775c4e8f6edf85b66209921785",170,104,72,16.5277777777778,117,53,3,3
"19432","86b317e37e8a0be3fb08540707944643",36,36,0,36,0,36,1,2
"19433","86b342064438e7e50d36ed2bace3216c",20,20,0,20,20,0,1,2
"19434","86b41f7bab3148e579a67e2cbd60404e",22,22,0,22,22,0,1,2
"19435","86b4b1df1ccae24d2306e44303baf6cd",50,50,0,50,50,0,1,2
"19436","86b5e014ed609edf497875eb37e11f38",27,27,0,27,0,27,1,2
"19437","86b82168cd5db72171aa011337a13af4",30,30,0,30,30,0,1,2
"19438","86b8eb2f245f942761e6a89d3a1e47e1",10,10,0,10,10,0,1,2
"19439","86baae6f7d183b5c06bf860408961ede",33,25,42,5.5,33,0,2,1
"19440","86bb1efa47c0d9387c186703c3f9c667",51,51,0,51,51,0,1,2
"19441","86bc9ff59d2f542cd142f5accead23cb",63,58,48,9.1875,63,0,2,3
"19442","86c020b2705a9533d58deba746170659",1,1,0,1,1,0,1,2
"19443","86c1c5ffd266b48156a66d43b64e314b",34,34,0,34,34,0,1,2
"19444","86c27e6856eeb73fa77a1966f8992efa",103,57,52,13.8653846153846,82,21,2,1
"19445","86c2b5968f2b922babd833ddf0cd8c1b",41,41,0,41,41,0,1,2
"19446","86c6cbd8e410c27cf7043185816c1c7a",25,25,0,25,25,0,1,2
"19447","86cc3a6108af8a5cedb1573ec962b3b9",8,8,0,8,0,8,1,2
"19448","86cce222f88a2fb4cad0f2557befff02",106,76,77,9.63636363636364,106,0,3,3
"19449","86cd3e8582d25c5c92eb55de70d3ca59",71,57,28,17.75,71,0,2,1
"19450","86cd5213f058d4730391ced80c920f37",170,90,42,28.3333333333333,170,0,3,3
"19451","86d05e3562f9ba4c493c5c657ff3c2da",90,70,48,13.125,41,49,2,1
"19452","86d0de9f4fa3292539dfe313bb9c93a2",124,96,65,13.3538461538462,104,20,3,3
"19453","86d1fe5c0e7ac48ef07e222a67606c5b",143,59,76,13.1710526315789,143,0,3,3
"19454","86d275088bf476a8f14fb45c4b7244d7",47,47,0,47,47,0,1,2
"19455","86d37e25dfd3b68ca6f744d1fd53726f",26,26,0,26,26,0,1,2
"19456","86d7f483d7ab0dc111bc84490d795e8c",188,117,48,27.4166666666667,188,0,3,3
"19457","86ddb11316503315b9a2bc633faa19b3",13,13,0,13,0,13,1,2
"19458","86dddc9e9d61606c6f057e1f6d879fba",20,15,33,4.24242424242424,12,8,2,1
"19459","86df65a7e1aea972bdcd22c5f6d12a5d",10,10,0,10,0,10,1,2
"19460","86e76d314b8029873e1a83eaeae45453",137,86,79,12.1392405063291,137,0,3,3
"19461","86e8960e31f577dbfbf9a4d9f38a0a76",25,25,0,25,0,25,1,2
"19462","86e97b753711ba148be52ad38e2d2739",40,33,39,7.17948717948718,24,16,2,1
"19463","86ec7bc49b23de62b6ec3aa708203407",48,48,0,48,48,0,1,2
"19464","86ed97b98252391fc09efc50de074ab1",60,48,13,32.3076923076923,60,0,1,2
"19465","86efc0fd437f867f1d9d52b799b7e6cc",34,34,0,34,34,0,1,2
"19466","86f1674adbce27e6e5f60498c4d2ea54",69,65,74,6.52702702702703,24,45,2,3
"19467","86f443a382525e1681b10f6e0376c52b",17,17,0,17,0,17,1,2
"19468","86fa6c7be4bd85bb0f1dc57ddcc3a2cb",37,37,0,37,37,0,1,2
"19469","86fab13229f1f6958e454d42fdd06701",81,60,15,37.8,32,49,1,3
"19470","86fc58992bcbfe3f6cbf85dd3d0ab88b",175,117,43,28.4883720930233,175,0,3,3
"19471","86fce598e1117cbe5ea6cc19878c79de",102,66,90,7.93333333333333,102,0,2,3
"19472","86fd7366ab745105e3186747440e8700",79,66,74,7.47297297297297,79,0,2,3
"19473","86fdaaea7effd0bacb14e65d2ea56295",29,29,0,29,29,0,1,2
"19474","86fdb413ab09d37979cf093fd229dc39",100,74,43,16.2790697674419,100,0,3,3
"19475","86fea92267ea8e650d5307e0e9b100bc",58,53,43,9.44186046511628,19,39,2,1
"19476","86ffc2f96171dfd4116217d69eb4fcfb",89,59,74,8.41891891891892,89,0,2,3
"19477","86fffffa23fbeb434604da56d105049f",22,19,45,3.42222222222222,22,0,2,1
"19478","870486b32ae675a5fdeac96c50128b51",47,41,9,36.5555555555556,47,0,1,2
"19479","87060dd6018290af12df656ea9c031a9",140,97,69,14.2028985507246,93,47,3,3
"19480","87079e5ea0d3c99821904a38bea16650",30,23,26,8.07692307692308,30,0,2,1
"19481","870979b5a519835fb5806ac1874c6005",83,74,36,16.1388888888889,83,0,2,3
"19482","870a156081486d4dbdb0328ae9770333",35,34,6,40.8333333333333,35,0,1,2
"19483","870c53a1f2e37b354fb38cf774331092",7,7,0,7,7,0,1,2
"19484","870f23f80364a6194e5156c8e44de84f",30,30,0,30,30,0,1,2
"19485","87115c2b5be116e3529945f96a32ec02",1,1,0,1,1,0,1,2
"19486","87169b8618582553acfa891d6d5e9176",192,100,80,16.8,192,0,3,3
"19487","8716bfc9538c60d1a0eedc09581a2788",30,30,0,30,30,0,1,2
"19488","871c79b2cae34c20bfc6f3e9e2625d3e",92,51,41,15.7073170731707,92,0,2,3
"19489","871d76d6831d13f0853322e2366fe267",16,14,54,2.07407407407407,16,0,2,1
"19490","871ec03f6ce1058d821e40fd0c1599a0",5,4,38,0.921052631578947,4,1,2,1
"19491","871fa2f56f3e3ae28de4d2b7ab976cf7",67,50,58,8.08620689655172,34,33,2,1
"19492","87225a78309db998dd169bd17bbfb7ab",43,21,56,5.375,43,0,2,1
"19493","8723d6d1141b7dcfa979a23c3b14f0c6",7,7,0,7,7,0,1,2
"19494","872446cb2db22eaf70c2460a7f00b1f2",157,116,64,17.171875,111,46,3,3
"19495","872475f3b30af4656bad2ba5822fa3a3",17,17,0,17,17,0,1,2
"19496","87286c998e0a10dbc0060b7045bc780c",31,31,0,31,0,31,1,2
"19497","872b79f7816a755ac1de0fe003f580c8",76,62,69,7.71014492753623,76,0,2,3
"19498","872c8b7099f24c9bfd1a61ab92b4fd12",108,61,77,9.81818181818182,108,0,3,3
"19499","8730377c79cd335e41b969ac82ac04a4",131,75,85,10.7882352941176,131,0,3,3
"19500","87304abf98718fbc0a83d3bc978bdf50",15,15,0,15,15,0,1,2
"19501","8730a5a508ad1c6ffdd5c7db4a710758",47,47,0,47,47,0,1,2
"19502","8734a8439687f4e28cb2b0020f8c0fae",50,50,0,50,50,0,1,2
"19503","87376ff329be2498607bed7aaabffe0a",34,34,0,34,34,0,1,2
"19504","873a6c536b29bcfaaa9298595299a1b8",25,25,0,25,25,0,1,2
"19505","873b3759d7b2fd6005502af9dab3a365",51,44,63,5.66666666666667,51,0,2,1
"19506","873c4ea03ede0f5d4e0f66a4de1cc1bd",27,22,71,2.66197183098592,27,0,2,1
"19507","873d3e9d678ecd4bb6b7d1ef64a080ff",25,25,0,25,25,0,1,2
"19508","874226f1cefc41dfb0fbc192b6752b1a",58,38,29,14,12,46,2,1
"19509","874363b3e3ce4fcd9014d5343a6216f5",121,80,59,14.3559322033898,121,0,3,3
"19510","87439c6bf849d7e46d0dbc2d5538007d",185,98,84,15.4166666666667,142,43,3,3
"19511","8743ee81194490277e57ca26efd76ae7",125,95,57,15.3508771929825,125,0,3,3
"19512","8744dd87adb0d82be979b9d26815a525",64,45,33,13.5757575757576,35,29,2,1
"19513","8745684cfcddda4cc19b5f0a99cc54fc",110,76,54,14.2592592592593,110,0,3,3
"19514","8747e0b6659fb4e428549eeeaaa94c2c",29,29,0,29,29,0,1,2
"19515","8747e8b15557460a81dfa2ae5ee8c521",42,42,0,42,42,0,1,2
"19516","8748ec3f04daaeffb522a84d1724c921",133,78,57,16.3333333333333,133,0,3,3
"19517","874d393f3decc2720b96278d99ea2de3",192,109,66,20.3636363636364,138,54,3,3
"19518","874da04efede284b2507725542d0ff8b",11,11,0,11,11,0,1,2
"19519","874de894661fe7f9fa37fdba511ed2df",115,74,58,13.8793103448276,80,35,3,3
"19520","874dfb3ec4134fcd25ae5c4e09d449bc",25,25,0,25,0,25,1,2
"19521","874f529ca5d1118787e0096460fd403a",28,28,0,28,28,0,1,2
"19522","8750530023b78f137e5714b2630c5af9",29,29,0,29,29,0,1,2
"19523","87514d144a37f6000bf0eef241c89481",114,79,21,38,114,0,3,3
"19524","8753d686ef21fa61ecb875d41dfb327c",165,98,75,15.4,118,47,3,3
"19525","8753e462d2e28a8f49f66bdce8b2a4cb",29,29,0,29,29,0,1,2
"19526","8753ea75c54884b9c186eba5889e63c1",85,69,20,29.75,85,0,1,3
"19527","875496aa131b73a1527d6febb0175a12",70,49,63,7.77777777777778,70,0,2,3
"19528","8756392e4599a1ee3c0280e628292b91",33,33,0,33,33,0,1,2
"19529","87568e7b9aa3df17b6f519e29bdb8bd2",15,15,0,15,15,0,1,2
"19530","8756d8d6a9d8b84365085e55d8b5b510",26,26,0,26,0,26,1,2
"19531","875d4fbcce09500633931e7c3f222bfe",103,65,83,8.68674698795181,93,10,2,1
"19532","87608b62e4e89b8923686fee90b2c049",53,53,0,53,53,0,1,2
"19533","8760a211614ece73ddb02c3bf2e9581a",27,27,0,27,0,27,1,2
"19534","8761b49266ae0260497386dacf82f0d2",31,31,0,31,31,0,1,2
"19535","87621d086b26de501f8756d4f4bb32c3",28,28,0,28,28,0,1,2
"19536","8763e2eb78d94befe89225f744243510",33,31,54,4.27777777777778,33,0,2,1
"19537","8766698df2c0359830e1f26022a5b1af",36,36,0,36,36,0,1,2
"19538","8766d8e8437fe53a501e4307fb5e5c01",134,89,75,12.5066666666667,134,0,3,3
"19539","8769a55b9b1732551b6f07b8e7f0e59a",45,45,0,45,45,0,1,2
"19540","876ca9e04f9d9ec87cb47f709f9818d2",60,44,81,5.18518518518519,60,0,2,1
"19541","876e5496fa9466cf883666694ab10515",14,14,0,14,14,0,1,2
"19542","876ea87de825622b39cb4db3dccb6822",32,32,0,32,0,32,1,2
"19543","87709736288af76865d343be69e20bb6",48,41,21,16,48,0,2,1
"19544","8771762074c9d5e160c8cb4b71974182",29,29,0,29,29,0,1,2
"19545","8771b084f280e92b0a434ced18d53c01",26,26,0,26,0,26,1,2
"19546","8771fbafa203c6d02d9952657e12dbaf",40,40,0,40,40,0,1,2
"19547","877447cc1ed39eaf17fd71fd08bbdae7",35,35,0,35,0,35,1,2
"19548","8776c5b9f40ed79fea538e0fb5c99aed",137,112,56,17.125,137,0,3,3
"19549","877a21866d4a3789338c56004beb8a22",9,9,0,9,9,0,1,2
"19550","877ba41e8cbcde32e9adf77b0339b90a",106,70,55,13.4909090909091,106,0,3,3
"19551","877bc0862c03684f7c18fcf951323adb",9,5,61,1.0327868852459,9,0,2,1
"19552","877f0df86b7cd07425c3914ef23eba8a",42,42,0,42,0,42,1,2
"19553","877fc9aa0042b71b63a24b93413c67f5",50,36,64,5.46875,50,0,2,1
"19554","87807d439da50897ecffc0185b838bd1",1,1,0,1,1,0,1,2
"19555","878114ccdd33bd786f859466c764e45e",27,27,0,27,27,0,1,2
"19556","8785fa9697e8cef736f04a67cc5b001d",66,54,14,33,66,0,1,2
"19557","878685c2a9ab8a81059b5398592e2545",38,38,0,38,38,0,1,2
"19558","87881b8546be5f7815de94b8ed5b5395",16,16,0,16,16,0,1,2
"19559","87887a172e2e6f42b112f01b85ef32e2",9,7,53,1.18867924528302,5,4,2,1
"19560","87895d74578328462ac37c39ba9f7a90",33,33,0,33,33,0,1,2
"19561","878a432eecb45f050f337baf0d794049",48,48,0,48,48,0,1,2
"19562","878ac592c98327505333bc75319337b7",33,21,44,5.25,33,0,2,1
"19563","878eaeef400fdac23f95b41d2f8c6fce",26,26,0,26,26,0,1,2
"19564","87946cb0357d0b198ae3958e4e4d4ba8",100,69,78,8.97435897435897,52,48,2,3
"19565","879616eac08fb8a52d873feb3c4e6ffa",9,9,0,9,9,0,1,2
"19566","879699702d818a2c273a967843290163",74,41,64,8.09375,74,0,2,3
"19567","879b4ba2c6cda30905e0e546edd5684e",82,71,51,11.2549019607843,82,0,2,3
"19568","879b6fcea78a2dbd0815216cc0f0c25d",174,105,37,32.9189189189189,174,0,3,3
"19569","879cd1604c3895d649ce35de6a4a4826",16,16,0,16,16,0,1,2
"19570","879f4bda40a11cb2e1d07bc534741650",54,42,55,6.87272727272727,54,0,2,1
"19571","87a26c64034e1366cbb7a4cd29312929",30,30,7,30,30,0,1,2
"19572","87a405a1959a47588874629be4b2b24f",24,24,0,24,24,0,1,2
"19573","87a527a6c8242a833f009fb9f2d308ca",153,80,61,17.5573770491803,125,28,3,3
"19574","87a799a3c9cc07afe41bcb581f482c12",111,88,27,28.7777777777778,111,0,3,3
"19575","87a7e3d7dbf72d1cefef0ae3d04fa874",153,79,35,30.6,153,0,3,3
"19576","87a9156ca8cc39e2bfaa91f35bab83f9",24,24,0,24,24,0,1,2
"19577","87a9e16816e5dc8988fff938d072455c",110,75,64,12.03125,77,33,3,3
"19578","87a9fa3a7df33ac59419156dafd69848",135,52,82,11.5243902439024,135,0,3,3
"19579","87acf61e37fa45841aed110313cba35c",98,63,68,10.0882352941176,60,38,2,3
"19580","87b20e3611e9b20b3a190d08c97134c8",18,18,0,18,18,0,1,2
"19581","87b3f13969f348b520f0ee11598bb785",83,59,77,7.54545454545455,83,0,2,3
"19582","87b937f854fdcce0e37942ff03de1aae",64,46,33,13.5757575757576,64,0,2,1
"19583","87b9fa7b4b62fe46ec1c93f4e947eec1",112,79,57,13.7543859649123,112,0,3,3
"19584","87bc390902aeabb332160384166c48d6",3,3,0,3,3,0,1,2
"19585","87bd3cda6c8b247baefadc62e26bdc14",88,37,62,9.93548387096774,53,35,2,1
"19586","87be5c40ca138e79eb6d9d1c5e868853",73,68,30,17.0333333333333,73,0,2,1
"19587","87bf36af81b5ea7414548bf572661724",4,2,42,0.666666666666667,4,0,2,1
"19588","87c1d60f600acf98e03df85543e62356",81,77,24,23.625,81,0,2,3
"19589","87c25ad81420d55147c589c99e81c4d8",27,27,0,27,27,0,1,2
"19590","87c28d62f9575e4980db1da2eca94af4",29,29,0,29,29,0,1,2
"19591","87c6e4c2228524151d53ae67a8e3d711",17,17,0,17,17,0,1,2
"19592","87c714fd96fd8ee68a80432f31f86061",224,113,87,18.0229885057471,183,41,3,3
"19593","87c747aa6915494ff3cc66891955ca8e",21,21,0,21,21,0,1,2
"19594","87c8a235fa7b6da495fcc24170329b71",96,63,71,9.46478873239437,96,0,2,3
"19595","87ce403beb239e6240ea08b61bee88fe",18,12,28,4.5,0,18,2,1
"19596","87ce7ec59490fc8033336da3eca6a2db",169,80,67,17.6567164179104,169,0,3,3
"19597","87cf0dbaf11144f19e568f1f41d8f5aa",20,20,0,20,20,0,1,2
"19598","87d0b7a9eff77c48f906691b85327617",24,17,34,4.94117647058824,24,0,2,1
"19599","87d0fe42727b94609766150c0f5aa595",14,14,0,14,14,0,1,2
"19600","87d135d481d4671c7629f18680e510d6",116,79,61,13.3114754098361,116,0,3,3
"19601","87d2e5a0e5d5fe96fba0970a746dbec0",170,72,71,16.7605633802817,170,0,3,3
"19602","87d337e65213e2536ed12d24d7f4edea",68,55,40,11.9,24,44,2,1
"19603","87d35882093348a662d4ad6ebaedc0bb",47,47,0,47,0,47,1,2
"19604","87d3cbef0cc14b5b505f84991544dac0",247,148,80,21.6125,200,47,3,3
"19605","87d5d6934aec909d6c01b144df64ae3c",215,87,79,19.0506329113924,191,24,3,3
"19606","87d722cf0dc7d81d9659894491407ce8",59,39,52,7.94230769230769,59,0,2,1
"19607","87d7701b4d25e1667ebf2d1194ba8dd6",24,24,0,24,24,0,1,2
"19608","87dc98aca7202dffc358dae6cc739156",95,47,45,14.7777777777778,76,19,2,1
"19609","87de94fb9aac351683f852753de9740e",56,28,82,4.78048780487805,47,9,2,1
"19610","87e11c956bbfe9ca18c0e40599e55ff2",213,114,85,17.5411764705882,165,48,3,3
"19611","87e80c75b1383d26dbd95dd81dfdf581",11,11,0,11,0,11,1,2
"19612","87e8d2292f9b4cf9a94feccbc51b15f8",113,78,67,11.8059701492537,78,35,3,3
"19613","87e97ef36bd8bfccdc0623a001d170e5",171,78,69,17.3478260869565,133,38,3,3
"19614","87ecda236600d07caf97a5236d3d8f99",28,18,70,2.8,28,0,2,1
"19615","87edd9789cdb7bbc05e37e5347625912",24,24,0,24,24,0,1,2
"19616","87efc1c6828d5f46fa8e5f94f9d06a99",2,2,0,2,2,0,1,2
"19617","87efd084db6fe40ac6b29a714fee0c45",52,45,80,4.55,26,26,2,1
"19618","87f1bbda37d0758cc194d96140cff691",104,80,14,52,104,0,3,2
"19619","87f2c53dc67facfc3192b8711508e23b",155,83,65,16.6923076923077,114,41,3,3
"19620","87f35aa9fc30a5a42f31a5ceb69d71d5",19,19,0,19,19,0,1,2
"19621","87f3faf24de9893e1c2db9e38e1cb066",22,22,0,22,22,0,1,2
"19622","87f5b6ab94975705dafb29ac0bacfc54",70,49,55,8.90909090909091,70,0,2,3
"19623","87f62f46bedde7fa353ec24ae0815c55",152,102,60,17.7333333333333,102,50,3,3
"19624","87f80c667a14fdd145544d827cd064d7",86,61,89,6.76404494382022,86,0,2,3
"19625","8801d3dd92cc51b37482efeb862520d9",150,83,81,12.962962962963,126,24,3,3
"19626","880343a18a97b91762fcbdc828b68155",241,97,70,24.1,200,41,3,3
"19627","880664463a1224a249c4d793d53d52c0",73,49,49,10.4285714285714,55,18,2,1
"19628","88079c9a54a17484f84f54edf8c32c7c",194,81,76,17.8684210526316,194,0,3,3
"19629","8807bf9dbe77ba5f7e7d26057b797691",37,37,0,37,37,0,1,2
"19630","880d43887d1187eeae8db50bfee3d984",19,19,0,19,19,0,1,2
"19631","8810b91217084ab3a5989289dc0d3408",53,43,13,28.5384615384615,53,0,1,1
"19632","88112c1c95e42cdae8e2ea36e4eb157a",9,9,0,9,9,0,1,2
"19633","881264c317c9a93eeca7a301d81119c0",123,91,56,15.375,123,0,3,3
"19634","881294fce79d104092db71fda1ab0a0e",29,28,21,9.66666666666667,0,29,2,1
"19635","8813a9b7630bba7ca1d26afe6d614b36",97,55,85,7.98823529411765,97,0,2,3
"19636","8814021ed0e06bccf05f83fd9c0ecba6",8,8,0,8,0,8,1,2
"19637","88163df97dd8520bf7197ae8f07064a3",76,69,60,8.86666666666667,48,28,2,1
"19638","8816b65aa1fe09789eab0acebd203295",22,14,20,7.7,22,0,1,1
"19639","8819acb4c58f19b746773bf1cc472274",130,83,64,14.21875,111,19,3,3
"19640","881da53147c81f5c31aa7d019a518439",82,69,24,23.9166666666667,82,0,2,2
"19641","881ed194e91e2b13cff51c6386a3fb93",32,32,0,32,0,32,1,2
"19642","88205158e735df66fcbb7efd93a082ba",24,24,0,24,24,0,1,2
"19643","8822ba1994046d02e8eec71ada264e14",40,40,0,40,0,40,1,2
"19644","8822bdd16c1da3876927e669643666a9",139,82,58,16.7758620689655,105,34,3,3
"19645","88246a3dc6f57e3fefc44ae1b0dfd959",53,53,0,53,53,0,1,2
"19646","8824ee44b8220e7ce12711a185b73086",70,52,51,9.6078431372549,34,36,2,1
"19647","88260a8a770dd088925435db0cad2f59",67,54,75,6.25333333333333,67,0,2,3
"19648","88295a33aeeb86c61fe0cded864c1744",35,35,0,35,35,0,1,2
"19649","882b2ea23d05c347bd2d691fa230e80d",29,29,0,29,29,0,1,2
"19650","882c77ede3185fc5d6b9bacc3907f306",4,4,0,4,4,0,1,2
"19651","882ceff4a463eec6340ca5498a388d12",4,4,0,4,4,0,1,2
"19652","882e0ede833e3ac93d1f9448fc84d26b",104,56,54,13.4814814814815,67,37,2,3
"19653","882f526039836e69d36c0c3606282a9e",133,86,68,13.6911764705882,133,0,3,3
"19654","883b57306b3453090bc46a4015dc2e4a",46,36,17,18.9411764705882,46,0,1,1
"19655","883bbabe7509827cb11b0154a3989452",48,48,0,48,48,0,1,2
"19656","883c906436c5be14328f453daf9a78c7",19,19,0,19,0,19,1,2
"19657","883fb445a2bc1ad3d2d75f9989294354",40,34,49,5.71428571428571,40,0,2,1
"19658","88403e02dd323dcc9ffe76d97d5896f7",77,58,25,21.56,53,24,2,1
"19659","8843ecad09de5b69d88594dba9309b0a",102,45,84,8.5,102,0,2,3
"19660","884487f155caddab942ee06a976559bf",58,49,14,29,58,0,1,1
"19661","8845392290f7cf8d5fff927910bfa4f7",24,24,0,24,24,0,1,2
"19662","884651ac57eacedc25a94708d4119237",40,30,71,3.94366197183099,40,0,2,1
"19663","8848376673e05998f7374c5b6bb07276",23,23,0,23,23,0,1,2
"19664","884871273fb343467845b1c4c977255d",12,12,0,12,12,0,1,2
"19665","8849e9b79131cc7f44272931b55a5e99",17,17,0,17,17,0,1,2
"19666","884abe47b81f00cbdccc405d81a61eaf",153,132,27,39.6666666666667,153,0,3,3
"19667","884c13be32789805055e6fe16a870e2e",37,37,0,37,0,37,1,2
"19668","884ff92bc27f8d33f697344885f65920",52,45,57,6.3859649122807,52,0,2,1
"19669","8850ddf7dfac855c3a5dcf705ecca0de",29,26,68,2.98529411764706,16,13,2,1
"19670","885117521e6a29636aa3323d54224929",31,31,0,31,31,0,1,2
"19671","8851a9be88b199ae972c1099d5da7733",157,86,57,19.280701754386,157,0,3,3
"19672","88529a05c88228992474ff3fe7d7cbdd",190,119,82,16.219512195122,190,0,3,3
"19673","88549882d418b1060e595dc79cbe3015",70,43,22,22.2727272727273,50,20,2,1
"19674","8854e7dc087e45d8aa21723e60fb019d",35,20,8,30.625,35,0,1,2
"19675","885585f362a434ed5bae073e73620d61",94,75,47,14,53,41,2,3
"19676","88559a3f95bd6d4beceef87f89d93f7c",159,89,75,14.84,159,0,3,3
"19677","8856736bb29b69e29db1ff59455f9385",20,20,0,20,20,0,1,2
"19678","88570b0e6d7dfb44d4515ffe9c1633b7",17,17,0,17,17,0,1,2
"19679","885776972995782b589241711da38324",83,43,75,7.74666666666667,83,0,2,3
"19680","885778374252d9ed51eee92819b91947",147,80,61,16.8688524590164,147,0,3,3
"19681","88587dcfbb6bc81d88b2b1c902c5521e",90,54,56,11.25,90,0,2,3
"19682","8858c2731cd2d89cf6d19f4428755f03",112,81,38,20.6315789473684,112,0,3,3
"19683","8858c4e204d7faa16ae888c885db6e31",45,45,0,45,0,45,1,2
"19684","8858ce3a6f9b243469a4e9491131d96e",23,15,35,4.6,23,0,2,1
"19685","885be4e22f45dd063c9001e2aa018cb5",10,10,0,10,10,0,1,2
"19686","885c66be2ed9a123917ee8d3e7a260f2",44,34,49,6.28571428571429,44,0,2,1
"19687","885dfd81098a39f5a0954876a5e33b6f",8,8,0,8,8,0,1,2
"19688","885ec6c07c8b519279162e8c379b62a9",28,26,71,2.76056338028169,14,14,2,1
"19689","885fa672a43c4799acd11b3a7e3acb0d",22,20,73,2.10958904109589,12,10,2,1
"19690","886047d28b03be979a5853079e0cfc95",95,72,56,11.875,95,0,2,3
"19691","88613b3f333c7b38bc3664bcca18aac5",68,59,22,21.6363636363636,68,0,2,1
"19692","88614723bfec101cc3b0d79a1a705178",66,57,13,35.5384615384615,37,29,1,2
"19693","8861c1a7e7116b066a444981f53b59df",2,2,0,2,2,0,1,2
"19694","886280b28d74f4c1d150912c6dd7919d",28,28,0,28,0,28,1,2
"19695","886656245b87fa081b1f6f3e34839aa8",34,34,0,34,34,0,1,2
"19696","8868149b908aa5dec4b475c030b8b1bd",152,94,71,14.9859154929577,152,0,3,3
"19697","886826f29fd19ab0f7115776bcb94962",127,98,45,19.7555555555556,127,0,3,3
"19698","886a07f0d720b947d0a7322c004df88c",151,77,54,19.5740740740741,102,49,3,3
"19699","886bf03927935f10548d171d296b04b5",155,118,24,45.2083333333333,155,0,3,3
"19700","886bfa25067a47c37a90bc2f1934a6bd",51,28,12,29.75,51,0,1,1
"19701","886cdc9a58701eca16bb2123093fbbc0",39,39,0,39,0,39,1,2
"19702","88726a307e332b847fe92bfba29f435e",47,42,25,13.16,47,0,2,1
"19703","8873902bfa3a5d647d364eaa0caf1489",53,49,60,6.18333333333333,53,0,2,1
"19704","8875f5147f2fc281866623d6fbf9fe99",45,30,51,6.17647058823529,32,13,2,1
"19705","88786106399d525907ef8a50693f8c69",46,39,24,13.4166666666667,46,0,2,1
"19706","887b50513103780f23ff84caa8a026b0",35,35,0,35,35,0,1,2
"19707","887ce2c2aec21ccea8c41b0e126cd128",43,36,49,6.14285714285714,0,43,2,1
"19708","887d156f02d39d9e8c83651dab09cd08",84,60,28,21,84,0,2,3
"19709","887db2ac15008ef9d995e538f009ea9e",31,31,0,31,31,0,1,2
"19710","887e723755ef6bb8011ea1c669b1f54d",41,41,0,41,41,0,1,2
"19711","8880a72434896753aa6d1e8c983a46cd",55,55,0,55,55,0,1,2
"19712","88831dfb0f79a376b3914222cd2fdb7f",4,4,0,4,0,4,1,2
"19713","888320331063e0c1cae0f4f4bfc478d1",105,86,85,8.64705882352941,105,0,3,3
"19714","888323da4fe45fe8a953a0f616d6dadc",18,18,0,18,18,0,1,2
"19715","888388a919ade8e96e42672ea69459a8",21,21,0,21,21,0,1,2
"19716","8884e958b08bb6a89b8839a8241b4bca",205,114,63,22.7777777777778,205,0,3,3
"19717","8888d2d3f790866ad592c0ef2239f5f2",112,89,58,13.5172413793103,112,0,3,3
"19718","88892d0010f46348f903ff99f382c4c1",24,24,0,24,24,0,1,2
"19719","888a7b819ae32e46596e00bd8e635b96",112,44,70,11.2,112,0,2,3
"19720","888b5826b4164000fe1a813fd44e11d1",72,65,15,33.6,72,0,1,2
"19721","888ca88e535aac801bb7fb80206cc032",32,29,6,37.3333333333333,13,19,1,2
"19722","888d44b0e9e96c04f0014ca9c033be9a",25,25,0,25,25,0,1,2
"19723","88902afdd13a10a81f723439c52fbb31",29,29,0,29,29,0,1,2
"19724","88906236d173a7015140933a00d88a8f",219,144,56,27.375,219,0,3,3
"19725","8890f0164a3cd5b363574ae817b324c8",54,45,42,9,54,0,2,1
"19726","8891cb5e675e400f5d88dde4bd4e1d82",10,4,69,1.01449275362319,10,0,2,1
"19727","889580eb06f6d353b9691ce55e84ab59",21,21,0,21,21,0,1,2
"19728","8898aae0d77d5c76432a0faa21b4195f",23,23,0,23,23,0,1,2
"19729","889a5fa35682c72577f420ed287417b1",12,11,57,1.47368421052632,8,4,2,1
"19730","889ae5e1bcabcce444cdab419a2f5f81",59,41,61,6.77049180327869,59,0,2,1
"19731","889c7c208982f50328002759a8b1d951",91,65,42,15.1666666666667,91,0,2,3
"19732","889d44dcf40be29efd085865902dbc81",56,44,35,11.2,56,0,2,1
"19733","889e0979dec30fe07d4ede06dfe1c567",158,123,52,21.2692307692308,158,0,3,3
"19734","889f3e55e470531fc654e4ebbc3e760d",66,53,31,14.9032258064516,66,0,2,1
"19735","889f8fbd4518ea307675b3dfcbaf5525",4,4,0,4,4,0,1,2
"19736","88a02a8815007d974cc01425dd2f8aca",114,51,61,13.0819672131148,114,0,2,3
"19737","88a3bca4469f0026876b7402ee489125",100,67,38,18.4210526315789,100,0,2,3
"19738","88a602c3a8e18056cbbde4b85d819b63",86,56,82,7.34146341463415,86,0,2,3
"19739","88aa9896814b321e2a801e5c5d73465a",31,31,0,31,0,31,1,2
"19740","88ac03ae0afe16a49a416a9e42680d93",216,135,58,26.0689655172414,192,24,3,3
"19741","88ad1c665ddd6089df82e47575d96d7a",50,37,42,8.33333333333333,50,0,2,1
"19742","88ad3fed71814b399490fd0df732ee65",56,45,21,18.6666666666667,56,0,1,1
"19743","88ad6854a39690a77a1f121e41e3abd0",50,50,0,50,50,0,1,2
"19744","88ae9df4ff156edc0187cd158a244f06",133,79,65,14.3230769230769,133,0,3,3
"19745","88b43f724dc90a4c0ba07bb30f97be02",161,96,77,14.6363636363636,124,37,3,3
"19746","88b96ce320731271789ce4f19ded5a65",104,90,63,11.5555555555556,104,0,3,3
"19747","88b9b8d17e287808d00a7ee1ed1013ca",22,22,0,22,22,0,1,2
"19748","88bca2100c83f07b9385c9766bb4ed17",139,102,80,12.1625,89,50,3,3
"19749","88be935f32f6177e2263b2a7c25498c6",118,66,82,10.0731707317073,118,0,3,3
"19750","88bec99c93d7ee26514611d9cd20ab9b",27,27,0,27,27,0,1,2
"19751","88bf3e0049103ab292246fdb966fb367",5,5,0,5,5,0,1,2
"19752","88bfec51ba81415b2f2a4b1c209d0d8c",30,26,42,5,30,0,2,1
"19753","88c05aeeb2b88c77534b7a1925cee1fe",73,67,27,18.9259259259259,73,0,2,1
"19754","88c08661555f10dcd73904a2f6d6efe7",19,19,0,19,19,0,1,2
"19755","88c11b2300f28211de9f951ec73c67b3",55,42,19,20.2631578947368,55,0,1,1
"19756","88c17ae35e68c8cd4996356c35a1cfab",69,49,25,19.32,69,0,2,1
"19757","88c3997a2b960d11d678478d84023b93",126,69,50,17.64,105,21,3,1
"19758","88c74433934fe3f267ce6f337a9a7369",78,73,15,36.4,78,0,1,2
"19759","88c89f4f9b6b651a64b950c7359f8e2d",48,47,40,8.4,48,0,2,1
"19760","88c8ccd78f31b332fb90afad879c33f9",154,50,73,14.7671232876712,154,0,3,3
"19761","88cb1a11e9b47df6fcc6dfe0fa899b28",29,29,0,29,29,0,1,2
"19762","88ce1f8cc2132beeb600ac17d5e02fba",26,23,4,45.5,26,0,1,2
"19763","88cfe890855b29d383cd14af8ea8241e",30,30,0,30,30,0,1,2
"19764","88d3cd0efc3eb2884ce7fa5b7ee3e00e",30,30,0,30,30,0,1,2
"19765","88d5aad76f554dc65d814d270c2f69b5",73,63,31,16.4838709677419,73,0,2,1
"19766","88d63aac40ab8712d2206eb5427b6414",25,25,0,25,25,0,1,2
"19767","88d8f13da19b28945356639b7437abdc",41,33,42,6.83333333333333,0,41,2,1
"19768","88da7314e3155ae04e0bc7d679c3a9cf",22,22,0,22,0,22,1,2
"19769","88dae00e98921334cb32b70d567437d7",185,99,77,16.8181818181818,154,31,3,3
"19770","88db977f4a27129b40e884603e328a74",83,45,50,11.62,60,23,2,1
"19771","88dd6489ca1de52487fd65eade9abb97",72,48,78,6.46153846153846,72,0,2,3
"19772","88de533bfa40ffacb5cbb59ab9cc51c6",147,98,65,15.8307692307692,147,0,3,3
"19773","88e08b9a4452c6764416d24c3ce27b63",38,38,0,38,0,38,1,2
"19774","88e214554663bc0ab377cd62601fd0c1",52,42,53,6.86792452830189,43,9,2,1
"19775","88e2893bf568b4f8e82e77ee74305837",154,111,59,18.271186440678,154,0,3,3
"19776","88e3861d9afb3a904d087ca90ebe00d9",41,35,49,5.85714285714286,41,0,2,1
"19777","88e38752621262e5e34548c660e2c7a7",84,70,42,14,84,0,2,3
"19778","88e7044e1f8c438edd5a69d55c03d305",77,57,62,8.69354838709677,77,0,2,3
"19779","88e72888f9b73ef637e8cccce52ceb9c",183,87,76,16.8552631578947,183,0,3,3
"19780","88f0184f3d5a107cd3b50e664c0f16ad",94,59,42,15.6666666666667,94,0,2,3
"19781","88f17a643db2382b0ce02c719cc53d63",1,1,0,1,1,0,1,2
"19782","88f2e2bbdc0f1fac1241cb47ae1ed6f5",63,41,62,7.11290322580645,63,0,2,1
"19783","88f3fdca64afbc8a56d484818340d11a",39,39,0,39,39,0,1,2
"19784","88f49ccfdeca67c2928642583ae0b92b",60,56,82,5.1219512195122,60,0,2,3
"19785","88f549ce413e811b85e422533288dea5",76,56,14,38,76,0,1,2
"19786","88f62248184bcc160cce3f52a537f572",30,30,0,30,30,0,1,2
"19787","88f6f76ff45d0c125f8bf5b4938af19f",39,31,42,6.5,39,0,2,1
"19788","88f7c2c72683bb5e893532e1021733c7",25,25,0,25,25,0,1,2
"19789","88fa44bf97cb4d2c48d5a1d8e0ed61d7",24,24,0,24,24,0,1,2
"19790","88fbf70ec26d2d9198927251ebb916d7",48,48,0,48,48,0,1,2
"19791","88fd642a77e7903480fc55c92ff2c097",116,76,36,22.5555555555556,116,0,3,3
"19792","88ff265c3bb349dab605a2a889b43a89",29,29,0,29,29,0,1,2
"19793","8900818d5c47e5391f547c89bdf50b08",132,89,49,18.8571428571429,132,0,3,3
"19794","8900b14c36eb3251e46d115d7e36bffb",13,13,0,13,0,13,1,2
"19795","89016a4327101ddb7d6910aaf3422a66",11,11,0,11,11,0,1,2
"19796","89026172498a159c9f8dafaf2870cfda",169,120,38,31.1315789473684,169,0,3,3
"19797","8902b26e199fd3b165015ff8b924867b",28,28,0,28,28,0,1,2
"19798","8904bd186d2ac8942be22e3c9d4c8f39",174,86,82,14.8536585365854,154,20,3,3
"19799","8908f916ef2475cda8140f4eae1236a3",53,45,63,5.88888888888889,53,0,2,1
"19800","890ad703e5fa90aa6c8b2a6db7c75906",25,25,0,25,0,25,1,2
"19801","890d896df54b53b85369e2790e39252c",144,87,45,22.4,144,0,3,3
"19802","891074d52fac689c2b5ede4b88e497a4",26,21,64,2.84375,26,0,2,1
"19803","89119c08fcf817cf275b6b404fe2b432",100,53,82,8.53658536585366,62,38,2,3
"19804","8913c89ff3ad79c8f3d69719ba55322e",70,55,55,8.90909090909091,70,0,2,3
"19805","89144b3c4d190dc9ab2ee0800386a94f",27,20,31,6.09677419354839,27,0,2,1
"19806","891493b63715b836300a502f3f6e1f87",58,48,68,5.97058823529412,42,16,2,1
"19807","8916536f2b71a98da3287bbb38915e45",129,88,69,13.0869565217391,129,0,3,3
"19808","8917fc53ff626817b4271fd2386524a9",66,39,69,6.69565217391304,58,8,2,1
"19809","891e242c55c85df08d34414b1eba44d7",208,53,84,17.3333333333333,208,0,3,3
"19810","891f30f804e235765add3ff0f61d4dd0",172,107,63,19.1111111111111,172,0,3,3
"19811","892178997bb2938102c0d8713ef696d9",18,18,0,18,18,0,1,2
"19812","8922161b8964de4f1d329d775a8935be",82,60,39,14.7179487179487,36,46,2,1
"19813","89221c60fb10cb12ae41a88cf5aa97ca",24,23,62,2.70967741935484,24,0,2,1
"19814","8924078c00a08f594d377adf80e4ed53",28,17,78,2.51282051282051,28,0,2,1
"19815","89246586483a68852e761c8492e9cafb",25,25,0,25,25,0,1,2
"19816","892bf251eb9a93e6edc5038331fd7e12",58,51,32,12.6875,42,16,2,1
"19817","892d9ec84fd364610ee592c81cf972b2",204,96,70,20.4,166,38,3,3
"19818","892dc7a92d07c8fe43cb384f4898c10e",55,53,14,27.5,0,55,1,1
"19819","892df05e096702283930a666ea77b039",109,92,58,13.1551724137931,109,0,3,3
"19820","892e6142949d25773f21ead6fe79cc71",28,28,0,28,28,0,1,2
"19821","8931db187d1bee788c53257c87a575ea",12,12,0,12,12,0,1,2
"19822","89321556761d6c789207c62febd56ffc",56,56,0,56,56,0,1,2
"19823","89328cc0669560d0483cd5f5c9c7f7f4",23,23,0,23,23,0,1,2
"19824","8934d11bda7713a4e9532f5c8e89d3f7",31,31,0,31,0,31,1,2
"19825","89373b7751c8958ab13919ca46707ff4",25,25,0,25,25,0,1,2
"19826","89390b12dd47522eda52d8435434a66e",143,77,65,15.4,111,32,3,3
"19827","893a0d8ae4ef36ab206a0d0d4fffcd0c",99,39,68,10.1911764705882,59,40,2,3
"19828","893b5645e91213af31c4e0831601daaf",1,1,0,1,1,0,1,2
"19829","893b735808510383a549732e9052d83f",27,27,0,27,27,0,1,2
"19830","893d8b5a624df9f48f321c43488c9efc",12,12,0,12,12,0,1,2
"19831","893e3200cd6975ee9ccb36a90219ab87",1,1,0,1,1,0,1,2
"19832","893e511bb75b722d2d7fede1b9f61d47",18,17,76,1.65789473684211,18,0,2,1
"19833","89401c93d7643ecd8dab9aa5c7bfda7d",7,7,0,7,7,0,1,2
"19834","8940c2e65096c64c96ea41afd7ddc672",32,18,55,4.07272727272727,32,0,2,1
"19835","8941eae209605c1ebe9c8de8a684b179",57,50,54,7.38888888888889,57,0,2,1
"19836","89425831af5b05b1c8c44ed727df628b",42,35,47,6.25531914893617,42,0,2,1
"19837","8942b2ad3378533a545e05e93a537855",96,63,33,20.3636363636364,52,44,2,3
"19838","8947b0469715cc9b513635594cfecb85",18,17,11,11.4545454545455,18,0,1,2
"19839","8947f81cd0d1059fdf1b05b6c8184d1e",35,25,49,5,35,0,2,1
"19840","89483a174e142686cd50d7d88d976608",12,12,0,12,12,0,1,2
"19841","894c06adcade99ed149aefb0b58aaf8b",187,97,58,22.5689655172414,150,37,3,3
"19842","8950befafda3a72ca2e5ecbc6fc68aa9",10,10,0,10,0,10,1,2
"19843","89518e0122a4e60f08c482462aa0fb79",124,96,20,43.4,124,0,3,3
"19844","8952084feef59126bfac6be985449171",16,16,0,16,16,0,1,2
"19845","8953d0df3d514f51b17e6ee16698167c",42,42,0,42,42,0,1,2
"19846","895457eef6cac70cb70941dcaf6ea84c",14,14,0,14,0,14,1,2
"19847","8956370e3ac56524b8a1abed0f8f5519",23,23,0,23,23,0,1,2
"19848","89564f72c7ec693de2c12ac834ebcde8",51,51,0,51,51,0,1,2
"19849","8957b0dc9a8a532a291fa56ca3dac672",46,46,0,46,46,0,1,2
"19850","895db035500cc94348fe3f6d9dc5a457",29,29,0,29,29,0,1,2
"19851","895de92d123d05d750ca22ac94416641",115,62,64,12.578125,102,13,3,1
"19852","895f2f3a69f55b27791df1336c80225c",54,48,10,37.8,54,0,1,2
"19853","8963c5dff847fe981884289346b021e4",56,46,65,6.03076923076923,1,55,2,1
"19854","89649f52078878d49c14585ab168338b",28,28,0,28,28,0,1,2
"19855","8964d6ac8987f47a085f6712bc4d9276",110,71,35,22,110,0,3,3
"19856","896533779323dc1feb58aed0797055b7",76,54,34,15.6470588235294,76,0,2,1
"19857","89688263b84f42c5dc1372dd594c7ade",42,42,0,42,42,0,1,2
"19858","896af54b84c667481b1b7407b96f067b",37,28,48,5.39583333333333,37,0,2,1
"19859","896dc6c75e3e38028155e6415cfbe581",35,35,0,35,0,35,1,2
"19860","896e83ff1085cda57f9f38d7822e7afe",62,51,29,14.9655172413793,29,33,2,1
"19861","896fcfb509d5b2984dd500fab44d0057",12,12,0,12,12,0,1,2
"19862","896fe6760072dd7ad09a229d2d3bba11",79,63,68,8.13235294117647,79,0,2,3
"19863","89705f10f24660ddde45d5b3143d5972",16,16,0,16,16,0,1,2
"19864","8971f1f954d3c3a84a7d326ed9e95199",42,42,0,42,42,0,1,2
"19865","8976199f1c6249c5b98e7e95b626cd2f",21,21,0,21,21,0,1,2
"19866","89766730f0033243cfcd1a65b5f1ca9f",16,16,0,16,0,16,1,2
"19867","8977070868ddf0fc9045d9d9d65c3aa3",6,6,0,6,6,0,1,2
"19868","89771a47df2ea54d32dfd72dd5c1bf0d",3,2,56,0.375,0,3,2,1
"19869","89784d3dc22fb92d5d2a8ee88c97e6f7",8,8,0,8,8,0,1,2
"19870","897aec84546af658a140b27b291d1849",56,56,0,56,56,0,1,2
"19871","897c6565ee9dbfca151977d3531d5aa0",191,101,82,16.3048780487805,191,0,3,3
"19872","897e80e4ec4f1498dbb9991e9f62866e",14,14,0,14,14,0,1,2
"19873","897fb00a21317b435fa0eba23d0f80a0",19,19,0,19,19,0,1,2
"19874","8980f35abadd1b3b69670600c581c01b",32,32,0,32,32,0,1,2
"19875","89815627eb11554f42b2835dbfb74427",131,78,56,16.375,131,0,3,3
"19876","8981f200386f7bea6f4b5d3e2e40d4a9",13,13,0,13,13,0,1,2
"19877","8984c978bf2e723fe1c2cf9beb204d62",45,35,21,15,0,45,2,1
"19878","8988ce04ba406fb592d6874816b00787",71,56,40,12.425,39,32,2,1
"19879","898c0aa3f0310e96125f1a56a236195b",1,1,0,1,1,0,1,2
"19880","898e3234366f4395a4e849532898caa7",72,65,26,19.3846153846154,33,39,2,1
"19881","898e573ca772267ce89ab244edd9b280",50,42,24,14.5833333333333,20,30,2,1
"19882","898e64f5f1bab278630765762c84e40f",50,45,50,7,50,0,2,1
"19883","899067e8770d2e6d0dae7c80212a2be5",72,43,63,8,35,37,2,1
"19884","89910575c43faf51304bfb2a764d9064",31,27,28,7.75,31,0,2,1
"19885","8992d11c8ac4332abf1c0ba5a588c0ff",37,37,0,37,37,0,1,2
"19886","89943f5d46ec9033984cdf580b9b8ee5",17,17,0,17,17,0,1,2
"19887","8995fad899e52a76266842cd254c6567",46,40,23,14,46,0,2,1
"19888","8996194db95f673e7f94882c8a6b9465",130,102,48,18.9583333333333,130,0,3,3
"19889","899661d515577592faf0e07794e1ed06",99,70,62,11.1774193548387,99,0,2,3
"19890","8996b11a22cf9c49080b61ed213ae44b",2,2,0,2,2,0,1,2
"19891","899753b34bd3b85078c0803899017a6d",38,38,0,38,0,38,1,2
"19892","899795a68f19f38259d2b75bc2ae5991",69,57,34,14.2058823529412,52,17,2,1
"19893","8997f5aeb6a045610aead5118154f3de",97,43,83,8.18072289156627,73,24,2,1
"19894","899b645c0bd02924259e8447c5f3544d",34,34,0,34,34,0,1,2
"19895","899bdcb157866f6aa594598357279c17",45,33,63,5,45,0,2,1
"19896","89a22d15cc93d94c0e385d0d1b59d1dc",216,137,67,22.5671641791045,216,0,3,3
"19897","89a384785b693ad95ee7aa041598b950",19,15,67,1.98507462686567,19,0,2,1
"19898","89a4a3dc863a19843b5ee394a7e329d3",32,32,0,32,0,32,1,2
"19899","89a5046cc1cb741e04bf1a92b968553f",140,89,62,15.8064516129032,140,0,3,3
"19900","89a52be04c7334d777158de3f84f7acb",22,22,0,22,22,0,1,2
"19901","89a67827e9f71f0c59ba46d0d58b7297",98,73,71,9.66197183098592,98,0,2,3
"19902","89a707325ec93ee232a72308d6915f1e",241,76,43,39.2325581395349,205,36,3,3
"19903","89aaa2952d3e4714b27eed5cdfec72a9",44,44,0,44,44,0,1,2
"19904","89ab928b04dcf0914fc00a93ec46e061",129,98,76,11.8815789473684,129,0,3,3
"19905","89ac85aae59a7737d31266d9071255cf",17,17,0,17,17,0,1,2
"19906","89ad2cb718d854cd112aef1efe550921",94,80,56,11.75,94,0,3,3
"19907","89ad3105b7ea11736e3e57cf2e46c8c8",22,22,0,22,0,22,1,2
"19908","89ad6b56829ac83f2852cbecf561fcf9",24,24,0,24,24,0,1,2
"19909","89ae4e5bd248a9134f7607dc36a2537c",25,25,0,25,25,0,1,2
"19910","89b8332237e0d0aefb0b88f90d2ad521",68,42,41,11.609756097561,68,0,2,3
"19911","89b8c0e40a8add069408041ccc5612cd",15,15,0,15,15,0,1,2
"19912","89bc709d0204b16171bab715609742d9",66,51,44,10.5,35,31,2,1
"19913","89c0ff39e7f0f5859d1a779a1b28aaea",114,60,77,10.3636363636364,114,0,3,3
"19914","89c37cdc81a8565ddf3be89c9adc302e",51,51,0,51,0,51,1,2
"19915","89c65c154e90355a9f3d2626500c3d4a",134,88,63,14.8888888888889,134,0,3,3
"19916","89c928449fdd97e41aaa3464d0e4a95b",44,36,37,8.32432432432432,44,0,2,1
"19917","89c944add49ae7e02f56e56c612b9e58",6,6,0,6,6,0,1,2
"19918","89d07f0a783923967e886bb935485bf3",35,35,0,35,35,0,1,2
"19919","89d5098e026e423fb3aae773cf41450c",199,63,84,16.5833333333333,199,0,3,3
"19920","89d5c134abc836b57caa5652127a51af",139,99,70,13.9,139,0,3,3
"19921","89d6c1d50fd41281776e535d0a3278c0",62,49,48,9.04166666666667,62,0,2,3
"19922","89d9379b11631cfdc8c4996197a002f7",53,53,0,53,53,0,1,2
"19923","89d9603ba5281b96db0b543504afebd6",16,16,0,16,16,0,1,2
"19924","89dca34c1a15f49b7cbf426dee89ec88",28,28,0,28,0,28,1,2
"19925","89dd51565f238deb381eb8da87f09541",112,84,28,28,112,0,3,3
"19926","89dd68b042cf43f2cebcc2504b37c34f",145,114,60,16.9166666666667,145,0,3,3
"19927","89dd7efc8b90b2e7b0f3da614e2c0c95",15,15,0,15,15,0,1,2
"19928","89df531bd23a32d4cfd7a68f26680d3e",116,87,57,14.2456140350877,62,54,3,3
"19929","89e2bc6bbeb252cfbbe4808164eab29e",16,16,0,16,16,0,1,2
"19930","89e72c81fe2c2dc2582b7ca2043849fd",131,60,38,24.1315789473684,131,0,3,3
"19931","89e8c4fddd5da961c2cb407e68de46ec",1,1,0,1,0,1,1,2
"19932","89ebc0f833a85e63482eb1c5bf5e9e13",26,22,38,4.78947368421053,14,12,2,1
"19933","89ec6ff202811a89f7edcbb254bab91c",34,34,0,34,34,0,1,2
"19934","89ec78023a8aa07e07ddb79dc9bdc1e0",16,16,0,16,16,0,1,2
"19935","89edfed33f6fdf13e1341a220ef1ab87",15,15,0,15,0,15,1,2
"19936","89eea387934c8b07a23e3b63f65d2da1",139,92,36,27.0277777777778,139,0,3,3
"19937","89ef2495fa174d2042a6f3fb4511c631",26,26,0,26,26,0,1,2
"19938","89f14e1958440d9c82359936f2f31b10",35,35,0,35,0,35,1,2
"19939","89f23010fcb6091303fd1ba9e2c09528",125,87,65,13.4615384615385,125,0,3,3
"19940","89f2f6fc7c587d2330aeae72f3e86768",95,83,50,13.3,95,0,3,3
"19941","89f33da86e2d18127ab434752e05cf47",34,34,0,34,34,0,1,2
"19942","89f3cc31ecdc6b8dd4fe649d938e58e6",99,35,70,9.9,99,0,2,3
"19943","89f55db86b26f9842128913d6ec71edc",26,26,0,26,26,0,1,2
"19944","89f5776f6e3668e1bc50609b8eca80de",21,21,0,21,21,0,1,2
"19945","89f6ca8d4464d5765c079c448d7c3491",30,30,0,30,30,0,1,2
"19946","89f81d748e58058202b674e82f80e2c0",41,41,0,41,41,0,1,2
"19947","89f83c35cc979fc211142495f5ddf6d2",75,61,59,8.89830508474576,75,0,2,3
"19948","89f8b70dd9e04ec21618cc05c9c8e6ef",12,8,49,1.71428571428571,12,0,2,1
"19949","89f960aa450e6e5b71397a92631aee33",89,73,70,8.9,89,0,2,3
"19950","89f9a5abb00a4415eb6f7669ddf85398",16,12,28,4,16,0,2,1
"19951","89fc3f024196d8bd260d5f783af691d2",52,49,65,5.6,52,0,2,1
"19952","8a0aa00ca8e6f19ff255e29abbf36f44",71,58,66,7.53030303030303,71,0,2,3
"19953","8a0e2b4c60697f8d7632ba9e78dacb51",164,76,88,13.0454545454545,126,38,3,3
"19954","8a0ed51fe43d189ed6ce629ea6e93e86",131,61,63,14.5555555555556,131,0,3,3
"19955","8a10263cc67190006e473249b64e62ee",27,27,0,27,27,0,1,2
"19956","8a1182bdd6e532236a5bddb9a232dc76",37,28,46,5.6304347826087,22,15,2,1
"19957","8a11ebab3582c814001b978a80fc3a3a",39,31,11,24.8181818181818,39,0,1,2
"19958","8a1424d52ccf2017cb46d23fc20f00fc",17,13,69,1.72463768115942,17,0,2,1
"19959","8a15c6dcad56613317dee1a471dc882c",75,58,33,15.9090909090909,36,39,2,1
"19960","8a19b29db8c7e32e8824adbba5673c67",87,53,38,16.0263157894737,60,27,2,1
"19961","8a1a82103276c159e4e06cb31f1f2911",6,6,0,6,6,0,1,2
"19962","8a1ac9bac4189dabb823d299c24fd05d",48,35,65,5.16923076923077,48,0,2,1
"19963","8a1f9785b162395b545e5d9313e03e08",43,33,69,4.36231884057971,43,0,2,1
"19964","8a20a736fd9b176acc54c91961f43654",33,33,0,33,33,0,1,2
"19965","8a2171170debcc76f6955b6b263e6de1",60,45,38,11.0526315789474,26,34,2,1
"19966","8a22243c26603e5ee3644125c4de2208",17,13,57,2.08771929824561,17,0,2,1
"19967","8a246112d7a56b9572a0f8ec1aa40668",67,45,72,6.51388888888889,67,0,2,1
"19968","8a25f46a90e21f79ed7d8d61020de6ae",47,47,0,47,47,0,1,2
"19969","8a2795ea5b50703a18ec1126466320f1",134,90,42,22.3333333333333,134,0,3,3
"19970","8a29e5e7f1bbd1978a9d670d33109813",150,111,66,15.9090909090909,150,0,3,3
"19971","8a2a2b3e71d2da122e7a9f476357226e",31,30,42,5.16666666666667,31,0,2,1
"19972","8a2a5284fcd7f5b78252dddcb092045f",24,24,0,24,0,24,1,2
"19973","8a2aed2bbb03d663072b3b09d95f1747",22,22,0,22,22,0,1,2
"19974","8a2b483ad1f44f3b790d70483a5dc155",145,87,47,21.5957446808511,109,36,3,3
"19975","8a2bc048d84bff686aecf5913850f2c3",45,40,15,21,45,0,1,1
"19976","8a2ce38db11cb3a125c7e36d3864148e",27,27,0,27,27,0,1,2
"19977","8a2dd8b7bcc895660d5e0cb72d1af41b",34,34,0,34,34,0,1,2
"19978","8a30838d6aced1d38a10de252f72527f",42,32,38,7.73684210526316,42,0,2,1
"19979","8a32618d6105fc98d3d62d4dcefc44c1",32,30,35,6.4,32,0,2,1
"19980","8a32d2f33265a9699613afc9e6870795",63,60,26,16.9615384615385,63,0,2,1
"19981","8a35a047a5bd5576c082288d1f7d1300",60,48,37,11.3513513513514,60,0,2,1
"19982","8a3cd8a6baa3af66b6ae10dbfdcc8834",43,33,50,6.02,43,0,2,1
"19983","8a3eac725f608cbb8b5b92793651221b",14,14,0,14,14,0,1,2
"19984","8a409e803c52eacdcab2979a2d714b91",114,60,78,10.2307692307692,114,0,3,3
"19985","8a41e3159cfcbfe79802803b500fdb5e",116,88,34,23.8823529411765,116,0,3,3
"19986","8a42691f1db3b4d8632f8da8969b9521",105,77,88,8.35227272727273,105,0,3,3
"19987","8a429f3f359f1bde9b6f09a5aab7d786",203,96,68,20.8970588235294,203,0,3,3
"19988","8a43fa84afef3eaaf36bf9ca42398a29",69,57,63,7.66666666666667,69,0,2,3
"19989","8a47707cd2068372d96bce31462e66a6",12,12,0,12,12,0,1,2
"19990","8a498c5bd9dfd9f29b41cfe1f075bfad",75,61,42,12.5,75,0,2,3
"19991","8a4d7e6a1c623a0e42a5139e3c7e70d6",59,45,29,14.2413793103448,59,0,2,1
"19992","8a4dcbcd844f4d23df3820225d492959",25,25,0,25,25,0,1,2
"19993","8a4de50bb73ac5cd9d3c72271af581df",21,21,0,21,21,0,1,2
"19994","8a511ab3aa7108750cc1fe6475fee610",28,28,0,28,28,0,1,2
"19995","8a515fa4946c6539b75133e044fd28a6",31,27,68,3.19117647058824,31,0,2,1
"19996","8a5318a794bfdae7891a1aba9f1a31d9",24,24,0,24,24,0,1,2
"19997","8a5477323e2e532b66ffffafef18224b",67,63,30,15.6333333333333,67,0,2,1
"19998","8a570b8d0c4bce0736c3d877190e4672",64,55,24,18.6666666666667,64,0,2,1
"19999","8a57ff1aa1f0db7188308e10e4c49883",36,23,50,5.04,36,0,2,1
"20000","8a5848609fa6b69179305499ee6dc3ea",27,27,0,27,0,27,1,2
"20001","8a58f668683b2e6a9d67679ab9ed93ef",188,89,59,22.3050847457627,188,0,3,3
"20002","8a59575bd7bb0ccc90d28d501db79213",70,53,18,27.2222222222222,70,0,1,2
"20003","8a5a8dc98da62c98e6f0a9481d9da9b8",65,37,56,8.125,40,25,2,1
"20004","8a5ad6aca6b28cd793bbd4f07b28989e",152,117,49,21.7142857142857,152,0,3,3
"20005","8a5eb189eb3e64f4090b1982cd957547",94,72,28,23.5,94,0,2,3
"20006","8a5f663bdcffa536c2a6f86479efef5d",204,123,72,19.8333333333333,204,0,3,3
"20007","8a6200022be7d032e1a724c5223a2df3",47,33,35,9.4,47,0,2,1
"20008","8a62037612d4ae519a59e0e62376dc06",137,83,82,11.6951219512195,95,42,3,3
"20009","8a6325c3261aec51035de2632e5edfc1",53,53,0,53,53,0,1,2
"20010","8a660beab6017d5d11f98f8da439c6d4",173,97,49,24.7142857142857,138,35,3,3
"20011","8a686b5bf4e6d097033af9b36a54e780",17,17,0,17,17,0,1,2
"20012","8a68a66e6f4ff3bd4cd1c4c18333f499",22,22,0,22,22,0,1,2
"20013","8a68e9477c9bd3499c44b182435ee539",97,60,60,11.3166666666667,97,0,2,3
"20014","8a6a3ec521949f779a97a5d47ebf0d18",33,33,0,33,33,0,1,2
"20015","8a6ab5399b665cd1ccb0a8c826d07fae",60,49,21,20,60,0,1,1
"20016","8a6ab74a1b27be07e8ee2b9be2aadfb9",131,82,76,12.0657894736842,131,0,3,3
"20017","8a6ba9d41590a21a2b527224af897ad9",37,32,20,12.95,37,0,1,1
"20018","8a6bc30dab98d63cb23bf38c849ab775",123,63,73,11.7945205479452,110,13,3,1
"20019","8a6c589c46bf8314fd1f883527e82206",32,32,0,32,0,32,1,2
"20020","8a6f6498505b8b3d67e6c9af82c7c719",73,61,63,8.11111111111111,73,0,2,3
"20021","8a6f96da47b0a32fb1f178b8a199671a",86,54,77,7.81818181818182,42,44,2,1
"20022","8a7005084d2ddeececd48e8a6e597266",108,75,72,10.5,108,0,3,3
"20023","8a72690912098b3297b8f6a0eac38383",40,33,13,21.5384615384615,40,0,1,1
"20024","8a73bd0cd559b7e4e78548ed493a4a7c",29,29,0,29,29,0,1,2
"20025","8a75e851a44ef9ca7214a0127331a729",60,41,55,7.63636363636364,60,0,2,1
"20026","8a76a659c9f8e248b28fcb79872b65c6",150,100,70,15,150,0,3,3
"20027","8a76c4b0986a45f17d47dc5a7b9eb4f3",39,39,0,39,0,39,1,2
"20028","8a77a12db66d7ca635a857e4d4543a92",184,103,68,18.9411764705882,184,0,3,3
"20029","8a790bff83acb9ca69f264b4bd82d7cc",70,50,37,13.2432432432432,70,0,2,1
"20030","8a7a3e5c43ab2f881d271ef09ad9229d",33,31,16,14.4375,33,0,1,1
"20031","8a7b78728443e383a150d5c2f7cdfd32",48,48,0,48,48,0,1,2
"20032","8a7d9728fbe1d22404da7c8ae7071160",163,72,55,20.7454545454545,163,0,3,3
"20033","8a7e4dc8c155cc0276fd62ab5687c0fb",80,57,62,9.03225806451613,55,25,2,1
"20034","8a80ce61b47f54ddae106e8a2dd0b085",106,77,62,11.9677419354839,64,42,3,3
"20035","8a826fece3e3fb6be8ff085779c05c17",164,111,73,15.7260273972603,120,44,3,3
"20036","8a86c31551a854f7663b210ad33ede51",20,20,0,20,20,0,1,2
"20037","8a87a1436d1e2f6309fba833aa530825",20,20,0,20,20,0,1,2
"20038","8a89279c45c5d0245affea4a455ce65a",13,13,0,13,13,0,1,2
"20039","8a89adc577abfc2924dfbc01e5620bb3",38,34,56,4.75,38,0,2,1
"20040","8a89dbe1749563b13b5810b8f9998f63",55,55,0,55,0,55,1,2
"20041","8a8c5dfece3b8c7769209473be7a54a7",75,48,62,8.46774193548387,52,23,2,1
"20042","8a8dd8315eb783bd4b4bb4b115886c25",20,20,0,20,20,0,1,2
"20043","8a8e3f3d538fabbb5824fec6dab0f6b6",22,22,0,22,22,0,1,2
"20044","8a9113388f62ea632315527212d9b238",107,76,62,12.0806451612903,107,0,3,3
"20045","8a9177a6b978e710bab12acf8c47240f",127,87,83,10.710843373494,86,41,3,3
"20046","8a9684c2702ec1fdc4ba0082e38fe190",43,32,58,5.18965517241379,43,0,2,1
"20047","8a991f4767589e9a72553eec5c6983d0",182,70,71,17.943661971831,182,0,3,3
"20048","8a993f7642220c626692bf3a4c89904a",42,33,48,6.125,42,0,2,1
"20049","8a9c2da62f25563ee4be09b4cc3c718a",33,29,7,33,33,0,1,2
"20050","8aa12f7b4b01fd27c83e7151ce734770",95,57,61,10.9016393442623,95,0,2,3
"20051","8aa3ec0d78279c7026e938b072fbba2c",83,59,70,8.3,83,0,2,3
"20052","8aa51dd128380b79ae1d67ab6c39c2ba",14,14,0,14,14,0,1,2
"20053","8aa7158bd2e09631c9eb8bc8807272dd",72,61,18,28,72,0,1,2
"20054","8aa7c69d0d4e4294aa21d59f14036169",82,68,66,8.6969696969697,82,0,2,3
"20055","8aaa7d9db722f79764a61cd93b5d8766",39,39,0,39,39,0,1,2
"20056","8aaaef92b857b2551e1a5ac71206e838",47,33,40,8.225,47,0,2,1
"20057","8aacde05cd8ccc6c4a4c75c8a33dd39f",33,33,0,33,0,33,1,2
"20058","8aad4b6c26f65eec4a1d03a7faf26f27",29,28,33,6.15151515151515,29,0,2,1
"20059","8aaf2db93a7a769e990d9f31e5f96ded",32,32,0,32,32,0,1,2
"20060","8aaf4efbd4b2be0bca1dbb2ee6e028d8",169,99,75,15.7733333333333,169,0,3,3
"20061","8ab0803b37957962deeec4f663a59be7",34,32,63,3.77777777777778,34,0,2,1
"20062","8ab23e181cb7a5a69036d7eda2753cd7",86,56,28,21.5,63,23,2,1
"20063","8ab24c6585cd8838353327b1e6378a43",71,43,57,8.71929824561404,37,34,2,1
"20064","8ab29ee6d118847dc860a0fb2f94bb92",68,58,75,6.34666666666667,43,25,2,1
"20065","8ab31fb0a9c1189b567aee225b654111",35,35,0,35,35,0,1,2
"20066","8ab5998b680637bf1a3d1a903c715298",1,1,0,1,1,0,1,2
"20067","8ab59ad8298029633260f1677c51f9ad",49,49,0,49,0,49,1,2
"20068","8ab6be4007974db9e8fd481726685519",20,18,45,3.11111111111111,20,0,2,1
"20069","8ab72db88ccc187d9f148e0c6be9929b",91,30,55,11.5818181818182,79,12,2,1
"20070","8ab78636f084df368e64b4697a5214da",33,33,0,33,33,0,1,2
"20071","8abad0ad26cfd86c90a7bca88c2b05be",42,42,0,42,42,0,1,2
"20072","8abb470b1933e75e33f63c99e0432a9c",31,31,0,31,31,0,1,2
"20073","8abd8608976105a6044feb0fd5feea82",35,35,0,35,35,0,1,2
"20074","8ac0968fac0f8eef798e9f5335ee0389",30,26,40,5.25,30,0,2,1
"20075","8ac145ebb582d0d69a47c5dc34e23947",21,21,34,4.32352941176471,21,0,2,1
"20076","8ac32b7c832cb0580a078aefb1ebefdd",32,32,0,32,32,0,1,2
"20077","8ac45582401f0137f2d5a8d2d69275bc",89,51,56,11.125,89,0,2,3
"20078","8ac8567476061c9b8a9fd8c458f54855",74,44,61,8.49180327868853,74,0,2,3
"20079","8ac8d6ac08030cd97af07435dabbf063",40,40,0,40,40,0,1,2
"20080","8ac8e3332d10eb7909d6ac2d8a0d0567",32,32,0,32,0,32,1,2
"20081","8ac9f4c910f3b5da8f9c435a2e701983",190,80,62,21.4516129032258,190,0,3,3
"20082","8acbb4859b4553e823bb772545dde9d3",95,67,60,11.0833333333333,95,0,2,3
"20083","8acd6d79a80ff5cc7bbc99156abda8f9",58,51,36,11.2777777777778,27,31,2,1
"20084","8ad013f2e77d288b85b04eaf00a9b4cb",49,41,48,7.14583333333333,49,0,2,1
"20085","8ad1a705441e93b5cd0ef5183228f996",68,40,81,5.87654320987654,68,0,2,1
"20086","8ad5e03f3faca0b9a67ce9f7ca4d240f",61,46,75,5.69333333333333,43,18,2,1
"20087","8ada60dfbe3856f518d000b6079b025f",103,75,38,18.9736842105263,103,0,3,3
"20088","8adc4b889c0ea6ff79c64e0adadc2c7b",79,69,28,19.75,79,0,2,3
"20089","8addb69536cc01e5b5f7d0ed75d9d3b2",75,65,42,12.5,75,0,2,3
"20090","8adfc2d95a80db4a52149989cdf5b5f9",27,27,0,27,0,27,1,2
"20091","8ae321430265f6db0fd6596044dded81",23,23,0,23,23,0,1,2
"20092","8ae72bee8531631453503e7bdc2fdca7",15,15,0,15,15,0,1,2
"20093","8aede738464615cc86f39eb1ab56b5f6",90,64,34,18.5294117647059,61,29,2,1
"20094","8aee835d281e217ef7d943f5def77bd9",52,44,34,10.7058823529412,52,0,2,1
"20095","8aefc75201eaf4ad162c72541d06f4f5",59,47,25,16.52,59,0,2,1
"20096","8aeff9d33c982741275f1a9cffa419d9",109,64,70,10.9,109,0,3,3
"20097","8af10495705bacbd3db4d09b295f5374",222,156,65,23.9076923076923,169,53,3,3
"20098","8af1561f1fa1988a9510b5b08636490d",105,46,86,8.54651162790698,65,40,2,3
"20099","8af179c7183d6dc2f454c630aa2d481a",10,10,0,10,10,0,1,2
"20100","8af359c0930ae9b5623532551470803f",19,8,48,2.77083333333333,19,0,2,1
"20101","8af44fd96fa01931f3ac61af8c2d31ec",26,26,0,26,26,0,1,2
"20102","8af5303d5c89593e2c8b5ccb75f82c0b",49,43,20,17.15,49,0,1,1
"20103","8af6705bd0c0ae25d13ccdaedf432e67",37,37,0,37,37,0,1,2
"20104","8af98abff55a8f9b6b4ebb3eedbe0f6e",2,2,0,2,2,0,1,2
"20105","8af9ecd1f63787f3ebb1033c60fb644e",60,49,41,10.2439024390244,60,0,2,1
"20106","8afce46a4d5d1a80a1bc07f83040eded",128,70,70,12.8,128,0,3,3
"20107","8b0310ef17eaca02887415d0b549fa95",36,32,8,31.5,36,0,1,2
"20108","8b03f1dacb662f1ef20880e81b4e48d6",32,32,0,32,32,0,1,2
"20109","8b04837dfc31a7f0fff5d8bee19beba3",124,90,89,9.75280898876404,100,24,3,3
"20110","8b0b11afb98ad1afbf7346679e094214",211,95,69,21.4057971014493,211,0,3,3
"20111","8b0c34000f05daa505b7c26c5e0e93f4",63,44,62,7.11290322580645,63,0,2,1
"20112","8b0d34db944166d112b502e09ccbdf32",82,55,63,9.11111111111111,82,0,2,3
"20113","8b0e30879f327d996c56d257200d3f87",47,47,0,47,47,0,1,2
"20114","8b0e8120b9ca737218987b19aca904d4",52,40,31,11.741935483871,52,0,2,1
"20115","8b0ec16008769a81fa3fbc85d7dbc6c2",23,23,0,23,0,23,1,2
"20116","8b0f2d9c2bc64e34598ba0d0b9bb4cc4",25,25,0,25,25,0,1,2
"20117","8b10a6e6bd387ea76119fe01b3239187",45,45,0,45,45,0,1,2
"20118","8b1181707b5bfde88c47dfbc11af3e05",20,20,0,20,20,0,1,2
"20119","8b11831c48294ba0ae9701feb86d8a89",101,65,55,12.8545454545455,101,0,2,3
"20120","8b11a68113ddbf92addc08b0429d7598",155,78,83,13.0722891566265,155,0,3,3
"20121","8b11d45e3d319505169082b376c6de27",152,79,74,14.3783783783784,130,22,3,3
"20122","8b123fef4e2ce6668f7bcec8004ea288",35,35,0,35,35,0,1,2
"20123","8b1580e31cf4d8c12574307e05253002",189,81,85,15.5647058823529,157,32,3,3
"20124","8b163d5d4ea520a1dc5c072021b1386d",33,33,0,33,33,0,1,2
"20125","8b16bb2d1b4b1d06ad1e69a6b6b1d891",26,26,0,26,26,0,1,2
"20126","8b176489c3b51dc680ad5cb782b3b531",4,4,0,4,4,0,1,2
"20127","8b17a9563c21b33eecad320715c3dd44",163,105,46,24.804347826087,114,49,3,3
"20128","8b1a5a9592f53a45fa7a12e4a20e2ad3",75,49,58,9.05172413793103,58,17,2,1
"20129","8b1b0ecdaa43ba814da65a71a0458eae",24,23,7,24,24,0,1,2
"20130","8b1b218c9678b4f8d17ce3cf494db5ab",81,43,55,10.3090909090909,81,0,2,3
"20131","8b1b5256755f18b9df333bf5421f66e3",45,37,68,4.63235294117647,27,18,2,1
"20132","8b1b96dd8574b40c4fb5faa48c2bc4f9",38,38,0,38,38,0,1,2
"20133","8b1cca6fb952dd45fe0dfff74e698bda",25,25,0,25,25,0,1,2
"20134","8b1d12c17dcca084f768edf580c500a0",81,56,49,11.5714285714286,28,53,2,1
"20135","8b2080a2ff28430635670aeeff28cb73",50,36,33,10.6060606060606,50,0,2,1
"20136","8b21270f4cb808bfb266ee467be939a9",212,151,70,21.2,170,42,3,3
"20137","8b21a569e3ac87c5bd8eff395074425a",122,63,63,13.5555555555556,122,0,3,3
"20138","8b257e6a74ef3cbd35e7872cb3fe1152",42,42,0,42,42,0,1,2
"20139","8b283b31ef8f3fe46581f62970ccca16",63,52,48,9.1875,63,0,2,3
"20140","8b2b58a62e089ace928efcf45f17a99c",47,41,32,10.28125,47,0,2,1
"20141","8b2fb334985c39a450eeb46e5a1d8d8c",134,83,59,15.8983050847458,106,28,3,1
"20142","8b30c6295a90793bd9e19ebefc22a6bf",31,29,26,8.34615384615385,31,0,2,1
"20143","8b319e7405dc1dc4cc6be6ceb91e9c99",121,72,42,20.1666666666667,95,26,3,3
"20144","8b33c10bdcd82aea189e99e0c1e8122d",112,61,84,9.33333333333333,112,0,3,3
"20145","8b3adb8975c0f0a15050d6ccb67dabfc",27,27,0,27,27,0,1,2
"20146","8b3eb14f3cff489978966047b30ef38f",79,53,34,16.2647058823529,79,0,2,1
"20147","8b3f20a000cc0fd8dee38cd79b517814",46,46,0,46,0,46,1,2
"20148","8b3fbbeeb8db87dfb12e48c0631b5540",19,19,0,19,19,0,1,2
"20149","8b40f5ab805b5cf127616ec2554350a0",195,114,90,15.1666666666667,195,0,3,3
"20150","8b411c5ac61025d57f906ab01408917d",10,10,0,10,10,0,1,2
"20151","8b430e693de7ecfbd773350df17e34ae",6,6,0,6,0,6,1,2
"20152","8b43a95749441c7cf2d863302073fa06",44,44,0,44,44,0,1,2
"20153","8b46e96ece87247f278714f19bddacc5",68,40,71,6.70422535211268,68,0,2,1
"20154","8b475a40b92b910e5a876af7ea43ec73",182,74,83,15.3493975903614,182,0,3,3
"20155","8b48dddad430509313d9878a59f633c7",90,43,69,9.1304347826087,90,0,2,3
"20156","8b4c879548ecb83fa87aa65b32719d61",241,80,82,20.5731707317073,193,48,3,3
"20157","8b4da0f36034dad141b2897ca74b289b",94,65,22,29.9090909090909,79,15,2,3
"20158","8b4f9aaf1f97263bf9a02f1c77c6db3d",12,12,0,12,12,0,1,2
"20159","8b4fb057c0b07975c959b401f037ad2b",76,57,70,7.6,76,0,2,3
"20160","8b5322d979c6fc0adaee4cf59fe61ae9",28,27,32,6.125,11,17,2,1
"20161","8b554aa72cc95dca5ae42324fd90cea5",20,20,0,20,20,0,1,2
"20162","8b557bd45d6efd3bd2f2e75047f37cf0",19,19,0,19,19,0,1,2
"20163","8b56e94154bf4d24331cfb44def5a50a",63,37,65,6.78461538461538,63,0,2,1
"20164","8b56f204544bb8fa4c44df0636bd48a4",188,82,65,20.2461538461538,188,0,3,3
"20165","8b570d6b1afad6e8a584d8d47be28493",24,24,0,24,24,0,1,2
"20166","8b604ce8c87c7649be892e2e7bc77219",40,40,0,40,40,0,1,2
"20167","8b65ff88d8afc74a0e8e138904ee4f14",13,13,0,13,13,0,1,2
"20168","8b66712fc897be4b502e1479a3baab86",25,25,0,25,0,25,1,2
"20169","8b6aadf6edceaf67377af2a88d5627ce",75,59,15,35,75,0,1,2
"20170","8b6d6c22b916765c3e1249144c7c2410",105,43,84,8.75,105,0,2,3
"20171","8b74857be7f4eb9968e686795b0b4e09",94,65,71,9.26760563380282,71,23,2,1
"20172","8b74ddd75eb9f52eed42ca9963678028",17,17,0,17,17,0,1,2
"20173","8b75965e3aca065c5bb9867726723789",132,77,66,14,132,0,3,3
"20174","8b7a2c62476f3fec36fdea27c19df97c",196,87,70,19.6,171,25,3,3
"20175","8b7bbc8165cc401a04b979454cebf23a",30,30,0,30,30,0,1,2
"20176","8b7c0edafa0d08f9ae4a8c7dc4ff6f36",153,100,54,19.8333333333333,153,0,3,3
"20177","8b7ca6de3877a60a6b8a7eccc82c9511",33,33,0,33,33,0,1,2
"20178","8b7ff06328bbf4c2451d6ff556c3bac4",39,34,37,7.37837837837838,39,0,2,1
"20179","8b810c07707e960ec857efa7975a1a96",25,25,0,25,25,0,1,2
"20180","8b8323bd04f9f79c8218c53737834500",18,18,0,18,18,0,1,2
"20181","8b83441ae26dd2d7446d1beac6a72b54",27,27,0,27,0,27,1,2
"20182","8b8a0a2c2cd22ffb4e62743860603b63",11,11,0,11,11,0,1,2
"20183","8b8c907a4872e12146d4dfaef066417f",85,75,61,9.75409836065574,85,0,2,3
"20184","8b8d15482c03f0785cbcbe494b595cf3",13,12,11,8.27272727272727,13,0,1,1
"20185","8b916d9a51b8448328006334bff2b0cc",53,53,0,53,0,53,1,2
"20186","8b945e3b7a37d24000f1a077ca387ed5",4,4,0,4,4,0,1,2
"20187","8b99a7dcb152c5caddd0e6552b760956",34,33,68,3.5,34,0,2,1
"20188","8b9aa623b654a8be21b316a5fdf41007",50,34,15,23.3333333333333,50,0,1,1
"20189","8b9e711a4610c1a9fcf658eec4c35b03",179,91,62,20.2096774193548,179,0,3,3
"20190","8ba1f24a93db1f85702430f2f47c9be7",45,45,0,45,45,0,1,2
"20191","8baa0866803da774b19c6d67591551fe",195,101,60,22.75,195,0,3,3
"20192","8babcfe1057b8ebc1a2a159c6c36a79c",157,77,70,15.7,157,0,3,3
"20193","8babee66504933facb700327bb5d3236",46,45,7,46,46,0,1,2
"20194","8bac2f9dd2bba172598260b7cf44b52f",106,70,58,12.7931034482759,106,0,3,3
"20195","8bacf30c300726fe821e6104ac3fca64",75,57,28,18.75,75,0,2,1
"20196","8bad65e81ee9bbe1aad6e667a1c1e93c",96,75,72,9.33333333333333,61,35,2,3
"20197","8bae08292eb8734b8be8c8a0d37db86a",76,58,53,10.0377358490566,73,3,2,3
"20198","8baf538a4e3cd8d62a07c9dd19c20965",28,28,0,28,28,0,1,2
"20199","8baf929ed48b6ae9e8155b26c2daa0a0",30,30,0,30,30,0,1,2
"20200","8bb0afd000b057356eeb410ea5b3b812",141,69,76,12.9868421052632,141,0,3,3
"20201","8bb4bf2b9ea7db9448b4624a100bfa1a",31,31,0,31,0,31,1,2
"20202","8bb7a874494150cee4bcede97c3ac1c4",35,35,0,35,35,0,1,2
"20203","8bc443cb9e7b2574e8a521be161cdfd6",50,41,13,26.9230769230769,50,0,1,1
"20204","8bc479451f842de17650529e4c3d6057",129,72,63,14.3333333333333,129,0,3,3
"20205","8bc5984cdbd47b1f81af5f7a41f08394",4,4,9,3.11111111111111,4,0,1,1
"20206","8bc73981496c88b7ff44135b2d3f9b53",24,24,0,24,24,0,1,2
"20207","8bc86bbc6d3652facc125edb223a03e3",64,41,38,11.7894736842105,32,32,2,1
"20208","8bc8a06dfacfbc226b707fc7c8b85ac8",68,54,13,36.6153846153846,68,0,1,2
"20209","8bcd314b842d849c782cd52bf5c1aba3",53,53,0,53,53,0,1,2
"20210","8bd19f3c56cb987355a5f5de5c801974",42,42,0,42,42,0,1,2
"20211","8bd2599f760530901a7275df59d63d11",19,19,0,19,19,0,1,2
"20212","8bd65089657b2e9cef2ea694347d24f3",4,4,0,4,4,0,1,2
"20213","8bd723d5a85f13b51ce123cc94989d2e",1,1,0,1,1,0,1,2
"20214","8bd80ca153e457b295b422d32334dea3",24,22,3,56,24,0,1,2
"20215","8bdb81f724323eeba5a5892a2106c5d0",91,62,71,8.97183098591549,91,0,2,3
"20216","8bdc66dc23a56e4c1d0fc8d53e57cd0a",77,45,67,8.04477611940299,77,0,2,3
"20217","8bde06167a593dac1273031796c356bb",19,19,0,19,0,19,1,2
"20218","8be10c7b1f6c85d921cb8112b8e56846",22,20,35,4.4,22,0,2,1
"20219","8be227f5cabb8b7a4bb9665395dbf506",41,37,42,6.83333333333333,41,0,2,1
"20220","8be2384067c9941edea634bc033abdeb",70,51,47,10.4255319148936,70,0,2,3
"20221","8be3e76a8e03c7edbe93120fba2ed882",80,65,56,10,80,0,2,3
"20222","8be55df383602348ddbee727d7474763",24,24,0,24,24,0,1,2
"20223","8be5bccdfe8ae8fc76c9fe3c793c6d08",17,17,0,17,17,0,1,2
"20224","8be90adededb9de3d508af2bcd81df52",30,29,5,42,2,28,1,2
"20225","8bea9f3938330780bc7596255bd9b3a0",5,4,25,1.4,5,0,2,1
"20226","8bec2e90a8cc59979a2f481537587551",167,45,82,14.2560975609756,152,15,3,3
"20227","8bec3ef2a60777b8d9836952f600ab4e",62,40,31,14,62,0,2,1
"20228","8becd710659fe7119a9f5a3c0f772d2d",210,94,74,19.8648648648649,210,0,3,3
"20229","8bef87c06e65b2192c3a26d3dcc7720b",199,104,81,17.1975308641975,199,0,3,3
"20230","8bf0fe47c45e69e5d299cd05953ff33a",65,36,57,7.98245614035088,65,0,2,1
"20231","8bf158a568f853bd58d5791895bbb5fd",85,51,28,21.25,85,0,2,3
"20232","8bf3618193518a3904a57291ea1b6a75",39,39,0,39,39,0,1,2
"20233","8bf3dfb9941fbc099a434ded45407609",16,16,0,16,16,0,1,2
"20234","8bf4564559de2a2c6062eacb2f3dde67",19,19,0,19,19,0,1,2
"20235","8bf471092d8dd4cf50555f012fd06374",26,26,0,26,26,0,1,2
"20236","8bf55c014326c36422a3ed7df4d02625",10,10,0,10,10,0,1,2
"20237","8bf64c35b5c98506ed0b9622361e5da5",60,27,77,5.45454545454545,60,0,2,1
"20238","8bf69067c1b7224653b7e068fb775442",30,30,0,30,30,0,1,2
"20239","8bf7213cb8c407bff05f0274be3e4a2d",83,66,40,14.525,83,0,2,3
"20240","8bf9f3d4510ce056cd0c7e670621e1e6",15,15,0,15,15,0,1,2
"20241","8bfd91103a17a0ebb9447e98fd62d501",36,36,0,36,36,0,1,2
"20242","8bfe44a09cb671b0d01782d326dd2870",27,27,0,27,27,0,1,2
"20243","8bff3e665c6a478fc1a05c28ac2e9ee6",100,55,81,8.64197530864198,79,21,2,1
"20244","8bff6ff6968d06e46a03879359d70633",132,80,68,13.5882352941176,132,0,3,3
"20245","8bfff49a03a27f53c2545767e6442d68",8,8,0,8,8,0,1,2
"20246","8c00eb72ff08cc1a8846282cb6328a1b",21,21,0,21,21,0,1,2
"20247","8c020552578bc7f80d478952eac1c231",31,31,0,31,31,0,1,2
"20248","8c0249eed52dd372fb746102c89008a3",110,82,34,22.6470588235294,110,0,3,3
"20249","8c03ee9ef5251da4a19205d4eea8f6d0",19,19,0,19,19,0,1,2
"20250","8c058a3aa2a161fa18b29ee9c978dfbf",83,69,55,10.5636363636364,44,39,2,1
"20251","8c05a453804a13ce263dd00b1d37a14e",151,93,56,18.875,151,0,3,3
"20252","8c0a66e492f9ea326155569186798235",221,93,78,19.8333333333333,188,33,3,3
"20253","8c0b407fabb640124640af0c2bf0ced4",40,40,0,40,40,0,1,2
"20254","8c0b6d0c63094dc6da1e3e59d8e2a76c",155,104,89,12.1910112359551,114,41,3,3
"20255","8c0b958350fe5aeef46f12039fd0a4b1",25,23,70,2.5,25,0,2,1
"20256","8c0bc529d9d67c7db9b1e60275fd5871",22,22,0,22,22,0,1,2
"20257","8c117e5be76f09cf4d1d3d6351d5fdf9",60,39,49,8.57142857142857,60,0,2,1
"20258","8c1237e5bd5e706f31eb851e84ca7419",59,36,83,4.97590361445783,48,11,2,1
"20259","8c1536a14df170d9c01102613c629b67",230,115,67,24.0298507462687,180,50,3,3
"20260","8c175e338722c2b91180e61798c24434",154,88,78,13.8205128205128,135,19,3,3
"20261","8c185c04e0cbcd9dd1c72db43666513f",49,49,0,49,49,0,1,2
"20262","8c1c225e4fd1a3132c448d6273558560",55,55,0,55,55,0,1,2
"20263","8c1c61ae4f64d04c75b8467e6f11653c",31,31,0,31,31,0,1,2
"20264","8c1cf933145a61e254eb96f70b9ede9c",64,54,48,9.33333333333333,64,0,2,3
"20265","8c1e668b2ae50fb558238f8c50cef35d",50,50,0,50,0,50,1,2
"20266","8c2070b467872c3e41c9590e92f3b1e7",37,31,31,8.35483870967742,37,0,2,1
"20267","8c20ccb4177f1ddeb2f92c51e9e329fb",32,32,0,32,32,0,1,2
"20268","8c2108698c7c43bcc68a81fd6a9a5ef6",5,5,0,5,5,0,1,2
"20269","8c2500ca7165d5bc98941b96910fb6be",63,38,51,8.64705882352941,63,0,2,1
"20270","8c26a30a02fa3b21fffb0e5e6a1a432b",51,51,0,51,51,0,1,2
"20271","8c2844df5d62abf7cf32a02a89b934de",1,1,0,1,1,0,1,2
"20272","8c28f71ceabe5c1a4dbca842d7270eef",100,73,35,20,100,0,3,3
"20273","8c2b82bb830e6655cda2247552d9dfa1",205,87,74,19.3918918918919,179,26,3,3
"20274","8c2be926ab1876ac408d4c91ce8096b9",125,81,56,15.625,125,0,3,3
"20275","8c2c7460a883fb69c6466f005ecc59b0",60,46,84,5,60,0,2,1
"20276","8c2e979246c7a46504a719d5d4fb3877",55,44,19,20.2631578947368,22,33,1,1
"20277","8c2e9b0cf95f96971182bb5657679c9d",38,38,0,38,0,38,1,2
"20278","8c33ce3ae901e5ade3fa0c758fae8b51",21,21,0,21,21,0,1,2
"20279","8c3405949a1800f7b330c92ddc39d87d",87,48,62,9.82258064516129,87,0,2,3
"20280","8c365eeb6d96d7dc436f9b6ae7c120a4",113,82,32,24.71875,113,0,3,3
"20281","8c36c92f14cb5271551703e015a89eeb",129,39,84,10.75,106,23,3,1
"20282","8c377cae7a7987d4baabc93b3a2c3c9b",18,18,0,18,18,0,1,2
"20283","8c39d0322b6395d1eafe31ea18395143",15,15,0,15,15,0,1,2
"20284","8c39fbb35bcbf2f0d0986005038b8daa",21,20,43,3.41860465116279,21,0,2,1
"20285","8c3a90158e69849238752396506e9d0e",69,60,32,15.09375,69,0,2,1
"20286","8c3b9adef4600fd42d40096260495052",30,30,0,30,30,0,1,2
"20287","8c3c3bb9b66fc8640351fe1a93ba50e9",9,9,0,9,9,0,1,2
"20288","8c3de09f34e984e901f7e160e33c9fd0",15,15,0,15,0,15,1,2
"20289","8c4065f6dbf652180ac03b098775efbc",98,85,21,32.6666666666667,98,0,3,3
"20290","8c41fa8330d730c6e9c2ea2277e658b2",1,1,0,1,1,0,1,2
"20291","8c463bc092bab98b8f94a8720a104bd1",24,16,59,2.84745762711864,24,0,2,1
"20292","8c464ced4d2abe924b356f3650226dd8",31,31,0,31,31,0,1,2
"20293","8c476491e14bb2ee9c85a039d087e1c1",124,59,76,11.4210526315789,124,0,3,3
"20294","8c49ce5a966a9597951504a158398814",201,98,70,20.1,201,0,3,3
"20295","8c4c2ddd5999c9bba15f2c3608a1e6d3",29,29,0,29,29,0,1,2
"20296","8c4eab397087b5beb855cbaf9e5cd06d",35,29,21,11.6666666666667,35,0,1,1
"20297","8c5573cf8ade4499ebda2e51a7dc0288",19,19,0,19,0,19,1,2
"20298","8c569fab04a77e6745938242ad167cd4",16,16,0,16,0,16,1,2
"20299","8c5bb56738ba02c6a6de2cb91b1a01c3",39,39,0,39,0,39,1,2
"20300","8c5dff0981c4fdf52bfc1a6e7f1d4d29",26,20,55,3.30909090909091,26,0,2,1
"20301","8c5ef976fbafa5908581f5071414cde2",44,32,33,9.33333333333333,44,0,2,1
"20302","8c5f0e4f43d712f1da61336451365125",35,28,42,5.83333333333333,35,0,2,1
"20303","8c634d62776a621c2d33cb13c9ce38f9",48,48,0,48,48,0,1,2
"20304","8c63555d5a4311f4b86f605d062713ed",92,52,57,11.2982456140351,60,32,2,1
"20305","8c635b9d85b6cd88ef95578dfde8f626",46,27,63,5.11111111111111,0,46,2,1
"20306","8c644dd659efdfcf367539fec7ef770a",188,103,42,31.3333333333333,188,0,3,3
"20307","8c65685c77e80751a3006855db212c68",26,26,0,26,26,0,1,2
"20308","8c68acab60f036547ff785af54fede08",76,68,13,40.9230769230769,35,41,1,3
"20309","8c690ad3865bb6c3e12a609a474b8399",107,58,81,9.24691358024691,107,0,2,3
"20310","8c69dec393811c94cdbf8651fd7a5af8",25,25,0,25,25,0,1,2
"20311","8c6ab1762c4cd1e80bc05205bb42a09c",7,7,0,7,7,0,1,2
"20312","8c6c0bf1fee7829e5647e581c86c2d22",32,16,76,2.94736842105263,32,0,2,1
"20313","8c7709944644ec40ba63fe202493fe7e",142,51,77,12.9090909090909,142,0,3,3
"20314","8c78789093919e2252a0a23c9c47203c",58,42,68,5.97058823529412,29,29,2,1
"20315","8c787f03279cab41edf36bbb00c1bd86",9,9,0,9,9,0,1,2
"20316","8c7b13eadd02c32246bd44c005a2e827",61,57,17,25.1176470588235,58,3,1,1
"20317","8c829318c539fc5bdcb5f76715d436c6",69,56,39,12.3846153846154,69,0,2,3
"20318","8c857cb551c3750d9b2e7b673b192e44",94,79,18,36.5555555555556,94,0,3,3
"20319","8c86217e151c756dd41282c6d7bf401e",6,6,0,6,6,0,1,2
"20320","8c86d431db8d0ca746ef3b63c0ec951b",55,55,0,55,55,0,1,2
"20321","8c8abf60bc7eec79221b8975cd349913",46,46,0,46,0,46,1,2
"20322","8c8b1987d781551ce0280f2686abf9c1",9,9,0,9,9,0,1,2
"20323","8c8ffb6461af722045652d2718f1814a",76,65,35,15.2,76,0,2,3
"20324","8c951af2739abb0c1d84bde7c61b44b1",53,42,51,7.27450980392157,53,0,2,1
"20325","8c953da4f073ba34bcdf0b642a8c86b4",174,101,61,19.9672131147541,147,27,3,3
"20326","8c97a39251b0ddd4196c2179429d7ded",44,44,0,44,44,0,1,2
"20327","8c98095197125a492c95404098625dba",18,18,0,18,18,0,1,2
"20328","8c9836d1818bd6119c311e618b46b0d4",43,37,61,4.9344262295082,43,0,2,1
"20329","8c985ff580f928786e6b8a31dec0bca4",42,42,0,42,0,42,1,2
"20330","8c9ae9074b7371e60a5dee141afe3aa6",7,7,0,7,0,7,1,2
"20331","8c9cddcd1b01c166b68ceb7947e03ad5",2,1,21,0.666666666666667,2,0,1,1
"20332","8ca1926239b10a4bdbcfee6462bd436f",63,39,19,23.2105263157895,33,30,1,1
"20333","8ca2c3876ef1b66671d167e20a12993e",18,18,0,18,18,0,1,2
"20334","8ca4a33a0abc139c0323ae2e4b0c8397",45,44,7,45,45,0,1,2
"20335","8ca6bd19e85ef51ccc31aea0f9a7b594",23,23,0,23,0,23,1,2
"20336","8ca98e978bd29716a76501cd8acddf5c",34,34,0,34,34,0,1,2
"20337","8caa5bba6e64d2f544855f4fbb11e1e8",32,32,0,32,32,0,1,2
"20338","8cad0023e6d7ed00079d808b39ad9ba8",2,2,0,2,2,0,1,2
"20339","8cad07eb5a7613878583aede1739480b",175,76,61,20.0819672131148,175,0,3,3
"20340","8cad8b55d1d50fa8b1278a5f1b601ec9",85,63,18,33.0555555555556,85,0,1,2
"20341","8cadb4fc951141033247f08ec5c86751",98,54,26,26.3846153846154,98,0,2,3
"20342","8cafd87a7f6152292c90d986b9114d52",38,38,0,38,38,0,1,2
"20343","8cb0066cc3f07f8307ded3255d6417ff",46,38,48,6.70833333333333,46,0,2,1
"20344","8cb182cd0e80dbc779b46154173fa983",20,20,0,20,20,0,1,2
"20345","8cb5ee00f163d12b72b1ef49e0a198a5",135,73,62,15.241935483871,135,0,3,3
"20346","8cb67e142992757ffd325c3f95bc4dde",16,16,0,16,16,0,1,2
"20347","8cb7598c90254470aa42697269b89830",109,59,47,16.2340425531915,79,30,2,1
"20348","8cb8f5df423d14658d04d3cf0d28fae7",130,79,50,18.2,92,38,3,3
"20349","8cb98da1cf2b1c60abbf469ac7edf54e",45,34,39,8.07692307692308,16,29,2,1
"20350","8cbdcfa3229d7bf434a080b0426711e8",5,5,0,5,5,0,1,2
"20351","8cbe3760b0b1f8dd347286e26501ff87",23,23,0,23,0,23,1,2
"20352","8cbf3064377d9d6f28430d2e10766891",41,41,0,41,41,0,1,2
"20353","8cbf59d7c5a8ad470f231db156c5ffb4",66,52,26,17.7692307692308,66,0,2,1
"20354","8cc3d5784faf58a484a40a15922243e9",247,102,77,22.4545454545455,202,45,3,3
"20355","8cc41feea40e4ee739088705f74c1014",131,85,63,14.5555555555556,131,0,3,3
"20356","8cc5dc996491356ec1f25de75eae2b5d",67,55,63,7.44444444444444,67,0,2,3
"20357","8cc866e7db36d10beed18c6ec31c00a5",34,34,0,34,34,0,1,2
"20358","8cc9994bff3af2c0e339584bbbf40fd8",40,40,0,40,40,0,1,2
"20359","8ccbb0fa1ffb044d0d82945c94236aa3",60,44,37,11.3513513513514,51,9,2,1
"20360","8ccebc57b4ebe8897fe8ffb1d2810db0",49,43,34,10.0882352941176,49,0,2,1
"20361","8cd0a7e41dd21111489a522d95c798cb",24,24,0,24,24,0,1,2
"20362","8cd243dd17b4c058b32081874dda7e4b",66,44,76,6.07894736842105,34,32,2,1
"20363","8cd31a362344e21f37883bfcefa926f7",21,21,0,21,21,0,1,2
"20364","8cd419a34665c2ce27d7706d5988628c",89,68,57,10.9298245614035,89,0,2,3
"20365","8cd865c17c83b92c022494ba254a7d93",74,59,28,18.5,74,0,2,1
"20366","8cd939b9b9cf6efdc0cd04d66ad6cc51",39,39,0,39,0,39,1,2
"20367","8cdb694e9667072adad7168122491fbf",144,90,70,14.4,144,0,3,3
"20368","8cdce1fc9dd82b3d9b58d89a8575578d",20,20,0,20,20,0,1,2
"20369","8ce16f4182899b7b0a1a44927f8be743",51,38,45,7.93333333333333,28,23,2,1
"20370","8ce36185d496b7bbce05b12609c1fabd",113,72,29,27.2758620689655,81,32,3,3
"20371","8ce403a416ac8bb45c2c3d09cb117109",146,82,78,13.1025641025641,146,0,3,3
"20372","8ce54462cff470a24581393e0777a2d1",61,33,50,8.54,61,0,2,1
"20373","8ce5874784cc4e4ff03b6300cabb441b",11,11,0,11,11,0,1,2
"20374","8ce75f05082868831bff2fbff525586a",56,44,48,8.16666666666667,56,0,2,1
"20375","8ceb3908e22d205a17b7629ed7f7e244",40,36,60,4.66666666666667,40,0,2,1
"20376","8ceb731612b79c56025f448d1c6a31c2",55,48,42,9.16666666666667,0,55,2,1
"20377","8cec46089d699699ed97d94f548471c0",72,66,38,13.2631578947368,30,42,2,1
"20378","8cee509dee4e337b8be049102a4ed305",164,114,52,22.0769230769231,149,15,3,3
"20379","8ceed4ef721fdf4933e34287400c6116",130,77,31,29.3548387096774,130,0,3,3
"20380","8cf0d3f84fe51fe7ee28d37da988f06a",21,21,0,21,21,0,1,2
"20381","8cf6a6808268b521d0f074c4a50cb768",38,38,0,38,38,0,1,2
"20382","8cf8c9e4a5bc231c1dc13e574bb0364d",24,24,0,24,0,24,1,2
"20383","8cfadc7d25b47255a9a1fc9017d7e85e",33,28,40,5.775,33,0,2,1
"20384","8d00b5642259dfa87d3d0a0b211202b3",44,44,0,44,44,0,1,2
"20385","8d01198c0fc2efe201d8c2ec99075c68",180,89,64,19.6875,129,51,3,3
"20386","8d049701d3c0cf376edd71c4c6ab19ed",202,68,76,18.6052631578947,165,37,3,3
"20387","8d09e4c76ed840729f8b2059caade479",20,14,84,1.66666666666667,20,0,2,1
"20388","8d0d6b02dfe8080dd84ce845788494ec",147,97,29,35.4827586206897,147,0,3,3
"20389","8d0ebe59b5ccef1b238448ef9a9532d3",38,38,0,38,0,38,1,2
"20390","8d0ee841ad6f661539d78977ef94b239",32,32,0,32,32,0,1,2
"20391","8d10361f84a7c6ee449411ae6279c26d",67,47,83,5.65060240963855,67,0,2,3
"20392","8d1318edddf35d2693124b0592ad3334",46,46,0,46,46,0,1,2
"20393","8d140b0bbaa892d503ed473a0999a2f1",30,30,0,30,30,0,1,2
"20394","8d1450a06055b8fa4cc7ccae8aeca821",13,13,0,13,13,0,1,2
"20395","8d152562b1f037ed0bb3e351867cfef9",92,78,49,13.1428571428571,92,0,2,3
"20396","8d164edf0e8e146a33a0e3c57266d11a",189,145,55,24.0545454545455,189,0,3,3
"20397","8d1df3fb331ba8dcb19be0727a9e94d2",17,17,0,17,17,0,1,2
"20398","8d1f63a8577a23dc5878ca2ee3f081fa",190,123,64,20.78125,190,0,3,3
"20399","8d2195fe365d7324bdcd5b766ee11eb9",19,13,54,2.46296296296296,19,0,2,1
"20400","8d23ccc0a32cf9ed1f46c6f7b7c4fada",133,85,67,13.8955223880597,133,0,3,3
"20401","8d2457ffbc30cdc0e32e5889c8c926de",43,38,27,11.1481481481481,43,0,2,1
"20402","8d263a836375f6ba4d1bd941011439c5",38,32,25,10.64,38,0,2,1
"20403","8d26c3736ba0956d7f30a1ba00716464",43,31,28,10.75,0,43,2,1
"20404","8d26e959d3d8a2b2ed450c07aa14279e",41,34,16,17.9375,41,0,1,1
"20405","8d2806f30673b54fad5c46b732cd4d9b",47,39,49,6.71428571428571,47,0,2,1
"20406","8d2919847a1a69450e30e469a1accb35",169,75,41,28.8536585365854,137,32,3,3
"20407","8d2be15b631803740c4b6ab422b77d38",202,92,79,17.8987341772152,202,0,3,3
"20408","8d2d37071a6ea06e54cedd29d8079509",19,19,0,19,19,0,1,2
"20409","8d2ee119fb15754b39612a7c8eef3d72",35,32,26,9.42307692307692,10,25,2,1
"20410","8d2f50658512eb33927d72afea2b6808",96,32,70,9.6,96,0,2,3
"20411","8d2f658dea015d5c62e02887b06e023e",103,81,50,14.42,81,22,3,1
"20412","8d326da8319257f7a82a901d38136d71",23,23,0,23,23,0,1,2
"20413","8d33a91c8921b72507c9ab1cf98c2356",150,93,46,22.8260869565217,150,0,3,3
"20414","8d340d2051084f22773a90e4e91bf9ce",14,14,0,14,14,0,1,2
"20415","8d3d35d7910ec43f772aab3fb699b9ec",1,1,0,1,1,0,1,2
"20416","8d3d48971dd8f6d4f28f9bd6f2637902",225,156,75,21,197,28,3,3
"20417","8d3e558aa23243e655954995b851914c",83,58,77,7.54545454545455,83,0,2,3
"20418","8d3e55d5e02b48ee2f00c593f032dc07",168,119,85,13.8352941176471,168,0,3,3
"20419","8d41d8e560b209b3083c8a6a3ddfdeb1",12,11,35,2.4,12,0,2,1
"20420","8d423dbb11b506524b9acbb2797767a7",82,72,68,8.44117647058824,82,0,2,3
"20421","8d4281ce81756133c3f2639a48d161f1",27,27,0,27,27,0,1,2
"20422","8d42f5ff071d361ecfc6ccb91daf236f",54,53,45,8.4,54,0,2,1
"20423","8d450895c5e98dd262b36a0d481f3658",24,24,0,24,24,0,1,2
"20424","8d4636843b94558def010fe3458c0209",13,13,0,13,13,0,1,2
"20425","8d48f86b4bcc54aaead5fb3b090f13df",2,2,0,2,0,2,1,2
"20426","8d4c33b33f386e6b02f39b539d334197",178,79,85,14.6588235294118,138,40,3,3
"20427","8d4cea9bd68139950274d6c389e05607",72,53,80,6.3,66,6,2,3
"20428","8d4db76ba65d1b1cfcfcbdf2e420130a",36,32,37,6.81081081081081,36,0,2,1
"20429","8d500cf88f80d0f07c9a6a95af87cf38",73,61,57,8.96491228070176,45,28,2,1
"20430","8d55fdec98068b6b330008df110bb88c",40,29,53,5.28301886792453,40,0,2,1
"20431","8d5682065e6a8fde55981d231cd24bdd",22,17,13,11.8461538461538,22,0,1,1
"20432","8d57dd77ac8c251a3e93bb0ef8ec3157",32,28,78,2.87179487179487,32,0,2,1
"20433","8d5a336737be050762c0b93b952a631a",17,17,0,17,17,0,1,2
"20434","8d5a9e3d86b847ba1ad9a1d42d3cf761",93,74,76,8.56578947368421,49,44,2,3
"20435","8d5f3502d163dfa5bc77620fb8a96bf3",148,80,77,13.4545454545455,148,0,3,3
"20436","8d61d0d830691582e7e9c33941615a25",135,84,78,12.1153846153846,135,0,3,3
"20437","8d624cbe1455e3ad43ffcb8d28907f3c",26,23,57,3.19298245614035,26,0,2,1
"20438","8d62b26e48d6376247a13aa44ca565bf",7,7,0,7,0,7,1,2
"20439","8d63f5e5d5c04797facb1ffcbf4920b4",163,115,75,15.2133333333333,163,0,3,3
"20440","8d658dccde06d0e809a2e9015ace630e",2,2,0,2,2,0,1,2
"20441","8d670135afa8aad14e27a1ec10a5bc22",134,107,25,37.52,134,0,3,3
"20442","8d67d1722877cda3478aa9b465c07456",33,29,56,4.125,33,0,2,1
"20443","8d68414cd0f055caf5094507f996f606",6,5,18,2.33333333333333,5,1,1,1
"20444","8d69291958b822dce06c6af8d18765f9",34,34,0,34,34,0,1,2
"20445","8d6a441bab4f67349fc9591a9221ae83",133,58,71,13.112676056338,108,25,3,3
"20446","8d6adb75955afdc8d5ed6ed891c3f31b",9,9,0,9,9,0,1,2
"20447","8d6c70384f674128a6df6eff254b683c",42,39,21,14,42,0,2,1
"20448","8d6f420783b9bf8fd66e07377417fcd5",9,3,52,1.21153846153846,9,0,2,1
"20449","8d728e43e10d56da8a46a7fdd396f7ae",80,53,48,11.6666666666667,57,23,2,1
"20450","8d72cd882752d9da56f1eb56cf37df13",100,76,25,28,100,0,3,3
"20451","8d74874f5e00a3ce1ff40682acfcba5e",247,107,86,20.1046511627907,207,40,3,3
"20452","8d74f9d9ef5303c899339eb4f140caaf",19,19,0,19,19,0,1,2
"20453","8d773ed339d3ae5c9a0beb92f4c042cd",54,40,14,27,54,0,1,1
"20454","8d78c2bc62e0cc39a1f8683744038fcc",132,103,84,11,117,15,3,3
"20455","8d7eb0ea2d7606d4e56f2f07c83d70a9",36,36,0,36,36,0,1,2
"20456","8d7eb63635ebb71fd2fba44a191552c0",36,23,54,4.66666666666667,36,0,2,1
"20457","8d803563abb51bbc36dcac85ebbcd1a9",37,37,26,9.96153846153846,37,0,2,1
"20458","8d804b92af2630a10c9813ce4cacea58",172,110,70,17.2,121,51,3,3
"20459","8d815485cb8e291ffd572cec63ea21d8",24,24,0,24,0,24,1,2
"20460","8d819834b16d9c77035cb44b622088d3",95,45,82,8.10975609756098,85,10,2,1
"20461","8d8575f8453305a0319feacf31c03b9e",62,50,56,7.75,62,0,2,1
"20462","8d881b4a19f1e117ec338674db9232a0",120,87,28,30,120,0,3,3
"20463","8d8b43de2b872bb4a5172089c6936a5a",9,9,0,9,9,0,1,2
"20464","8d8d2ae4a8af2592ad6197d4d3ecf0b1",237,94,82,20.2317073170732,196,41,3,3
"20465","8d8e8650558bd372b3b84ba31b39b6c0",42,42,0,42,42,0,1,2
"20466","8d8f7f42ed5017ac6ae6db652e203769",88,72,71,8.67605633802817,88,0,2,3
"20467","8d91451ada37957a3bc08084908c4ffd",78,47,69,7.91304347826087,59,19,2,1
"20468","8d919dbf85e5e5abe0e4a20cb80e57df",73,52,36,14.1944444444444,73,0,2,1
"20469","8d9633b57c04750833e9c5bdbd2340e9",41,41,0,41,41,0,1,2
"20470","8d976e759ab1b9f730425dd2e94dbc61",82,49,72,7.97222222222222,82,0,2,3
"20471","8d979d890b829092f1ea430d27cc06b5",37,37,0,37,37,0,1,2
"20472","8d980a68b3aa823e1ee14036e00b722f",109,68,71,10.7464788732394,109,0,3,3
"20473","8d9b7b9a8532a173fe6995f528171bc9",34,27,64,3.71875,20,14,2,1
"20474","8d9c889aaa07cd4aad105da927e479a0",140,73,75,13.0666666666667,91,49,3,3
"20475","8da0576b80bb8861887d266caab7123f",93,74,54,12.0555555555556,50,43,2,3
"20476","8da1009b7a0c9d22de0f31e3987d69ff",43,33,80,3.7625,43,0,2,1
"20477","8da4308acad4189f1cc221ead23f5f5b",177,86,62,19.9838709677419,177,0,3,3
"20478","8da4b452efd941840b0a3677297fbc00",133,80,80,11.6375,101,32,3,3
"20479","8da5a83aed7a48c8919bc4e10cd5443f",81,76,55,10.3090909090909,81,0,2,3
"20480","8da9df8b7c8948cbde739e843f25ab80",18,9,4,31.5,18,0,1,2
"20481","8daa3d259f0087ca152b3bdd1ecda752",57,48,72,5.54166666666667,24,33,2,1
"20482","8db5c1757ea63b4fd2634aaf518482ff",36,36,0,36,36,0,1,2
"20483","8db61007d069facdea5a24e640d02bd0",139,31,74,13.1486486486486,120,19,3,1
"20484","8db8a2632a9a07c25061d26543977da1",138,78,49,19.7142857142857,138,0,3,3
"20485","8dbbb68d6e16147b48f843d2ead120cc",83,65,73,7.95890410958904,60,23,2,1
"20486","8dbc79a516e6b5fc35235587b85773bf",14,14,0,14,14,0,1,2
"20487","8dbd258c60cd9c6d34f428825ad42865",51,39,12,29.75,51,0,1,1
"20488","8dc6ba20edf843fc30d7fe2eaa8ecd0c",82,45,68,8.44117647058824,56,26,2,1
"20489","8dc7d1e44aff5d838b1a37d23dbd0bb6",46,46,0,46,46,0,1,2
"20490","8dca5ac3cb465eb24263267e6b3a0fe2",19,19,0,19,19,0,1,2
"20491","8dca7bb7efca05a0439c9304da3690eb",16,15,59,1.89830508474576,5,11,2,1
"20492","8dcee01cec5757b1d4dc3a1fc4b8cd77",31,31,0,31,0,31,1,2
"20493","8dd13453794ea746588a68ab80381e30",33,33,0,33,0,33,1,2
"20494","8dd1b2db113f6da33021330b12d5c027",31,31,0,31,31,0,1,2
"20495","8dd1b8342600685e6ee48e0f059c2b4a",12,12,0,12,12,0,1,2
"20496","8dd33b8a674926f1a6789e0563d620cd",60,51,78,5.38461538461539,60,0,2,3
"20497","8dd5966e4b6df8c00e724c5a6445df96",22,22,0,22,22,0,1,2
"20498","8dd692de063b07102d16381cc1f9369b",11,8,63,1.22222222222222,11,0,2,1
"20499","8dd79e03ea6a5404d07d46208adddf9b",54,46,32,11.8125,30,24,2,1
"20500","8dd7c591804674be87957c1237dd0cc6",137,78,52,18.4423076923077,137,0,3,3
"20501","8ddccfd019c64099779ac4367e0de818",26,26,0,26,26,0,1,2
"20502","8ddf041e8cc569e61b329b54571fdb38",16,16,0,16,16,0,1,2
"20503","8ddf73dae3cc79261b14e0543efd20ee",88,70,38,16.2105263157895,69,19,2,1
"20504","8de1d5b7c3c4d73e6630374f2c93d504",44,44,0,44,44,0,1,2
"20505","8de1f31fb2215c58b5b636ff8e386600",21,21,0,21,21,0,1,2
"20506","8de45edbdcaaf6fabff6efa841c2163d",41,41,0,41,41,0,1,2
"20507","8de4e91d18037c82aa01a0aa566df9c2",21,18,27,5.44444444444444,21,0,2,1
"20508","8de52fdfbd72e579ef3970d5fc39d5db",88,72,62,9.93548387096774,88,0,2,3
"20509","8de5b9e706f91539975dcb55e70045ae",196,117,69,19.8840579710145,163,33,3,3
"20510","8de7447f17f2f76ce41b73678bd7fe92",33,33,81,2.85185185185185,33,0,2,1
"20511","8dea80c48b39ff81776990a05cba3ebc",17,17,0,17,17,0,1,2
"20512","8deca76f1a1572f9cdb25af9f7392e10",75,59,39,13.4615384615385,44,31,2,1
"20513","8dece6b662f6038f05954bffbb87590e",21,20,15,9.8,21,0,1,1
"20514","8ded463b262830f03c1515aa583032e8",51,51,0,51,51,0,1,2
"20515","8deeab1d79fb53294677249fc26482d8",41,41,0,41,41,0,1,2
"20516","8df31320ad13ab909622b11b42d11358",79,60,56,9.875,79,0,2,3
"20517","8df52345f225854a2a9aa80d721a0c7f",63,51,44,10.0227272727273,63,0,2,3
"20518","8df5fd1c89177d6ca17843ec0107b369",10,10,0,10,0,10,1,2
"20519","8df811338b1cbe507458bc4e71de6976",86,76,11,54.7272727272727,86,0,1,2
"20520","8df8c4b7739ca0417132c6bffcf3af32",4,4,0,4,4,0,1,2
"20521","8dfa60df3d3da3c0ead654bbe3b1970e",14,14,0,14,14,0,1,2
"20522","8dfaf263f39b869226f16d72bca8a5c4",98,66,63,10.8888888888889,98,0,2,3
"20523","8dfb4e1943e90cb84ca4f4660c5700a1",65,45,61,7.45901639344262,41,24,2,1
"20524","8dfef587a4c265b2ac074aed09b1cd62",191,129,47,28.4468085106383,171,20,3,3
"20525","8dffdeda92e6433898804d66cf4b3f24",22,22,0,22,22,0,1,2
"20526","8e04554fde3360661f40563cab1eaca6",39,39,0,39,0,39,1,2
"20527","8e05037fe0abc1f81b10c1703bd79629",35,35,0,35,35,0,1,2
"20528","8e0bb7b638c4a0c5d6a5c8eb43bf436f",24,24,0,24,24,0,1,2
"20529","8e0c9605e9e7e476791a7acacaff3043",122,82,82,10.4146341463415,122,0,3,3
"20530","8e0e9fd6de5c8aac710d9938382595f0",81,65,38,14.9210526315789,81,0,2,3
"20531","8e0edcd0dca23bc06b3c36163d395511",33,33,5,46.2,33,0,1,2
"20532","8e0fddaac56330a029d503761f415f6c",44,44,0,44,44,0,1,2
"20533","8e10a848c376ada34d42b4085263249f",17,17,0,17,17,0,1,2
"20534","8e10d5581b28f15910b1cd8bd7ecc56c",66,53,58,7.96551724137931,66,0,2,1
"20535","8e11f46ca71acd95563782d6073eea12",73,61,34,15.0294117647059,73,0,2,1
"20536","8e13714562dcaf74a6335431ea332328",55,48,58,6.63793103448276,14,41,2,1
"20537","8e144157424f14260195e14b75f231ee",26,26,0,26,26,0,1,2
"20538","8e16da7b77eb7fb772bd52324c2b646c",6,6,0,6,6,0,1,2
"20539","8e188e395be835a716b7aa3063d5a3b7",62,41,58,7.48275862068965,48,14,2,1
"20540","8e18c9275fece8f4e08a4a142164a7c4",22,15,35,4.4,22,0,2,1
"20541","8e19f80ea27f4e5aee9d02a9f3494175",81,69,39,14.5384615384615,81,0,2,3
"20542","8e1c36dffbc43d6718516e2545f46b59",41,41,0,41,41,0,1,2
"20543","8e1e72d65fa2c035879e40eee1e718c5",112,95,78,10.0512820512821,112,0,3,3
"20544","8e1ed3fd351902a3bc2a8f6a3d3032a9",62,51,13,33.3846153846154,62,0,1,2
"20545","8e200311f7a903bbb2fa11339aeb2d7b",26,26,0,26,26,0,1,2
"20546","8e2054532fdd9b988f1f5c0267038e4e",21,21,0,21,21,0,1,2
"20547","8e246eae8cbb8a678d51475c3fbd9797",16,16,0,16,16,0,1,2
"20548","8e2614aabfe95c51719e03d7b8badf81",124,85,77,11.2727272727273,79,45,3,3
"20549","8e30eff0806360393f14033b9596f790",8,8,0,8,8,0,1,2
"20550","8e3100b26ad2b47518687a8b37403634",40,30,45,6.22222222222222,40,0,2,1
"20551","8e3143794074bd67d1710e36c0eaa730",50,44,15,23.3333333333333,50,0,1,1
"20552","8e318e4083e9fa081f0f73131da1888a",36,36,0,36,0,36,1,2
"20553","8e31c76af21a18ee64b3342f0e3fabeb",48,38,36,9.33333333333333,30,18,2,1
"20554","8e3204d7b390b7d23f7ac894ea7d48ec",15,15,0,15,15,0,1,2
"20555","8e361cebcd8e2add100ad4ae1f6b1293",17,15,9,13.2222222222222,17,0,1,2
"20556","8e3729515b81cf26ff1febc95f11f96d",19,19,0,19,19,0,1,2
"20557","8e3803804490be7392ff53b87b90ef99",76,55,35,15.2,76,0,2,1
"20558","8e384aed3600f5dd349cf05b59b5025a",110,74,46,16.7391304347826,76,34,3,3
"20559","8e38fa43621d6ec23775adc3c4fd4b69",157,131,42,26.1666666666667,157,0,3,3
"20560","8e3a61cf26c0905bad565a4623c4e516",32,32,0,32,32,0,1,2
"20561","8e3cb5b1cbc5176e0a48720c911a4b19",166,120,80,14.525,131,35,3,3
"20562","8e3ce5303d27aeacb0864ea23d8ddf13",93,47,43,15.1395348837209,69,24,2,1
"20563","8e41a13cb1b380d985a294301a74b74a",95,75,26,25.5769230769231,95,0,3,3
"20564","8e4710a2d4f858f4cda9d4c607395d5f",40,40,0,40,40,0,1,2
"20565","8e4744c9486680b69528d1eaa8b7b4af",109,87,25,30.52,59,50,3,3
"20566","8e478a328b5e04795c502e9ecc480aa5",31,31,0,31,0,31,1,2
"20567","8e48754c80094d07c71ad6e124121ad8",51,51,0,51,51,0,1,2
"20568","8e49a5d47174ddb9c993d29737427ba9",101,67,65,10.8769230769231,101,0,2,3
"20569","8e4b6947ce0cccd466c58adc0fa3d3f9",134,102,87,10.7816091954023,134,0,3,3
"20570","8e4ce4dc7da110a7219dafe47b3c1ee8",132,74,32,28.875,132,0,3,3
"20571","8e4f521110bf9877152c3439d16e901a",79,51,21,26.3333333333333,79,0,1,2
"20572","8e51b0727a3fcaf182db975221cfcbec",66,43,38,12.1578947368421,31,35,2,1
"20573","8e53e66743e26bed36270ad1830e38f7",31,31,0,31,31,0,1,2
"20574","8e54034ae1592166d8899113727cdc55",20,20,0,20,20,0,1,2
"20575","8e582e1ff694261ffea747a427670bdc",157,100,49,22.4285714285714,157,0,3,3
"20576","8e5b7f0d7a563313b75971a37c6701b5",21,21,0,21,21,0,1,2
"20577","8e5bf75830c3962d344c97db683c139e",31,28,24,9.04166666666667,31,0,2,1
"20578","8e5dbb70fea03b23d4061b05d24837f7",48,37,8,42,24,24,1,2
"20579","8e635631553e59cf3e91188c3e168da5",48,44,65,5.16923076923077,24,24,2,1
"20580","8e6445908dc9047fd904ef06b7e904e7",110,84,57,13.5087719298246,110,0,3,3
"20581","8e6478d4a0d63378bbea7f9a86e242f4",5,5,0,5,5,0,1,2
"20582","8e67654d90ac7aa8566179290f7a6812",191,91,77,17.3636363636364,158,33,3,3
"20583","8e6dc44792fa1463607228d4b419f5a8",14,8,83,1.18072289156627,14,0,2,1
"20584","8e6dd0918926ec5f2d9a2409bdb3017d",49,46,44,7.79545454545455,24,25,2,1
"20585","8e6e90e0495c6ae893bf29e1cfa8dd9b",106,73,73,10.1643835616438,79,27,3,1
"20586","8e71512351f22a25f57823e61eb96aa4",21,21,0,21,0,21,1,2
"20587","8e7188b4baae1af2159f8453a1d2b294",33,22,41,5.63414634146342,33,0,2,1
"20588","8e74b2a8e1bf230a08bd9740bd9b69b4",43,37,22,13.6818181818182,43,0,2,1
"20589","8e74e0c83c1d33add4c10c86a141250d",157,77,65,16.9076923076923,157,0,3,3
"20590","8e7736dd68e22629172d10ffc8577c80",93,66,27,24.1111111111111,93,0,2,3
"20591","8e7842241b38f040effea483fb25bdc0",28,28,0,28,0,28,1,2
"20592","8e78b9ebad8633123f9787479453e8a2",30,30,0,30,30,0,1,2
"20593","8e7a03d05d6d970a62a499d825528f2c",11,11,0,11,11,0,1,2
"20594","8e7a20c27e0922766289aa246774721e",102,62,56,12.75,102,0,2,3
"20595","8e7b1fff8dc7aa9fb74501ebd7d1c16a",28,28,0,28,28,0,1,2
"20596","8e7d0c604fe1791388e282629864c1da",24,24,0,24,24,0,1,2
"20597","8e7e3470bb398d00e82988fa704b436c",45,45,0,45,45,0,1,2
"20598","8e81c77cc99874a3e9abab85624991ba",56,45,52,7.53846153846154,46,10,2,1
"20599","8e825171aa3910f51542b419ebe8ec42",28,28,0,28,28,0,1,2
"20600","8e8315ed119c1382c4d351bbb188510e",229,85,83,19.3132530120482,208,21,3,3
"20601","8e835820d1c6f801d8c657e73743b8e7",34,32,10,23.8,34,0,1,2
"20602","8e8d92f0143dcebf37c09a6ad983e09c",42,36,62,4.74193548387097,42,0,2,1
"20603","8e8e8b37df5fe08be362bb22a17fb0f3",54,44,30,12.6,54,0,2,1
"20604","8e91bc96f682ed5cb40fbab945023ccd",41,41,0,41,41,0,1,2
"20605","8e9210490403230bdfb90f165f710acd",51,41,47,7.59574468085106,28,23,2,1
"20606","8e94c371ead82915a94dc46dcb9dba94",57,41,19,21,57,0,1,1
"20607","8e998c4ab0203d0f81fd717b84d89542",47,41,36,9.13888888888889,47,0,2,1
"20608","8e99bd3e7535c70f31288f71f439ad82",3,3,0,3,3,0,1,2
"20609","8e9a0accbc84354183f2881afdf2d216",18,18,0,18,18,0,1,2
"20610","8e9ab05e81e9416d19c77afc6ca71436",50,46,27,12.962962962963,50,0,2,1
"20611","8e9ad298841d1905f39abae3cef3180d",22,22,0,22,22,0,1,2
"20612","8e9afee2aba51d1f3161a9735d83f034",17,17,0,17,17,0,1,2
"20613","8e9c326fb0c571e2c2a2386795196f11",55,55,0,55,55,0,1,2
"20614","8e9e71a68d2d5be20eda2266e0d31087",7,6,7,7,7,0,1,2
"20615","8e9e73c0adf280541deb6d3d97a25978",75,51,47,11.1702127659574,53,22,2,1
"20616","8e9ee4a4be263ca874649c44d7339e6c",195,118,61,22.3770491803279,153,42,3,3
"20617","8ea0389d443a0cfe60c4175fa5df59e4",62,50,61,7.11475409836066,62,0,2,3
"20618","8ea38c8acd03ce3e559c3e72a4d2406a",93,75,31,21,41,52,2,3
"20619","8ea53ccc39a9420e03072d17f73e91b6",98,66,82,8.36585365853659,98,0,2,3
"20620","8ea66a594b884e92161c20a44fc99192",98,64,60,11.4333333333333,98,0,2,3
"20621","8ea8ea43f3ef3b62ad736f45101567f0",63,49,33,13.3636363636364,63,0,2,1
"20622","8eae7bf5c22d74ef9b7cb8375cf3f4da",70,46,33,14.8484848484848,70,0,2,1
"20623","8eafd265edabf9a29d04d2705148d3f2",14,14,0,14,14,0,1,2
"20624","8eb10ca7e54bcdac3a8a9dfaee159d0d",181,98,65,19.4923076923077,158,23,3,3
"20625","8eb25c7c3bcf9ee83c0a81b2588bb0f2",13,13,0,13,13,0,1,2
"20626","8eb297ff1b6570a6f71f88ff9184f5a8",61,37,59,7.23728813559322,34,27,2,1
"20627","8eb338bddf952a6df947da76f5f29a35",48,44,39,8.61538461538461,48,0,2,1
"20628","8eb36e022c9c29a8d2e7d65a1fdace79",83,26,70,8.3,83,0,2,1
"20629","8eb578897a1d534fa5a4f5761443848e",102,75,75,9.52,59,43,2,3
"20630","8eb8c28edd6bb1c72b5873b35eaec0e5",102,72,56,12.75,102,0,3,3
"20631","8ebbcc0444f6c577988abe5bddee9380",18,18,0,18,18,0,1,2
"20632","8ebcfb2c82137280084dcd94c096309d",42,42,0,42,42,0,1,2
"20633","8ebd2a64b94f021107fa95d830408139",108,90,63,12,82,26,3,1
"20634","8ebe41ed2a2ab56a7652148ee3b4e7ec",24,24,0,24,0,24,1,2
"20635","8ebe9b26303ee8f8d506381491526680",29,29,0,29,29,0,1,2
"20636","8ec064ad7ab7e10ec8dcb95fd6192652",62,54,14,31,62,0,1,2
"20637","8ec2b05c243a92d2609cca53d6ba8369",156,95,73,14.958904109589,156,0,3,3
"20638","8ec4ea74a5f70155092c2ac06cb921d5",15,15,0,15,15,0,1,2
"20639","8ec596f03c5b2ed59d721718be95f099",6,5,20,2.1,6,0,1,1
"20640","8ec5bff1679ec151d5882f6a39fa7301",32,32,0,32,32,0,1,2
"20641","8ec94ac2794cca0870c059f1409e427a",10,10,0,10,10,0,1,2
"20642","8ecc0d133027cbddfc5c36bfa75db340",13,13,0,13,0,13,1,2
"20643","8eccb82d088fc79578214a865cc33168",139,102,53,18.3584905660377,139,0,3,3
"20644","8ed0d93b5306392cff21ab4234ca7f4f",91,64,60,10.6166666666667,91,0,2,3
"20645","8ed3f7d14e3597d90e2bd74986194e63",22,22,0,22,22,0,1,2
"20646","8ed4948553a4ca483edbb039cd82ce21",74,57,27,19.1851851851852,35,39,2,1
"20647","8ed8985917102419f36d8dcd19178e52",169,87,76,15.5657894736842,169,0,3,3
"20648","8ed9e9b9ed8bc7ce6361407e4ad63a10",61,50,58,7.36206896551724,26,35,2,1
"20649","8eda8acfefb74d2f5e5315a325bee160",20,20,0,20,0,20,1,2
"20650","8edd9350eb6cdd2b9060e9c935641225",132,61,70,13.2,132,0,3,3
"20651","8edee4e501d021f97b3be401a20e7772",117,93,34,24.0882352941176,117,0,3,3
"20652","8ee2e4243a7f9fcc7645950c255c2e75",12,12,0,12,12,0,1,2
"20653","8ee47ad8f37ede58496a82d233cdae06",18,18,0,18,0,18,1,2
"20654","8ee4d0f9cad03021a6bf5fba3812af3e",16,16,0,16,16,0,1,2
"20655","8ee5568ff93cd233427770076fb6a931",41,36,56,5.125,41,0,2,1
"20656","8ee58b07a39bc7b83e3ca283f50e355e",223,99,85,18.3647058823529,204,19,3,3
"20657","8ee61b21ada63abada9d7f6232f3acf8",78,63,31,17.6129032258065,78,0,2,1
"20658","8ee69d89e9e85a752049409ac182cb36",33,33,0,33,33,0,1,2
"20659","8ee75886a17040131908d073b47c2614",95,74,69,9.63768115942029,95,0,2,3
"20660","8ee99b6d0cd0d19f095145a1e8a9592b",236,152,64,25.8125,208,28,3,3
"20661","8ee9fb830eec8679e58fe5618d812194",64,50,36,12.4444444444444,64,0,2,1
"20662","8eea2bc4c9bc769ca190bfc77acb3f17",54,43,77,4.90909090909091,54,0,2,1
"20663","8eeb1a6fd24a9f147d0cdcd56149699d",21,21,0,21,21,0,1,2
"20664","8eec6671b00231fec420d49bc879b340",9,9,0,9,0,9,1,2
"20665","8ef11b17c50782548de152ba945822b5",114,54,71,11.2394366197183,114,0,3,3
"20666","8ef37be97cab12e2c3231bd3a1de2959",22,22,0,22,22,0,1,2
"20667","8ef71b25f39305f7242b489ed07daebd",139,101,49,19.8571428571429,139,0,3,3
"20668","8efa6aa018ad2b97cb5de120cdc2501b",38,38,0,38,38,0,1,2
"20669","8efb049df2432b3a4950fc03ae290873",43,43,0,43,43,0,1,2
"20670","8efbab8736e94898e91cfc064aadcbfc",26,26,0,26,26,0,1,2
"20671","8efc35faa14ce8c4636a34189f119f1a",55,55,0,55,55,0,1,2
"20672","8efdad4b1db19a7f45d8ad8b6d6f2d4f",59,46,21,19.6666666666667,59,0,1,1
"20673","8eff7af6114522dbefdac410ff2ffeb9",75,26,86,6.1046511627907,68,7,2,1
"20674","8f00c8a04774bf1d93e921061b2e4674",8,8,0,8,8,0,1,2
"20675","8f02ba05825e22443c8f174f3558f962",4,4,0,4,0,4,1,2
"20676","8f0339c59393691007aff24a86522854",82,67,28,20.5,82,0,2,3
"20677","8f05f3fb9721e26f660992e14f90b506",23,21,7,23,23,0,1,2
"20678","8f074ca16b7d616782da548e069e7782",39,39,0,39,39,0,1,2
"20679","8f074d5811334eed80bc24744c1c32d5",198,106,62,22.3548387096774,150,48,3,3
"20680","8f0a2bdd9412f1ac02df13b010203262",80,49,69,8.11594202898551,80,0,2,3
"20681","8f0afec87d99fb9c7e4f763099688ab1",46,30,84,3.83333333333333,46,0,2,1
"20682","8f0b41c17da9cbc20bdaf46a2e4d50c4",205,130,86,16.6860465116279,205,0,3,3
"20683","8f0d109d5d1a651e3edd26e7a34e534e",130,104,44,20.6818181818182,130,0,3,3
"20684","8f0d2d3adcc9465267bcfc3d49fb08b6",21,21,0,21,0,21,1,2
"20685","8f11a7da6383c9fd4b880b5448539d8a",42,38,39,7.53846153846154,42,0,2,1
"20686","8f133bc50787145d387d946ec93fac61",18,18,0,18,18,0,1,2
"20687","8f14e900bbb9236d08b446097e4d881e",37,37,0,37,37,0,1,2
"20688","8f15be1a481ad724c30d24996eb5c166",16,16,0,16,16,0,1,2
"20689","8f17663ec2916d62a5b60554d85354c4",49,40,42,8.16666666666667,49,0,2,1
"20690","8f17832bf4133414e278a6069c01b39d",78,61,30,18.2,46,32,2,1
"20691","8f17c21cccf665b43a9b927042e32d86",209,89,78,18.7564102564103,209,0,3,3
"20692","8f1a8431c57c55e5039a0d95a227b0af",21,21,0,21,0,21,1,2
"20693","8f1acd32300c58ee91efedea980333a5",27,27,0,27,27,0,1,2
"20694","8f1adffef105eb523b4ba6e51a58bcb2",190,96,84,15.8333333333333,190,0,3,3
"20695","8f1be9b9c2080378e89cf2277a665ff8",70,43,62,7.90322580645161,70,0,2,3
"20696","8f1c5f30091040a439a554a3d289dc48",143,84,65,15.4,107,36,3,3
"20697","8f1da177b2013b83c3d04d889bd7a576",22,22,0,22,0,22,1,2
"20698","8f1e529840683efb1b02cc47754dae06",12,12,0,12,12,0,1,2
"20699","8f24b3cee13a19025be5a51e296f1bb8",28,28,0,28,28,0,1,2
"20700","8f25a4268a24e96ffa8f3a61cbbcfd40",89,70,80,7.7875,89,0,2,3
"20701","8f28f63785228a2ba14ca85cc8474b74",65,49,82,5.54878048780488,65,0,2,3
"20702","8f299806c68199f54cead4ac8b51f529",158,114,57,19.4035087719298,158,0,3,3
"20703","8f2ad4e32809774b7528653d6dded47d",3,3,0,3,3,0,1,2
"20704","8f2b4a70b3191ad72f5c2c1d5d120c06",39,39,0,39,39,0,1,2
"20705","8f2c1855dab9c3b6a7cb15e0a4c0865e",24,24,0,24,24,0,1,2
"20706","8f2c4af07c1d75d08efdd155dcd4810e",7,7,0,7,7,0,1,2
"20707","8f2c828eec0359c32647577cb4f961f1",97,67,36,18.8611111111111,97,0,2,3
"20708","8f30f3103e1f913c7750d7297de6a766",37,33,38,6.81578947368421,19,18,2,1
"20709","8f3264dc124ab29240bae0efd8709ccd",15,15,0,15,15,0,1,2
"20710","8f3715d691b260b42c15f7cf319f86f8",143,80,85,11.7764705882353,143,0,3,3
"20711","8f38681ddf05c5f4e0559f4c45c089f8",17,17,0,17,17,0,1,2
"20712","8f39e080a44be8381f83597d0ccf0315",155,93,68,15.9558823529412,155,0,3,3
"20713","8f3a606f84ca3d9f499283b74e5df419",21,21,0,21,21,0,1,2
"20714","8f3c674a4f38e2f0152aa428eb4f38a7",6,6,0,6,6,0,1,2
"20715","8f3c7c8a08de1559384c95e5400d9fab",17,15,32,3.71875,6,11,2,1
"20716","8f3f084859c3708378ba06ac2a107929",112,65,21,37.3333333333333,82,30,3,3
"20717","8f3f51b1527b876efbe3698bf859b58f",1,1,0,1,1,0,1,2
"20718","8f40d97924d64208f3bf49f66b1e14ef",87,73,79,7.70886075949367,87,0,2,3
"20719","8f41b56de09ef05c4134de51861117f2",68,51,17,28,27,41,1,1
"20720","8f434faa639b7958ec6f6292cd737d1d",15,15,0,15,15,0,1,2
"20721","8f438fdec0d2685a26763acacb75c716",27,22,34,5.55882352941177,27,0,2,1
"20722","8f43d135ef89eb81d269b908f26d70e6",30,30,0,30,30,0,1,2
"20723","8f4a05bb275501589e06f6c001898cd3",58,54,21,19.3333333333333,58,0,2,1
"20724","8f4a4a214e002d4871d4ee751bd02f90",105,70,71,10.3521126760563,80,25,3,1
"20725","8f52f306b7bc3e79197570d7318a87ba",28,28,0,28,28,0,1,2
"20726","8f55ef12d715fbd44e90ab8fac8ec9a8",93,70,68,9.57352941176471,64,29,2,1
"20727","8f566bb63f9cf997516d97b36379080f",51,51,0,51,51,0,1,2
"20728","8f57c91b8cf70bc143234d78df43d570",57,36,31,12.8709677419355,57,0,2,1
"20729","8f5870cfd65b800650074828934b9186",135,75,66,14.3181818181818,135,0,3,3
"20730","8f58aae51d0cb19dc9e9e011d231eafc",34,34,0,34,0,34,1,2
"20731","8f64e089c7859d9ce9a326d1fc32b329",40,28,37,7.56756756756757,40,0,2,1
"20732","8f669447b61c150f0208e8348c0e8d66",88,68,54,11.4074074074074,58,30,2,1
"20733","8f66eff53cfdfeda9b0ad6c33c4017ca",21,21,0,21,21,0,1,2
"20734","8f680f9f2c15f9f2b455817b376fac4b",260,119,68,26.7647058823529,208,52,3,3
"20735","8f68362ba7f7a2a953481770fd15a53a",20,20,0,20,20,0,1,2
"20736","8f685edaef42f15c47dc2eabc8f48671",70,53,18,27.2222222222222,70,0,1,2
"20737","8f6a41c9b1453bd1f05b1582c00b9b4e",22,22,0,22,22,0,1,2
"20738","8f6c5eb09e44dfcf7ee3a65be65078eb",18,18,0,18,18,0,1,2
"20739","8f6e8365809cbab0fa6c3d2306b98b1c",32,30,35,6.4,32,0,2,1
"20740","8f6f93f5cef18273f414f0acd0b38dff",217,69,77,19.7272727272727,217,0,3,3
"20741","8f71680018873421fe8e723ad9172977",97,75,35,19.4,97,0,3,3
"20742","8f716c03a10fa8505e188a1bdf42373d",20,20,0,20,20,0,1,2
"20743","8f7620e2b0e803f88063a4a965a5aaa5",8,7,2,28,8,0,1,2
"20744","8f7849368918589564371b67d79a8a44",19,11,60,2.21666666666667,19,0,2,1
"20745","8f7a38e9f37379f01efcb56aec32f094",9,9,0,9,9,0,1,2
"20746","8f7af7aef56db41efad791a837c08c37",36,36,0,36,0,36,1,2
"20747","8f7cd62d3709fd72938b603f4fb7e0ae",113,84,63,12.5555555555556,113,0,3,3
"20748","8f7ce939532f8cc75eb79048fed11a38",54,54,0,54,54,0,1,2
"20749","8f7f6459bcc4290320336303b4fa8383",81,42,70,8.1,32,49,2,1
"20750","8f80028a7116f8df19f8540047933eb6",34,34,0,34,34,0,1,2
"20751","8f821b0f80d9ff66392f0f6f057853e8",196,85,82,16.7317073170732,196,0,3,3
"20752","8f82aec32ad9f85e7738f30a87621ebd",134,80,72,13.0277777777778,134,0,3,3
"20753","8f836dc41590241a421237f7582cfd0a",15,15,0,15,15,0,1,2
"20754","8f8618e08692687744f66c5995d076ec",9,9,0,9,9,0,1,2
"20755","8f883c4a41c8d60f6146998a0f62ec40",107,26,84,8.91666666666667,107,0,2,3
"20756","8f88779160b0b19d4c971762b12b2a45",89,71,48,12.9791666666667,89,0,2,3
"20757","8f89be7c3a94ba850751e8d9a4e4856f",28,28,0,28,28,0,1,2
"20758","8f8a3512923e7f306fc96ef1f5ce52bc",29,25,65,3.12307692307692,27,2,2,1
"20759","8f8c4a57b51ecbd60b7e0835de4991fc",40,32,41,6.82926829268293,40,0,2,1
"20760","8f8dec42f4eaff8f38f9160102bc484b",2,2,0,2,2,0,1,2
"20761","8f8e5992aaf0a2a8401103ecff2a5cc9",95,81,45,14.7777777777778,95,0,3,3
"20762","8f90cdda3df99026864493d1af5d4a56",4,4,0,4,4,0,1,2
"20763","8f922e3227c18bd913c854be018f84c8",23,22,17,9.47058823529412,1,22,1,1
"20764","8f925359525c01aa8d68f40fd15d8ee6",43,32,56,5.375,43,0,2,1
"20765","8f9567a2452c36da991e88c07b69a078",69,55,51,9.47058823529412,30,39,2,1
"20766","8f98b8a9cde611a80496451a3df384cf",52,41,30,12.1333333333333,52,0,2,1
"20767","8f998eca83818ff5a42eb762f0af2b45",55,55,0,55,55,0,1,2
"20768","8f9b11dd1e446fa456959605121886f7",16,16,0,16,16,0,1,2
"20769","8f9b4a91cb7e0066e452f206d8e3a732",45,45,0,45,45,0,1,2
"20770","8f9e6113c6548472bc95460e9d123748",87,55,71,8.57746478873239,87,0,2,3
"20771","8f9ed813a5512a63e5419cafa32a41dc",169,93,76,15.5657894736842,169,0,3,3
"20772","8fa1581e1c621d4d30f478d4445744a6",97,77,35,19.4,97,0,3,3
"20773","8fa37b04183fa8af777cc18f3fdfa2b4",52,43,54,6.74074074074074,14,38,2,1
"20774","8fa97bbf98d300bea052711390844c0a",82,59,52,11.0384615384615,82,0,2,3
"20775","8facb3430c854dc7f260c962a5ae41a4",9,9,0,9,9,0,1,2
"20776","8fadb2587a06d0863b6164dfdf0e5b40",56,56,0,56,56,0,1,2
"20777","8faeef2ad09d5a3853b5704e93c70373",198,75,83,16.6987951807229,198,0,3,3
"20778","8fb2fb375acd435faa5a086e5d391451",29,29,0,29,29,0,1,2
"20779","8fb4c2c911ba4f0081a5f7077d839585",34,34,0,34,34,0,1,2
"20780","8fb650a546580de94fb26bef3bcfced1",125,94,65,13.4615384615385,125,0,3,3
"20781","8fb80f7eb6d7e16697112a8a385c3606",6,6,0,6,6,0,1,2
"20782","8fba4b181890513d95005d57109415a1",86,57,66,9.12121212121212,70,16,2,1
"20783","8fba54d6b335abf7bf6dbf327828eea0",67,50,20,23.45,67,0,1,1
"20784","8fbbe54548bf6e5232d47dc65ff7b222",87,57,89,6.84269662921348,41,46,2,3
"20785","8fbce3d74d9115be129b625910a2c7a8",95,69,36,18.4722222222222,95,0,2,3
"20786","8fbd83eb43269a1f5311861af0e2faac",168,46,84,14,159,9,3,3
"20787","8fbda980683ca3ab753b08102f1c74ee",16,16,0,16,16,0,1,2
"20788","8fbf2f8d3d48f9c59cf607072cd4b44e",119,92,35,23.8,119,0,3,3
"20789","8fbf78b77edc3823bc81fdfe427f047f",29,26,14,14.5,29,0,1,1
"20790","8fc08f2cf3188e75d0666ed744f64ffe",31,31,0,31,31,0,1,2
"20791","8fc0e2896f9b40d1c06597b17b4ffa46",62,41,56,7.75,62,0,2,1
"20792","8fc18f26f3155e722b51540c5df36b58",91,78,49,13,66,25,2,1
"20793","8fc21532b5891e1aecf27a55cd6e68de",139,99,77,12.6363636363636,139,0,3,3
"20794","8fc7d864a1cfb3dc0ac382de29c60fcf",11,11,0,11,11,0,1,2
"20795","8fcaccae9b4ec35d00767e4c0a73c058",194,130,58,23.4137931034483,194,0,3,3
"20796","8fcae0bf9de80e7ce03e31133554b2c6",5,5,0,5,5,0,1,2
"20797","8fcc6173dabc00f6aaff3a9dfc2e15ed",75,59,58,9.05172413793103,58,17,2,1
"20798","8fcd2c5ecb9c868f22d6f23f93e10c77",62,54,20,21.7,62,0,1,1
"20799","8fce502ec125ecacf864d547ca5de45e",76,58,36,14.7777777777778,76,0,2,1
"20800","8fd3ffa1e016267a3a596dc0fb973f42",24,24,0,24,24,0,1,2
"20801","8fd43a908b77f5d9d5c8ca3f6c470dcd",27,27,0,27,27,0,1,2
"20802","8fd53c8acd46a6c3c8ad480901c61403",16,16,0,16,0,16,1,2
"20803","8fd80023f78fdeb6cfd7777a73d5e44f",106,71,72,10.3055555555556,106,0,3,3
"20804","8fda2d1a2fbef5d595eb1ec5d69e9938",85,67,16,37.1875,85,0,1,2
"20805","8fdc97b61f3f0772c91ad78481bc31d1",77,56,64,8.421875,77,0,2,3
"20806","8fe03cd82605c104f00f3f776cd0b46b",30,30,0,30,30,0,1,2
"20807","8fe4520f0be23e9fa792ff81cbccc226",25,25,0,25,25,0,1,2
"20808","8fe5db50ee80f90a1daf56f0b75b8eec",22,18,19,8.10526315789474,11,11,1,1
"20809","8fe6e3ed19c6dd868a3e260b0a291123",51,37,29,12.3103448275862,51,0,2,1
"20810","8fe6e74501c510537585480d08f595b6",15,15,0,15,15,0,1,2
"20811","8fec54c8c8f8961da23b8ad580235961",122,68,50,17.08,72,50,3,3
"20812","8feee9fd10d13e9a670b5f64f28bb13e",26,26,0,26,0,26,1,2
"20813","8ff0b0b334a80adbd87cd071ae0fa949",146,86,24,42.5833333333333,146,0,3,3
"20814","8ff143fb2fdd5768cdc688684cc87e21",18,18,0,18,18,0,1,2
"20815","8ff5d9f440e523ca923d604ece649ae9",8,8,0,8,8,0,1,2
"20816","8ff808b4647525d8e39d0302b3bdb843",21,21,8,18.375,8,13,1,1
"20817","8ff96c9cb9c4f42dada2348ecc639bbb",155,115,62,17.5,155,0,3,3
"20818","8ffcfc99eb6242e206077e2e88d5cc5c",39,39,0,39,39,0,1,2
"20819","8ffe3079a7a6eba058d9a212e0d3c7c6",42,26,73,4.02739726027397,42,0,2,1
"20820","900026975779c98e523a4453e277776b",151,68,67,15.7761194029851,109,42,3,3
"20821","9001198f5aa1833c11d4c2dbbc7ecb17",14,14,0,14,14,0,1,2
"20822","90023cf3d1636af107e7c85fe1d8a8c0",214,98,54,27.7407407407407,178,36,3,3
"20823","900258f1ddb2bdce6fca79efc31f0960",34,34,0,34,34,0,1,2
"20824","9003cec4c93704e1775443e07a2fe027",79,54,55,10.0545454545455,46,33,2,1
"20825","9004ffa549893c3046cf7f32a3fc19bf",137,72,77,12.4545454545455,137,0,3,3
"20826","9005b8c09dc92e62d4008793d9c63ec3",29,29,0,29,29,0,1,2
"20827","9005e6d0ee6bef3d0fa9468b121a92d9",56,50,50,7.84,27,29,2,1
"20828","9005ebecfe83caea4c9728c80c33203b",164,115,56,20.5,164,0,3,3
"20829","900647568c4cf80924505da1e020bd53",78,62,79,6.91139240506329,61,17,2,1
"20830","9008d933a123764a9aefb98446210309",35,30,14,17.5,35,0,1,1
"20831","9009358f83819fcabfc576479648cef4",33,33,0,33,33,0,1,2
"20832","900ca45f2a048f42fb2862208c07c058",49,39,54,6.35185185185185,49,0,2,1
"20833","900d1a1d0ec940146c6e9a8af36ef5aa",87,61,31,19.6451612903226,87,0,2,3
"20834","9011a7d0e5fa4962d7f364f2d220fd13",8,7,25,2.24,8,0,2,1
"20835","9012b44ec08e2c6f2667e58ef2928011",39,29,35,7.8,39,0,2,1
"20836","90131045c93ce786ca88a4d56476f78e",88,74,22,28,88,0,2,3
"20837","9015c8f2e100a6b27a03d7881dd45430",136,72,59,16.135593220339,136,0,3,3
"20838","9016661132b6f9c04a21d648d2b3abf6",89,31,76,8.19736842105263,49,40,2,3
"20839","901a1a53754ab33c0565cad3ca6f5b06",142,82,77,12.9090909090909,142,0,3,3
"20840","901adca50394e6a2a442303dde61b458",11,11,0,11,11,0,1,2
"20841","901fcc57334a00b19753d28c7d5c420a",30,30,0,30,0,30,1,2
"20842","901fd5fa1d69b745f1587c60a3695722",70,50,65,7.53846153846154,70,0,2,3
"20843","90204b3c0d8aa3f16d024fe364004d80",83,40,60,9.68333333333333,83,0,2,3
"20844","9020599c0248671b0494402206a853c4",109,64,63,12.1111111111111,109,0,3,3
"20845","9021262e064e85706ec6cb08c51d0c89",20,20,0,20,20,0,1,2
"20846","9025a4ddfd6888ddae357d4fbaf3b4be",42,42,0,42,42,0,1,2
"20847","9026ec5d3d57ecf937826bfcfb6372bf",102,90,81,8.81481481481481,102,0,3,3
"20848","9027bbd1d3dd1db08dce73cffd8e1932",53,41,15,24.7333333333333,53,0,1,1
"20849","90294b5d9dbc292e97626f2ec342c4ef",69,56,54,8.94444444444444,69,0,2,3
"20850","902c2e7f70d2dbb194e7d211c2ca709d",70,32,73,6.71232876712329,70,0,2,1
"20851","90305e482d4d6c5c297913006dcb9e32",37,37,0,37,37,0,1,2
"20852","90310aa7ecefb9e12e0c2c045a1e3d55",72,49,63,8,72,0,2,3
"20853","9031d3a69956a3f93d9982f5faab997a",12,12,0,12,12,0,1,2
"20854","90329b1bbb03155cb32fa575e8159e9c",25,15,78,2.24358974358974,25,0,2,1
"20855","9033692bde20b4f0e3f87d022237c1db",136,56,78,12.2051282051282,136,0,3,3
"20856","903495b4dc6abe26aa16fbf5323fb5e8",95,70,56,11.875,95,0,2,3
"20857","9034eb34a5ffea5b036c32e1b0719984",140,79,69,14.2028985507246,140,0,3,3
"20858","9034eca473b054ad8e99e9f916d2d242",26,20,5,36.4,26,0,1,2
"20859","90355d8b97f5e765e884512321b049a7",87,67,35,17.4,87,0,2,3
"20860","903b8ce7e2f8bee396e6bc06f35ff2c9",42,32,36,8.16666666666667,42,0,2,1
"20861","903fbd3b488ffb49c12d08e6cb7bc8ab",62,52,33,13.1515151515152,62,0,2,1
"20862","90407f874b828a805837f8b006b53a3c",120,87,66,12.7272727272727,120,0,3,3
"20863","90435092d2d78c4c666841326a7ddeb1",29,29,0,29,29,0,1,2
"20864","9044c8eafde4a370bdac1c5f6f044ea2",55,41,39,9.87179487179487,55,0,2,1
"20865","9044fc95d04e98d00cacb1d580f80ebd",88,63,56,11,88,0,2,3
"20866","9048d6fe5ca7079b2a6866d08cdb667e",172,135,62,19.4193548387097,168,4,3,3
"20867","904c358ab85ffb4a1cf7c028aa803f3a",11,11,0,11,11,0,1,2
"20868","904c7b166f8887c66ab44d10472fe802",63,51,36,12.25,63,0,2,1
"20869","904e445d891cf09fed9f7c9e9c6a2203",40,35,49,5.71428571428571,40,0,2,1
"20870","9056afd04b4e3753df2411d9eb75a8f3",42,34,17,17.2941176470588,22,20,1,1
"20871","90578381817e8ae9ba7223521e55860c",23,23,0,23,23,0,1,2
"20872","9057e3cda6a708d3dc93b8cfb17ed05d",77,60,49,11,33,44,2,1
"20873","905977dedde5da50d0e5c6ac21ac27db",55,55,0,55,55,0,1,2
"20874","905b5cd0588e0feeb77a8ec64de50f8c",10,10,0,10,0,10,1,2
"20875","905bd826bcb576a4f80e7a32851fb4e4",41,24,56,5.125,39,2,2,1
"20876","905c6c2d72d3a0ec8c613daffc863989",26,26,0,26,26,0,1,2
"20877","905ea9c41e84e7facf20a8b4c16476d7",41,32,70,4.1,28,13,2,1
"20878","906570edc5dfa637f397613a04dc9b88",10,10,0,10,0,10,1,2
"20879","9066193b5e72f7500558b22b81ff55b9",218,141,50,30.52,218,0,3,3
"20880","90662ceaa48c3289eb2f5c3339960957",34,34,0,34,34,0,1,2
"20881","9066fb27e12935e322c77d976e90edc8",47,38,15,21.9333333333333,33,14,1,1
"20882","906942e49a3fbb8016137a70f7451462",30,23,11,19.0909090909091,30,0,1,1
"20883","9071fd4ae892db5434f95c2558c7ce4d",10,10,0,10,10,0,1,2
"20884","907286e82b64969577ca3c39e77decab",38,38,0,38,38,0,1,2
"20885","9076398540623fe4e192ee5a103396ea",17,17,0,17,17,0,1,2
"20886","9078ebc062c2ecaa4242ccadd4f6d782",24,24,0,24,0,24,1,2
"20887","90797d141f1a056623c589da2d276125",24,24,0,24,24,0,1,2
"20888","907b88e063ad6887ca1a1cec7def48d5",23,23,0,23,23,0,1,2
"20889","90815f8aab10def482dda37ab277bbed",239,91,61,27.4262295081967,193,46,3,3
"20890","9086194483eebc09bb50f1775ac7aea4",13,13,0,13,0,13,1,2
"20891","90892db647fbff7fbb006dc6d6620fd6",190,105,60,22.1666666666667,190,0,3,3
"20892","908cfcdb2919b874ccd118941ff8df59",27,27,0,27,27,0,1,2
"20893","908e985cd0ada574ee7e713b9acf74d8",24,8,69,2.43478260869565,24,0,2,1
"20894","908fbbaf707e69a615ffea50326ac94f",2,2,0,2,2,0,1,2
"20895","908fdc2cbe191627f44cfd5b0c245194",179,98,84,14.9166666666667,179,0,3,3
"20896","90933ae817c55355119a2418cd87a81f",1,1,0,1,0,1,1,2
"20897","90934d41fe1c8f3263961b077e2c9f22",5,5,0,5,5,0,1,2
"20898","909520287ea236ec4a805527e2fbf494",7,7,0,7,7,0,1,2
"20899","90955988985894e411ce0a5a693e91d2",64,58,42,10.6666666666667,64,0,2,3
"20900","90995532b7ab55aaa50858272b3369fd",120,96,57,14.7368421052632,120,0,3,3
"20901","9099ca9ac381177f7671933657a6620b",192,113,84,16,192,0,3,3
"20902","909d362e13cf998d6bd9de103fac7b98",115,76,77,10.4545454545455,115,0,3,3
"20903","90a1e0eae978ab06841ca97ae8f37eda",144,98,46,21.9130434782609,144,0,3,3
"20904","90a29df299b2c656dc41f5512280658f",45,45,0,45,45,0,1,2
"20905","90a5ff3d871932a03e5225ad898bcfa2",18,18,0,18,18,0,1,2
"20906","90a771f3b99ab62c4b9cf6d06d9742bd",120,91,21,40,120,0,3,3
"20907","90a7b261c1d4eeed1c1ef4e8b274cef7",48,48,0,48,48,0,1,2
"20908","90a84949be8937cfdf21e83557ebe5b1",152,95,90,11.8222222222222,126,26,3,3
"20909","90a9ceab9331719868efaa0f3db9e7f0",136,71,28,34,111,25,3,3
"20910","90aa21b3d5a8a629abec27db114a9412",51,51,0,51,51,0,1,2
"20911","90ade5a2a67b48f625b4694d6fee6c01",35,35,0,35,35,0,1,2
"20912","90ae04f4fbb3ea02c0b6006a10365929",25,25,0,25,25,0,1,2
"20913","90b0b9e2e955ffa883397ccf52d55b21",27,25,7,27,0,27,1,2
"20914","90b122ed2057768c5c17c14acd9c6ccd",101,59,49,14.4285714285714,101,0,2,3
"20915","90b1caa967094c28b59cc6f634f133e2",82,64,25,22.96,82,0,2,3
"20916","90b2250ce25e6765324bd88c5612bd0f",20,20,0,20,0,20,1,2
"20917","90b3b9b15030095449eca26feeadd36a",46,46,0,46,46,0,1,2
"20918","90b640695b811fc98f41070068eb2ea4",65,57,55,8.27272727272727,65,0,2,3
"20919","90b6dfe672c83ef056441544fd5e872b",27,27,0,27,27,0,1,2
"20920","90b76a6120fe0c556faa61f500d78de8",200,110,77,18.1818181818182,200,0,3,3
"20921","90b8cdd4267536b294bec9ee1b6f231b",3,3,0,3,0,3,1,2
"20922","90b934acc0bb6a115ac9cc6f0fd866a0",80,59,38,14.7368421052632,80,0,2,1
"20923","90bb15f2badda57b635b7a214b14be0e",18,18,0,18,18,0,1,2
"20924","90bbcd768877682691f06b02ab7ce128",33,33,0,33,0,33,1,2
"20925","90bf3b6c2ce52f5ada46e9e3ef1623db",35,35,0,35,35,0,1,2
"20926","90c0a5d3fca1ad29bc49de40e94a346b",29,29,0,29,29,0,1,2
"20927","90c20154bff5f8f4170b74c63c2d86c1",50,35,37,9.45945945945946,26,24,2,1
"20928","90c30cb27be61c6a962cfe20ab11390c",115,70,81,9.93827160493827,95,20,3,1
"20929","90c394c9f9ae5d23fb79c556f415e2a6",25,25,0,25,0,25,1,2
"20930","90c47956af10bca406f97c9034f503b1",40,18,70,4,40,0,2,1
"20931","90c57e0e9c662d06eaa49c23d33f7137",69,48,72,6.70833333333333,43,26,2,1
"20932","90c62b83db2715862448aee7ff8c9719",51,39,42,8.5,0,51,2,1
"20933","90c78aa37067596b58863c1b9b48632e",18,18,0,18,18,0,1,2
"20934","90cac9f8a78b07e1f9a6106082f9aa91",180,80,74,17.027027027027,155,25,3,3
"20935","90ccabdb1e771a46a7c585ac5bdb4d9e",47,47,0,47,47,0,1,2
"20936","90ccf6bbee6309a11467ac6a66fdb379",41,38,23,12.4782608695652,20,21,2,1
"20937","90d00333400ffdcd6c1be118c474b9b3",43,43,0,43,43,0,1,2
"20938","90d11cc357642484a409735645d6e4d8",48,42,64,5.25,48,0,2,1
"20939","90d24b942a78e75306d397f2bcd1a955",106,78,58,12.7931034482759,106,0,3,3
"20940","90d33216b450ffd0652d67496c51a0ca",26,26,0,26,0,26,1,2
"20941","90d3eaf236bbe5091161534c1f1448e0",95,63,67,9.92537313432836,95,0,2,3
"20942","90d449d3d6466c06cb01369d7762965e",40,40,0,40,40,0,1,2
"20943","90d54528268a4365a18694e6576c9df1",86,51,77,7.81818181818182,64,22,2,1
"20944","90d843b688eac25901728067cbaa1cdf",140,110,63,15.5555555555556,124,16,3,3
"20945","90d84419ac2e1662f8c20273e86ae804",26,26,0,26,26,0,1,2
"20946","90dfa8a6b58c8cbccb0cbe801d50b425",22,22,0,22,22,0,1,2
"20947","90e0d094f59774b898babbf34d04c595",69,60,50,9.66,36,33,2,1
"20948","90e162252cbc2ddac9580e44c3ab984d",147,70,63,16.3333333333333,122,25,3,3
"20949","90e2632780177bac65554cf5d64426fc",48,36,69,4.8695652173913,48,0,2,1
"20950","90e2d6f9e1774d6a99f03e5a75463d28",14,14,0,14,14,0,1,2
"20951","90e40028178a58dc3a952b62330683bb",57,52,73,5.46575342465753,28,29,2,1
"20952","90e42c4d3310a94eb3eac2ff344cb569",52,52,0,52,52,0,1,2
"20953","90e44324df685663dadcafc0fd7b2e41",68,51,39,12.2051282051282,68,0,2,3
"20954","90e5fe905fe98ec553b06d0f12d06b9e",18,18,0,18,18,0,1,2
"20955","90e745c78c5dd7de6bf3db66419f4521",56,56,0,56,56,0,1,2
"20956","90e7eebc445d7d133f30b55ef8cbff92",73,57,51,10.0196078431373,73,0,2,3
"20957","90e7ffe6c3b495f15d9c1aeabe3959e7",54,41,14,27,54,0,1,1
"20958","90e8d678c5b047376d0e343010eebb90",27,27,0,27,27,0,1,2
"20959","90ea544531429f0afff664e6b96bd634",42,42,0,42,42,0,1,2
"20960","90ea654c5d68b4cdcfc4502b9c3992d8",11,10,2,38.5,11,0,1,2
"20961","90ebc07ee2a0552f07274e530b6e664c",51,41,33,10.8181818181818,17,34,2,1
"20962","90ed0bfe040970194138bb920f8176a8",13,13,0,13,0,13,1,2
"20963","90ed68890aa05519eb1f3645e259a18f",13,13,0,13,13,0,1,2
"20964","90ed9db3676d27017cb2e800a7cd0b9b",1,1,0,1,1,0,1,2
"20965","90eee116ecdf78e8117b57dd62b57136",30,30,0,30,0,30,1,2
"20966","90efdd4ab4809cc2f0c36267aecd321c",11,11,0,11,11,0,1,2
"20967","90f0d5e613445696b5c1c478cdc08d23",28,28,0,28,28,0,1,2
"20968","90f3843924da315187a46be0cefecb2a",13,13,0,13,13,0,1,2
"20969","90f749b18d7d4a553fe8f7c9f83dba04",21,21,0,21,21,0,1,2
"20970","90f77ea59fc19957ca5595f13f4c02ab",44,44,0,44,44,0,1,2
"20971","90f9eb0d5a6e5bed83500814feebcc39",43,43,0,43,43,0,1,2
"20972","90fa001050625353584f4e65f04635af",44,44,0,44,44,0,1,2
"20973","90fc7ad5c6e3def731b2c72c867186c2",101,60,47,15.0425531914894,73,28,2,1
"20974","9101158fc44107bea152300387d7e091",59,51,71,5.8169014084507,59,0,2,3
"20975","910229e3cdf9814852e90bb659cf7138",43,39,59,5.10169491525424,32,11,2,1
"20976","9102b2bd62c6b18b22ce0a0c3ffd01e3",30,30,0,30,30,0,1,2
"20977","91032e8271f8170f320fdd0ec9598b45",62,55,30,14.4666666666667,62,0,2,1
"20978","9103f2945889ba0278366363e06a828b",23,23,8,20.125,23,0,1,1
"20979","91046cbcbc5f54782ca21dd10b2d89cc",31,31,0,31,31,0,1,2
"20980","910537a13e4c0d4cab313bd28c65f598",124,76,46,18.8695652173913,124,0,3,3
"20981","910736ac9e7b33ac4168d2773e57cee2",21,21,13,11.3076923076923,21,0,1,1
"20982","9109c1ed5eb3d23d6a053791577dcb37",71,54,57,8.71929824561404,71,0,2,3
"20983","910b71ce6692769163d962e609e6f70d",16,16,0,16,16,0,1,2
"20984","910e9ff3e8c7e92d02ff01ebd2a9a9fa",141,75,67,14.7313432835821,141,0,3,3
"20985","910f980ff778d262d762551071263ab4",41,28,39,7.35897435897436,41,0,2,1
"20986","910ff5b4f1cacec2fa7f75fa8635c2d9",18,18,0,18,18,0,1,2
"20987","9110798eee3c80951c7457ed78c97c34",27,27,0,27,27,0,1,2
"20988","91128985d2052b2a2f10878d3eda5f45",28,28,0,28,28,0,1,2
"20989","9114213381881bb9ebebde4d42550264",176,116,85,14.4941176470588,159,17,3,3
"20990","91147ede8d04800345d10225fe1818de",33,33,0,33,0,33,1,2
"20991","9114afc30ff2b3cbb799bba62954304e",73,61,43,11.8837209302326,73,0,2,3
"20992","91172954c738e0b913a522046e12c3a6",71,46,61,8.14754098360656,71,0,2,3
"20993","9117952c0e18e2328f43978cac2f34a7",88,64,17,36.2352941176471,37,51,1,3
"20994","9119da17e5048816562eb2bc695dc2ee",28,28,0,28,28,0,1,2
"20995","911a31331a6c77a6e9b9254fe0dfe464",36,36,0,36,36,0,1,2
"20996","911d53ebf5dea72eeba1432f026e4a05",42,42,0,42,0,42,1,2
"20997","911e0587213f47db774177e54cfc3790",53,44,11,33.7272727272727,53,0,1,2
"20998","91223ae9fe8cc0ff83ae36b1bf2c8fe7",69,42,82,5.89024390243902,69,0,2,1
"20999","91225b1c8ca27b251579221bf6ffa0d8",107,76,67,11.1791044776119,107,0,3,3
"21000","9123691dd80fac8178d64d97b84bac01",116,65,65,12.4923076923077,91,25,3,1
"21001","91245e4d6d8cd7ff1a28b8c1b5e80634",163,77,85,13.4235294117647,136,27,3,3
"21002","9127194aabf5f5c254ec6d81328b1721",90,67,36,17.5,62,28,2,1
"21003","91287f73062c057f4551fba33ebddd20",69,53,23,21,69,0,2,1
"21004","9129e0e48e6fa1ba7727a6a503c31b6b",41,32,70,4.1,41,0,2,1
"21005","912b52daec23db6a1e5f6913bffdc1be",20,20,0,20,0,20,1,2
"21006","912d569926ee3738dea54e4f15d8e28c",86,62,63,9.55555555555556,86,0,2,3
"21007","912fe3bd6d51c53be3879de3c3d2a6bf",1,1,0,1,1,0,1,2
"21008","9132aabfd622991ec243686f03111eb4",21,21,0,21,0,21,1,2
"21009","9132e5ebccc52ff4541240ecc7af2907",55,55,0,55,55,0,1,2
"21010","9133b7566e40bdcb6d9f636bf392b03e",153,116,41,26.1219512195122,103,50,3,3
"21011","913608296702f401db853194cbb7ed3c",222,106,87,17.8620689655172,186,36,3,3
"21012","913648a88f44890dd7c055a52b37b3c4",14,13,3,32.6666666666667,14,0,1,2
"21013","91373456f6623a64c4fa24cc1d7b08d3",47,38,51,6.45098039215686,47,0,2,1
"21014","913782199eab96de97d8edb9f9165e79",53,53,0,53,53,0,1,2
"21015","91395265a418125cdef2b0e0d3566d4b",4,2,71,0.394366197183099,4,0,2,1
"21016","913b38f7993a741b81c120147a88913c",39,39,0,39,39,0,1,2
"21017","913bc48666102fb1c557a4d70ea5441b",17,17,0,17,17,0,1,2
"21018","913e2ce59d5f13e72dfd12220f04aa00",191,97,82,16.3048780487805,168,23,3,3
"21019","91411ad32c175629ea66704208c06756",90,49,41,15.3658536585366,36,54,2,1
"21020","9143aa8c7f6b8e604e79d837bf42b02a",16,16,0,16,16,0,1,2
"21021","9144dbc58f12d447e9b3435ebce23159",110,76,80,9.625,87,23,3,1
"21022","9146382b561b0f2a9f896269c2b9833c",190,114,84,15.8333333333333,159,31,3,3
"21023","91493a09988d6b279e5a1cbec9467093",113,75,33,23.969696969697,68,45,3,3
"21024","914a8241ba0d5ffc49556c2504c3767e",29,29,0,29,0,29,1,2
"21025","914aa64832a5bafe26a2f8b9e62a9842",39,39,0,39,0,39,1,2
"21026","914cee696bec1f85c6029d6a05f8e146",75,49,66,7.95454545454545,53,22,2,1
"21027","914ed52a6235aa8ada88fd61f783685b",129,72,44,20.5227272727273,93,36,3,3
"21028","9156008e57ec23e047ed74261b83773c",163,85,61,18.7049180327869,163,0,3,3
"21029","9156baf0215a11c14f20722e59e648a2",20,20,0,20,20,0,1,2
"21030","9157778c651df0b8895574d2698528e0",22,22,0,22,22,0,1,2
"21031","915921500eae7405d02ec51290a79690",79,40,74,7.47297297297297,74,5,2,1
"21032","915ea875ecdf72921a8f788c3a906dee",71,48,76,6.53947368421053,58,13,2,1
"21033","915f1b73b74f4d5a8de432e0f6ad0c3e",35,35,0,35,35,0,1,2
"21034","915f89d0a921ce09217a2d9c64622771",18,18,0,18,18,0,1,2
"21035","91607ea470727f5455929567b953af58",97,86,14,48.5,97,0,3,2
"21036","9160b3dbc12e4b78e4112803e66ba291",31,31,0,31,31,0,1,2
"21037","91610e515fb4974af3452d56880f9bb9",40,40,0,40,40,0,1,2
"21038","916153d047a8e4b1debbe101496856dd",168,114,33,35.6363636363636,168,0,3,3
"21039","9164885878b6a92f9af2c5280a925cc4",196,124,49,28,152,44,3,3
"21040","9164bce674267c60ba0668c995d2547e",35,35,0,35,35,0,1,2
"21041","91656d4e0edff7288b1c6e20f3b45f71",26,26,0,26,26,0,1,2
"21042","9166583c7721411086800cae89a8ef53",13,13,0,13,13,0,1,2
"21043","9166e913f951248b07ab674a2a0214df",192,122,61,22.0327868852459,192,0,3,3
"21044","9169274e459f8fac5c8dafd57fb8ceef",74,50,55,9.41818181818182,74,0,2,3
"21045","916c7d27aeea9637a596e8a077613ebf",31,31,0,31,31,0,1,2
"21046","916cb5ca6527fe488bcf6098ca3a9e98",7,7,0,7,7,0,1,2
"21047","916d117b073dfa0e3023a6dcf4a39614",14,14,0,14,14,0,1,2
"21048","9170488ee93d24f7384c69ca98a2fd66",51,41,26,13.7307692307692,51,0,2,1
"21049","917160d305242d1496fbfb64ce992a9f",22,11,77,2,22,0,2,1
"21050","9172996e26da36f013ffcb34d7df6062",21,21,0,21,0,21,1,2
"21051","9172ede1647384dc75ce7f69fe719a4f",75,70,28,18.75,75,0,2,1
"21052","91757a28751f9922086a160070e9648c",32,32,0,32,32,0,1,2
"21053","91776618fc92a71deb661f720cb1bb32",216,108,89,16.9887640449438,216,0,3,3
"21054","91790d330f2e8993a588b15b293e3cfe",14,14,0,14,14,0,1,2
"21055","917b06c7028df72252f0f24bfd74cd7a",83,61,56,10.375,83,0,2,3
"21056","917ce3b8dafe861d9833433f072c624b",51,36,56,6.375,51,0,2,1
"21057","917dd60080003960e1ab75739a58aa74",45,45,0,45,45,0,1,2
"21058","917f4d6607c8aafc8afe224d1981526d",146,99,58,17.6206896551724,102,44,3,3
"21059","9182350f8e6af4b81e980883bea27c76",56,40,51,7.68627450980392,56,0,2,1
"21060","9182c688733ea45043801dc467cf1696",30,26,45,4.66666666666667,17,13,2,1
"21061","9183e18a37491aad59522e004bd1e9c4",218,113,63,24.2222222222222,218,0,3,3
"21062","9184327b9d00f76f60edcd745da2e23f",49,49,0,49,49,0,1,2
"21063","9184665c7a8d76dec6aea0535acd8188",91,77,20,31.85,91,0,3,3
"21064","9184c5cf83e8a57d2d394926ba6749fc",17,17,0,17,0,17,1,2
"21065","9184d72af8fdcb394cc5ea44d9c71e9c",20,19,7,20,20,0,1,2
"21066","9187b960a346a254e4914281f23a5fde",52,52,0,52,0,52,1,2
"21067","9187cf42ba2ec0bfb683b1734f91451a",35,20,14,17.5,35,0,1,1
"21068","918b596e5639f6d6d0ea0b82e3f8d6b7",143,97,55,18.2,143,0,3,3
"21069","918b9baf7aa7fb25c0b6ffa5a06b6655",35,35,0,35,35,0,1,2
"21070","918cd53585c86886b62190dbe20ddfc4",81,74,13,43.6153846153846,49,32,1,2
"21071","918e9f9f5b91a0e88a11ed2e9d56704c",61,57,31,13.7741935483871,61,0,2,1
"21072","91905e51f09ec823ca2bd97fa9c4accb",97,70,39,17.4102564102564,55,42,2,3
"21073","9190978cac643908938a3ba820363db3",18,18,0,18,18,0,1,2
"21074","9192eccc4347a1a4d1f608d0502d4809",26,23,62,2.93548387096774,26,0,2,1
"21075","9195229f9712d5a80bc4bdca1cab4969",40,38,24,11.6666666666667,40,0,2,1
"21076","919d4ea5833bd0a23d8112c888707acf",50,39,64,5.46875,50,0,2,1
"21077","919f0baaf003963d22467f279e47f91e",51,39,69,5.17391304347826,51,0,2,1
"21078","91a1b99a9072596048f24255c367c8e6",66,45,52,8.88461538461539,66,0,2,3
"21079","91a4271e2d8be06d2ea5ea0c186501ee",25,22,43,4.06976744186047,25,0,2,1
"21080","91a43a5a3189c988b24e38cc58ef87a9",24,24,0,24,24,0,1,2
"21081","91a72862d8041d6af1d757537f39e082",122,82,43,19.8604651162791,122,0,3,3
"21082","91a82d63a2f0869f13bc74a1ee3879e4",73,44,35,14.6,47,26,2,1
"21083","91a868bbbcfc3996192f479eeec34745",39,24,15,18.2,39,0,1,1
"21084","91a87a2dc587144451059d9d7d6e0f87",9,9,0,9,9,0,1,2
"21085","91aa6f8c067aea3cdc851ad5a345e521",91,75,68,9.36764705882353,47,44,2,3
"21086","91aafd0ac0ee9b713de8888560efc97e",73,56,34,15.0294117647059,73,0,2,1
"21087","91b3ba15e1dfc71c866fb150d34f3f77",113,82,82,9.64634146341463,113,0,3,3
"21088","91b75e6622e33c0fa6568051ac0eff2e",37,37,0,37,37,0,1,2
"21089","91ba44e8fd1d811e7d40d32aaec5c5bc",136,99,45,21.1555555555556,136,0,3,3
"21090","91bb0b9c657968c66537a8b29302b5e2",28,28,0,28,28,0,1,2
"21091","91be5b3c1c4f403c5178fcd6debab735",65,45,48,9.47916666666667,65,0,2,3
"21092","91be86ef41ec714b55775606846b0906",34,34,0,34,0,34,1,2
"21093","91bedd97e0e9576edc7441380de600bc",17,17,0,17,17,0,1,2
"21094","91bfe1f82f10e8c3598d4ed45935ec51",11,11,0,11,11,0,1,2
"21095","91c09f6316f1e7d302d7815354e770c1",29,29,0,29,29,0,1,2
"21096","91c3ee3199c8801e8cd1a50dff75c749",61,43,10,42.7,40,21,1,2
"21097","91c4455b9163d862a43589f427ab0769",9,9,0,9,9,0,1,2
"21098","91c6c792d3dd7c02676eaa9eebb49cbd",38,38,0,38,38,0,1,2
"21099","91c928c029af295bb2482e0ce3233469",29,29,0,29,0,29,1,2
"21100","91ca4414aec2f27a1ecd0ea41a1fdb19",50,39,45,7.77777777777778,50,0,2,1
"21101","91ca687bf88b38e212a2ec98f8808ffe",192,119,42,32,153,39,3,3
"21102","91cd3bff2e8e5cf5b8b2c4102550e603",11,11,0,11,0,11,1,2
"21103","91d0db6338b0e7d330a2ecff896a018a",58,36,73,5.56164383561644,58,0,2,1
"21104","91d127413a71c4d20f78327a762336be",34,34,0,34,34,0,1,2
"21105","91d15cd0be1f3676421c8bd4621141dc",112,44,84,9.33333333333333,112,0,2,3
"21106","91d4c4f3ca3a6ae3de6e8bfa37095c78",137,76,57,16.8245614035088,137,0,3,3
"21107","91d4e3f32e3344437738f95ab0f0d3c5",37,31,26,9.96153846153846,17,20,2,1
"21108","91d6854cbe30877a081f3afaa2f3197a",15,11,36,2.91666666666667,8,7,2,1
"21109","91d979fc876ab23a257b1dfde1f2ac74",51,43,36,9.91666666666667,29,22,2,1
"21110","91d997dc18abe81609cfde446461d39a",8,8,0,8,8,0,1,2
"21111","91dba775a2bc1eee5e461ade62fcb414",40,34,21,13.3333333333333,40,0,1,1
"21112","91dd00f9dead2bf04338bc9d488c2577",15,15,0,15,0,15,1,2
"21113","91de3f963c3f6fd5e4fedeee1b0571c7",20,17,5,28,20,0,1,2
"21114","91de430dd90ce3685cea876796542187",18,18,0,18,18,0,1,2
"21115","91debfc4ed6c1a855576aa3b681a527a",67,64,50,9.38,33,34,2,1
"21116","91e1ee25e8ed78388a7589067d7037d3",25,24,8,21.875,25,0,1,2
"21117","91e387db6abb033bbd63939d59555527",20,20,0,20,20,0,1,2
"21118","91e803d8187b2723f44c61d6ba0827a2",55,43,15,25.6666666666667,27,28,1,1
"21119","91e8f9d4388177f186d12990aa8aabe1",89,68,18,34.6111111111111,89,0,1,2
"21120","91e9f3099654fe600620ad87ee0039de",54,45,44,8.59090909090909,54,0,2,1
"21121","91ea536899d11e1219ac33aa176628d7",15,11,43,2.44186046511628,15,0,2,1
"21122","91ecae80d80ac6ee3d94ce0a396af84b",33,33,0,33,0,33,1,2
"21123","91ee2a281a608c8af6b2d494e36327d3",26,26,0,26,26,0,1,2
"21124","91f045e1f48954502dc9a08d66403fe4",133,100,70,13.3,133,0,3,3
"21125","91f108523192609981670f928ba48876",136,74,77,12.3636363636364,136,0,3,3
"21126","91f340bc60eedebc9523b3dd9b6a9d65",35,35,0,35,35,0,1,2
"21127","91f566b5c97183c7a7a7bc22c02fb568",24,20,70,2.4,24,0,2,1
"21128","91f7053185cc551557e0e1fe9526271b",33,29,47,4.91489361702128,33,0,2,1
"21129","91f9790608c76c3c8d85b0b7fd80525f",56,38,59,6.64406779661017,40,16,2,1
"21130","91fc28bbb57c95543f3d3ca01baecb94",240,111,60,28,208,32,3,3
"21131","91fe759231d4a2a12fcb18a1c16c51ab",60,45,63,6.66666666666667,60,0,2,1
"21132","92020725db4ce2cc84e8c173e428c71b",179,138,49,25.5714285714286,179,0,3,3
"21133","9202a257cd075eba9afe97baa694c098",69,55,38,12.7105263157895,69,0,2,3
"21134","9205eee6a382dd79ca5c8b727aef02b0",112,71,61,12.8524590163934,112,0,3,3
"21135","920681b49624a083c4c511ee65a616b4",6,6,0,6,6,0,1,2
"21136","9207c955433f25ff5f064c568ead0bcb",192,100,81,16.5925925925926,192,0,3,3
"21137","92096ea7e5b3131a8e70012e22edfa29",102,70,76,9.39473684210526,102,0,3,3
"21138","920a7c205cb8559b9276000aee01de90",55,46,16,24.0625,38,17,1,1
"21139","920caa4b5f8a3cf0cea7329f4244bbe5",1,1,0,1,1,0,1,2
"21140","920d52f97978f784b8f47e11c256be81",37,37,0,37,37,0,1,2
"21141","920e39b51e288b92b93ec7017d10997a",34,34,0,34,34,0,1,2
"21142","920f5ec7e2a5600a3829db3c3138fb76",70,57,13,37.6923076923077,70,0,1,2
"21143","9210f4ee00ef39984abaf5c63d6b262b",48,48,0,48,0,48,1,2
"21144","92112a9631262491a0a05ca0fd99d1b1",110,72,40,19.25,68,42,3,3
"21145","9211892d140a26e6e1171c3d8f75daa8",71,45,47,10.5744680851064,71,0,2,3
"21146","92126c307f8b527806e4d3e3bb0cd7d1",220,112,71,21.6901408450704,185,35,3,3
"21147","921535fc524491fc458dff785e86674c",18,18,0,18,18,0,1,2
"21148","921b4461258b1e71b40d3fb564ad6144",30,25,60,3.5,9,21,2,1
"21149","921b9de7520235bfc206395d63f13a93",38,38,0,38,38,0,1,2
"21150","921c0eecda7231e64f82be77c05bd311",118,81,67,12.3283582089552,118,0,3,3
"21151","921cc7356ce901ca065c2553a01b2495",175,107,56,21.875,175,0,3,3
"21152","921e37245a77111b64d25e61191137cf",33,33,0,33,33,0,1,2
"21153","921fda6fed8ae4999efbc1e26d76f12e",29,29,0,29,0,29,1,2
"21154","922177fb5dbcfc954a61edfadaa5161b",77,58,49,11,77,0,2,3
"21155","92226d85b5de8c0a931b2797d36c5576",24,24,0,24,0,24,1,2
"21156","9224d842d99d33fbe6d99ced44562def",21,21,0,21,21,0,1,2
"21157","9224d8fc8c4a14fb9bc14c4f4da0a035",58,49,10,40.6,58,0,1,2
"21158","92253c8f744650f0b575165900f11eb6",27,27,0,27,27,0,1,2
"21159","9227a2863c2e5eaceee80fdf34a3f0ef",33,33,0,33,33,0,1,2
"21160","922811ce1c2497a23840270b8f9a753f",39,39,0,39,39,0,1,2
"21161","92288d8757b10008306a6ab83b5c91ef",15,15,0,15,15,0,1,2
"21162","9228bf87ea1ec3db1d0c95e757428e79",88,45,60,10.2666666666667,78,10,2,1
"21163","922cc3a2059ef8cd8de594e4f9f69d4b",14,14,0,14,14,0,1,2
"21164","922e5de51d4e0e769ba570bcbdf4358a",19,19,0,19,19,0,1,2
"21165","9231422d37992ffce5d234b5c602edba",22,22,0,22,0,22,1,2
"21166","9232683ab2faaceabaff5e3a4e9b7176",48,38,18,18.6666666666667,48,0,1,1
"21167","92341f64169df70f57b0b921aade6dcc",34,34,0,34,34,0,1,2
"21168","9234fae8677e65ef96bebaa5297c1b20",92,75,21,30.6666666666667,92,0,3,3
"21169","92369c6fde002f45b6a54752b7eb018d",39,31,59,4.6271186440678,39,0,2,1
"21170","9237676f9baafc004bbaa52a5df5e11f",13,13,0,13,13,0,1,2
"21171","9237c83b0d456ffbf8515cab8d26144a",18,18,0,18,18,0,1,2
"21172","923a8c53b235d3b010b0f9c3ec0c449b",104,79,56,13,104,0,3,3
"21173","923d2dcd6c6cae7abfac1eaa99376c49",129,58,78,11.5769230769231,129,0,3,3
"21174","923da37747fc7b37553efe29ecd1921e",21,21,0,21,21,0,1,2
"21175","923e086cf260fbb2f5cb938fded4a4b5",97,59,70,9.7,97,0,2,3
"21176","924241775b7c2dc1089e6f10a582aa25",32,22,69,3.2463768115942,32,0,2,1
"21177","9245cab2451366d8b02d0dace6ae2392",15,11,31,3.38709677419355,15,0,2,1
"21178","924acdf7c7ac98365353dae5c592d6da",32,24,38,5.89473684210526,32,0,2,1
"21179","924c0675680499e67a6d0ad2f7b40956",75,59,52,10.0961538461538,75,0,2,3
"21180","924d085b5a7795f361b107dbe1bca1d3",35,35,53,4.62264150943396,35,0,2,1
"21181","924dadf0349008b311bad05379ec7613",37,36,10,25.9,20,17,1,2
"21182","924ec3a313015b4f95b0326815a0adab",11,11,0,11,11,0,1,2
"21183","9250415514cc261e2ebb1d2b3f07f8e7",77,51,62,8.69354838709677,77,0,2,3
"21184","9251d36a4a86cbee3e649ce08407bcff",22,22,0,22,22,0,1,2
"21185","92522ed9aef1125aeb26516ba6117dd3",15,15,0,15,15,0,1,2
"21186","92534a06f46af860f4683bcdd8471a63",76,48,68,7.82352941176471,57,19,2,1
"21187","925408081a19fd9d3197be4d09837f17",17,17,0,17,17,0,1,2
"21188","9254d5f0fd0905deff9507888cbaed58",48,48,0,48,0,48,1,2
"21189","9254f56dde26ad9386ca7c6f5ced2fc6",24,18,54,3.11111111111111,14,10,2,1
"21190","92581182b0201fe0695a7b1ef0437683",152,68,74,14.3783783783784,152,0,3,3
"21191","92594c683216e59dce799b7d6422595a",43,43,0,43,43,0,1,2
"21192","926095c78ba87675cf3693766212fd43",30,30,0,30,30,0,1,2
"21193","9261e59f6a3519c5c9f8a1439ab111e4",23,23,0,23,23,0,1,2
"21194","9263128ec37015dc6dc78a58173b43db",30,19,0,30,30,0,1,2
"21195","9267a338e96744a63088d3f3dc27e603",11,8,50,1.54,11,0,2,1
"21196","926cc852c3c6fbfe893d1cab88cde79c",95,54,70,9.5,50,45,2,3
"21197","926d85cf4f3d4e5d11dafb203d475589",55,47,23,16.7391304347826,27,28,2,1
"21198","926e0eb9734134945977b6cc4e978f53",47,47,13,25.3076923076923,47,0,1,1
"21199","9273a7a52432f414e62b61c28d785d57",5,5,0,5,5,0,1,2
"21200","92748a3d73c5897f723bb9b6bce21d9e",110,63,77,10,110,0,3,3
"21201","9275ed78d045eda35c0f5fb06fdaa298",38,34,8,33.25,38,0,1,2
"21202","9276d5e09c24b6df1d729fee98ba96fd",123,96,58,14.8448275862069,69,54,3,3
"21203","9276e5502cd9b168df35e5617d86cfc9",6,6,0,6,0,6,1,2
"21204","9277655cb59006053f5a19109e59a3f6",2,2,0,2,0,2,1,2
"21205","92776f77a6c2c7c2a31ee38758b794e9",64,51,27,16.5925925925926,64,0,2,1
"21206","927821d2bb0071bb87ffa84879815211",42,41,53,5.54716981132075,42,0,2,1
"21207","92784948325c30aa386b6206fcd7e941",21,21,0,21,21,0,1,2
"21208","927993940b2c8c83faeb14eed3d4e96f",32,32,0,32,32,0,1,2
"21209","927b093f324797b211150467da721da8",95,74,67,9.92537313432836,64,31,2,1
"21210","927b501cca820a16337a35bd875cd13b",25,25,0,25,25,0,1,2
"21211","927bcf71edfe42152ddfc7a44fba33ff",40,28,46,6.08695652173913,40,0,2,1
"21212","927cee439649bfc98b3864a71bbbfdad",53,35,18,20.6111111111111,53,0,1,1
"21213","927ebe1cfdfcf5cab89b1ac7f777cfd0",12,12,0,12,12,0,1,2
"21214","9281f15d8f37d081b97601419b409d6b",36,36,0,36,0,36,1,2
"21215","9282c521405e0c85480717d5fff28055",175,97,53,23.1132075471698,175,0,3,3
"21216","9285f06902ea713e0a2965a66d22a010",14,14,0,14,14,0,1,2
"21217","9287c602c6826a6177d6f0820bfcab4b",103,92,46,15.6739130434783,103,0,3,3
"21218","928ac324fb9f54d6cc73e48567bc455f",146,91,70,14.6,146,0,3,3
"21219","928b8298358c39b642cf980a3ba8bcfa",24,24,0,24,24,0,1,2
"21220","929020a6cd8b3a9fe2a1eead93096ea5",184,99,77,16.7272727272727,154,30,3,3
"21221","929284bc24b456cee024ca998b340c85",218,128,76,20.0789473684211,202,16,3,3
"21222","9294e9e46051fd4bbabc5ea41ed8f2c0",16,16,0,16,16,0,1,2
"21223","9295b5f2a51ed0487b5d64ba0708c7e0",130,72,77,11.8181818181818,130,0,3,3
"21224","9299932a4795276fdea447bb8eba8476",25,25,0,25,25,0,1,2
"21225","929b1eb21549c426681a3f6ea599589e",145,86,42,24.1666666666667,145,0,3,3
"21226","929bb90fbc77db61d96981a699a3f090",94,45,35,18.8,94,0,2,3
"21227","929bc40a65f5783a08bb61f8f4b03e88",47,38,14,23.5,0,47,1,1
"21228","929db22cb9d5b39b66223288f3916b25",30,30,0,30,30,0,1,2
"21229","929e8925e10f5739b96e71338f1d5ee7",172,77,69,17.4492753623188,125,47,3,3
"21230","92a0562d9e81613ab47afd712a9a4660",113,57,63,12.5555555555556,113,0,3,3
"21231","92a334162d2498af7c712c55f0aaa1e4",28,28,0,28,28,0,1,2
"21232","92a479643594063cb19ef24dc5ec7635",2,1,13,1.07692307692308,2,0,1,1
"21233","92a5731b049d98a0f51843c94a71d56e",48,48,0,48,48,0,1,2
"21234","92a594fc4ff6f9ce77573a84b78a4b80",26,26,0,26,26,0,1,2
"21235","92a8650831b389c0f0ef645d0565efd8",147,94,54,19.0555555555556,147,0,3,3
"21236","92a8aaff64ff626052548ee4923e5b51",33,33,0,33,33,0,1,2
"21237","92aab9cebcafa3a947e7687c73c1baf5",205,101,73,19.6575342465753,205,0,3,3
"21238","92accae169eea4da51dd34b77a688008",49,49,0,49,49,0,1,2
"21239","92ad0f5c94b60a1762ec599d3205a9d6",1,1,0,1,1,0,1,2
"21240","92ad7484c6925a60ca4c41ce0e521d34",38,38,0,38,38,0,1,2
"21241","92af6b6717f2db68704fce4c8be30221",2,2,0,2,2,0,1,2
"21242","92b1c87d48f36999c97f2b2172242c2a",204,106,69,20.695652173913,204,0,3,3
"21243","92b5d70ef2a45a17889a0625a3999892",33,33,0,33,33,0,1,2
"21244","92b7f403d84fbd9d78cf65d3eecda314",36,26,62,4.06451612903226,36,0,2,1
"21245","92bda890917247de71497423cd52447e",65,57,20,22.75,65,0,1,1
"21246","92c084683518ef0c4ce952ea4dde11ba",182,112,77,16.5454545454545,129,53,3,3
"21247","92c34590ee3ee106596ca34a9aefb0f3",28,28,0,28,28,0,1,2
"21248","92c7c52b05a6867c0dff360ae2068e22",29,29,0,29,29,0,1,2
"21249","92ca0ae100881aec183f548b66377289",12,12,0,12,12,0,1,2
"21250","92ca6ca0e9da779fd20f79d14bd45047",143,67,53,18.8867924528302,143,0,3,3
"21251","92ce3a4bb3d73002c46c83c4e14980c3",38,38,0,38,38,0,1,2
"21252","92ce6b4c440938b012a12d5a8d072ca3",61,47,36,11.8611111111111,61,0,2,1
"21253","92ce88730f4a102e51c62af2ec510a0b",14,14,0,14,14,0,1,2
"21254","92ced377786ab1e2f686c0da17e17d87",13,13,0,13,13,0,1,2
"21255","92cf6964e5b91431ee43c5f4b66f15f2",66,57,61,7.57377049180328,23,43,2,1
"21256","92d0e3d56221af4019dada56ad5f0cd4",1,1,0,1,1,0,1,2
"21257","92d1ef5f4152d018da66b56077d8bf76",63,57,17,25.9411764705882,35,28,1,1
"21258","92d2a8dc0ac8bec890e59bd80ef6c337",85,57,69,8.6231884057971,85,0,2,3
"21259","92d56a8df532c679cd70e8e1f5988f0c",52,32,30,12.1333333333333,52,0,2,1
"21260","92d670c96696a9160b263f6407c9b943",96,61,54,12.4444444444444,96,0,2,3
"21261","92d7b2f2ef5d63cd739e4eddd5f6ad10",46,46,0,46,46,0,1,2
"21262","92d7b6c1374413dd38fb086edd38e0aa",53,49,42,8.83333333333333,0,53,2,1
"21263","92da36f67e0e911d2aa0e69f36fde784",24,24,0,24,24,0,1,2
"21264","92da48694ff2b60cbbbdc037f3175076",30,30,0,30,30,0,1,2
"21265","92de7d6651b0a349c8ad7eb23605de2e",31,31,0,31,31,0,1,2
"21266","92def3fe84f244f6a8d54c7bf6a3b486",37,37,0,37,37,0,1,2
"21267","92e0f018f623f7ce21549cc998bb7fdf",20,20,0,20,20,0,1,2
"21268","92e4ffb7d9d70e37068f22185b03aa3c",27,27,0,27,27,0,1,2
"21269","92e82a6c43e6afc6d9652ea0334453b6",9,9,0,9,9,0,1,2
"21270","92e84957044fd18e93f26bb451dbfa22",25,25,0,25,25,0,1,2
"21271","92ebca61cd2584074863758086b38a27",54,50,23,16.4347826086957,54,0,2,1
"21272","92eea334889b87fb30f7aec2e9457499",25,25,0,25,0,25,1,2
"21273","92eee5db87ea39a561a2656e87e9152f",8,8,0,8,8,0,1,2
"21274","92f282d8e1728f978791e4a1d48aa8e9",97,64,61,11.1311475409836,68,29,2,1
"21275","92f3d156215f3fd20e5c57528ad5fc3b",46,46,0,46,46,0,1,2
"21276","92f40c9476778d52cfb089a2abb57560",17,17,0,17,17,0,1,2
"21277","92f43b1a496b326f9bd8d14865f8e6cc",182,93,70,18.2,182,0,3,3
"21278","92f52e9375a4799c661c8516525e9297",54,47,17,22.2352941176471,54,0,1,1
"21279","92f6c916cac2bb552088853c2c115658",4,4,0,4,4,0,1,2
"21280","92fd38529325954e91202ec310f71f77",51,44,81,4.40740740740741,33,18,2,1
"21281","92fe66b81263835810430486aa5c84f4",1,1,0,1,1,0,1,2
"21282","92ff2b1c0728ddaf688a3d69b1e0cc19",204,101,66,21.6363636363636,204,0,3,3
"21283","92ffda5e74db38fc5a14f053f17c47fb",97,67,47,14.4468085106383,97,0,2,3
"21284","930060df66f7c461841dfb96ef856631",162,115,70,16.2,162,0,3,3
"21285","9301d8b2089fe08035f4325aff0b7865",25,25,50,3.5,10,15,2,1
"21286","9304bc55204df033554d5948f97f40b8",45,40,53,5.94339622641509,45,0,2,1
"21287","9306a0eba5dea7bd1eb1c681d8df9b98",42,33,13,22.6153846153846,42,0,1,1
"21288","93073c2ce00c0dcc20f601ab4a38d89d",192,130,69,19.4782608695652,192,0,3,3
"21289","930c81bc9c8af543b37ac9e418af551e",28,28,0,28,28,0,1,2
"21290","930d80e6ab648352886e05cfc17da715",202,118,70,20.2,202,0,3,3
"21291","930efd2925b909dfab1329c820f96f30",16,16,0,16,0,16,1,2
"21292","9312f1c7fb427f25615b9c1d4e95fb94",22,22,0,22,22,0,1,2
"21293","93199fd5d28f304c5639db9a29d633d7",21,21,0,21,21,0,1,2
"21294","931aa04c4f3320178183c654da1c20aa",18,18,0,18,18,0,1,2
"21295","931d682a60dade49779592324c7406b8",216,117,63,24,216,0,3,3
"21296","931dae3af341afa126f790f61843fe5b",64,51,9,49.7777777777778,33,31,1,2
"21297","93208e6ebea7776f99bd7280f5bc3022",24,24,0,24,24,0,1,2
"21298","93214ca352c53eabe4c8b51641cb10cd",21,21,0,21,21,0,1,2
"21299","9322d30012e14df6840593355a7591fc",53,53,0,53,53,0,1,2
"21300","93264828db394f0312a34222ecc6ec4e",1,1,0,1,1,0,1,2
"21301","93266a8ad294033077e350a14a476cdd",8,8,0,8,0,8,1,2
"21302","932a270d7290365e4bc73f6440ddabd7",8,8,0,8,8,0,1,2
"21303","932aa605c91a6b1208fe85cbd8b326ad",199,129,68,20.4852941176471,145,54,3,3
"21304","932ce6b853a69b7b2ac4abe5be4374c1",76,48,52,10.2307692307692,76,0,2,3
"21305","932db16db7193d948968b1edc149a7d0",151,67,63,16.7777777777778,151,0,3,3
"21306","932f68da459c641cd1fa9f05fb32298c",35,35,0,35,35,0,1,2
"21307","932faa7b2e2ffc18fcfca301690c5b86",40,35,28,10,40,0,2,1
"21308","9332bc154caacd1246c94f2830cc4ca9",27,27,0,27,27,0,1,2
"21309","933375301be6cd93acad493826165412",13,13,0,13,13,0,1,2
"21310","9334dc302235f83b6426247044cce625",107,68,55,13.6181818181818,107,0,3,3
"21311","933907bc308b3b63fd1ee93b2ad78e9a",2,2,0,2,2,0,1,2
"21312","933970e6aca68af2f347790e9773ca40",25,25,0,25,25,0,1,2
"21313","93398fd164669cde8f2fbd593c90ab87",183,107,46,27.8478260869565,183,0,3,3
"21314","933a4ded1cfe505396db82ea27f2020a",43,43,0,43,43,0,1,2
"21315","933b3833a618fe6abccfa31200d945bd",107,67,56,13.375,107,0,3,3
"21316","933c34f0557f097e11046548b7265277",66,52,40,11.55,66,0,2,3
"21317","933da19294a086f7ae9fe9976a883486",229,91,74,21.6621621621622,188,41,3,3
"21318","933e3738c5bc043c01b6a4744abe57e0",40,12,84,3.33333333333333,40,0,2,1
"21319","93408bbf94f805b2f8f971e6e0d70541",35,35,0,35,35,0,1,2
"21320","93409fad63860b87fb7cc1c25d1c3422",6,6,0,6,6,0,1,2
"21321","9340ad099d13f861359a3a54e8179b04",87,76,43,14.1627906976744,37,50,2,1
"21322","9342816b78dac25c1780f5f4e89ba64e",169,107,85,13.9176470588235,169,0,3,3
"21323","9343be3dc44bef5ad78e5b1745748051",8,8,0,8,8,0,1,2
"21324","9344235c34f08511d2d42ab16d6349a2",41,41,0,41,41,0,1,2
"21325","9344340fbe04f8bfcc5502b4f9a4a038",7,7,0,7,0,7,1,2
"21326","934463bb0e711075793df1b6475e9abf",205,127,70,20.5,205,0,3,3
"21327","93457acb68589393a4b5612f73093746",18,18,0,18,0,18,1,2
"21328","934887331d3f507018e87db1b7aedf51",29,29,0,29,29,0,1,2
"21329","9348c282168c11d5330751b51adbd776",124,84,84,10.3333333333333,86,38,3,3
"21330","934af8d32292c8b52ea09e1b70d9154f",25,25,0,25,25,0,1,2
"21331","934bd29848575e1db7fd609179742007",67,54,54,8.68518518518519,67,0,2,3
"21332","934c967c753c3dd3e3bb7fe07e96f73d",4,4,0,4,4,0,1,2
"21333","934c99103b27dee9fe7d82803ba7200a",28,28,0,28,28,0,1,2
"21334","934de079de2de33f31126f80f1c547c3",19,19,0,19,19,0,1,2
"21335","934ec7933b6fe47934778dbc375a77fa",23,21,25,6.44,23,0,2,1
"21336","9352e2bc2dd0fee81326b6a1c073d76f",16,16,0,16,16,0,1,2
"21337","9353088a42f385ef8ac491e37cedccf7",22,22,0,22,22,0,1,2
"21338","9353816091ac296cb1bb222c8227b4bc",29,29,0,29,29,0,1,2
"21339","9355855ed65b0708154640bca172c606",47,44,44,7.47727272727273,47,0,2,1
"21340","93568056bbb91961bb80b878d5bd72d9",135,90,44,21.4772727272727,135,0,3,3
"21341","93572dbd261e23aba4f5535e1f74cf87",47,47,0,47,47,0,1,2
"21342","9358176b55c0715ec4ea1b8bb839caf4",63,53,56,7.875,63,0,2,1
"21343","9358f364bc2a5430223d1a112044d795",50,33,27,12.962962962963,50,0,2,1
"21344","935a58d9d401f4c2c681ae89e094c1ab",222,112,85,18.2823529411765,194,28,3,3
"21345","935ad01ad3f54fef33ecda540a1f7d48",52,52,0,52,52,0,1,2
"21346","935ba4d882a87e258c05d67fcc4073d4",119,76,72,11.5694444444444,75,44,3,3
"21347","935fe29da00a8f8557fc051c0944556f",65,45,20,22.75,31,34,1,1
"21348","936446412c6082d2050d9fa9c66f2201",53,48,21,17.6666666666667,53,0,2,1
"21349","9365823c559d549f816b8d6f5a92965f",82,63,68,8.44117647058824,82,0,2,3
"21350","9365e85675ec4bb27b3866c28460f9a1",1,1,0,1,1,0,1,2
"21351","9368fd43232acc58a54ff8b6476001f9",39,34,52,5.25,39,0,2,1
"21352","9369faa043767674b234391364ae97e4",21,21,0,21,21,0,1,2
"21353","936a5ff1ecb3c78498c3aa821938ca7d",39,30,47,5.80851063829787,39,0,2,1
"21354","936b076dc905996f78d116b365005eab",141,79,60,16.45,141,0,3,3
"21355","936b1f7b425b5f9a0d797b72b8d9a965",7,7,0,7,7,0,1,2
"21356","936b8a27f08c6bfcc97eaf728ce54233",95,44,58,11.4655172413793,95,0,2,3
"21357","936f65c5763fe2e261c57fe35652eaf2",130,82,79,11.5189873417722,130,0,3,3
"21358","936f81d17b05971c8c614466f37a46be",4,1,84,0.333333333333333,3,1,2,1
"21359","937481f9be228d06166abfb8b93a91ca",38,38,0,38,38,0,1,2
"21360","9375029abfff2d6a74047616f9aeade3",37,37,0,37,37,0,1,2
"21361","937612cc37bb9c93dc58ea70cf055e34",60,44,73,5.75342465753425,60,0,2,1
"21362","9378ea0eed0fc6d6e0c1b3c1e9084a69",57,37,35,11.4,57,0,2,1
"21363","937977c718ccf7e139849d178c01261f",178,109,46,27.0869565217391,178,0,3,3
"21364","9379850b8a83a64a0a9c020f43044ad8",31,23,62,3.5,31,0,2,1
"21365","937a1d7e3fefc51d3d6b10fac989376b",18,18,0,18,18,0,1,2
"21366","937ab4d17db3da896429529dded691e3",191,95,73,18.3150684931507,139,52,3,3
"21367","937ebff29a51cce1e2c80fc568a73428",39,35,75,3.64,39,0,2,1
"21368","93838660891024e9bb8fb577a6c7be1e",20,20,0,20,20,0,1,2
"21369","93841ac2c4ac3a43a03f17e17c0555f0",21,21,0,21,21,0,1,2
"21370","93851f7c6b96a5bbdd3c3c1b1f50cb3e",30,30,0,30,0,30,1,2
"21371","938a1b291ba2b734642ae7e97fee8f5e",91,73,39,16.3333333333333,91,0,2,3
"21372","938b6e82f5a1fa598bf88e8625201d83",102,88,38,18.7894736842105,102,0,3,3
"21373","938d2d9b73875480caacc3cfeb1dffc3",66,57,29,15.9310344827586,66,0,2,1
"21374","93905e46a95dac990aaabd85b7d98647",150,90,70,15,107,43,3,3
"21375","9390ad3f105bbf863f90340933f42961",24,11,60,2.8,24,0,2,1
"21376","93915e831878f8b71c59eb30cbc00011",43,38,39,7.71794871794872,43,0,2,1
"21377","93925146cdf2382b523a5feb8e23e15b",13,13,0,13,13,0,1,2
"21378","9394d53b79d0763391159ee6f23525a7",49,39,10,34.3,25,24,1,2
"21379","93970f9a0341b3e05d02c5c998cfe4d5",3,3,0,3,3,0,1,2
"21380","939987c3adf4c38d24242358fef14b9a",8,8,0,8,8,0,1,2
"21381","939b05e0aed3ac835fba0e63be82a78f",67,57,52,9.01923076923077,37,30,2,1
"21382","939dc6cd1eae104864b4ac0b29f8726a",84,57,78,7.53846153846154,84,0,2,3
"21383","939eeea2f569e80aa058033b94cb765e",5,5,0,5,5,0,1,2
"21384","93a0b06eeabc281229a2d9836ea4816f",94,71,83,7.92771084337349,94,0,2,3
"21385","93a188ce88023f8fc4f16f3c45f0f5bb",27,27,0,27,0,27,1,2
"21386","93a2a07f196ec50d2fcd45fbb6c3011c",7,7,0,7,7,0,1,2
"21387","93a34765aede71c5fcfa09366f142872",62,53,35,12.4,62,0,2,3
"21388","93a45d5554e20d3b413123555017af06",43,43,0,43,43,0,1,2
"21389","93a4b1c45d75ac5ff6e332f97b5c6e71",30,30,0,30,30,0,1,2
"21390","93a62a02ae5609da00464aa666c3079b",42,42,0,42,0,42,1,2
"21391","93a903d4f5d894600221c86b4f887e8d",36,20,55,4.58181818181818,36,0,2,1
"21392","93a916161c9e5ef1ebba6a9482f0eeec",114,95,33,24.1818181818182,114,0,3,3
"21393","93a9c622957616483d7a56bf9b0f425e",89,72,62,10.0483870967742,89,0,2,3
"21394","93aa1057d500b1a21b08ababfd5e813c",23,20,63,2.55555555555556,23,0,2,1
"21395","93aa3dfbbe5be2df490434c492cc8344",10,10,0,10,10,0,1,2
"21396","93ab56eb8d4e0c7591ca08fa2bac676a",74,41,63,8.22222222222222,74,0,2,3
"21397","93acbb86bdf493a09c7bef447709e422",56,49,35,11.2,56,0,2,1
"21398","93adae70df81210ea418750d7daa9e11",26,24,66,2.75757575757576,26,0,2,1
"21399","93b2139ff4aca4948754903cf6ab9ab0",93,56,65,10.0153846153846,93,0,2,3
"21400","93b23c151fddab26007cd413d901e6a7",39,39,0,39,39,0,1,2
"21401","93b2acbb433b28802ea3be8027fe5ecb",112,76,65,12.0615384615385,112,0,3,3
"21402","93b379bf740e2d21833deca51fec8101",38,38,0,38,38,0,1,2
"21403","93b66fd7ede45c2adacc83e83455d6a6",119,60,62,13.4354838709677,88,31,3,1
"21404","93b8b80c2e19040550b5094fe64ec2fb",7,7,0,7,7,0,1,2
"21405","93ba4174e24eb20158712c9c55711ef4",73,62,23,22.2173913043478,73,0,2,1
"21406","93bb0b4fbb45dbbd4861210c9ece6146",156,114,35,31.2,117,39,3,3
"21407","93bbdc62c6193827886ddb5f83e1f32a",172,103,54,22.2962962962963,172,0,3,3
"21408","93bf294827cd21109e91d95d9ec4ae54",75,48,65,8.07692307692308,61,14,2,1
"21409","93bf2c0ca352ef69b78db38573d4b92e",58,55,33,12.3030303030303,58,0,2,3
"21410","93c3fb236ab607cd42ee48f6ce130b35",194,97,59,23.0169491525424,194,0,3,3
"21411","93c4b0b61677c095bd787c00052bbb73",31,31,0,31,0,31,1,2
"21412","93c67cd66d578b0d4bea5a4d8159d007",21,21,0,21,21,0,1,2
"21413","93c7173422357073d3d81af71499f7e8",142,71,72,13.8055555555556,101,41,3,3
"21414","93c875b7bdb617678c46fe4ffe45640c",110,64,63,12.2222222222222,110,0,3,3
"21415","93c9e58c33fa6f249cd7aa74d1add05b",56,49,76,5.15789473684211,56,0,2,1
"21416","93cab964e499fa2811044ba27bb62237",70,45,74,6.62162162162162,70,0,2,3
"21417","93cc44009a02ee914beac4f4d6b05997",134,100,64,14.65625,93,41,3,3
"21418","93cd45da2865e97f9a674e5d4094066a",74,65,39,13.2820512820513,74,0,2,3
"21419","93ce5409610e649a1ff7db96ff2dd85e",52,52,0,52,52,0,1,2
"21420","93ce837098147d77a6a87da929fc217b",56,46,70,5.6,56,0,2,1
"21421","93cfc4eff3e3f1db5f7b272d07f7d785",34,34,0,34,34,0,1,2
"21422","93d1de0f6bbed36b81b7ebc91c816786",30,27,28,7.5,30,0,2,1
"21423","93d23f837b467627479c904ff5587350",29,29,0,29,29,0,1,2
"21424","93d2656efb5d477c0a337fa4d890543c",93,77,62,10.5,56,37,2,3
"21425","93d53ba2292f6c998a3267d04e7a6d3b",33,33,0,33,33,0,1,2
"21426","93d561fbbf7c631949c1f8f5b69e4246",18,15,43,2.93023255813953,6,12,2,1
"21427","93d5cac4fcc6fd5a822d610b6e3b1fc8",56,56,0,56,56,0,1,2
"21428","93d65d022676a1259b8585f695f9bf75",19,19,0,19,19,0,1,2
"21429","93d730240d35ed3224ac256ed21e2571",29,29,0,29,29,0,1,2
"21430","93da04636244aa5c9c85df5948931b60",76,62,38,14,43,33,2,1
"21431","93da87c8efb5cb330790e83ac1360265",108,50,73,10.3561643835616,66,42,2,3
"21432","93dd6760a9d7deb3559e43d192e70191",21,15,31,4.74193548387097,9,12,2,1
"21433","93dde3a40745f253ed2eaa13a250e9a8",11,11,0,11,11,0,1,2
"21434","93de851a6ce73aef6a96e2a543ad5d2c",40,37,21,13.3333333333333,40,0,2,1
"21435","93e4acf85ec01f546b4193b54450cf4e",210,69,89,16.5168539325843,189,21,3,3
"21436","93e9f18aea70b9fef31e9e05cab00907",6,6,0,6,6,0,1,2
"21437","93ea7c5e719f8ffb6fec082543f9f90b",37,35,20,12.95,37,0,1,1
"21438","93ec40423a1ae7e0d1d1f50ac794a0ac",39,32,19,14.3684210526316,17,22,1,1
"21439","93ecbc244afbb4c7a0bad785368c5fbd",195,94,73,18.6986301369863,195,0,3,3
"21440","93f1785863306fc2bc2e57feea052a8c",46,46,0,46,46,0,1,2
"21441","93f6a5e0256e9b4d012bb77f66dc614f",41,25,70,4.1,35,6,2,1
"21442","93f75c3c7c0179059ed987c1faa34a9e",135,84,47,20.1063829787234,108,27,3,3
"21443","93f879aa31d32c9677ba8b5ebd893f2a",35,13,63,3.88888888888889,35,0,2,1
"21444","93fa1927b1b00fafa8cd48b4d8d02253",41,41,0,41,41,0,1,2
"21445","93fa509a07879be143c81d08896958bb",105,64,37,19.8648648648649,105,0,3,3
"21446","93fb1d72ce43e850568891b20a3bf9a1",126,88,63,14,126,0,3,3
"21447","93fb1f0627cb8bdb514fb2c03592d684",54,40,29,13.0344827586207,31,23,2,1
"21448","94035aaabb7c9cee54df7c1394dfcb5e",49,44,47,7.29787234042553,26,23,2,1
"21449","9403f7bc489cfa6fcb0331fd42d6b410",70,61,64,7.65625,70,0,2,3
"21450","9404f778ea4e2086025c90d2df6279ed",11,11,0,11,0,11,1,2
"21451","9405810714ab46c65df51bf8b8bcaea9",30,30,0,30,30,0,1,2
"21452","9405d1a7157d949eecd26d2ebf48f338",101,55,52,13.5961538461538,69,32,2,1
"21453","940728440a23a661b490a3e28a695a2d",25,25,0,25,25,0,1,2
"21454","940a0238a606819a2858a23f86cb3bfa",26,21,50,3.64,26,0,2,1
"21455","940a2f55bd36f1c9cf6804b5370b17fd",4,4,0,4,0,4,1,2
"21456","940bbae9f43b21f25b2cb0323f57f98b",96,83,58,11.5862068965517,96,0,3,3
"21457","940ca88585433c75137260da828a7c4b",37,37,0,37,37,0,1,2
"21458","940f1c77921cab2420903cbdf68d465d",141,77,62,15.9193548387097,141,0,3,3
"21459","9410d29dc86e65acbdcbef9fcb96d351",25,25,0,25,0,25,1,2
"21460","9411a16d57a607c166c7813c3a4fb05a",60,43,41,10.2439024390244,60,0,2,1
"21461","9411d5eecd45b7233087698001da72bd",64,57,33,13.5757575757576,49,15,2,1
"21462","94123cf6fc40edc748f15c67c99a8af8",32,32,0,32,32,0,1,2
"21463","9412d3a87ad00a10c8fc1043c4ed0cac",117,79,82,9.98780487804878,82,35,3,3
"21464","9413a60d0facc0ec73a379a4e6f65c5f",34,34,0,34,34,0,1,2
"21465","9416fcf784187666cd98f2eb4884e39d",47,41,56,5.875,18,29,2,1
"21466","9417d845dfaad25fd70717d5f7e6d038",42,42,0,42,42,0,1,2
"21467","941d4be8d7cd6c7a190b6b78845b758d",41,33,35,8.2,41,0,2,1
"21468","941d6bd6597f24e912ef28d856c3024a",38,33,30,8.86666666666667,20,18,2,1
"21469","941dd980744a32c3da68e6e68aaa9fe4",193,98,81,16.679012345679,193,0,3,3
"21470","941eafa6dd7ac5ba498ee8e2e854aa34",13,13,0,13,0,13,1,2
"21471","942031a3ac33550aaf5b7b0595f64429",122,84,49,17.4285714285714,87,35,3,3
"21472","9421b043f497443b2fddf4b42dac7fd7",95,52,58,11.4655172413793,95,0,2,3
"21473","94226c346e11d59b27b93c71dde924a2",18,18,0,18,18,0,1,2
"21474","9422808852e4a6626a36a22e78c3ff0a",149,82,63,16.5555555555556,149,0,3,3
"21475","94247ccb783409e8d00086d51bba2510",128,88,56,16,76,52,3,3
"21476","9424cc9a7df40a682241bf8af1316fde",16,16,0,16,16,0,1,2
"21477","94262832719cb59fbb0c50c68ba55b84",17,17,0,17,17,0,1,2
"21478","94265f63aecfb0c5457d9544820f2992",53,53,0,53,53,0,1,2
"21479","94266212ecdd0ffd8bd792a028da0e40",42,19,56,5.25,42,0,2,1
"21480","9426721209130098492f5b425e793ec6",106,40,83,8.93975903614458,94,12,2,1
"21481","9427d08b917bca2c3503a6493015b939",155,62,64,16.953125,125,30,3,3
"21482","94345ea6f201a27ae7417c7986dfca94",131,91,74,12.3918918918919,131,0,3,3
"21483","94359c0968977213b4e602b5659fe7e6",22,22,0,22,22,0,1,2
"21484","94394e14deb73fc488127992c352fa52",93,76,70,9.3,79,14,2,1
"21485","943edb70540b2340c1f848b9ca7cee88",61,46,22,19.4090909090909,38,23,2,1
"21486","943f1ee1bfd1a0528aef11bec21010a7",24,24,0,24,24,0,1,2
"21487","94415ac084f63fe4305f8d2e5e8bcfd9",36,36,0,36,36,0,1,2
"21488","9441a477e1d5d560c7a95066498cd6e0",37,37,0,37,0,37,1,2
"21489","9444958e86407c4d0619e8c124e82458",10,10,0,10,0,10,1,2
"21490","94460493c40f08fe783ae85f22d14777",213,106,70,21.3,213,0,3,3
"21491","94469255053b425342ad91e7f9883f96",173,75,62,19.5322580645161,141,32,3,3
"21492","9447fa554fabf8e3bd36439248b4faea",168,101,60,19.6,117,51,3,3
"21493","9448da0296cb014f50203c35f1272034",94,45,27,24.3703703703704,69,25,2,1
"21494","944a898b2e6f0348f753a937b446244e",12,12,0,12,12,0,1,2
"21495","944acd2bb65dc74be3bcbd4aaee25092",102,76,37,19.2972972972973,49,53,2,3
"21496","944d3c130ff36cd586fbc1568d858ca7",33,33,0,33,0,33,1,2
"21497","944f2654aeb28a9fe8c4eb0d6c503f05",187,101,63,20.7777777777778,187,0,3,3
"21498","94501f2bdfcabb2cd3e26d06f43d4001",50,39,34,10.2941176470588,50,0,2,1
"21499","94521636566d81751b0f4515ee56a6a4",118,83,51,16.1960784313725,118,0,3,3
"21500","9452c46cb92bf9409e21f8bcd0ce1087",54,54,0,54,54,0,1,2
"21501","9454a0da673687f492eb2ce51c0c507c",13,10,36,2.52777777777778,13,0,2,1
"21502","9455896ce8efd5805feee8fab57c8d23",17,17,0,17,17,0,1,2
"21503","945a4377d5ab689e85f785477bb808b3",132,85,47,19.6595744680851,86,46,3,3
"21504","945ad1a760f0a355b536300a9e56134f",73,56,73,7,73,0,2,3
"21505","945cfc698d932aa4d777ef0262445c94",25,25,0,25,25,0,1,2
"21506","945d55687b3f3c65de8cea7b6237d0e4",16,16,0,16,0,16,1,2
"21507","945e33da088f59106736aa6a9c9e921c",26,26,0,26,26,0,1,2
"21508","945ffc2b95d66e1dc6dc6635d83bd6c0",43,43,0,43,43,0,1,2
"21509","9462d534b6f02354f2abc736d0fdd466",74,68,51,10.156862745098,74,0,2,3
"21510","9463f05f29a6c9e3c0c0357f0e7a43c7",18,18,0,18,0,18,1,2
"21511","9464f7069268455c7b0b46912feeb563",138,72,76,12.7105263157895,138,0,3,3
"21512","946a1a40d0fed1d9e0e50c84c681f136",152,82,81,13.1358024691358,118,34,3,3
"21513","946e5a82c7acd9fed0727fdacc8723e4",30,30,0,30,30,0,1,2
"21514","946eeceef379ecdc2956c08d32318385",181,115,65,19.4923076923077,129,52,3,3
"21515","94734999555c61de2885530d804526f0",68,47,56,8.5,68,0,2,3
"21516","94737af12f279d865c5e0ff726af874f",21,21,0,21,21,0,1,2
"21517","947421fe8578e55d52712a65aa8174a8",75,61,67,7.83582089552239,75,0,2,3
"21518","94755e085e911e79a483db7ae994f78e",13,13,0,13,13,0,1,2
"21519","9479fedd76be3ca9f67a6a37c2cfe9e5",19,19,0,19,19,0,1,2
"21520","947abc80633bc397b0a7f01f136b7189",2,1,46,0.304347826086957,1,1,2,1
"21521","947fc06aa5adf3f0ef6b16eb604c2025",27,27,0,27,27,0,1,2
"21522","94807e0327cbd1ff2a1719fc1917d36b",25,25,0,25,25,0,1,2
"21523","94807ed81a1ea8cadc6d28c2fa1019d1",81,64,71,7.98591549295775,81,0,2,3
"21524","948485950f36c86747d4b25ffa9b6cd6",6,6,0,6,6,0,1,2
"21525","9486f72cb7b2e8110733a6522bf8f537",151,71,67,15.7761194029851,151,0,3,3
"21526","9487d00689525d0a2e5c07520d19f154",156,59,69,15.8260869565217,156,0,3,3
"21527","948ccf37d0953f916bd75d2ce808b6b6",74,63,14,37,74,0,1,2
"21528","948f8c4478e0e0d447e27f26518b9dbf",7,7,0,7,7,0,1,2
"21529","9493e40a032f0c93f46494b88258dc9a",148,90,81,12.7901234567901,106,42,3,3
"21530","949461f5e9eb9c6ac790a0181f4b5800",178,64,73,17.0684931506849,178,0,3,3
"21531","9495ec40fcadc793d493700b5a7218aa",6,2,70,0.6,6,0,2,1
"21532","94987f1f8bfb978531935891fcf8b9ec",45,45,0,45,45,0,1,2
"21533","949ccbf9d6d7109856c4a28ed635e48a",19,19,0,19,19,0,1,2
"21534","949d48b6cdccc5b3f727e339fc540bf2",46,32,9,35.7777777777778,46,0,1,2
"21535","949e69a87eb045d9d5d01d8efe1f0af8",28,21,35,5.6,28,0,2,1
"21536","94a43350777a7f77dbb4ddce658c4d74",11,11,0,11,11,0,1,2
"21537","94a5a963988dd26ad3adf10519cf4186",79,53,72,7.68055555555556,79,0,2,3
"21538","94a5e9365944615ba0a3f11d529ba977",48,48,0,48,48,0,1,2
"21539","94a7bc5b65f2ad2f2e5dc16878608342",29,27,21,9.66666666666667,29,0,1,1
"21540","94a83f1e642c67765b7e0905a8366965",105,70,89,8.25842696629214,105,0,3,3
"21541","94a9560edbed895e0e5f0a2071f5f830",15,15,0,15,15,0,1,2
"21542","94a95e2a014182960ef7d63de6dabd65",36,36,0,36,36,0,1,2
"21543","94aa54f1d68be8b4978e7c7ed3f48573",65,52,42,10.8333333333333,65,0,2,3
"21544","94aa821cb40f65120950f37b2c3690db",166,109,81,14.3456790123457,123,43,3,3
"21545","94aadf8415f9134671c182f7cffecb87",15,15,0,15,15,0,1,2
"21546","94ae252eb339f6d5bbb0e7f3375be95f",192,94,81,16.5925925925926,192,0,3,3
"21547","94aeee7cfd606f07f7e15ecfb929a967",4,4,0,4,4,0,1,2
"21548","94afbfbb64eed8499cc9c43731657add",39,39,0,39,39,0,1,2
"21549","94b16aaba5584c8cd56d871101f35710",166,99,88,13.2045454545455,145,21,3,3
"21550","94b3ffec5c92c1b1712ee57c4e68fa19",36,11,64,3.9375,36,0,2,1
"21551","94b4e0bba105795d249460f2003d1276",47,44,17,19.3529411764706,47,0,1,1
"21552","94b52314b53fcd484a006d26d903dddb",126,77,49,18,72,54,3,3
"21553","94b833cc1f4604cdd83e14dc73f40539",4,3,2,14,4,0,1,2
"21554","94b99c772340cd712d02ea5a3048846d",20,20,0,20,20,0,1,2
"21555","94bbec38852c4e377ba4cc7c1fed1b86",27,27,0,27,27,0,1,2
"21556","94bc31fc3a510e17aa90b1f5e9239dbe",11,11,0,11,11,0,1,2
"21557","94c55fa5b73082efd8feef8b0b22e572",70,57,34,14.4117647058824,70,0,2,3
"21558","94cb57a5b94ed27af09ad9176119499e",81,70,61,9.29508196721312,81,0,2,3
"21559","94d0e7eba45966d43aced679c701d1f5",28,28,0,28,28,0,1,2
"21560","94d31dfd36b258b8402200fc040d4284",36,36,0,36,36,0,1,2
"21561","94d3d02afad1ca51fcdf35e5d0e676c6",40,21,65,4.30769230769231,27,13,2,1
"21562","94d5cfe66ecdd217b02fe3ab9a6fd88a",6,6,0,6,6,0,1,2
"21563","94d691eb510f876bb67723852dc37e31",51,51,0,51,51,0,1,2
"21564","94dad0427b72ac46b7448e1288560c40",62,48,52,8.34615384615385,41,21,2,1
"21565","94db8c6e4bd1d460b4c5c7061a208f3e",32,32,0,32,32,0,1,2
"21566","94dcf10748b8f8023b6485e12d57e0a6",6,6,0,6,6,0,1,2
"21567","94e0658ca6927a9179711dc39ef1c426",22,22,0,22,22,0,1,2
"21568","94e33fc9690dffe261fbebf0d26f820b",47,47,0,47,47,0,1,2
"21569","94e6b2a9b46c38d4a3faa9ca53986a97",68,54,39,12.2051282051282,68,0,2,3
"21570","94e80945ac3198a41deb69444bae4a29",30,30,0,30,30,0,1,2
"21571","94ed73b19a5bc40e32dd6b737930ecc4",27,27,0,27,27,0,1,2
"21572","94f396743c12f02da3dcd7f80c9b61ad",145,83,66,15.3787878787879,145,0,3,3
"21573","94f397899004a6e8a09f6f44fbd39f94",24,24,0,24,24,0,1,2
"21574","94f5d2f80a30d055d12754d0884e2ce9",3,2,9,2.33333333333333,1,2,1,1
"21575","94f77ef8035ccc26ea735904e2259df8",142,122,40,24.85,142,0,3,3
"21576","94f7be7d0da9140f21777a2d044c892c",247,142,58,29.8103448275862,218,29,3,3
"21577","94f83583cb2b088c7dc17f267f3476f9",37,34,26,9.96153846153846,14,23,2,1
"21578","94f870a79e972ea0d869b33301599630",73,56,40,12.775,73,0,2,3
"21579","94fa05d14cc1c08b75ed5600a28127cf",33,33,0,33,33,0,1,2
"21580","94fad506ae97aae786eb65f717809238",59,46,12,34.4166666666667,39,20,1,2
"21581","94fb2a2a46a8c0dc5a12a513589ef83b",102,72,57,12.5263157894737,87,15,3,1
"21582","94fb33af0c1db55153088e5bb5ba1b1b",130,90,84,10.8333333333333,130,0,3,3
"21583","94fb7fde3bcb02143c4c8e5088948cf8",85,45,67,8.88059701492537,63,22,2,1
"21584","94fd2827d7819d8bafd5b3e22cb06941",99,54,72,9.625,99,0,2,3
"21585","94fd82e46b4ddb8dbabcdd59ec468511",27,27,0,27,27,0,1,2
"21586","94fdf86b7ea39480902d57a0b6cff0b2",20,17,66,2.12121212121212,20,0,2,1
"21587","94fe8f487b7e16fc5de50c892944fdca",98,67,34,20.1764705882353,63,35,2,3
"21588","94ffaaeb5f5dd46df02b1ad6adf19aee",131,76,34,26.9705882352941,89,42,3,3
"21589","95029908881b3c01e539ba4850a73c11",23,23,0,23,23,0,1,2
"21590","95044fad97b977ce2f09a9d6fb76d154",11,11,0,11,0,11,1,2
"21591","9506ff0e0ded977c154b99d7cb753a66",12,12,0,12,12,0,1,2
"21592","9508bb9ee4f547a2aa5d5e7ea42b7e5d",24,24,0,24,24,0,1,2
"21593","950a8e258cdd6aa4368c605a0957a201",33,33,0,33,33,0,1,2
"21594","9510d2f16b863be53cb3fe312ee43367",53,48,24,15.4583333333333,17,36,2,1
"21595","95112ef25a75386a804fb81cef0fedf1",18,18,0,18,18,0,1,2
"21596","95140815248055e184348112ef21cabb",80,51,63,8.88888888888889,80,0,2,3
"21597","95144df005696bd2e3c6825530c69295",35,35,0,35,35,0,1,2
"21598","9517e2504a65a1c8b4d4dfc8ddcfa8cb",82,49,80,7.175,82,0,2,3
"21599","951b2862b48ee6f911f306d07c4f5fe2",98,79,21,32.6666666666667,98,0,3,3
"21600","951bab53082bb01b8ea72b09625d670a",52,36,42,8.66666666666667,0,52,2,1
"21601","951bd1df7c753fdc2d268f5346228b66",41,41,0,41,41,0,1,2
"21602","951c2502cda4c2116babfb3fe0a5d3c4",47,47,0,47,47,0,1,2
"21603","952228e7c2c130569a2ba843ba0b7379",37,37,0,37,0,37,1,2
"21604","9526153cc072492e0f5301747d262323",82,73,52,11.0384615384615,82,0,2,3
"21605","95266abb7f0f87900f1d4f999462f0a4",47,47,0,47,47,0,1,2
"21606","95296cdc259f5bd76eed69043f5c9dfa",109,60,57,13.3859649122807,85,24,2,1
"21607","9530ac8b171b9fbfa6f3e2044ef69be5",73,38,63,8.11111111111111,73,0,2,3
"21608","95326604375021a102af212e769216b0",52,52,0,52,52,0,1,2
"21609","9534434405ba7ad67af8d8e444fa514c",2,2,0,2,0,2,1,2
"21610","9536603a36563e9087f50803d258957c",102,72,81,8.81481481481481,85,17,3,1
"21611","9536eec8355d7f6ea8846223b3cfbdf1",37,37,0,37,37,0,1,2
"21612","953b2a085bafe4dbe4568f0959b09d07",52,38,53,6.86792452830189,36,16,2,1
"21613","954007efdb96afb8d869d1c29e1366e2",35,35,0,35,35,0,1,2
"21614","9542017a9ff81e61df7a63cd3ab5142b",67,50,60,7.81666666666667,67,0,2,3
"21615","9544642bd0bd108a634dc47c81c7d496",13,13,0,13,13,0,1,2
"21616","9545628b03b2dfe8f133482a2eb8ebd9",13,13,0,13,13,0,1,2
"21617","9547028e9941483b8087c0eedfde26e3",23,23,0,23,23,0,1,2
"21618","954a3611d1a487b1bb51768f38368da3",34,34,0,34,34,0,1,2
"21619","954bd49b216e3b84ffa5e51b0761099b",31,24,59,3.67796610169492,31,0,2,1
"21620","95505ed760fc98cb58f5a093e7291cea",107,90,34,22.0294117647059,107,0,3,3
"21621","955068c7b83e6786619c3bcc6a563938",37,37,0,37,0,37,1,2
"21622","95535b70ddd00d0527281ebac6871019",28,28,0,28,28,0,1,2
"21623","9553ffa76336268d86e30ff8c82cabe3",175,77,75,16.3333333333333,175,0,3,3
"21624","9554b45db3454e02701cf9bfbd6d5570",16,8,36,3.11111111111111,16,0,2,1
"21625","95552304408ff1a106fffdbc8f8c7e89",58,45,31,13.0967741935484,58,0,2,1
"21626","95557270ddcbe8eb017c0fd5db5bcef6",2,2,0,2,2,0,1,2
"21627","9558529105c5244d79697e3a84e84d58",187,118,60,21.8166666666667,187,0,3,3
"21628","955a69874ab3e8050d62d64198506dd6",50,39,55,6.36363636363636,50,0,2,1
"21629","955bf1f607e7bd3e0fbd3fe21d30d693",22,20,6,25.6666666666667,22,0,1,2
"21630","955e6e2af593e3ef0aa9c316563962cd",15,10,43,2.44186046511628,15,0,2,1
"21631","955fafaf94559d76bb60185504e33c92",14,14,0,14,14,0,1,2
"21632","956111c09745ede97b3a0c7ec3027309",141,81,82,12.0365853658537,125,16,3,3
"21633","95640e16c2c20217032004217472ae9d",47,42,42,7.83333333333333,47,0,2,1
"21634","9564c68baba85da2153073296968e469",22,22,0,22,22,0,1,2
"21635","956510ec084e2ae8397440567aeeed9c",130,72,36,25.2777777777778,130,0,3,3
"21636","956706385af4c93c365fd8a3bb00c3f3",74,54,81,6.39506172839506,41,33,2,1
"21637","95675bd1cf7cd0cde15510a03dd26b7f",117,107,49,16.7142857142857,117,0,3,3
"21638","956817e2f25e8885d646d676864105a3",154,106,68,15.8529411764706,126,28,3,3
"21639","956a8311f83f72e519041f1a04ea4284",138,84,70,13.8,138,0,3,3
"21640","956b7dde5c16a7d4423990192b06aba1",100,66,61,11.4754098360656,100,0,2,3
"21641","956cbb8cd5ec70f7c8b0e03e18c00941",247,121,63,27.4444444444444,197,50,3,3
"21642","956d26c2034430181c51dc548cf41504",205,118,70,20.5,205,0,3,3
"21643","95704f81edf65707b8320996e54bf615",4,4,0,4,0,4,1,2
"21644","9572467bd1de7800578cf3ad07df40e8",33,33,0,33,33,0,1,2
"21645","9572803249fd667ae0c7e9b356b5956b",98,57,76,9.02631578947368,98,0,2,3
"21646","9579aed0c1febbe27bdb9a39eb32f958",23,23,0,23,23,0,1,2
"21647","9579cb64c524a31cffbe50b3e11afd2e",30,27,40,5.25,30,0,2,1
"21648","957d3d70dde52d2e09d7e9449ee4dd48",1,1,0,1,0,1,1,2
"21649","9580cdd46f7b6fb1ed77210dc1fe600e",15,15,0,15,15,0,1,2
"21650","95810e06908904ff8a377c0c239a1199",57,44,49,8.14285714285714,57,0,2,1
"21651","9588a8d0d35e006d8b7fe86c06affaaa",91,79,33,19.3030303030303,52,39,2,3
"21652","9588c4420e9624788df4764f26bf4d88",13,13,0,13,13,0,1,2
"21653","9588c543138ba0ada8224dce0724af3d",36,36,0,36,36,0,1,2
"21654","958b90ea1732e06ac28fac51f90049ed",144,54,70,14.4,120,24,3,3
"21655","958ba26e7579be26d94ee39a90784795",45,45,0,45,45,0,1,2
"21656","958e1954a2b7483c175556b0ba074dfe",117,84,69,11.8695652173913,117,0,3,3
"21657","959130d246f3edd15a05619505d22893",10,10,0,10,10,0,1,2
"21658","9591782aaa28fd01dacb239aecbf6c25",38,28,47,5.65957446808511,18,20,2,1
"21659","9593b8f74d4330f778a8f052cd626921",120,79,83,10.1204819277108,81,39,3,3
"21660","95954cbf0de8d0547000ab7279cbba31",7,7,0,7,7,0,1,2
"21661","959b2b851ca57bba3dc1db6bbbf587b2",51,51,0,51,51,0,1,2
"21662","959d1e27ce672c4a15872b4c154159c9",52,52,0,52,52,0,1,2
"21663","959d1ff30a4c017f66f3a8a30c3dae99",122,76,21,40.6666666666667,70,52,3,3
"21664","959db423f5ce2f23efac50f1aca46158",130,101,69,13.1884057971014,109,21,3,3
"21665","959dfffa40f96a040ae0b3e7a8187b79",16,16,0,16,16,0,1,2
"21666","959edf5d45a6d5524dc2746481bc4ee1",93,76,61,10.672131147541,93,0,2,3
"21667","95a01bbe89e52a40167d7b8f033293a4",24,24,0,24,24,0,1,2
"21668","95a0c9e655c95e9908447b6226eeb1f7",46,46,0,46,46,0,1,2
"21669","95a1b98f57bab08161adf06c4526711f",158,120,56,19.75,158,0,3,3
"21670","95a291d89e96eacf559a7b04eb685495",15,15,0,15,15,0,1,2
"21671","95a2f00cd88e88c05444b091ed99f990",81,56,42,13.5,81,0,2,3
"21672","95a7291da8752044bd56b7d7ec6df883",160,99,69,16.231884057971,131,29,3,3
"21673","95ac69665a7c5f406bef846a1e48a604",50,47,9,38.8888888888889,3,47,1,2
"21674","95ad82b380d227b6c570ca8ab0547be3",73,64,22,23.2272727272727,73,0,2,2
"21675","95ae3468718d9b8efdbf847cd1753dd5",111,63,69,11.2608695652174,111,0,3,3
"21676","95ae91c0d41f8b2b5adae8085f7cc6b6",91,62,58,10.9827586206897,67,24,2,1
"21677","95af0e57239e179bc9225f15f062cccd",164,91,85,13.5058823529412,164,0,3,3
"21678","95b11b7af0be38a15abc85b5f2f4eb63",19,18,4,33.25,19,0,1,2
"21679","95b12a26d7a7148e2aa9417a1618e8a7",17,17,0,17,17,0,1,2
"21680","95b28e1545709f5091051a8079547d48",71,62,20,24.85,71,0,1,2
"21681","95b2ff30a39f56bede3e278fe7e070d5",22,22,0,22,22,0,1,2
"21682","95b33e9a6074c4c9d71b95673375eac0",35,29,59,4.15254237288136,35,0,2,1
"21683","95b72e8965aeae27e2f1d670b92be764",21,17,59,2.49152542372881,9,12,2,1
"21684","95bf3c6d4be438dec775237797a6a378",12,12,0,12,12,0,1,2
"21685","95c0050466f242739dbaf7860e619399",57,45,27,14.7777777777778,57,0,2,1
"21686","95c06981fb7d28d33c23c7eef9e658fa",43,43,0,43,43,0,1,2
"21687","95c3813ef422da9884da6eeee99154c1",32,32,0,32,0,32,1,2
"21688","95c5e475c9f45d2ae393728e4d7fda27",79,49,81,6.82716049382716,62,17,2,1
"21689","95ca70ca5731fbd560ea53f39e2e4e3c",39,39,0,39,39,0,1,2
"21690","95cc564b19f3c1a16ba866934ced6296",131,100,63,14.5555555555556,131,0,3,3
"21691","95cd5126934806c5d99e0821ff4042e2",27,27,0,27,0,27,1,2
"21692","95ce189728154fd1ebb46af604911ef6",214,126,56,26.75,214,0,3,3
"21693","95cfb3e97436ba4485af64700eafa052",29,29,0,29,0,29,1,2
"21694","95d065188d182972445f30311cceb1d5",96,67,78,8.61538461538461,75,21,2,1
"21695","95d13564775bd840c29c4f4d93189918",86,69,76,7.92105263157895,86,0,2,3
"21696","95d49012d86e20f902c2d67d1a0a2f7f",36,36,0,36,0,36,1,2
"21697","95d815b728d35c872956f2ffc197d8fc",88,69,52,11.8461538461538,88,0,2,3
"21698","95d874aa2a464f58919aa092b9fff1fa",39,39,0,39,39,0,1,2
"21699","95d9857422064c3534347bda7465c96c",113,60,69,11.463768115942,113,0,3,3
"21700","95dafc533b9adb09c797c22aa2bcacc2",13,13,0,13,13,0,1,2
"21701","95db27811895e750f6e542bd1789136c",38,31,47,5.65957446808511,24,14,2,1
"21702","95ddafc87b04bfb4cd0eb074027cdcfe",35,28,43,5.69767441860465,35,0,2,1
"21703","95e227203a0f371e2ab647f0a347b05f",28,28,0,28,28,0,1,2
"21704","95e31db31bba3ae1bff4b2aca02f1f23",37,37,0,37,37,0,1,2
"21705","95e32be9e4ac7e556f42711ee2d9101e",31,31,0,31,31,0,1,2
"21706","95e48788d338627af43e0903d0fa79e0",122,64,78,10.9487179487179,122,0,3,3
"21707","95e690afbc8fe547e38cf8f40b31b5fd",179,104,75,16.7066666666667,179,0,3,3
"21708","95e6a674ef328b7cbc50a35a14c07e41",182,86,71,17.943661971831,182,0,3,3
"21709","95e6f01b50f86af16c6358f573104ee8",135,86,74,12.7702702702703,135,0,3,3
"21710","95e770b2bd79434feffc861ce4fd937d",1,1,0,1,0,1,1,2
"21711","95e87483bccc597deeeb1e61960ac664",101,70,51,13.8627450980392,71,30,2,1
"21712","95eb581d7e60e5684c12f33d49ddef39",89,55,45,13.8444444444444,89,0,2,3
"21713","95ecae0bdc975341c9b4aa21e960f772",118,77,56,14.75,118,0,3,3
"21714","95ecba134e0551c8fe5b0582ff6979a5",13,13,0,13,13,0,1,2
"21715","95ed92e7184ba337902a77837e916104",26,26,0,26,26,0,1,2
"21716","95ee130c3e71c20b6e142b306b94856b",40,40,0,40,40,0,1,2
"21717","95ee855c28b046482df9128ddc5db4fe",139,82,85,11.4470588235294,139,0,3,3
"21718","95eebc1faa32f06d4b767c2bf7bb5775",13,13,0,13,13,0,1,2
"21719","95f05fd9cef41233ec22c31088a44d9a",14,14,0,14,14,0,1,2
"21720","95f06fffdcc81439d68b52986a644953",84,74,25,23.52,84,0,2,3
"21721","95f4b25882113072bed05c0d88b5e72a",6,6,0,6,0,6,1,2
"21722","95f55c340a537a004d7576c6baf0ae82",33,33,0,33,33,0,1,2
"21723","95f6e7f5e4cac170c0bee8167e923442",36,36,0,36,36,0,1,2
"21724","95f6f22e5aae63eb573510b9d830cae4",39,39,0,39,39,0,1,2
"21725","95f7091e24b85cfa9ea145850aabdde8",107,60,83,9.02409638554217,76,31,2,1
"21726","95f95662f34a3a7f541a8d548a1f09b2",35,35,0,35,35,0,1,2
"21727","95fc9a6f3fffb1e6e3d5f25bd761ec76",49,43,41,8.36585365853659,27,22,2,1
"21728","95fdba2acaaee2b30fa14ec3255e1653",11,11,0,11,11,0,1,2
"21729","95fe8a8ab2e518cd36d948e7ffb07422",34,34,0,34,34,0,1,2
"21730","95fe9686d5e2f304c094c4596b11c204",90,51,66,9.54545454545454,90,0,2,3
"21731","96004c1850a8bf74d22460a251d4227b",27,27,0,27,27,0,1,2
"21732","9600e07fde953725162fede0b6dd8307",49,46,43,7.97674418604651,12,37,2,1
"21733","960126f55abe66b3eb0907f97b5c96b7",15,15,0,15,15,0,1,2
"21734","9601929985a7891cca46de381f79bf8e",11,11,0,11,11,0,1,2
"21735","9603e89343999c0862d6c5862890e206",80,71,40,14,46,34,2,3
"21736","96044e56ac78650c72eef42d8d0b38c8",30,30,0,30,0,30,1,2
"21737","96049ac4047a9dd5eec10e1f04df3429",239,98,82,20.4024390243902,213,26,3,3
"21738","9604c9ba249cd7f5c15d34222d1e15ed",21,21,0,21,21,0,1,2
"21739","960597d4f43f9cebd9fdb1bb52d8314d",41,41,0,41,0,41,1,2
"21740","96076882ac8d4458dda8a5735e040993",17,17,0,17,0,17,1,2
"21741","9609394ae36d234cafec551ddf04563c",55,51,15,25.6666666666667,55,0,1,1
"21742","96096a6252270bffbf0b6dfffe431d3d",176,110,40,30.8,142,34,3,3
"21743","96099dab63e754ccb32ab352feddd489",159,80,75,14.84,159,0,3,3
"21744","9609fbda66703f296af2b692c95a30c8",36,36,0,36,36,0,1,2
"21745","960af849739f1881cba17448dc328982",24,24,0,24,0,24,1,2
"21746","960b1a4eba12f91b78688ff49eaa004b",20,20,0,20,20,0,1,2
"21747","960b43c405536c45f015312c8dbcfc9e",146,95,57,17.9298245614035,146,0,3,3
"21748","960c848d6d6e451d5e6641ccdaee22bb",38,38,0,38,38,0,1,2
"21749","960d3c54b8067c32f47e74046f254baf",12,12,0,12,12,0,1,2
"21750","960eebae30b2eb4eca04172613335ec1",18,18,0,18,18,0,1,2
"21751","96137c1b8d50f2baaa67dfe2ece9cedc",172,108,69,17.4492753623188,172,0,3,3
"21752","9614007269846ce3e73b0c0bd306166a",48,39,57,5.89473684210526,31,17,2,1
"21753","96158f0afd1f998bdf72c93c3e45a623",51,51,0,51,51,0,1,2
"21754","9618439dd3662f156f8f927d8edbed65",4,4,15,1.86666666666667,4,0,1,1
"21755","961ae5049a2ea05310fba0ed6c6e6390",56,50,46,8.52173913043478,56,0,2,1
"21756","961ae9b653584f770a37539e91ed56c7",1,1,0,1,1,0,1,2
"21757","961bc86d34f6019ba4936ac09fc83998",80,65,23,24.3478260869565,80,0,2,2
"21758","961e732a51f8f81088d441a980c507bd",38,38,0,38,38,0,1,2
"21759","961e933dc9d3da41bc6526823502de83",40,40,0,40,40,0,1,2
"21760","96237476834dc324c8c133fa624d2945",49,44,13,26.3846153846154,49,0,1,1
"21761","96242d781390ba8aa85a2060243905de",10,10,0,10,10,0,1,2
"21762","962798523a6a74727b27be8e39a23613",35,27,38,6.44736842105263,25,10,2,1
"21763","9627e02c3059963698d80207672355fa",23,23,0,23,23,0,1,2
"21764","962ab29ff01340e467eb6183958ef646",93,74,48,13.5625,93,0,2,3
"21765","96381a0fa10702c8a5f6dbaa499c8077",28,22,28,7,28,0,2,1
"21766","9639cb485f1a0d12b0b2cfca4d1b7453",114,69,46,17.3478260869565,114,0,3,3
"21767","963b053c62579391842daeb2feb452d1",100,77,59,11.864406779661,100,0,3,3
"21768","963d04394c4aedc5c65c5b50f42eee62",90,72,51,12.3529411764706,90,0,2,3
"21769","9643542620f28db3d4d503d5dad93d07",27,27,0,27,27,0,1,2
"21770","96455671f4c6a9228393fb134c2609f4",6,6,0,6,6,0,1,2
"21771","9646d5be501373e834c8c9706a1e963a",40,29,35,8,25,15,2,1
"21772","9647a3ba28eb73f96c2a96bec665d1a0",77,48,58,9.29310344827586,29,48,2,1
"21773","9649d8d8ece8bdd5c7d5bf98c415ffec",46,39,14,23,0,46,1,1
"21774","964cb19dcd9d5b16d4131cc1814becca",37,29,46,5.6304347826087,37,0,2,1
"21775","964ce6b84932f2e86af490b72c4dc78c",30,30,0,30,30,0,1,2
"21776","964ee92472a4c026704b374cd52e4b99",42,37,14,21,42,0,1,1
"21777","9655061c39767e3fc1770a102ace8283",85,59,57,10.4385964912281,63,22,2,1
"21778","9657fb6d8654b5402af0a2ca8dc5ad01",107,72,50,14.98,107,0,3,3
"21779","965971406e5e3eef6599c3f43b2b35ca",183,94,71,18.0422535211268,144,39,3,3
"21780","965e3903f705c704b9ae9e8d0482b76a",70,39,55,8.90909090909091,70,0,2,1
"21781","965f4484b47da8bbc7c2d12258834b8b",54,50,49,7.71428571428571,54,0,2,1
"21782","965fbe765869fd0e9bab12567d17df49",48,48,0,48,0,48,1,2
"21783","9663e566c7faeff0c9c2e43c6c811d08",3,3,0,3,3,0,1,2
"21784","9664c034ff289967258f56168b22457c",16,16,0,16,16,0,1,2
"21785","9666ddadc2df06090b21b758ea6fddf7",103,57,61,11.8196721311475,103,0,2,3
"21786","9668544f2e084393a353eb5dad1976bb",8,8,0,8,8,0,1,2
"21787","96688b0e72952e4560be16e60773c0d6",73,52,21,24.3333333333333,73,0,1,1
"21788","966923fdbf39817e5de6843dd0dcbfc6",28,28,0,28,28,0,1,2
"21789","966948f3a8fbe22818c82e9c812bced9",45,45,6,52.5,45,0,1,2
"21790","9669701b1381936534e36ed5d14062a1",21,21,0,21,21,0,1,2
"21791","9669b70d7da6d6bac70cef491071ef02",120,84,74,11.3513513513514,120,0,3,3
"21792","966dcedd0c6676c3c746d130bca9e529",45,43,21,15,45,0,2,1
"21793","966f3924cc3b3de527fdeeb6e0142366",81,48,83,6.83132530120482,81,0,2,3
"21794","966f5d5ab3b5fc45ce8bb74b257c9a33",137,73,84,11.4166666666667,137,0,3,3
"21795","9670858dc91691d5aa366079a7fb56eb",22,20,45,3.42222222222222,22,0,2,1
"21796","96710a0441187a15dc949499d7102bc7",184,114,71,18.1408450704225,184,0,3,3
"21797","96720a4083328ab103fc052a4961a2d7",182,76,86,14.8139534883721,182,0,3,3
"21798","9674d0cb1aab967c48c1cd264ad28325",74,57,60,8.63333333333333,41,33,2,1
"21799","9674e716a84b2755a95b8a8f7bebe9eb",148,77,72,14.3888888888889,148,0,3,3
"21800","9674eb325aaaa4f0d96bbeb607dc1eea",130,84,59,15.4237288135593,89,41,3,3
"21801","9674fa17f4f154088ef1f739822a0e39",145,91,65,15.6153846153846,145,0,3,3
"21802","96773831418fd81de808728db6226d06",159,82,77,14.4545454545455,159,0,3,3
"21803","9678503fb4e6c62ce03c9c9d01a8989f",20,16,56,2.5,20,0,2,1
"21804","9678e47ced029f525b1ef568cd299f08",30,13,64,3.28125,30,0,2,1
"21805","96799eb709aa833d0ce3aa5ec27754a2",53,40,42,8.83333333333333,53,0,2,1
"21806","9679e988c7e377a7b3d9b01653158b64",46,41,21,15.3333333333333,46,0,2,1
"21807","967b2828516b00cf60bf80aed855735a",147,73,81,12.7037037037037,147,0,3,3
"21808","967cdab5015758fa38c0d9d3f905aed4",18,18,0,18,18,0,1,2
"21809","967e3afe0ee11f0fb01baccfea3946aa",1,1,0,1,1,0,1,2
"21810","967f3d9bcc6f6f4c5cb985b2125474fa",33,33,0,33,33,0,1,2
"21811","96806e4357b4252ef3f43900a1ea8b10",11,11,0,11,11,0,1,2
"21812","9681e08f3e8e852ce9b83cabd8edd6ef",203,129,84,16.9166666666667,203,0,3,3
"21813","9682cdde3360b1522b73b22480550cdf",24,24,0,24,24,0,1,2
"21814","968670017964f4d102875090e45d6953",48,48,0,48,48,0,1,2
"21815","96892469220bf0ea610b2158e710b07f",146,84,84,12.1666666666667,146,0,3,3
"21816","9689b065ddc27dfceca30853d274f6b3",39,39,0,39,39,0,1,2
"21817","968b6e6f3dd98b952e13c51bea65ccd4",46,31,69,4.66666666666667,46,0,2,1
"21818","968c73e23c51fae83f212a0d45ebff52",48,48,0,48,48,0,1,2
"21819","968cef4cbb76455135fec8641eba9e68",29,29,0,29,0,29,1,2
"21820","968dbc1614a715addfb18570d9e3f9f6",25,25,0,25,25,0,1,2
"21821","96902e5e3942739add1e7ef666d16319",103,67,48,15.0208333333333,103,0,3,3
"21822","9690a36019bc2539c41a502769cbc4bd",17,17,0,17,17,0,1,2
"21823","9691cd97054414b849af6c94e7289c47",12,12,0,12,12,0,1,2
"21824","9693873862ef950b064ef801576a9383",87,62,61,9.98360655737705,54,33,2,1
"21825","9693ed815f41ba4d23218311228bebac",41,41,0,41,41,0,1,2
"21826","9694637cc34e3b7382e79b652e727296",18,18,0,18,18,0,1,2
"21827","969588db9e5713a71e2cd4596a5e9c11",209,135,72,20.3194444444444,168,41,3,3
"21828","9699313cff83eabd1aed0411a7a26f9b",46,46,0,46,46,0,1,2
"21829","969ad9046faed66738797679d5969985",103,84,63,11.4444444444444,103,0,3,3
"21830","969bbe5fc12387d78d10473e5aa795aa",141,82,61,16.1803278688525,141,0,3,3
"21831","969bc06781b8975eb6742e01cfb3eaad",53,53,0,53,53,0,1,2
"21832","969ca6317e64e190db4764a1020cd4c6",56,51,19,20.6315789473684,56,0,1,1
"21833","969d0503718dbcb8e9108c5f85a27bdf",111,63,85,9.14117647058823,81,30,3,1
"21834","969d35ae596d3e287f75fa9df7303063",25,25,0,25,0,25,1,2
"21835","969d8d7abe87ef758ad4c15d38963cc6",54,49,7,54,54,0,1,2
"21836","96a186aa73079138d243d41d5267823c",57,41,42,9.5,57,0,2,1
"21837","96a2b572b480ba23cb6938a74620626d",69,53,39,12.3846153846154,69,0,2,3
"21838","96a58150911d00ae94954308266ab57e",13,13,0,13,13,0,1,2
"21839","96ab8cce0e5765545953e2093cbac133",66,41,77,6,66,0,2,1
"21840","96ac92961a68986cc615d049bca09a91",23,23,0,23,23,0,1,2
"21841","96b0ddf71309a342ff510de75b1219df",34,34,0,34,34,0,1,2
"21842","96b33ab4c638210e5df41b8a9fc63516",19,19,0,19,19,0,1,2
"21843","96b381e15fe92f59b0190330e3e0b31c",55,42,59,6.52542372881356,55,0,2,1
"21844","96b46dcf6f04dc7ea719b9a93a3368d4",6,4,42,1,6,0,2,1
"21845","96b4bdd244f8ca4829df2bd578b31316",46,46,0,46,46,0,1,2
"21846","96bb10f50602aef951abc0ccd13fc07c",20,20,0,20,20,0,1,2
"21847","96bb7149dafa732701143bf5f580bc04",5,4,31,1.12903225806452,5,0,2,1
"21848","96c04959f60dacecd0eb7960a339870b",46,36,41,7.85365853658537,23,23,2,1
"21849","96c1928f31327cd5acb14f46bf64265a",48,48,0,48,0,48,1,2
"21850","96c1b12f0cde2cc73b65942ab6d1a722",28,22,65,3.01538461538462,28,0,2,1
"21851","96c6b4a67deb8929440b6f20d740d051",29,25,5,40.6,13,16,1,2
"21852","96cb6b3811733b2d203e7bf3d8975fae",95,87,72,9.23611111111111,63,32,3,1
"21853","96cc77fcc224889edbbb0afdbb7c24f3",33,13,69,3.34782608695652,33,0,2,1
"21854","96ccfabe88418c964a7b2e2e0d1bc58c",73,43,77,6.63636363636364,73,0,2,3
"21855","96cd110d9224b3765db3cb984095266a",15,15,0,15,15,0,1,2
"21856","96cdce29ab1ae1c6c876605402e577aa",35,35,0,35,35,0,1,2
"21857","96ce0b04740da9fc5d56be65c8d04bbd",8,8,0,8,8,0,1,2
"21858","96cf56c693df7151a44f32707c2ea762",30,30,0,30,30,0,1,2
"21859","96d0462eb9daece21c65d68fa79d43f0",109,72,86,8.87209302325581,109,0,3,3
"21860","96d0cf1882ce9b74ac8d00a465d1f81b",69,51,47,10.2765957446809,69,0,2,3
"21861","96d673fe692ea3b1905eed6583316ff1",29,22,63,3.22222222222222,29,0,2,1
"21862","96d7773afcd0277229e86eab542b16bf",74,39,56,9.25,74,0,2,1
"21863","96d90e504193bece314e042acc06e0c5",14,14,0,14,14,0,1,2
"21864","96dec4d73438fc1e0411096b766a0d0d",34,34,0,34,34,0,1,2
"21865","96e242fa53474ae7804385103046a91c",40,40,0,40,0,40,1,2
"21866","96e90f133d84ecfb989e16c20173fa07",159,103,58,19.1896551724138,118,41,3,3
"21867","96e9e1d8159a4546a4686e1bce0af252",1,1,0,1,1,0,1,2
"21868","96eafb3f7924eba1385d1466d68ad99f",16,16,0,16,16,0,1,2
"21869","96ed1215654495aaa2e9b4efde57529c",206,110,79,18.253164556962,154,52,3,3
"21870","96f0a0bb94e95874723c89d909776554",200,67,80,17.5,151,49,3,3
"21871","96f0d5b389df0b92e4e95f8867e90571",81,60,65,8.72307692307692,62,19,2,1
"21872","96f0ddca371637424e49cfb2c864b42d",69,59,48,10.0625,69,0,2,3
"21873","96f368c3ddb45789678c8b37c2f2fff7",52,46,54,6.74074074074074,52,0,2,1
"21874","96f6f8b5c8bec519e190013d2d7dfd18",88,49,75,8.21333333333333,88,0,2,3
"21875","96f9d9c49a06a15ea66006b59175368e",22,22,0,22,22,0,1,2
"21876","96fb84449d0434114ab9db6857083ccb",31,31,0,31,31,0,1,2
"21877","96fcb311c3b282d0c80df19d1ea80705",26,26,0,26,26,0,1,2
"21878","96ffde67da9ca49dfde769d717444c5c",44,33,49,6.28571428571429,44,0,2,1
"21879","9700d45d43bb6821e3645ee575b5dfbb",22,22,0,22,22,0,1,2
"21880","9701c28a6af04c61c2edd3b3ad0cfcec",60,49,42,10,60,0,2,1
"21881","97037b1521f5e039c1c5ab95ef4dbda5",55,49,12,32.0833333333333,55,0,1,2
"21882","97048733f9de961dbf0ab00d2cae694a",5,4,2,17.5,5,0,1,2
"21883","9704cdce454a65675a998cd366975911",110,65,64,12.03125,86,24,3,1
"21884","9705696d8038d8a8a8e0f693414eee00",41,41,0,41,41,0,1,2
"21885","970776008d1bec8507b4273916400c98",46,42,59,5.45762711864407,46,0,2,1
"21886","97089d0b0dc10931a9cf094db257937f",48,43,11,30.5454545454545,48,0,1,1
"21887","970eebe4042f070112c0d9527991b2b9",73,59,58,8.81034482758621,73,0,2,3
"21888","97111a8b2d81c006598fc299334df6ba",65,58,23,19.7826086956522,65,0,2,1
"21889","9712caeb3b2ed26307ea631f19b988bf",24,24,0,24,24,0,1,2
"21890","97133e8bcd20eeaec0e68a44766c0e81",229,155,85,18.8588235294118,188,41,3,3
"21891","9715f14d6b77b09c573abb7fec43cd78",43,27,62,4.85483870967742,43,0,2,1
"21892","971785d35a10ed303e44f0eb32a5f9aa",5,1,79,0.443037974683544,4,1,2,1
"21893","9719dc295804be86cb4ff8f1311da19d",9,9,0,9,9,0,1,2
"21894","971afffefd8e8e235fde049b80a05a61",80,53,62,9.03225806451613,80,0,2,3
"21895","971ebfba09bd78bc0caebdff15ee967c",34,34,0,34,34,0,1,2
"21896","971ef5102a3a6dba98a7cf68cfacc1bf",95,54,81,8.20987654320988,95,0,2,3
"21897","971f4709a1cff66f458a98937742a277",21,21,0,21,21,0,1,2
"21898","971fa88cb5982f63db1f6bca11e09970",26,26,0,26,26,0,1,2
"21899","9726606efec809c8f216048a748fa9e8",21,17,35,4.2,21,0,2,1
"21900","972ad02f3e9270ab9659dabc8c2eb6af",54,47,43,8.7906976744186,54,0,2,1
"21901","972ba6023d91df395cae6efd16811996",90,69,45,14,90,0,2,3
"21902","972bac91f4b7f0aad537d7e385e84c67",34,28,62,3.83870967741935,34,0,2,1
"21903","972f7e4879fa8d0d308973422801e0c4",28,28,0,28,28,0,1,2
"21904","9731b26fa26a8f91f10c1bf213859983",59,46,35,11.8,59,0,2,1
"21905","97327eee46c50c25af068731e3089215",50,50,0,50,50,0,1,2
"21906","97335eb111ba1e1c5ecc638403c17393",88,74,37,16.6486486486486,88,0,2,3
"21907","9734309646cb64efef95af87c5fe8feb",76,57,39,13.6410256410256,76,0,2,3
"21908","973922562a12ee3fc272254c0530167d",36,32,43,5.86046511627907,36,0,2,1
"21909","97394d0fd2860e9d1c3e0829e1aaa462",64,55,20,22.4,37,27,2,1
"21910","973a49d10e3a8cc3b1fce8e278356b36",85,60,57,10.4385964912281,85,0,2,3
"21911","973a7cd425f4664258f4e682a85acd9c",162,64,70,16.2,162,0,3,3
"21912","973eb7188e58613b3c45bedf07f209a1",47,34,67,4.91044776119403,47,0,2,1
"21913","973fe7d3b00a3e6bb43b8306199315aa",33,31,14,16.5,0,33,1,1
"21914","97417b003132bf7101f25fabf756c700",23,23,0,23,23,0,1,2
"21915","9741b17215b9e0a91073a1612b3e3213",32,32,0,32,32,0,1,2
"21916","9742a6e7d90c1071e9eb7ff44c369a3f",15,15,0,15,15,0,1,2
"21917","974540aee856cdfbdf1f961046ed6c68",82,57,28,20.5,82,0,2,3
"21918","9746b0166c0e5b518f72e1d983730ce8",175,74,77,15.9090909090909,175,0,3,3
"21919","974978dd5457f1c540623355d099e73b",99,71,38,18.2368421052632,64,35,2,3
"21920","974c91f444591f15c454270fc07ab7bd",35,33,5,49,35,0,1,2
"21921","974e429b39357a86d95479553b35e5bf",69,48,53,9.11320754716981,69,0,2,3
"21922","974ee0c2b832db0d631685811f161bd5",27,27,0,27,0,27,1,2
"21923","975174c2b8890be47cc0e84c9a2ef352",34,34,0,34,34,0,1,2
"21924","975273089bbe4a7990cd2e06420908b4",12,12,0,12,12,0,1,2
"21925","9752e4fbaec4af91f484f9348e050656",17,17,0,17,0,17,1,2
"21926","97533acae053e8e738894e856d24be69",3,3,0,3,0,3,1,2
"21927","9755a74e9c18dfffd010d298d8a40978",25,25,0,25,0,25,1,2
"21928","975a1d104c8998971f26e2e375bf7096",25,25,0,25,25,0,1,2
"21929","975a6c9e8095fc7214f686d7f6325b67",175,81,57,21.4912280701754,175,0,3,3
"21930","97607b21723a3405986ef4806ba68a3d",175,77,84,14.5833333333333,175,0,3,3
"21931","9761145c3a953224fbd0ed179e290140",152,114,70,15.2,152,0,3,3
"21932","9762a4d705257d420c392e5f4677b764",68,55,46,10.3478260869565,68,0,2,3
"21933","97689f0ebf04c08a08dcd609e31be83e",55,55,0,55,55,0,1,2
"21934","976a34f155317da96c4d2cf5fc498690",37,37,0,37,37,0,1,2
"21935","976d4833f959a80d53adc792826a3f48",84,61,19,30.9473684210526,84,0,1,2
"21936","976e331b74ba2cb8ce73e541c8da05f0",15,15,0,15,15,0,1,2
"21937","97719eb722dffc236703bdfb6fd67113",19,13,45,2.95555555555556,11,8,2,1
"21938","97746945ae50c39c62330d7899d131bf",10,9,32,2.1875,2,8,2,1
"21939","9774ae9249225a23b986d1f23b4e0acb",140,98,58,16.8965517241379,140,0,3,3
"21940","9774af72e2b1fa9041063ae6eb4c8cb9",37,32,49,5.28571428571429,0,37,2,1
"21941","977693fb77705c477029b55d0c85a40b",25,25,0,25,0,25,1,2
"21942","9777886f93d8b5d40b193a49e532e727",196,145,64,21.4375,151,45,3,3
"21943","97789bfd5c202ca27d30c7b626ca4bea",137,65,65,14.7538461538462,119,18,3,1
"21944","9779d3322d96c3eef39af855d72191e6",82,60,17,33.7647058823529,82,0,1,2
"21945","977aff7a21dc58766168647c22b27391",92,61,76,8.47368421052632,92,0,2,3
"21946","977ceeab65d81a56166262fd9e99f7ea",68,55,60,7.93333333333333,36,32,2,1
"21947","977dfd044c465400ed92144b6708adde",22,19,62,2.48387096774194,22,0,2,1
"21948","977e1be7d044984308f7b03c87387603",26,26,0,26,26,0,1,2
"21949","97811393ae2ae217a8cdbe87ba35d604",121,57,84,10.0833333333333,121,0,3,3
"21950","97826069022ba92f2b75100444677dfa",18,18,0,18,18,0,1,2
"21951","97843a6fd6834c4ac6163a02f7a01d89",15,15,0,15,0,15,1,2
"21952","978610dd26036eeef97de1d5e73f34fa",9,9,0,9,0,9,1,2
"21953","97876c0fa5afbf159333e78d16533ee0",44,38,27,11.4074074074074,44,0,2,1
"21954","9789a21f98450838f8c165e5cad8f955",161,115,51,22.0980392156863,128,33,3,3
"21955","9789bc4e7d1140ef75589b13e3df3cd4",168,109,70,16.8,168,0,3,3
"21956","978a42621e5f34f8ad30b4b2d41a43ee",149,88,41,25.4390243902439,104,45,3,3
"21957","978b0711f50d69b2b4a273d3b9b7527f",20,20,0,20,0,20,1,2
"21958","978d2949ddbdd0c58283796573dd1fea",31,31,0,31,0,31,1,2
"21959","978d42f1bfcad22a87fb1ab74f6d2769",90,61,70,9,90,0,2,3
"21960","978d53f7041a7bbf8b2dbbfdde70807a",82,60,70,8.2,82,0,2,3
"21961","978e38a31a0a7b8753774fcda0ae9ed7",35,35,0,35,35,0,1,2
"21962","978ece9e88b6e6216dab1d287c868676",11,10,14,5.5,11,0,1,1
"21963","978f45b056eb5632380a96f6cd7bbacd",37,32,8,32.375,37,0,1,2
"21964","9792635bd051cbbdde2a97dd6c6c1619",27,23,13,14.5384615384615,13,14,1,1
"21965","979317483e4fed7e4f5e329b66ae0b7f",43,30,70,4.3,43,0,2,1
"21966","9793690d39a71c79647c64faf7e3219a",34,34,0,34,34,0,1,2
"21967","9796cd4b56e7ec7f2cd2fe9eec319b59",55,55,0,55,0,55,1,2
"21968","979b452cb1ac85f9a04ae2fb9af07a6f",160,101,76,14.7368421052632,160,0,3,3
"21969","97a0207678c3ae34078738e730d8f089",34,34,0,34,34,0,1,2
"21970","97a742c7892c97ae234fd00bd6b8b13b",39,39,0,39,39,0,1,2
"21971","97ad81cf1bc4f45d186f398d425a397d",14,8,49,2,14,0,2,1
"21972","97ae424d29076eafd6d971b87ad7a642",92,65,76,8.47368421052632,92,0,2,3
"21973","97b19807eba4354e204e28c4b336f4d6",31,28,40,5.425,11,20,2,1
"21974","97b6071ea9b4c4db7cec5d134e593143",30,30,0,30,30,0,1,2
"21975","97b84f40237ccf21f564d86fc7207860",154,72,88,12.25,112,42,3,3
"21976","97b96d2a9611624c9c13300a7e996e01",28,28,0,28,28,0,1,2
"21977","97bbd548d135ea9cebeea96f17ce55d0",56,56,0,56,56,0,1,2
"21978","97bc49509dd70bb902a5a9d9f52625d9",89,70,14,44.5,89,0,1,2
"21979","97bf60a628979a74e15ac8347448593e",23,23,0,23,23,0,1,2
"21980","97bf7ddc7cb739ba0dbd375cf3c1b5ef",43,38,11,27.3636363636364,43,0,1,1
"21981","97c16251e03f5e890cf26c38635db932",30,19,76,2.76315789473684,30,0,2,1
"21982","97c169f64eb829ab5fe9a7b7ff4cd0a4",98,56,81,8.46913580246914,98,0,2,3
"21983","97c26634d90d08cf1a9a7b93210273bc",131,66,84,10.9166666666667,111,20,3,3
"21984","97c3669bb37caac4e60877a958cae3e2",73,60,49,10.4285714285714,73,0,2,3
"21985","97c4facf586eb39687a34a2be0fffd55",121,67,63,13.4444444444444,121,0,3,3
"21986","97c5e46e6f6f3bb65419306fd77cad32",135,63,64,14.765625,135,0,3,3
"21987","97ca0ed821d12422e1ba78d05410e0bf",54,51,22,17.1818181818182,54,0,2,1
"21988","97cbda65d76d4ddb10c3f93f5ae90f4a",80,54,75,7.46666666666667,52,28,2,1
"21989","97cc1c1e1a46ed44079ea61448186fdd",84,66,49,12,84,0,2,3
"21990","97ced4dd0d5481ab0161e96cecb866eb",65,27,70,6.5,65,0,2,1
"21991","97cf8af83983ab76735ee0c206b70e25",125,65,63,13.8888888888889,125,0,3,3
"21992","97cfe017c113a4989e7e08f85c247198",39,39,0,39,39,0,1,2
"21993","97d0ee7201226dd2affc4a5cca3ec2fc",55,39,41,9.39024390243902,40,15,2,1
"21994","97d23a02d3fa8790544b802b8cf62303",41,41,0,41,41,0,1,2
"21995","97d48a61ba4391c9fd5d97f7a7ed7175",51,48,7,51,51,0,1,2
"21996","97d64d9ac87cf072e87b143421b51455",50,49,19,18.4210526315789,50,0,1,1
"21997","97d7f8695a4b0bc489eaa9d3adf45064",16,16,0,16,16,0,1,2
"21998","97d80c888fa9e01e55a4cf8b548584ac",79,55,62,8.91935483870968,52,27,2,1
"21999","97db48fe2e0266da79a944e159d2c04e",37,37,0,37,0,37,1,2
"22000","97df47f10da7cbc7b2397604602e1c83",65,57,36,12.6388888888889,65,0,2,3
"22001","97e202835178d8a3b21e9325d7fcd0e1",95,55,74,8.98648648648649,95,0,2,3
"22002","97e239aa987573f34d5a541db1c9e12d",106,78,70,10.6,106,0,3,3
"22003","97e31dadb897a9ec651491202ece19c3",10,10,0,10,10,0,1,2
"22004","97e35ce2547f53036e4ce349c93ee2e1",150,104,67,15.6716417910448,113,37,3,3
"22005","97e397896eb7d624b9a4a9abfdb4f483",16,16,0,16,16,0,1,2
"22006","97ec342370e949f5d9bd06bbdd487ddf",9,9,0,9,9,0,1,2
"22007","97ed775c0a06487aaf48c743803b39a6",70,58,22,22.2727272727273,70,0,2,1
"22008","97f0e2ee04fd298f0abc1a900799f37d",14,13,56,1.75,4,10,2,1
"22009","97f18f788ffbb6d35a6e44362ef7ba81",14,14,0,14,14,0,1,2
"22010","97f484f8cb8098d8ba95a58873af5749",55,46,53,7.26415094339623,55,0,2,1
"22011","97f62bc72b8b12b3e4a556a807ff3b71",110,81,42,18.3333333333333,110,0,3,3
"22012","97f7b0763ef0e1e6c98182e289f9ebad",167,85,90,12.9888888888889,140,27,3,3
"22013","97f86e2073add5052f06478ee2834c8d",6,6,3,14,3,3,1,2
"22014","97f8d34b3b00cdf624c4d230f7c1ae23",5,3,0,5,5,0,1,2
"22015","97fafea4927a58e1fbac067da2ffd494",56,41,64,6.125,56,0,2,1
"22016","97fb9a41316708df40bf39f5ad550a27",26,26,0,26,26,0,1,2
"22017","98008daafd6e7f40e407dfbad34e0ccf",90,56,65,9.69230769230769,65,25,2,1
"22018","9803cb8789abea04b5d09d77d3b30af1",36,24,48,5.25,36,0,2,1
"22019","98052ef6cf60a0a7705fdc53c0995af5",118,80,64,12.90625,118,0,3,3
"22020","98061370205e75a5b4da23ca5e45fbea",43,33,42,7.16666666666667,19,24,2,1
"22021","9806f9e3510952f63a4440e0cd02fcce",11,11,0,11,11,0,1,2
"22022","98091dd79f89b54cfc2ca0035565d5f6",25,25,0,25,25,0,1,2
"22023","980a12b57869713548b2f7085751c593",36,36,0,36,36,0,1,2
"22024","980af513cf37c7e02fc2b11da7d0f1bb",13,12,42,2.16666666666667,13,0,2,1
"22025","980c7c521dd50cf15536bba8f2ec317b",30,30,0,30,30,0,1,2
"22026","980d496c7ba9b32ab16e3229fa9c0cfe",25,25,0,25,25,0,1,2
"22027","981199dfa5f74281ffb5b54b01632dbc",44,44,0,44,44,0,1,2
"22028","9812d561c121bae9ace9c0e57d5195fd",174,107,83,14.6746987951807,172,2,3,3
"22029","981350c9f24993c896d5d4e550a64363",78,40,50,10.92,78,0,2,3
"22030","9813dddf87db2414228e471291642346",20,20,0,20,20,0,1,2
"22031","9816efb97bbb358724f0f601d0cdf00c",18,18,0,18,18,0,1,2
"22032","98176c339bf591573f9d3a632e2b9e14",32,30,37,6.05405405405405,15,17,2,1
"22033","9818a205797a30110cc237e419cab87d",135,76,78,12.1153846153846,135,0,3,3
"22034","981c3fc489af28c7e459c1b2527f44cf",41,31,29,9.89655172413793,41,0,2,1
"22035","981ebe19999107183383742e8624d1d5",70,45,61,8.0327868852459,70,0,2,3
"22036","981f6d736df225286fad01fdfb7c4a3d",172,89,69,17.4492753623188,172,0,3,3
"22037","982110c9e22c37430103b42bfc21e421",79,68,13,42.5384615384615,58,21,1,2
"22038","9824e4ff2d32b49e1cf87bb55a382d9d",13,13,0,13,13,0,1,2
"22039","98255ab9696b31554785fe2d70404a25",85,59,59,10.0847457627119,85,0,2,3
"22040","982a01c70ff9e32d00bd4fceb484e7c5",75,69,38,13.8157894736842,75,0,2,3
"22041","982f72680f0a86f6c12fcfb7059d7cce",43,43,0,43,43,0,1,2
"22042","98337ea7b1196b7a88dc01763cc86f09",39,30,38,7.18421052631579,39,0,2,1
"22043","98339c6406b2d9596e140dcb1518c2db",29,29,0,29,29,0,1,2
"22044","9833c9e62c50bcedb03ebedf79474823",25,25,0,25,25,0,1,2
"22045","9834b4c8b3d67cc5218b230a5183e3ef",56,34,61,6.42622950819672,42,14,2,1
"22046","9838c823aea0fcc7e09084f3745a8eaf",7,7,2,24.5,3,4,1,2
"22047","983a33d245a65195267daabe0bb3d91e",2,2,0,2,2,0,1,2
"22048","983a8863dd331d9420c87ecd35117282",13,13,0,13,13,0,1,2
"22049","983beb7696cdc3f007b004c254ebd312",34,34,0,34,0,34,1,2
"22050","983d91930aafcdae7f651ec2e6d86fdc",36,36,0,36,36,0,1,2
"22051","983ecfc7e4ef1e9ee9782011c25b375c",49,49,0,49,49,0,1,2
"22052","983f06acf13beba40c8f8e60d805132e",179,101,65,19.2769230769231,124,55,3,3
"22053","984230fb33af19a8a464c05d8f203d6b",219,117,62,24.7258064516129,191,28,3,3
"22054","9844601fd3387867fbc85b4549c1d9e5",78,49,53,10.3018867924528,78,0,2,3
"22055","9844fed2ea158d2cdf36801fb545bf56",22,22,0,22,0,22,1,2
"22056","984716b2b229a269354a1c0f07be3437",112,80,34,23.0588235294118,112,0,3,3
"22057","98479ac1ab6133b434c8054eaaa949d3",27,27,0,27,0,27,1,2
"22058","9849bf69094f6ae635c9f9c75b7b59d7",7,7,0,7,7,0,1,2
"22059","984b2ca20d3f4528cfab3e517463906f",39,39,0,39,39,0,1,2
"22060","984c5bff9f4f1052dfa0193c151ce0f9",8,8,0,8,8,0,1,2
"22061","984d7c061a0550e23c83f976159038f4",14,14,0,14,14,0,1,2
"22062","985019a0900c4006f58f3d58f746fbfd",10,10,59,1.1864406779661,4,6,2,1
"22063","9850b91b1de18cd83d04beca8a5e4784",32,32,0,32,32,0,1,2
"22064","985402fe77e94c27cf372cf51d7f282a",21,16,72,2.04166666666667,12,9,2,1
"22065","985518bb85c39f6183e22def47bd1268",101,73,44,16.0681818181818,101,0,3,3
"22066","98559150cde12a34ddd59cac7f056c8c",120,68,76,11.0526315789474,120,0,3,3
"22067","9857a8e2c4fde3be30fd1d652685bd70",38,38,0,38,38,0,1,2
"22068","9858481fb27e598cfc84f84c9dccc8a5",126,90,89,9.91011235955056,126,0,3,3
"22069","985c00c1dede757baee05b5d614215bf",79,63,65,8.50769230769231,79,0,2,3
"22070","985cc98a268c66568a597fd8ce3e4d5a",12,12,0,12,12,0,1,2
"22071","985d714c71a51f032fe7fbc0f6d62825",72,56,57,8.8421052631579,72,0,2,3
"22072","985dbfde3c7450c71904967b4bd8dbbe",10,10,0,10,0,10,1,2
"22073","985fd2c6e33d6ba4588dd706526957e6",17,17,0,17,17,0,1,2
"22074","9862205822cf96aa57d3c005a71b7f4b",60,47,64,6.5625,60,0,2,3
"22075","9864c7bc88f7c387bb8dd77112a8b9a1",59,52,34,12.1470588235294,59,0,2,1
"22076","98659afe9a1f896c7220dcfe57fcbd31",105,65,62,11.8548387096774,105,0,3,3
"22077","9865ac66469e33820dd09b187d08dd91",130,43,73,12.4657534246575,111,19,3,1
"22078","9866939b11572b6a25c40dde73a9d76d",15,15,0,15,0,15,1,2
"22079","986c6620df4483211cea4bc575e9cc13",167,110,75,15.5866666666667,150,17,3,3
"22080","986edb2cbd45c01cf8739517cdc3bd8d",54,45,55,6.87272727272727,25,29,2,1
"22081","98700963cbe0f9465142347167f2b78f",146,93,77,13.2727272727273,146,0,3,3
"22082","9873b0f3f97323b38280c632d3ef0249",96,50,78,8.61538461538461,59,37,2,3
"22083","98742884c8d246866540976fc8e7e767",98,52,53,12.9433962264151,98,0,2,3
"22084","98770d7871d4ee247c85d3f1387d2132",37,30,70,3.7,37,0,2,1
"22085","9878cc7fc132a2c7fefafed332f6308d",19,19,0,19,19,0,1,2
"22086","987b9fd8c96eb5763c196e5e5f1ab559",68,53,36,13.2222222222222,68,0,2,1
"22087","987dcc6db501ae1fca7e249732d84e59",139,74,60,16.2166666666667,96,43,3,3
"22088","987f47aa3f02fe766c22aab3a56f1d6e",23,23,13,12.3846153846154,6,17,1,1
"22089","987ff424af347b9819c535f6e3eae1a8",69,37,86,5.61627906976744,69,0,2,1
"22090","9882fe22ea46e57d3c1413b46c4b8741",9,8,29,2.17241379310345,9,0,2,1
"22091","98841cef51bd4b6d704ce25d61303b79",16,16,0,16,16,0,1,2
"22092","9885cecafdb7e4c14f0e41f041a40579",29,29,0,29,29,0,1,2
"22093","9887adc02d7cd5ea1e55ae39e1fa251f",36,36,0,36,36,0,1,2
"22094","988bcc187f4d594c61fb25754fa400fd",18,18,0,18,18,0,1,2
"22095","988c933cfc9534d1349ac7dc24267090",19,19,0,19,19,0,1,2
"22096","988d67978bdfae50ee72ac5860387e5f",35,35,0,35,0,35,1,2
"22097","9890012cb1727eeba14e64e33953ff3d",16,16,11,10.1818181818182,16,0,1,1
"22098","98906142d38fdce98f71f9617ed90f3c",25,21,63,2.77777777777778,25,0,2,1
"22099","9891002b573ada7d212c9edcd8f686c3",40,40,0,40,40,0,1,2
"22100","989213089adeec67b02b1be5f7c9882a",16,16,0,16,16,0,1,2
"22101","98927af063654ce862a889136528963f",39,39,0,39,39,0,1,2
"22102","9892aecf6047c34ddb624c3f6bc0c76f",39,39,0,39,39,0,1,2
"22103","98933e987cfd688df13133bcac84e02e",83,68,28,20.75,83,0,2,3
"22104","9896726ab93542d115dc9865cb963c19",32,32,0,32,32,0,1,2
"22105","9899d9d02e46868a1179df6ac4a368b6",62,51,55,7.89090909090909,62,0,2,1
"22106","989b9445ad92e5f1e8f3c9136339a3b1",148,76,83,12.4819277108434,148,0,3,3
"22107","989c82190b50a3ddfe0ecb9e27c84547",78,55,31,17.6129032258065,78,0,2,1
"22108","989d75f874941a8ea7c3cf9259b375f9",53,53,0,53,53,0,1,2
"22109","989f5c9d544b9325cabefa56af8e7118",19,17,53,2.50943396226415,19,0,2,1
"22110","98a0b876bac308794b0c8a18b3a6a5fa",56,56,0,56,56,0,1,2
"22111","98a33482f951142f798cf8f3c7e087d5",21,21,0,21,21,0,1,2
"22112","98a6f1800f1c3cdba57a50044538e25a",30,26,39,5.38461538461539,17,13,2,1
"22113","98a96c028ee6441a1c7f09e146d054cd",1,1,0,1,1,0,1,2
"22114","98aa1cf1fad3ff716c52d90a8fc5a90d",35,35,0,35,35,0,1,2
"22115","98abfbea6cc0d6d7acd43f57777b2fa0",197,108,82,16.8170731707317,197,0,3,3
"22116","98ade4af1433fb2357aae2a956ab1274",39,21,60,4.55,30,9,2,1
"22117","98b1a6cb4a3069d4cf14abe634def48c",86,65,55,10.9454545454545,43,43,2,1
"22118","98b1b3a490a7843193e93f41de44a9df",42,23,52,5.65384615384615,42,0,2,1
"22119","98b2c2b9379071d6b7b0ae9ffbed467f",53,38,14,26.5,0,53,1,1
"22120","98b32db9582aa151cce6b73951e24a68",75,61,51,10.2941176470588,75,0,2,3
"22121","98b4ee404a1c3034180f18cfd0f0525e",19,19,0,19,19,0,1,2
"22122","98b51c6687246796a9f62b9815ec91b2",93,69,51,12.7647058823529,93,0,2,3
"22123","98b59c1779b4269689428e7915bc78cc",29,20,70,2.9,29,0,2,1
"22124","98b604c6607cca6f5023f2aef1f0f03c",54,54,0,54,54,0,1,2
"22125","98b66dfe751e387501a6513e12325f3c",36,31,36,7,36,0,2,1
"22126","98be9decd942419e578e2239b91eeee0",25,25,0,25,25,0,1,2
"22127","98befa70fcc5c15b7f75d2e44c4bf14a",24,24,0,24,24,0,1,2
"22128","98c633b6208f68cbbeb8ba940a3adc51",35,22,13,18.8461538461538,35,0,1,1
"22129","98ca09aab932e7317704ba2094e219fb",41,29,54,5.31481481481481,18,23,2,1
"22130","98cb4a62b37ad54216fce1e4e4e3ba0b",4,4,0,4,4,0,1,2
"22131","98d1f8f71cbd3d1fea32f0bded153a8c",72,47,69,7.30434782608696,72,0,2,3
"22132","98d5e54bdbddfa8413c742ed76133477",202,101,77,18.3636363636364,174,28,3,3
"22133","98d800f3c56991314db927cd7ffccc27",32,32,0,32,32,0,1,2
"22134","98da0673270381f085cf24a762a3edae",153,87,55,19.4727272727273,153,0,3,3
"22135","98de592c24d55de1eda679a72789796e",137,86,62,15.4677419354839,100,37,3,3
"22136","98e2f4e575f3e2cb5fde2d566291a3e4",26,26,0,26,26,0,1,2
"22137","98e3cf1caed424df75b5387abbeee592",20,20,0,20,0,20,1,2
"22138","98e85b5716879bd9710f55a5bbe58bf1",176,120,63,19.5555555555556,176,0,3,3
"22139","98edc9b8ab074372df541e98b922569f",28,23,61,3.21311475409836,28,0,2,1
"22140","98eefb3135a44f7a3d199656bdebaf4e",48,45,14,24,48,0,1,1
"22141","98ef2c373f2b75dbf0df164ecc366a7b",17,17,0,17,17,0,1,2
"22142","98ef8cb45d4000c675ceae7bc62ac91f",57,44,27,14.7777777777778,57,0,2,1
"22143","98ef8fe9d0f43be07d75cbaa7dac2316",15,13,52,2.01923076923077,15,0,2,1
"22144","98f278837fa6395a6453ea66d7f287f0",133,95,60,15.5166666666667,133,0,3,3
"22145","98f2c493714f0190756e20d0031dd670",104,77,75,9.70666666666667,104,0,3,3
"22146","98f37eee6b4bf4bc2f35074ec1f42339",60,52,26,16.1538461538462,17,43,2,1
"22147","98f55875b6e7e9fdd95a4212a2a05f75",102,40,53,13.4716981132075,68,34,2,1
"22148","98f98be81c596f06cb68a31f3e3eca19",75,60,57,9.21052631578947,42,33,2,1
"22149","98fa51a70129ad2f29768b49b70925e0",61,47,33,12.9393939393939,61,0,2,1
"22150","98fbae65791110a117fab0f174b55c2a",102,71,51,14,70,32,2,1
"22151","98fc99c93c771325e808d3c2816d1cad",23,23,22,7.31818181818182,23,0,2,1
"22152","98fcdd7eac589e2e32117c3549473ad5",57,49,24,16.625,57,0,2,1
"22153","98fd647fc22fa9bf06888ddaad49ce22",34,30,26,9.15384615384615,34,0,2,1
"22154","98fd7778824f666b1ceda50e2fc64760",11,8,59,1.30508474576271,7,4,2,1
"22155","98feae146c794ce0d1b4484e7b285149",251,97,56,31.375,203,48,3,3
"22156","98ff4f3054281cd8e517f157123d130c",102,82,41,17.4146341463415,102,0,3,3
"22157","98ffa2c258bb02dac82a325d6f1e2bad",23,23,0,23,0,23,1,2
"22158","9900c18c933066c1413e265ed42671ba",178,98,65,19.1692307692308,178,0,3,3
"22159","9903649c2d148f0a2b8c5a0453459fdf",104,77,69,10.5507246376812,104,0,3,3
"22160","990415a93cc79941dcaa9ae5d2c4fee0",29,29,0,29,29,0,1,2
"22161","99075a2542e699dc80b8307ae9c4a09a",50,50,11,31.8181818181818,50,0,1,2
"22162","9907e2ef213dc18d47aef7e61442654a",84,53,49,12,84,0,2,3
"22163","990805171fcad38a7fabb9a58e0c0ce1",47,38,55,5.98181818181818,47,0,2,1
"22164","990a7912b605560a8418bc3e4e147006",33,33,0,33,33,0,1,2
"22165","990b6c6e9e56098c1f7d931aaa93d65b",136,89,54,17.6296296296296,86,50,3,3
"22166","990bd66aeb526d774eb3a1bcbaf6318b",13,13,0,13,13,0,1,2
"22167","990c540d91c5689a8c14e8ca76703d10",40,40,0,40,0,40,1,2
"22168","990d6488a3a36eb80f9a72ec2fb447b2",84,66,41,14.3414634146341,40,44,2,1
"22169","9912fc15a749bb21c635fa3bff039349",48,48,0,48,48,0,1,2
"22170","99133ab9490be9590f9a363b67ff929b",37,37,0,37,37,0,1,2
"22171","9918c2cbd53cc5332a58a5f5ce14cb1f",109,78,53,14.3962264150943,78,31,3,1
"22172","9919301197114040ea78abed44f8c6c3",28,28,0,28,0,28,1,2
"22173","9919a1f5e84eaec2bf17f9b3f9f4d9b2",24,24,0,24,0,24,1,2
"22174","9919ce949053e2cf56bc10c6caf6ec6e",38,38,0,38,38,0,1,2
"22175","991a0e822879cc9279e512763e1859a1",91,48,50,12.74,91,0,2,3
"22176","991ced4c64e244cfd5ac6a5f37690503",18,18,0,18,18,0,1,2
"22177","99220c23ad2f97bca367e0acb8a80cc1",248,137,66,26.3030303030303,202,46,3,3
"22178","9923e040284abb699c4e911a67c64b19",24,14,63,2.66666666666667,24,0,2,1
"22179","9926e4e8800a195ee86573e4b68a66a8",134,75,48,19.5416666666667,101,33,3,3
"22180","9927e06724c42dbe99af0d0139386edc",39,28,70,3.9,39,0,2,1
"22181","9927fb70073f456350396f61ead776da",113,71,60,13.1833333333333,88,25,3,1
"22182","9929db59075e276ecce94636bbf456e5",8,8,0,8,0,8,1,2
"22183","992cbc9e5fe8afdc6ba61d23ee8ffcc7",44,44,0,44,0,44,1,2
"22184","992d1f40998f47352071d7572a1b1baa",3,3,0,3,3,0,1,2
"22185","992daa9b807d11aa3e8bfaf91631d353",36,36,0,36,36,0,1,2
"22186","992dd4e268bf7e94075969c4fd1d7163",80,47,54,10.3703703703704,80,0,2,3
"22187","99338f3ec24a785e71f866c32e079d3d",52,26,61,5.9672131147541,36,16,2,1
"22188","9933c5b42713a5ff2ef82dbaf7fca302",145,92,70,14.5,91,54,3,3
"22189","9933d0e730b2a5bd872d8009cdd0143c",13,13,0,13,13,0,1,2
"22190","9935159e544d270a3be4ebd642751456",112,72,77,10.1818181818182,112,0,3,3
"22191","99376b2dc4a65b2e75d5d401574a2094",103,78,82,8.79268292682927,103,0,3,3
"22192","993877b253d9b804c616060801aa2453",16,16,0,16,16,0,1,2
"22193","9938da4abce636ff1780421d41a39390",167,110,84,13.9166666666667,167,0,3,3
"22194","9938e9cf39ac33b07ab8653f2fd07679",40,40,0,40,0,40,1,2
"22195","993ac9ba8be328a0d3e9dd57487cb394",78,63,13,42,78,0,1,2
"22196","993dd83dac4fd1935139774b98d95d4a",199,156,40,34.825,199,0,3,3
"22197","9942112e68a9c90ebb5dc4742211ba13",104,63,62,11.741935483871,104,0,2,3
"22198","9942d48b9ef09d1a1ecd4a228cd634c9",2,2,0,2,2,0,1,2
"22199","9943e15149c7d26312ebae0d1b2854ee",102,48,61,11.7049180327869,66,36,2,1
"22200","99474d93226516754b264935044398ce",173,42,85,14.2470588235294,169,4,3,3
"22201","994767fedab86909640f20a9a524b2ff",33,33,0,33,33,0,1,2
"22202","994865b54f348fa4047f9796571f88cd",68,56,29,16.4137931034483,68,0,2,1
"22203","994929df138b03e7cb8f533df20c7767",21,21,0,21,21,0,1,2
"22204","9949cf1d986a3a0be36da55c618b26cf",26,26,0,26,0,26,1,2
"22205","994a4311f788a4d64f5a0e25310d79eb",134,77,49,19.1428571428571,134,0,3,3
"22206","994c89f90319a9fe3c91515b68c49093",28,28,0,28,28,0,1,2
"22207","9953db6a1a87bdec43c72f998c471b45",3,3,0,3,3,0,1,2
"22208","995476fc15820040808b0b3eac00b781",48,41,28,12,48,0,2,1
"22209","9956cccef822964f13dbe6f63ca974a7",33,33,0,33,33,0,1,2
"22210","99584103fa512f7a6f848d54296eb99c",10,10,36,1.94444444444444,6,4,2,1
"22211","995875ca4434cd8070f36dff49f1231c",23,23,0,23,23,0,1,2
"22212","9958eec2d08369f63ba2cab678bbf604",216,132,84,18,216,0,3,3
"22213","99597fbdabc9d64e25f2e39d1e993225",16,16,0,16,16,0,1,2
"22214","995e4b585e22c21f75ae1bb4c97178df",94,77,77,8.54545454545454,94,0,2,3
"22215","9961a93dcfeb50676f5a8c9205cf34e1",47,47,0,47,47,0,1,2
"22216","9964d83803eda37d65505393a0dc003f",86,64,77,7.81818181818182,86,0,2,3
"22217","9964de6d8248c925cb558d255ffc678a",90,54,60,10.5,90,0,2,3
"22218","996763c19c9005978cbbad5703f62051",20,20,0,20,20,0,1,2
"22219","9967ce0ef4e27fa91e7fc1084ba42a03",67,49,36,13.0277777777778,34,33,2,1
"22220","996d2fd75e300fd3923caf46c338ca2b",179,55,81,15.4691358024691,159,20,3,3
"22221","996eebadd80b7c866ec2e8e551546747",70,49,58,8.44827586206896,70,0,2,3
"22222","996ffe8bac0fb0e06e9c9cb832b1431d",41,41,0,41,41,0,1,2
"22223","99712079e0ddae548f476ddd416023a3",16,15,4,28,16,0,1,2
"22224","997459a2e4ae400b9ffa1d5f74718fa1",2,2,0,2,2,0,1,2
"22225","99752cd0c4638b152cb6498a7f685963",25,25,0,25,25,0,1,2
"22226","997530473da37bab73ba0f01fe9a2da9",10,9,43,1.62790697674419,10,0,2,1
"22227","99760c52b682efc1a1615d8b613ca535",109,86,68,11.2205882352941,109,0,3,3
"22228","997680680a0bb9b936b2ebefea291343",3,3,0,3,3,0,1,2
"22229","9976e1ba5de26640206cd432a941f991",107,62,77,9.72727272727273,107,0,3,3
"22230","99787f1336d4b5c618e344db47fffea8",13,13,0,13,13,0,1,2
"22231","9979f8e420ebde27b46b4c5a9759cd7c",42,42,0,42,42,0,1,2
"22232","997bf2b882db317c5e4927d677938de1",39,39,0,39,39,0,1,2
"22233","997e8b8e7c62db4e520ca23cd0f0b355",110,82,29,26.551724137931,110,0,3,3
"22234","997ff6aac30be71a2cc8ae9f4c8a4296",100,38,71,9.85915492957747,90,10,2,1
"22235","99817a4d181df46cd48e84c54d79cbfe",79,68,31,17.8387096774194,79,0,2,1
"22236","9985219b96efeffed7a8be93ca677a86",30,30,0,30,30,0,1,2
"22237","9988262654d14cbe554053d2b435b55f",33,33,0,33,33,0,1,2
"22238","9989e677605b8da1eac2dee66850bf8c",74,62,27,19.1851851851852,34,40,2,1
"22239","998b5c05b77ebb880baea7430f67b2db",23,23,0,23,23,0,1,2
"22240","998cc6123e4f10a1cdd95cfb55607a2a",66,35,47,9.82978723404255,20,46,2,1
"22241","998e589605fbdfa2e55e7ebaed6746cb",63,46,32,13.78125,63,0,2,1
"22242","998eb105559f2f9f4e3de0931f6f17a2",46,35,43,7.48837209302326,19,27,2,1
"22243","998f1978cd29baac954b7f54aa77c339",78,71,34,16.0588235294118,78,0,2,3
"22244","998f441172cf5919295bca51a5a6586d",11,11,0,11,11,0,1,2
"22245","9991c4d000ed8fcbd4836be4bfd5a33d",178,88,77,16.1818181818182,144,34,3,3
"22246","9992841db9752a55120edd4b282c7aee",10,10,0,10,10,0,1,2
"22247","99941ead0d62dacd280bd3d727e371a1",65,43,33,13.7878787878788,65,0,2,1
"22248","9994bc5b47478c23a983f35757b3127d",8,8,0,8,8,0,1,2
"22249","99954e88d6c624d45c500974330dd553",45,40,37,8.51351351351351,32,13,2,1
"22250","9995be1b084003c8ea525c42108926d9",57,43,55,7.25454545454545,57,0,2,1
"22251","999e7a72bb0b277a77d7c8d776907e2b",108,76,36,21,108,0,3,3
"22252","999f1433517e32a62cb781c5ab53e63d",23,23,0,23,23,0,1,2
"22253","999fdf6944c09d711cefdd52c41687ed",123,87,66,13.0454545454545,123,0,3,3
"22254","99a1188990ce7359a1d65ff83a956800",38,38,0,38,38,0,1,2
"22255","99a3efd7ea63b3b3fad065c7f3037a38",26,26,0,26,26,0,1,2
"22256","99a7ee01f93f5c18096deaefcb8e3918",90,54,34,18.5294117647059,39,51,2,1
"22257","99ad42e8903624982f15ca4d328acfe9",138,62,63,15.3333333333333,138,0,3,3
"22258","99ae4ac877c9ded2dd9b47f0a36b35bf",41,41,0,41,41,0,1,2
"22259","99ae7e9fc493861ffb8198237f6f4fad",116,86,46,17.6521739130435,116,0,3,3
"22260","99b144d0ed57c72d2ed22e77305b1585",36,36,0,36,36,0,1,2
"22261","99b1b95dcf168872f812fd4806df515e",88,81,75,8.21333333333333,88,0,2,3
"22262","99b458d673233492214734db01de4710",30,30,0,30,30,0,1,2
"22263","99b4ded7e49c529be12b23fde2644593",44,39,28,11,44,0,2,1
"22264","99b4f7c74c3c5b2e96272256c492379f",12,12,0,12,12,0,1,2
"22265","99b5411da7c90abdd879586d8d6b34c5",56,51,33,11.8787878787879,56,0,2,1
"22266","99b9643dd16f7c575ef8b5b7addd9d26",103,76,40,18.025,103,0,3,3
"22267","99baa9c9ac7872697211fc91a4aca5a8",1,1,0,1,1,0,1,2
"22268","99bc3a7a2bd8c50e42003647d584aa53",24,24,0,24,24,0,1,2
"22269","99bc7ee91cf5aae11efa64c003dbfa0a",110,80,62,12.4193548387097,110,0,3,3
"22270","99bcb28ffa93f433250628d712367beb",13,13,0,13,0,13,1,2
"22271","99bcb64167886461a7751318f7e0c2a9",37,27,46,5.6304347826087,19,18,2,1
"22272","99bdb98d94148200239625f3a3ccf6a1",64,56,39,11.4871794871795,64,0,2,3
"22273","99bdf67b97f6d3916a7792bd384dde6d",192,125,77,17.4545454545455,192,0,3,3
"22274","99bf4fdaa3baa37b71f65510440a2213",12,12,0,12,12,0,1,2
"22275","99c03f398a2d83290ee926e8ee111bd6",34,26,25,9.52,18,16,2,1
"22276","99c14811bc169a4014d43de9410826f5",23,19,77,2.09090909090909,0,23,2,1
"22277","99c15f78d853ad41c945daf07cdf3b0a",65,40,63,7.22222222222222,65,0,2,1
"22278","99c174ec7fcb16ecfc3f58f0467b8f64",47,47,0,47,47,0,1,2
"22279","99c2bb703afd5b5d82ce353cb5cbac7c",43,43,0,43,0,43,1,2
"22280","99c3380cb4cfc96eba4ddee6459c19da",150,75,72,14.5833333333333,116,34,3,3
"22281","99c33fbb67d7bfab23b9d97a912da332",40,35,46,6.08695652173913,18,22,2,1
"22282","99c8b19ee6d51ce84430ac112655cd00",29,29,0,29,29,0,1,2
"22283","99caa58fc5782d4801768a7a08dd0075",19,19,0,19,19,0,1,2
"22284","99cb6dde9751280b29573255debf34dd",125,67,70,12.5,106,19,3,1
"22285","99d09283d037647e7f195be1e578f552",19,19,0,19,19,0,1,2
"22286","99d117cb87cb3199e9e4af89e80c703a",24,14,83,2.02409638554217,24,0,2,1
"22287","99d1fdb4890f10d8864c5aea5b003dba",56,46,57,6.87719298245614,17,39,2,1
"22288","99d352030c324a186717d237fef46bff",68,51,60,7.93333333333333,53,15,2,1
"22289","99d402c13a1bba57ff1b665057b84bd2",26,26,0,26,26,0,1,2
"22290","99d51cf54402a2316c5b7bac944b0d32",23,23,0,23,23,0,1,2
"22291","99d7712c4481d519cc1b7c1d8f5287ef",48,37,64,5.25,48,0,2,1
"22292","99d84b73b98738316969ae4763ab3521",30,30,0,30,0,30,1,2
"22293","99d8f4d4de319a08e74e1268e05319e4",42,42,0,42,42,0,1,2
"22294","99da33400ff3465f39416ac91d529cb0",33,33,0,33,33,0,1,2
"22295","99db94f5338bb0a6e9ce93bee047add0",15,15,0,15,15,0,1,2
"22296","99dfc69f9d71d864734c14b07f74b0b8",38,38,0,38,0,38,1,2
"22297","99e1d421108f201923856b3a895431ae",46,40,19,16.9473684210526,46,0,1,1
"22298","99e6ec49ed480e6d3e2de4a88fd5c7c9",51,51,0,51,51,0,1,2
"22299","99e6f1fc9f7047eb37ea007c0551f779",114,85,41,19.4634146341463,71,43,3,3
"22300","99ec4cd013048675f54c42a1c29cc883",14,14,0,14,14,0,1,2
"22301","99ee21e3f82f210b03108c789839d9f1",17,17,0,17,17,0,1,2
"22302","99f393c905d39041caadb7c9c345b56f",27,27,0,27,27,0,1,2
"22303","99fde09de003ab8f712eadd345b58c4b",46,30,45,7.15555555555556,46,0,2,1
"22304","99fe2b92a7dc388bdad598eb9d45877b",52,42,43,8.46511627906977,27,25,2,1
"22305","99fe40d453a967b78993370d511afd84",37,37,0,37,37,0,1,2
"22306","99fea816c1b375af514a41709403d6f0",12,12,0,12,12,0,1,2
"22307","9a02dbeb2227ac4b6f24ac973ae31715",110,77,55,14,110,0,3,3
"22308","9a05baae88f29c01c8aa9da5d86dd87f",36,36,0,36,36,0,1,2
"22309","9a0ae0ec1ef099c93d91c7ec9caac91b",36,36,0,36,36,0,1,2
"22310","9a0bff4d69e346a7ab5c9530f407edf5",20,20,0,20,20,0,1,2
"22311","9a0d344d32d8db19730118411a022a90",4,4,0,4,4,0,1,2
"22312","9a0dcb54e614dc7bcce2d2d7a8943d54",98,86,16,42.875,98,0,3,2
"22313","9a16cdfff6a11966045cd3b7a4897434",19,19,0,19,19,0,1,2
"22314","9a1b1cb231859eb2922ab4dcf4fa734f",86,54,29,20.7586206896552,86,0,2,3
"22315","9a1c10dce54629da70407ba54f802437",148,112,83,12.4819277108434,106,42,3,3
"22316","9a20bd59036a3a056767e7af4b6279b5",2,1,45,0.311111111111111,1,1,2,1
"22317","9a216ec8bd7cdfbf1cb95e3136ab9786",51,28,72,4.95833333333333,51,0,2,1
"22318","9a22e123eecdaf338d9979c55497603b",83,66,55,10.5636363636364,83,0,2,3
"22319","9a2463a19c536b71c7051df79e039f03",20,20,0,20,0,20,1,2
"22320","9a254614e1565e0fd8a7840bf73d1b75",58,48,10,40.6,28,30,1,2
"22321","9a25921403cccaf03b46fbfc24dca7d2",77,52,69,7.81159420289855,77,0,2,3
"22322","9a2628c6fedb27f15b9fd27122b5c38a",120,75,54,15.5555555555556,90,30,3,1
"22323","9a2f4c467bacffaa0e6a4f065bbac652",12,12,0,12,12,0,1,2
"22324","9a310a9c51d5d4d2e77ad49343d382a0",74,64,56,9.25,74,0,2,3
"22325","9a310cc043122b5aeb2912b47b19f9a2",22,22,0,22,22,0,1,2
"22326","9a31619fdd7da7a3ff4a15d0b5ce2a51",115,87,58,13.8793103448276,115,0,3,3
"22327","9a34b4dcd6c7e41fc15fbc23abf3e61c",136,70,61,15.6065573770492,116,20,3,3
"22328","9a35277742bfd2c5c5dc8ad0a8d9b941",96,78,79,8.50632911392405,96,0,3,3
"22329","9a35326b632cf322e80e2d6d6fdfeaab",6,6,0,6,6,0,1,2
"22330","9a3536c8571be71b41fb13ce9e90c5b2",164,116,60,19.1333333333333,164,0,3,3
"22331","9a362387b63e3fedc5114628a10097a7",22,22,0,22,22,0,1,2
"22332","9a3732481bc618b5de249a16f7266b38",20,20,0,20,20,0,1,2
"22333","9a374af22954fdebea3e0b396a46813e",15,11,54,1.94444444444444,15,0,2,1
"22334","9a3a881dd3bae229ccc66adc83492d96",30,30,0,30,30,0,1,2
"22335","9a3ac5631d839a7da7ef0ad5308376f3",21,21,0,21,21,0,1,2
"22336","9a3ce2780b0d6c07315abb148ecf6cf5",80,64,29,19.3103448275862,80,0,2,1
"22337","9a3dc9316aaaf570e7c4dcbe7d6c8dfa",14,14,0,14,14,0,1,2
"22338","9a3f07d4f3348f85ba2f6ca79f8140ec",147,81,74,13.9054054054054,147,0,3,3
"22339","9a3fe631e929780156b7bf01ef103543",56,45,32,12.25,56,0,2,1
"22340","9a409bb98461abd0703d75d4c84ccaca",108,67,33,22.9090909090909,108,0,3,3
"22341","9a417218a2f9c1253472e4a05fdf7a4b",19,19,0,19,19,0,1,2
"22342","9a41d43b6ad5ad36fa6bf2efc95b89c3",124,81,83,10.4578313253012,124,0,3,3
"22343","9a423fecf1d9fac457d57170922bcea5",147,89,67,15.3582089552239,147,0,3,3
"22344","9a4364580ee59b0e926063f5893026a6",49,43,48,7.14583333333333,49,0,2,1
"22345","9a43edd3b4dd36cf5add8f6f132f4099",99,79,56,12.375,99,0,3,3
"22346","9a4629cf2355a9b342148138b9ed0857",31,31,0,31,31,0,1,2
"22347","9a47f8cf72f2588c68b9a0f13ccf9912",70,57,43,11.3953488372093,38,32,2,1
"22348","9a4b2d0ac4ff88cc53cc0236c4b3a4da",26,26,0,26,0,26,1,2
"22349","9a4c87b457ceec0405a96049b229a6e9",31,31,0,31,31,0,1,2
"22350","9a4ce4e2873a27a80ec2eae1bd361852",96,83,45,14.9333333333333,96,0,3,3
"22351","9a4d21985db37c820a4770b7cfc0dd30",84,43,62,9.48387096774193,84,0,2,3
"22352","9a50d55191e51c3596096112fa26c5ad",36,36,0,36,36,0,1,2
"22353","9a55d638b4bc2327c8002e2b095202bb",93,78,22,29.5909090909091,93,0,3,3
"22354","9a5cad0dd1ad9a4990331aea2bc611f4",46,40,60,5.36666666666667,16,30,2,1
"22355","9a5e982e2bc9e37d4e787221f07d755b",21,21,9,16.3333333333333,21,0,1,1
"22356","9a5f99c0b4b3ca530dde9ba6323abb66",29,29,0,29,29,0,1,2
"22357","9a61b949a1bbb4b14ca25b6dc56555ba",42,40,7,42,42,0,1,2
"22358","9a624515c833d70a9945bf8d72971e23",168,99,75,15.68,142,26,3,3
"22359","9a6441281a82ca439218ddceedc812c3",41,35,31,9.25806451612903,21,20,2,1
"22360","9a65b44d69ca93ab03f5c3bf52792305",22,22,0,22,22,0,1,2
"22361","9a666a67b62333c2d56427003dc6131d",1,1,0,1,0,1,1,2
"22362","9a67b04604cde0e1bc71908a4f3cad91",89,75,70,8.9,89,0,2,3
"22363","9a690dcfe870f1c13f730a94c00ff87f",12,12,0,12,0,12,1,2
"22364","9a6b624c944425ba930e152b1ef15393",21,21,0,21,0,21,1,2
"22365","9a6b8b860c47d831338914a2900d0175",75,58,35,15,45,30,2,1
"22366","9a6c045984a360e790c45afff884293d",32,32,0,32,32,0,1,2
"22367","9a6c41fb5b295f790ff16a2ddaa3edc8",46,41,24,13.4166666666667,46,0,2,1
"22368","9a6da8394af347e58672fbfcff96e38a",68,38,56,8.5,68,0,2,1
"22369","9a70a13c382a8d2ea1c14f12131478f2",33,33,0,33,0,33,1,2
"22370","9a7151b53c54fee30ce118540427920d",12,12,0,12,12,0,1,2
"22371","9a7262095c46291fc84b3aea28c73ef9",181,63,76,16.6710526315789,181,0,3,3
"22372","9a72b8fcdd2b597d52eecab6b70bac96",113,79,67,11.8059701492537,113,0,3,3
"22373","9a7430d71f700eeaac2399018dda342f",47,36,8,41.125,21,26,1,2
"22374","9a7629417b52b28ad949b8c27c350df6",55,43,60,6.41666666666667,55,0,2,1
"22375","9a767ca15796a670f7f2a434fb6da1c5",22,22,20,7.7,22,0,1,1
"22376","9a7975723cb45e744e5e828936bc012f",9,9,0,9,9,0,1,2
"22377","9a799cba2d6cb8c6b8eeb9d2a3a60b2a",1,1,0,1,1,0,1,2
"22378","9a7a2d15ce4c4b92e5e2b11c609310c3",16,16,0,16,16,0,1,2
"22379","9a7a2f90d782bc8e1496112f4a5e82e5",66,50,33,14,66,0,2,1
"22380","9a7a472577d196c7d9a6dbebb165cd2b",54,40,64,5.90625,54,0,2,1
"22381","9a7b0c07d1b4cfa23389f1ccff5d1352",173,114,69,17.5507246376812,173,0,3,3
"22382","9a7d32ca4608515ff53c61b527373ce9",22,22,0,22,22,0,1,2
"22383","9a7e31f23f269af56592510553cbedf0",120,85,66,12.7272727272727,91,29,3,1
"22384","9a7eb7d274ef5ae19289709db4ad30cb",24,24,0,24,24,0,1,2
"22385","9a81a3e03085d974708a039746432429",85,51,77,7.72727272727273,51,34,2,3
"22386","9a820374834f2e45a6d89aac208221d5",17,17,0,17,17,0,1,2
"22387","9a82c768fcb214f5406f3079928008c8",16,16,0,16,16,0,1,2
"22388","9a83a127c8be3bda52f0c655608fb3a8",146,78,61,16.7540983606557,101,45,3,3
"22389","9a849839a05862c06edc2b4622287d69",72,60,58,8.68965517241379,72,0,2,3
"22390","9a8809f5c7b88f484859eeb594c6d795",43,43,0,43,43,0,1,2
"22391","9a89741eef4fa825888413c12a915ca6",92,72,26,24.7692307692308,38,54,2,3
"22392","9a89989387121c416dff2cfbfa175fbe",31,31,0,31,31,0,1,2
"22393","9a8c220ca535be6c14bc3c2e6538e174",59,46,59,7,59,0,2,1
"22394","9a8e555c3ac7a1c89a93dcedeefdb024",151,83,62,17.0483870967742,120,31,3,3
"22395","9a9015bbfca8d6a8b72718eedcc1b7e8",49,31,62,5.53225806451613,49,0,2,1
"22396","9a9193a1312dc303d82e056a694acfcd",62,46,67,6.47761194029851,62,0,2,1
"22397","9a91c39d23245ccef48b20ad6f4cc74d",46,46,0,46,46,0,1,2
"22398","9a929486d22794a8ced908e84dc94419",225,88,87,18.1034482758621,189,36,3,3
"22399","9a945048fdd0f2ef22a4a595752b02c8",25,20,78,2.24358974358974,19,6,2,1
"22400","9a9736bfc0adb9c007f88fe8f5bf98b1",42,40,63,4.66666666666667,42,0,2,1
"22401","9a9a3a420d03d97666b6ab3dce5e3f8b",20,20,0,20,20,0,1,2
"22402","9a9d153ffc49883a31fa3dfed456dd63",30,30,0,30,30,0,1,2
"22403","9a9dc485132a8e553914a062fed78dc2",32,32,0,32,32,0,1,2
"22404","9a9e1d9a26c14af61bf1013ac604859e",113,65,75,10.5466666666667,98,15,3,1
"22405","9a9ed7bbcb795bd9333792a6f2787cd8",11,11,0,11,11,0,1,2
"22406","9aa18aa5821cf6a0d6d9a0878a465e8d",21,21,0,21,21,0,1,2
"22407","9aa1d5cfa7c7e5ddead738758e4ce3e3",64,46,60,7.46666666666667,64,0,2,1
"22408","9aaa1e731df9cd16e01c4518f5f8b24c",39,34,51,5.35294117647059,39,0,2,1
"22409","9aaa5e28af6bf66b800046cd9f857f3d",11,11,0,11,11,0,1,2
"22410","9ab02cb2edcb093a33117cbc9948a47e",22,22,0,22,22,0,1,2
"22411","9ab08d1f65a8f79568813d4ce2298e55",95,64,63,10.5555555555556,95,0,2,3
"22412","9ab435cb015af909876e0462a68203bc",31,31,0,31,31,0,1,2
"22413","9ab891e5f7dfce1a0a695b9187da3e19",65,55,25,18.2,65,0,2,1
"22414","9abaa5235d4688a2dd61f770babb8dc7",174,126,30,40.6,174,0,3,3
"22415","9abb0f6dd58666837d1224dbc8ce5f28",79,61,31,17.8387096774194,79,0,2,1
"22416","9abdc8ad4d1ae5185e23b66174faa769",34,30,7,34,11,23,1,2
"22417","9abfc9fa1d90e4898ec0f56c3adca8ad",190,91,70,19,190,0,3,3
"22418","9ac454973df4d430f6fd66852bb3bb18",29,29,0,29,29,0,1,2
"22419","9ac580da2b8738310548fe2ed936cc80",10,10,0,10,0,10,1,2
"22420","9ac6e2c133a07ca3ef5707c7c361321d",10,10,0,10,10,0,1,2
"22421","9ac71ec0992c232e95275e3aa3263a39",154,43,75,14.3733333333333,138,16,3,3
"22422","9ac7a5826469676267968d37705de888",209,122,56,26.125,155,54,3,3
"22423","9ac8c012aaab5b0be8b54cbef0ed252e",105,75,68,10.8088235294118,105,0,3,3
"22424","9ac9202a1650c7bff66d09d5a1fcdfd9",13,13,0,13,0,13,1,2
"22425","9ac9e2169cf26d50ec09bb0ffc36bf8e",37,37,0,37,37,0,1,2
"22426","9acb5892f233827eaaca3ab7a403de11",104,56,47,15.4893617021277,104,0,2,3
"22427","9acf4c7d3b566989e0dce8de2224fd7b",51,30,31,11.5161290322581,51,0,2,1
"22428","9ad4bce31eaaa397f5cf4ed2a428da4b",23,23,0,23,0,23,1,2
"22429","9ad92beae22fd6a6d9b3e9221347afb1",166,34,77,15.0909090909091,166,0,3,3
"22430","9ad9eaed5f886f1dd83e0f8d8cd8c4df",43,43,0,43,43,0,1,2
"22431","9ad9f6a0fd2aa31b03c8273da8e36668",84,64,37,15.8918918918919,84,0,2,3
"22432","9ada0a24d635146da1378f7d461c9878",30,30,0,30,0,30,1,2
"22433","9ada37a090406e3b6794baca1aeced95",199,111,64,21.765625,147,52,3,3
"22434","9ae045baf9d81cba8e75cb6dea291764",73,69,61,8.37704918032787,46,27,2,1
"22435","9ae048c3488ae0c7aeade1c792b6638d",12,12,0,12,12,0,1,2
"22436","9ae0aa500c7869148a58d52f2fcf2d51",88,45,82,7.51219512195122,63,25,2,1
"22437","9ae6ea70f5e082b1451824f7b2f730cb",32,32,0,32,32,0,1,2
"22438","9aeb488730c272922a3d2f393bf693d5",18,18,0,18,18,0,1,2
"22439","9aebcb0e8935438ee45c7137f381b8ba",113,67,84,9.41666666666667,113,0,3,3
"22440","9aed6233f5be3c2c24eef09612927cd1",35,35,0,35,35,0,1,2
"22441","9aee695fcd91811851cadad21960119c",80,49,81,6.91358024691358,80,0,2,3
"22442","9aee9ef482bcd2f9a6eef5a6941c6bc9",30,30,0,30,30,0,1,2
"22443","9aef901cbf7ce671c3c470420a1b1036",177,86,67,18.4925373134328,177,0,3,3
"22444","9af3aa6546a8936f10fc01269b57626f",204,125,82,17.4146341463415,204,0,3,3
"22445","9af9392a560e40b821800460ea93b62a",41,25,35,8.2,41,0,2,1
"22446","9afc1e392297ef5a29f90ca69ceeed62",5,5,0,5,5,0,1,2
"22447","9b03b8e7a93dfcede0f4d2cb1a4d2f8f",62,55,22,19.7272727272727,62,0,2,1
"22448","9b04424c35eaf0e76c4407c8c179dd95",28,28,0,28,28,0,1,2
"22449","9b063e78d6b7875dbef710b06975a5b2",34,34,0,34,34,0,1,2
"22450","9b082180c74cf9ed572196c40716cdfa",20,20,0,20,20,0,1,2
"22451","9b0ba15876b85c0827ea0322f1d86be5",43,43,0,43,43,0,1,2
"22452","9b0bff7573c345fe10604a91a5121708",34,34,0,34,0,34,1,2
"22453","9b0c568fa6e6bff874090c6fef8f074c",54,46,78,4.84615384615385,54,0,2,1
"22454","9b0dc548cf2aa032b8c3446755b2b105",93,69,72,9.04166666666667,93,0,2,3
"22455","9b0f2d7b46171ae476bba23f89dc9074",85,62,55,10.8181818181818,85,0,2,3
"22456","9b119d522c44594518254243a6963b8d",68,57,46,10.3478260869565,47,21,2,1
"22457","9b136c2adbdea06d8e406a6252fc7cf7",45,45,0,45,45,0,1,2
"22458","9b169dd28bb2b30503d2df9f41a804a6",15,15,0,15,15,0,1,2
"22459","9b16d301b5ca12a4fae0e4287afd09fa",51,51,0,51,0,51,1,2
"22460","9b18060afb40cf001406e0ac3fd58916",14,14,0,14,0,14,1,2
"22461","9b1a4f80c7099d10389694a9dab18898",26,26,0,26,0,26,1,2
"22462","9b1c4b5f61b567c125c8fb3a3fba650a",23,23,0,23,23,0,1,2
"22463","9b1f990b141aa5a9f40a4b0b6784abf8",11,11,0,11,11,0,1,2
"22464","9b1fe43a39b9a767b80032730f39a95e",26,21,35,5.2,26,0,2,1
"22465","9b234437f8038679293a8060c4d545a0",35,35,0,35,0,35,1,2
"22466","9b24a8e4cc288eb2c8091be35601249e",50,46,54,6.48148148148148,50,0,2,1
"22467","9b250052157dd0d810733fd7519072c9",73,51,38,13.4473684210526,73,0,2,1
"22468","9b272ed96ae377dd81ee422df7a7bdeb",215,124,57,26.4035087719298,215,0,3,3
"22469","9b32023f367f2a96ea61212b98bb6897",42,35,67,4.38805970149254,42,0,2,1
"22470","9b35366a6dbf5b748ba3905b23c2b8f3",151,75,70,15.1,151,0,3,3
"22471","9b35d6612489f86248e15e1839bc943e",37,37,0,37,37,0,1,2
"22472","9b36e90c76cf836d62d1d7cb7d315298",53,53,0,53,53,0,1,2
"22473","9b36f8970b27f445cb8511ac9944b387",36,36,0,36,36,0,1,2
"22474","9b3963057fad067649ce71c31ea4d5f9",14,14,0,14,14,0,1,2
"22475","9b39eb9e153fbf61b92330c33d7a1bde",141,92,66,14.9545454545455,95,46,3,3
"22476","9b3b8b576c12a1e3eaab9ab97377b8b3",49,37,39,8.7948717948718,23,26,2,1
"22477","9b3c84705177bedb37984cd22f31f49e",110,78,35,22,110,0,3,3
"22478","9b3d02fd548f2ace2282304243443a5e",28,28,0,28,28,0,1,2
"22479","9b3e3ddf54b828fc327b56f99df65e36",40,34,15,18.6666666666667,20,20,1,1
"22480","9b40338a41b5af1dd9bc3989e92a1448",15,15,0,15,15,0,1,2
"22481","9b4255767b1ac49a0e45958c36cfa0cb",172,122,77,15.6363636363636,117,55,3,3
"22482","9b43350aca6f9308f7ff16c35ca86f7b",109,87,27,28.2592592592593,109,0,3,3
"22483","9b4482505b8c3df660a892117361fcdd",43,39,7,43,0,43,1,2
"22484","9b44fff20642ef92c9d10ca041788831",49,30,44,7.79545454545455,49,0,2,1
"22485","9b4681fa2601e67e2a7d3e653febc7ce",65,53,14,32.5,65,0,1,2
"22486","9b49b0b67a8bb8bf97fb9d52d6da5af4",103,59,68,10.6029411764706,78,25,2,1
"22487","9b4a96bd152dc9c5673a96c5dc5dd098",122,93,41,20.8292682926829,122,0,3,3
"22488","9b4abe8a2cb75c3613838f462ccc319f",33,33,0,33,33,0,1,2
"22489","9b4be6a1089630e160ad77dafa1ecdcb",105,63,44,16.7045454545455,76,29,2,1
"22490","9b4c28e292c2e3af786e0737224bf717",30,30,0,30,30,0,1,2
"22491","9b4cf50f636a181ebf04fafb13f26e16",24,24,0,24,0,24,1,2
"22492","9b4d2145a657e8f6dc9213501f9648fe",67,51,46,10.195652173913,67,0,2,3
"22493","9b4f2a097126135082eefce4eefb191d",30,30,0,30,30,0,1,2
"22494","9b5419cb890f7755f30e760ce47f0bae",96,79,34,19.7647058823529,60,36,2,3
"22495","9b552a263535a4b2479b485ccd32207c",10,6,41,1.70731707317073,10,0,2,1
"22496","9b553b997413c79af959273fd5f8d9d2",186,110,51,25.5294117647059,186,0,3,3
"22497","9b5755beb7c9c7c0a0f5bd054a942e05",67,58,12,39.0833333333333,67,0,1,2
"22498","9b57ad491af02c1774dca601b414d26f",33,32,43,5.37209302325581,33,0,2,1
"22499","9b599408e355a83d2a8cdc8335eec547",180,84,75,16.8,180,0,3,3
"22500","9b5c4f1058533b6d1016e8a8d6411f54",1,1,0,1,1,0,1,2
"22501","9b5f9a177569a65c8c3cdee53f3b2a88",71,61,57,8.71929824561404,71,0,2,3
"22502","9b60e5f37952c2ba61f87024d9c185c8",11,11,0,11,11,0,1,2
"22503","9b661fa23f94c62e8b660d9aebe30968",23,23,0,23,0,23,1,2
"22504","9b68ef991761339b7a9a059c2e7cf57a",36,36,0,36,36,0,1,2
"22505","9b6dd50de613b1f0d4d5a05916e1f2a8",119,59,57,14.6140350877193,97,22,3,1
"22506","9b6e7d8490e71f4863aaf1ff57be1da6",17,17,0,17,0,17,1,2
"22507","9b6fb697f8e2de4ee2dfe8bb26b953df",66,55,44,10.5,34,32,2,1
"22508","9b7001ff3b9392e29f1b093c3a9c7a50",30,20,26,8.07692307692308,30,0,2,1
"22509","9b71075d34db8e4139acc31fd42c0e85",23,23,0,23,23,0,1,2
"22510","9b72077c3c089a144d0b4e2fe8ee2b2b",31,31,0,31,31,0,1,2
"22511","9b7440a6605b761ff07de7ca6da62078",22,22,0,22,22,0,1,2
"22512","9b767d3205e31d3a0ddaeaf888e66785",40,29,63,4.44444444444444,40,0,2,1
"22513","9b796559f2a0f1e931ba6e710f6a451e",14,14,0,14,14,0,1,2
"22514","9b7fb38c3a2e760b4a5020b7fafde3d6",16,16,0,16,16,0,1,2
"22515","9b7fc5a20d8d75cdfaa71ae9e27446ee",11,11,0,11,11,0,1,2
"22516","9b8108a6238d8fea9323e3a17b56eb1f",39,36,39,7,19,20,2,1
"22517","9b841e13d4082fa0b945b8c78009f5e7",63,42,53,8.32075471698113,63,0,2,1
"22518","9b8924cb04554786a0007ff4e4ab258b",71,59,76,6.53947368421053,71,0,2,3
"22519","9b89522dfb2e771643017620fff6e07a",71,44,70,7.1,43,28,2,1
"22520","9b8b000eab4b8835d44921d2cf317a2e",14,14,0,14,0,14,1,2
"22521","9b8b00c0de54941b6cdc1dc9ad27cf21",33,33,0,33,33,0,1,2
"22522","9b8b36043e83eca8c749c0fa75189a2d",48,42,75,4.48,15,33,2,1
"22523","9b8de3f2d3b6821a511402d0c2d90568",50,44,33,10.6060606060606,50,0,2,1
"22524","9b8dee84b2f9aa4669de9d2545f5617f",17,17,0,17,0,17,1,2
"22525","9b8eaaa5992346b34d604adca3bf5cb0",42,41,17,17.2941176470588,10,32,1,1
"22526","9b8fbd2adf9a52c85c9e72c21012d4e5",13,13,0,13,13,0,1,2
"22527","9b90beed6d0ea01552aac32a26f503a1",41,32,52,5.51923076923077,41,0,2,1
"22528","9b90cb6663269a90d67fe05b94f33656",176,96,75,16.4266666666667,176,0,3,3
"22529","9b95a575fb696996a20c17d228ed8c12",54,54,0,54,54,0,1,2
"22530","9b95e805fc351f82e10f4b74881af586",82,51,43,13.3488372093023,82,0,2,3
"22531","9b9cf5d5b42e1d77ee23cd10c0180293",52,52,0,52,0,52,1,2
"22532","9ba08ee6597df6e027b7ee3b5d194eaa",90,57,38,16.5789473684211,90,0,2,1
"22533","9ba2bb6376b8b7683d4836ffc9ba15e9",34,34,0,34,0,34,1,2
"22534","9ba394d5f08f0c27287da21143561d1c",42,42,0,42,42,0,1,2
"22535","9ba4b5bf758692a0b75865aa02b71087",30,30,0,30,0,30,1,2
"22536","9ba88dda55faa61fcd2f249fb8063eee",16,16,0,16,16,0,1,2
"22537","9ba949137321c8c21278857d0568403a",210,124,76,19.3421052631579,210,0,3,3
"22538","9ba997feddc2083724558c5f5c681a34",25,24,6,29.1666666666667,25,0,1,2
"22539","9bad53e92eb6ff093038eb82118e1475",70,48,20,24.5,70,0,1,1
"22540","9bb090f634624276ffe9824fab6fcfe4",27,27,0,27,27,0,1,2
"22541","9bb19b4b235c3d2bbb64d2cf60b58cf1",75,57,59,8.89830508474576,75,0,2,3
"22542","9bb1a00d6462a3108b0615edf7e38e7b",27,27,0,27,27,0,1,2
"22543","9bb4203871a602a3c6951051648046bc",73,66,72,7.09722222222222,21,52,2,3
"22544","9bb62426e9600c5dc3c924ff67d784ec",49,49,0,49,49,0,1,2
"22545","9bb7c87b4ed7598cde45159ff7669203",34,34,0,34,34,0,1,2
"22546","9bb7f8f4565c6074b47f2fea70282fe7",96,68,56,12,96,0,2,3
"22547","9bb843f8fdfdc0085a8b1c44044976d7",157,87,47,23.3829787234043,116,41,3,3
"22548","9bbf281c0dbc0221b2887b554e3e038b",30,30,0,30,30,0,1,2
"22549","9bc193cb31d851659aa8e0d6aafb3864",107,90,49,15.2857142857143,56,51,3,3
"22550","9bc52194fd0f8c7a08888f73a44ab7ac",108,83,29,26.0689655172414,108,0,3,3
"22551","9bcb966488668e7b428e482a76ac957a",47,47,0,47,47,0,1,2
"22552","9bcc8e6143078ca46366ec9a22097a2f",135,115,76,12.4342105263158,135,0,3,3
"22553","9bce0338741758c3234208d93f2ef000",186,84,89,14.6292134831461,169,17,3,3
"22554","9bcecdd838dd65526a1b5102205535db",180,67,71,17.7464788732394,180,0,3,3
"22555","9bceee483349bd2133c39c9b698ab2b5",131,79,53,17.3018867924528,86,45,3,3
"22556","9bd1676198b414362edfc34b755e32c8",10,10,0,10,10,0,1,2
"22557","9bd2a8b46826221390fce63f5a66ef48",64,42,62,7.2258064516129,64,0,2,1
"22558","9bd3208f89cc9a0b2982046ae395563f",99,21,74,9.36486486486486,84,15,2,1
"22559","9bd5a45c6bcf127858e9f46602d8f4b6",39,39,0,39,39,0,1,2
"22560","9bd6e3017c38a1fec8e8146b9f0007ed",49,26,28,12.25,49,0,2,1
"22561","9bd7efb532f338f0898ff2952c71ed76",24,24,0,24,24,0,1,2
"22562","9bde01ce004d286b8c1bf78cb5b8001b",11,11,0,11,11,0,1,2
"22563","9be9b2e9be04b13054bcbd04d97f4768",61,42,77,5.54545454545455,61,0,2,1
"22564","9bea717fb32855359c8c17568657742e",125,75,60,14.5833333333333,125,0,3,3
"22565","9bec56d0055a505d75bc33efaf68bc81",115,56,81,9.93827160493827,115,0,3,3
"22566","9bed14ead801d5cdfdfbbc4e8b9a4995",30,30,0,30,30,0,1,2
"22567","9befd16378af44894a333f1d4637ca52",100,51,64,10.9375,100,0,2,3
"22568","9bf0b604cb4eea7773c4e2ebc3173394",23,23,0,23,23,0,1,2
"22569","9bf3c4c1119871a7de1b819de0b2fa46",16,16,0,16,16,0,1,2
"22570","9bf4795b0f357efb19ae704558542b02",36,22,61,4.13114754098361,36,0,2,1
"22571","9bf493012579119303a512676ad954c1",33,33,0,33,33,0,1,2
"22572","9bfaceb81daa322e0624dce8a1a56d73",51,43,39,9.15384615384616,24,27,2,1
"22573","9c000a5bee17093968ad3b31e0320184",22,22,0,22,22,0,1,2
"22574","9c00d474a714adccfaf50bbb9164421d",37,37,0,37,0,37,1,2
"22575","9c037b249aa4ba10becdfd4966ab77ad",46,46,0,46,46,0,1,2
"22576","9c039e3aa4a6420baedfef747e954432",36,26,77,3.27272727272727,36,0,2,1
"22577","9c05f521051abb4ccdb188fcaec87562",4,4,0,4,4,0,1,2
"22578","9c0cd0d8861313283d520e262ad31e85",39,39,0,39,39,0,1,2
"22579","9c0d5af2bf96ea10ed0e329672016643",61,49,46,9.28260869565217,61,0,2,1
"22580","9c0dcdd36a49a712274d9f025b12b2e4",41,41,0,41,41,0,1,2
"22581","9c0ea211758f1a244c3e60817389f4e5",108,74,61,12.3934426229508,75,33,3,3
"22582","9c0f41a31e1d31159f2f8dfb66b0b219",18,18,0,18,18,0,1,2
"22583","9c1339161c8cd694a0d38264fd999599",37,29,38,6.81578947368421,37,0,2,1
"22584","9c193bdb79e11bf99c6aec18860e279a",3,1,52,0.403846153846154,2,1,2,1
"22585","9c1a2ff0f32dc5bfa3f730db82c8ae63",18,18,0,18,18,0,1,2
"22586","9c1e158a99fa2b11b648c6abb6471d8c",15,15,0,15,15,0,1,2
"22587","9c2384d5e64d92879f6795877e0e02f2",63,56,64,6.890625,48,15,2,1
"22588","9c248045faa57f04836e1fd35e054315",74,55,34,15.2352941176471,74,0,2,1
"22589","9c251805d6a3480dca68f636552336b9",31,31,0,31,0,31,1,2
"22590","9c2641b2c448f8f66801adb8bd628fe9",21,21,0,21,21,0,1,2
"22591","9c270eb51955cccb2a2481c90a3fe92c",15,15,0,15,0,15,1,2
"22592","9c28728d57cb760d8cc2010d3c9968c6",139,91,78,12.474358974359,100,39,3,3
"22593","9c296e1a6c102a90eb75778da1059d6f",95,72,27,24.6296296296296,49,46,2,3
"22594","9c2c8bb50d3697c098ee3f7d822d2461",58,57,11,36.9090909090909,58,0,1,2
"22595","9c2cfe897af86ad1a01dc0157577ddfe",186,88,82,15.8780487804878,146,40,3,3
"22596","9c2d7d5eecdff7aa51f7b25038f97e6e",190,109,85,15.6470588235294,190,0,3,3
"22597","9c339fe1eee3871c8d3a39cc37ba2a16",91,66,49,13,91,0,2,3
"22598","9c34fd2fa4fad3879edb11706bd58db8",94,69,30,21.9333333333333,94,0,2,3
"22599","9c367df0ec1f01c491ac16877c733863",218,102,87,17.5402298850575,193,25,3,3
"22600","9c380492d43379271c1227df891a0268",55,55,0,55,55,0,1,2
"22601","9c3c1cc7f81fe05c0acadc6a93ca0115",92,69,81,7.95061728395062,92,0,2,3
"22602","9c3e0a5da1cf456b1095741b308893d6",18,16,18,7,18,0,1,1
"22603","9c3f6456bf88cf8bc7e4c9b0772aa916",137,100,63,15.2222222222222,137,0,3,3
"22604","9c4008d6eb2ef98f4ceb3128e02f3311",126,81,47,18.7659574468085,126,0,3,3
"22605","9c40189d57b0e6ec885ae51740f8fe8f",49,36,58,5.91379310344827,49,0,2,1
"22606","9c434da5ce2b8ef7223ba4ae8ff98bda",84,75,23,25.5652173913043,43,41,2,3
"22607","9c442ec08b3ba2bbd14d4fa1a5fce36f",93,66,21,31,93,0,1,3
"22608","9c458fd4b81e10e9f6aff19a4c12d62c",44,44,0,44,0,44,1,2
"22609","9c4c819c59132950636149353b11678a",17,17,0,17,0,17,1,2
"22610","9c4d5cae40223e6d6cc4e7b761506942",150,113,61,17.2131147540984,150,0,3,3
"22611","9c4eacfa255aa875e48e4d67ef4bd8ea",29,21,76,2.67105263157895,29,0,2,1
"22612","9c4ef8fdb1458ca143d2367a5ebeee6c",182,94,74,17.2162162162162,182,0,3,3
"22613","9c510572831060fb77c944b0fe9e876b",64,49,54,8.2962962962963,64,0,2,1
"22614","9c517e5072afce5ec003d07919bed968",30,30,0,30,30,0,1,2
"22615","9c54fd97d3f95b71d4099b086b02880e",42,42,0,42,0,42,1,2
"22616","9c5b97b09b9a75253a03cf6ee78b895a",35,30,42,5.83333333333333,35,0,2,1
"22617","9c5c9e0aa264b9dd719ccae895853607",13,13,0,13,13,0,1,2
"22618","9c5de4bf538d56c6f25e4805a76391ce",91,72,71,8.97183098591549,91,0,2,3
"22619","9c684f462ea94a06138cc758764db566",41,36,28,10.25,41,0,2,1
"22620","9c69c8e16ee20d2dcc0119569c3105d7",64,51,38,11.7894736842105,64,0,2,3
"22621","9c6d31b380d58c73b5cd3ce35e1f0072",20,20,0,20,20,0,1,2
"22622","9c6efcbb000b8302fa1675930dbd9ca1",24,23,9,18.6666666666667,24,0,1,1
"22623","9c6f1999c64b9b203c9fc8fcd00063a3",150,89,60,17.5,150,0,3,3
"22624","9c6f21440df4eb03a030fa2224eab5a6",82,61,57,10.0701754385965,82,0,2,3
"22625","9c706b12b5eb4e365eeeb14763eab75e",47,47,0,47,47,0,1,2
"22626","9c707fef5bbce215bc68f77f45442729",23,23,0,23,23,0,1,2
"22627","9c70aa4a4c1db7e98de14178fccd5221",155,48,81,13.3950617283951,155,0,3,3
"22628","9c70bf4f13a2f205cf12ba2ce437fdaa",109,60,29,26.3103448275862,109,0,3,3
"22629","9c720808afd2b7ac40a8860959c95e14",186,89,73,17.8356164383562,143,43,3,3
"22630","9c730c6b24d3ca5e8eb01dc79bed4650",105,42,80,9.1875,67,38,2,3
"22631","9c731b4a2ce0c1e201386b39ad1076ac",10,9,4,17.5,10,0,1,2
"22632","9c779119e6e675854ac802cb84c66869",169,108,66,17.9242424242424,169,0,3,3
"22633","9c77b54ce69351485ee4088787ed6501",88,73,67,9.19402985074627,88,0,2,3
"22634","9c78bacd46b499f67e9c323de7e914aa",11,11,0,11,0,11,1,2
"22635","9c79eb4f3b1d613513180fc3a2b00322",81,69,27,21,81,0,2,3
"22636","9c7a2733a4f947b8c4aa8146dff1474c",37,37,0,37,37,0,1,2
"22637","9c7d236d5fe50308d176056a94f4c926",19,19,0,19,19,0,1,2
"22638","9c826aaba14d6689eb071bddfb64daf9",82,69,60,9.56666666666667,82,0,2,3
"22639","9c8327d41549e7c42b671b1d1910da3b",42,42,0,42,42,0,1,2
"22640","9c8565d93b3bcfa1417367b12185a193",21,20,5,29.4,21,0,1,2
"22641","9c87ef20e9b032b0b4e50fabba43ef04",43,24,56,5.375,43,0,2,1
"22642","9c889b2f921295b7ce7fd9f59b023491",34,32,11,21.6363636363636,34,0,1,2
"22643","9c895c90e8aa3e11cca86ccacf35f226",36,35,10,25.2,21,15,1,2
"22644","9c8a88a3ea605e5f9803d687d9044244",58,43,35,11.6,58,0,2,1
"22645","9c8d326d64e106000d5ff0c87ed7239d",22,22,0,22,22,0,1,2
"22646","9c8dbda443d6d4252065c534ba9f497a",113,36,76,10.4078947368421,99,14,2,1
"22647","9c8e27e8b7508eed1775d344f1b80dc7",33,33,0,33,0,33,1,2
"22648","9c8f757f0ca07a99aceff6c0fed07926",32,32,0,32,0,32,1,2
"22649","9c9062e4ea2d0541d4a7cf5420805a0a",14,14,0,14,14,0,1,2
"22650","9c983a817352eafc9e6e6f4233f07d07",22,22,0,22,22,0,1,2
"22651","9c98f76c1cb26219291899c520e5beac",92,53,64,10.0625,92,0,2,3
"22652","9c993fed77bb7dafa2be8ad377507485",20,20,0,20,20,0,1,2
"22653","9c9aa0ec4a75706f55704d94cdc1caa8",96,72,12,56,47,49,1,2
"22654","9c9ac8a3ff2040e20d56a5f33cfd834a",108,48,76,9.94736842105263,92,16,2,1
"22655","9c9be627042b3dedd1d844b5debb4cf6",17,17,0,17,17,0,1,2
"22656","9c9e11c5ad3983ec078ab4890542df54",34,34,0,34,34,0,1,2
"22657","9c9f30d7f0dbc2554c8a544529fed24e",92,61,49,13.1428571428571,92,0,2,3
"22658","9ca1a03db181a65badcbb806c1574c8f",200,92,70,20,200,0,3,3
"22659","9ca358ea66346f19a9d837f3b8aa68be",111,75,65,11.9538461538462,111,0,3,3
"22660","9ca740ed9f87e26899611d706aa5d8ec",18,18,0,18,18,0,1,2
"22661","9ca88c63dca3b9de4dd9ed913933a796",19,19,0,19,0,19,1,2
"22662","9caa96a6fe9ba10881b15eeb30720ef2",23,23,0,23,23,0,1,2
"22663","9cad1f87785d8a8ab58c59f0b0aff57a",78,58,52,10.5,78,0,2,3
"22664","9caf8906a127568dbbb72b4adcc68fc8",66,47,43,10.7441860465116,66,0,2,1
"22665","9cb27b972b4d5d7d20605ead3ab944f7",15,11,81,1.2962962962963,11,4,2,1
"22666","9cb495113746787189bad178df0ab95c",131,67,71,12.9154929577465,131,0,3,3
"22667","9cb729f18f016f597e8c30ca5be17b1b",22,20,45,3.42222222222222,18,4,2,1
"22668","9cb9540e41e48c635765c477841eec40",192,105,72,18.6666666666667,173,19,3,3
"22669","9cb9f05b1c688c2bd6a7223866d6da5d",85,70,77,7.72727272727273,85,0,2,3
"22670","9cba40f9f6005c56b78eb0a8a5ebad36",125,93,74,11.8243243243243,125,0,3,3
"22671","9cbbf5cd056f03e4cf5b78a8db5902c2",34,34,0,34,0,34,1,2
"22672","9cbd6dd4a5797dd6655a00c22f4f8888",1,1,0,1,1,0,1,2
"22673","9cc2d5eae3c1e75933c4120aceb2e552",174,99,58,21,174,0,3,3
"22674","9cc30a30c14d6e2eb30fe7723bf4062a",116,75,36,22.5555555555556,116,0,3,3
"22675","9cc411b2e4cfbfafd0445280c872dace",72,60,52,9.69230769230769,49,23,2,1
"22676","9cc4652701528d5246c566101a3645a7",55,45,37,10.4054054054054,55,0,2,1
"22677","9cc4e4ed83fd0cedd72125b16b282141",27,27,0,27,27,0,1,2
"22678","9cc59c0b83badc2b033fdb86e8ba7005",55,42,22,17.5,28,27,2,1
"22679","9cc7f32f07b40053dcc2b197f2c4877d",15,15,0,15,15,0,1,2
"22680","9cc8984be1a911f0082193995a1bd07a",72,48,53,9.50943396226415,72,0,2,3
"22681","9cc91d6c38bccfd4a12e9b31a38b4d42",36,36,0,36,36,0,1,2
"22682","9ccf2abb1169d2e587eeedf1f6fb7707",27,27,0,27,27,0,1,2
"22683","9ccfd73405c2e7f880500cc83b8a5a67",83,36,38,15.2894736842105,83,0,2,3
"22684","9cd15d82db0d879d31df4db73954f3cc",209,132,66,22.1666666666667,209,0,3,3
"22685","9cd65e789ee592536074f4efe3137d0b",125,78,56,15.625,125,0,3,3
"22686","9cd9f1af15fc508be45f7bbb43eb4078",18,18,0,18,18,0,1,2
"22687","9cdd400a10aa0c3e8ed6fc7d4af414d8",36,36,0,36,0,36,1,2
"22688","9cde29fdaa7699da0e95c45d3919bca2",23,23,0,23,0,23,1,2
"22689","9cdf6432970de4ec01895238f1b290aa",27,23,49,3.85714285714286,27,0,2,1
"22690","9ce1bff28908683520c00d812e976194",25,25,0,25,25,0,1,2
"22691","9ce2d88f08a5951a2faa7282a7a8f6b6",33,33,0,33,33,0,1,2
"22692","9ce4d7bcb7f2a76df2020af14e42e4c8",75,58,72,7.29166666666667,64,11,2,1
"22693","9ce8ebe58498b6ec21738810d907c7fe",30,30,0,30,30,0,1,2
"22694","9ce92daffd2ffb31d7ee129dcdf3192a",20,20,0,20,20,0,1,2
"22695","9ceaeb956c263160032809553d4e621a",34,34,0,34,34,0,1,2
"22696","9ceba682bbbfd5cc12c9e4892c54b468",42,34,36,8.16666666666667,42,0,2,1
"22697","9cf2dc894df0b948b9e5752e6ff3d3b1",118,74,62,13.3225806451613,118,0,3,3
"22698","9cf2dca1051f8704ac43e5b8acce48cc",37,23,29,8.93103448275862,37,0,2,1
"22699","9cf3b536a2b85fd8b2b570a7bca7751c",17,17,0,17,17,0,1,2
"22700","9cf4ec7de88ad0bc0be4897a10b4c000",151,99,82,12.890243902439,108,43,3,3
"22701","9cf5b4d290ccd94b458f84efa9c9b273",45,45,0,45,45,0,1,2
"22702","9cf5c15112b82713e8e8a72f1c6c420f",108,74,41,18.4390243902439,57,51,3,3
"22703","9cfbb18fddfcec298b60b0b69899916c",22,22,0,22,22,0,1,2
"22704","9cfd6d161733ed8280558937112a0dbb",28,28,10,19.6,28,0,1,1
"22705","9d0624f753913ce382b962cf4b12edb1",8,8,0,8,8,0,1,2
"22706","9d06a7253cd5fcea2d2ebf38412c0683",7,7,0,7,7,0,1,2
"22707","9d0a988022724a84793052f28fb802fa",26,22,22,8.27272727272727,26,0,2,1
"22708","9d0c9e15e4b987e5d6578277a01a1c16",35,35,0,35,35,0,1,2
"22709","9d0d7aaf8020ad3c8d66faccd25fb522",10,10,0,10,10,0,1,2
"22710","9d0e1425be519537b459320ede98cf7b",15,15,0,15,15,0,1,2
"22711","9d0f1ec53d85aed6e43a6c556be62ed0",34,32,60,3.96666666666667,34,0,2,1
"22712","9d117032d33525b399b9d69f08d7d3e3",29,27,40,5.075,29,0,2,1
"22713","9d11aca8e85fa0e8a29cf461b96f3150",209,108,63,23.2222222222222,209,0,3,3
"22714","9d12d3ffc8c32680fba37bd9b07a8b19",82,60,12,47.8333333333333,38,44,1,3
"22715","9d13bd0f49c4b345c5d3efc60cbab494",22,22,0,22,22,0,1,2
"22716","9d13ceb33d08b960312b0995a3f9903a",98,79,54,12.7037037037037,98,0,3,3
"22717","9d141609094f28294ca674e59312f939",204,110,70,20.4,204,0,3,3
"22718","9d14d36aed0d765d2a30765f712b9922",22,22,0,22,22,0,1,2
"22719","9d168b0de9c7e4b6ffe957c09bb98336",4,4,0,4,4,0,1,2
"22720","9d17b8800251e39f832f5528a3602e53",48,43,42,8,0,48,2,1
"22721","9d18d34bc41cc593bdca240a3a9807fc",76,64,21,25.3333333333333,76,0,2,2
"22722","9d1af94152fa25cf321040dec115b13c",75,57,46,11.4130434782609,75,0,2,3
"22723","9d1b38eaae048366fe13055aeb3e5caf",19,18,11,12.0909090909091,19,0,1,2
"22724","9d1ed305928df853f48d5ed6cf7617ef",39,30,45,6.06666666666667,39,0,2,1
"22725","9d23b279fdde8906250e0b2c7d404d4c",140,63,61,16.0655737704918,140,0,3,3
"22726","9d260db82325e918442dbd0a380f489e",87,67,53,11.4905660377358,50,37,2,1
"22727","9d28e369a6f89f613712e5a0c73130a5",134,75,63,14.8888888888889,81,53,3,3
"22728","9d29d1a37dc46cad837a560c962d319f",83,73,19,30.5789473684211,83,0,1,3
"22729","9d2ba4a45779cd8c40d0ab7aba295d4c",38,38,0,38,38,0,1,2
"22730","9d2ba5558d3ad391fce3c5356194ffec",40,29,30,9.33333333333333,22,18,2,1
"22731","9d2e646c443be8e8d0742bda03201af0",89,70,54,11.537037037037,89,0,2,3
"22732","9d339f951e062e00e4cba1360f0e4f4e",100,87,30,23.3333333333333,100,0,3,3
"22733","9d3515931a2e8239b24b1f38dbb12f0a",23,20,18,8.94444444444444,23,0,1,1
"22734","9d3760eebc565215c7473b763a30a752",48,37,31,10.8387096774194,48,0,2,1
"22735","9d3a841e8a2938d8cadf9ec3df1aeb4f",106,67,81,9.16049382716049,106,0,3,3
"22736","9d3ac161077fc7e5b93b2e0406d18ab6",6,6,0,6,6,0,1,2
"22737","9d3b5a4c2a15b80ead06cbd1b93d6af9",29,29,0,29,29,0,1,2
"22738","9d3c957862509503999a64dfb4c866b0",73,51,52,9.82692307692308,73,0,2,3
"22739","9d3d8f936726adf1681fe956767eba24",40,40,0,40,40,0,1,2
"22740","9d4173eb0ffcfa7cc2cc86093901fb36",15,15,0,15,15,0,1,2
"22741","9d43b265dd3f1158e040c94fcd06c163",49,49,0,49,0,49,1,2
"22742","9d469ea992aabe59bf17fa768934f93a",131,87,63,14.5555555555556,131,0,3,3
"22743","9d51d447fc956bd2fadbc4ef58c9457a",29,29,0,29,29,0,1,2
"22744","9d51eb4634a05d9e6d040f028d0f57ab",143,86,58,17.2586206896552,143,0,3,3
"22745","9d557b1537635370cbdf57f0f3214f6e",76,61,82,6.48780487804878,72,4,2,3
"22746","9d55d9679356018c8ee42c422eeeaea9",78,60,53,10.3018867924528,78,0,2,3
"22747","9d58e6bcaf253f2642bb0b9e6bb012c4",65,51,40,11.375,65,0,2,3
"22748","9d5ff64843563cc0f2fa1cd315d9cd75",12,4,74,1.13513513513514,12,0,2,1
"22749","9d604cc88a0d46ed96d3d4dd20ea329d",27,27,0,27,27,0,1,2
"22750","9d61108d821b8122bf92735e5ad2988f",33,33,0,33,33,0,1,2
"22751","9d64c48379d5828558e095765f8bac6f",125,87,77,11.3636363636364,125,0,3,3
"22752","9d66ac522e8bed08cd44dbe8a6058457",237,55,84,19.75,199,38,3,3
"22753","9d6874126a35663d7a0f8a6f45e05e90",135,95,48,19.6875,135,0,3,3
"22754","9d68a5dcd395cf2f87633a792daee040",41,38,41,7,41,0,2,1
"22755","9d68e925535a8fc6944d089a26f25305",2,2,0,2,0,2,1,2
"22756","9d6a289f90a79af5a4e281d92915bd06",147,93,74,13.9054054054054,147,0,3,3
"22757","9d6a7a805a26cbbdbce865e8c79bf426",13,13,0,13,13,0,1,2
"22758","9d6ab65bdbc8e8a148e75393d6c926bb",40,30,48,5.83333333333333,40,0,2,1
"22759","9d6b6225463ddd3baf388baeed9a9035",25,25,0,25,25,0,1,2
"22760","9d6c8ea7d51785f3b31ca1ca4f46923f",64,48,58,7.72413793103448,64,0,2,1
"22761","9d714af6925fa127b02dcf3949f1bd94",34,34,0,34,34,0,1,2
"22762","9d748a4cf946d8cae482540592108b6f",106,63,38,19.5263157894737,106,0,3,3
"22763","9d760a4271633bcac2f871522399711d",46,46,0,46,46,0,1,2
"22764","9d7638dce784ce51cd6bfad75d48e1cb",56,49,31,12.6451612903226,56,0,2,1
"22765","9d7b5d9e27c38bf5e489fdf7abe7bc99",168,102,54,21.7777777777778,168,0,3,3
"22766","9d7ea79551c054ce4471581a21d707a9",101,53,80,8.8375,81,20,2,1
"22767","9d81e3703dcf04787831e6b6bfb79b93",88,66,80,7.7,88,0,2,3
"22768","9d85052aceebfe8f12777df1482ad8ee",26,26,0,26,26,0,1,2
"22769","9d865d6a023c7c49e489e04eb5fcf5b8",65,41,62,7.33870967741935,65,0,2,1
"22770","9d8dd9b8c486c9924aa5a1c90f0ba6c9",39,39,0,39,0,39,1,2
"22771","9d90b5ae1c02d1817c5613d523f9094d",16,16,0,16,16,0,1,2
"22772","9d90db9e61c5b360b87c1343b40673f7",184,98,75,17.1733333333333,184,0,3,3
"22773","9d90f9ff77f0466ee188e3f669efee05",144,90,61,16.5245901639344,144,0,3,3
"22774","9d920fb7ad148c0d9284153bc9344942",73,43,18,28.3888888888889,73,0,1,2
"22775","9d925f6a230f39f985db5fdb07450980",38,38,0,38,38,0,1,2
"22776","9d94e2108e0ec0f640f2335076443d13",45,36,57,5.52631578947368,45,0,2,1
"22777","9d98698749b20eed92f172abdc60955b",4,2,0,4,4,0,1,2
"22778","9d99cf81e4dacdc4e9229a1a9dbb2105",40,36,43,6.51162790697674,40,0,2,1
"22779","9d9d07c6e7a609b7d95c67296ada3dd0",91,69,59,10.7966101694915,91,0,2,3
"22780","9d9d71e6b638992e7f65006d1bc95791",16,16,0,16,16,0,1,2
"22781","9d9d8789b740895538dfc682f4739fe0",166,72,44,26.4090909090909,135,31,3,3
"22782","9da23847b8df4ecb346af7b77b938495",117,84,50,16.38,117,0,3,3
"22783","9da3921345e19c0f9d51349f9e16f0dc",38,38,0,38,0,38,1,2
"22784","9da59674050ba86171b106cdc9fd09eb",21,21,0,21,21,0,1,2
"22785","9da5a6bd999070c52d6cb1760fb58632",36,36,0,36,36,0,1,2
"22786","9da5da221d9255faedc212c3859a5949",5,5,0,5,5,0,1,2
"22787","9da5e3128f8e9a867828b1e51392bc20",7,7,0,7,7,0,1,2
"22788","9dac3a3193915f60b378fbc3969e6843",33,30,43,5.37209302325581,33,0,2,1
"22789","9daf148632812a1cfaca2fbec71f3d05",47,39,50,6.58,25,22,2,1
"22790","9db1b08f32bf13817255c764b74e27e3",105,73,68,10.8088235294118,105,0,3,3
"22791","9db3950c1ade56c781cf1d1f4e0ebde0",134,92,87,10.7816091954023,134,0,3,3
"22792","9db50209043e87d8611b7cac2de04251",125,72,75,11.6666666666667,125,0,3,3
"22793","9db57f1409edb42d25eb547efe9977d3",48,39,21,16,48,0,1,1
"22794","9db64de04be3cc5105b506d312e9dd27",115,91,47,17.1276595744681,115,0,3,3
"22795","9db9f0376d80882901fa89164d4b79c6",44,41,25,12.32,44,0,2,1
"22796","9dbce909b507dd469b7d42bcd1052411",149,58,72,14.4861111111111,149,0,3,3
"22797","9dc0a8203e858837b18bd763de1783ae",33,33,0,33,33,0,1,2
"22798","9dc1be3482c7908d963169ef1c09a409",8,8,0,8,8,0,1,2
"22799","9dc2f70e3d56651a52671eae25125c2f",6,6,0,6,6,0,1,2
"22800","9dc512c9194446f6b602d5d81065bbba",15,15,0,15,15,0,1,2
"22801","9dc6874ea86ed21cc42ac1cdb14a76f4",19,19,0,19,19,0,1,2
"22802","9dc773c0ed70825d8696647d24e2635c",3,3,0,3,3,0,1,2
"22803","9dc7749bee518b98e7d2003f44beda80",13,13,0,13,13,0,1,2
"22804","9dc7fbe01733740a6364ef40c1befbad",29,29,0,29,0,29,1,2
"22805","9dc8acd630ec255a1ffdd8b709d40fca",26,26,0,26,26,0,1,2
"22806","9dcb5de7546811b7b8da63c9907cf210",44,44,0,44,44,0,1,2
"22807","9dcc2433139ecf43737668060d37767c",132,63,80,11.55,91,41,3,3
"22808","9dccd100c7236f417783e1e687675762",12,12,0,12,12,0,1,2
"22809","9dccf5c67d87790ff0e3fe8d38a0eac4",164,101,61,18.8196721311475,164,0,3,3
"22810","9dd0eff07f83d89c1e6aab4f4ee76630",42,37,48,6.125,42,0,2,1
"22811","9dd11282fd3e76bf37a79743de03ffe8",9,8,30,2.1,9,0,2,1
"22812","9dd398536d6727a2cab790160728ebba",26,15,43,4.23255813953488,15,11,2,1
"22813","9dd6eda4880f258e2b882434139e27f3",73,41,84,6.08333333333333,58,15,2,1
"22814","9dd8a6576d1bda60283e4b5f8c1964b9",238,153,76,21.9210526315789,188,50,3,3
"22815","9ddce7a7228c1de76b9f2d4f890dfd8a",49,45,7,49,49,0,1,2
"22816","9ddda5d5a1b7a2fc44032e820d9eedfe",7,7,0,7,0,7,1,2
"22817","9de097c16439fb8dd93b1594f0d5983a",125,70,62,14.1129032258065,86,39,3,3
"22818","9de45f9d7d07ef3391bb8c6dda104fa4",195,129,56,24.375,195,0,3,3
"22819","9de4de3e5778984e5dbc9b58432fac22",23,23,0,23,23,0,1,2
"22820","9de59f177dd36703a5cef80819d27139",74,63,21,24.6666666666667,74,0,2,2
"22821","9de7a0546c7644366235a2995d98bf49",25,21,29,6.03448275862069,25,0,2,1
"22822","9de841176a193a5710c38ee7923652e5",11,11,0,11,11,0,1,2
"22823","9de8970795912065450e96031af21959",26,26,0,26,0,26,1,2
"22824","9deaaddba2dc65990449a235d34022f4",46,46,0,46,0,46,1,2
"22825","9deb07a265e631fbf2ea2c2defd55b32",61,52,18,23.7222222222222,61,0,1,1
"22826","9deb0e915feb3f8bd0be634c58e3eb13",140,75,82,11.9512195121951,140,0,3,3
"22827","9dee34087c86d21e3df0ddc49d66ab0c",94,82,65,10.1230769230769,48,46,2,3
"22828","9defc1310c626067dd2025b6db9b29b0",47,47,0,47,47,0,1,2
"22829","9df0bdad314b7882242d3af85d61dc3a",36,36,0,36,36,0,1,2
"22830","9df527b328b122d6c6d698dcf8c85bb0",87,56,52,11.7115384615385,63,24,2,1
"22831","9df550bb0a375444aa2e4d93e00e97c0",113,87,55,14.3818181818182,113,0,3,3
"22832","9df5eb38611f05a3786ddd54b0b093e3",45,45,0,45,45,0,1,2
"22833","9df6bb2a5aba4e8e7de20d1fe1043b16",28,28,0,28,28,0,1,2
"22834","9df6c7be1db8edbfc8afe04bb4714662",25,25,0,25,25,0,1,2
"22835","9df835705546df054f3ee05eb20e916e",137,97,59,16.2542372881356,102,35,3,3
"22836","9dfbc22c5e4dfc629492eeda0d4d17f5",94,54,63,10.4444444444444,94,0,2,3
"22837","9dfd1fdca90138d0b818996a94c92884",9,9,0,9,9,0,1,2
"22838","9dfd9e1ac83462bcef9832bc91526c08",90,71,61,10.327868852459,57,33,2,1
"22839","9dfda808f4ca6bbc5fd9770863372931",17,17,0,17,17,0,1,2
"22840","9dfdefa1963553e67e225e3f79ea0461",158,101,83,13.3253012048193,144,14,3,3
"22841","9e05045e4524658137503561e23d25d3",37,30,35,7.4,0,37,2,1
"22842","9e0620b2ed6b5fd4ffb68ff969b5afe7",69,54,26,18.5769230769231,29,40,2,1
"22843","9e0685701fe997a0dfe6061e98d3e31b",8,8,0,8,0,8,1,2
"22844","9e06b0d93947828d94aae723f2c4eaae",90,76,80,7.875,90,0,2,3
"22845","9e0bcf133ad04cf91e0e4068dd4f58ce",32,32,0,32,32,0,1,2
"22846","9e109e26198f5cc80900a73788339327",33,33,0,33,33,0,1,2
"22847","9e148d52ee478dc48bb981668c360faf",97,85,30,22.6333333333333,97,0,3,3
"22848","9e164d5c575feb7b5d593069aab7a19e",90,71,35,18,90,0,2,3
"22849","9e180ac895fef86f69b87c22353fe411",119,99,76,10.9605263157895,119,0,3,3
"22850","9e187a09d9ddb84ff4a515f9bf1dc0fe",134,82,65,14.4307692307692,134,0,3,3
"22851","9e1a3208c420636ba0a988ff8869a441",28,28,0,28,28,0,1,2
"22852","9e1b8f40b8cc7afd953343c0676521f3",46,46,0,46,0,46,1,2
"22853","9e1b9ea1e8277e65e6bd723de40287c8",74,57,80,6.475,74,0,2,3
"22854","9e1d2538d5ad82413cca1cfa1f3229f2",75,66,43,12.2093023255814,75,0,2,3
"22855","9e1dd61b700431f0b4a27799de8dd760",23,23,0,23,23,0,1,2
"22856","9e2065966691d2aca2b40b80d8598d77",60,51,66,6.36363636363636,44,16,2,1
"22857","9e2179e5bcfb0dd4863f4de2fce23bad",56,50,16,24.5,23,33,1,1
"22858","9e222223919dcea83017e82bb7cc25ca",60,48,21,20,60,0,1,1
"22859","9e22d6ccda26a5ebb38861bbc5d2b310",32,28,59,3.79661016949153,32,0,2,1
"22860","9e23769e45e6e7a3442030c846767ae6",31,19,75,2.89333333333333,31,0,2,1
"22861","9e2834b2ef8c31454c5f9349f4b56c44",200,147,56,25,200,0,3,3
"22862","9e2976c2fbd86a02992f8dd506dfeaa4",26,26,0,26,26,0,1,2
"22863","9e29f842e62d9ba20c89060240ada894",189,102,84,15.75,150,39,3,3
"22864","9e2c384d4fdbece2ae4758faf6708bae",40,40,0,40,40,0,1,2
"22865","9e2d02cc76dd6b41b3ca064c52dad170",39,36,35,7.8,39,0,2,1
"22866","9e2dabca23abae8b4b78ef8e654303a7",38,38,0,38,38,0,1,2
"22867","9e2f07e0ff2d2ef45ff147b3b8798c17",49,35,33,10.3939393939394,49,0,2,1
"22868","9e305872d4b4d7a99c9af4f746d2ed09",23,23,0,23,23,0,1,2
"22869","9e30bab03209a9f2155fc8897aae49b3",16,16,0,16,16,0,1,2
"22870","9e322c92dca91fe3927307b2e58d8ec9",51,41,77,4.63636363636364,0,51,2,1
"22871","9e32a77e094c2bccdc7b88ff3ad22641",28,28,0,28,28,0,1,2
"22872","9e347ce1944425ecbb4a57802f70a3a0",69,51,61,7.91803278688525,69,0,2,3
"22873","9e34e1d32e6d2ecfaec70f13bc1001ab",17,17,0,17,17,0,1,2
"22874","9e34ec48f38e08064be3c6b648804bf4",50,50,0,50,50,0,1,2
"22875","9e3948fb352c9dca6f04b0ff1bbc82cc",63,48,45,9.8,29,34,2,1
"22876","9e3b1b1b3bd006bcb3fa0caab4e58539",111,79,59,13.1694915254237,56,55,3,3
"22877","9e3f024b70d92aa73f0c0c0ea60b8278",37,34,12,21.5833333333333,37,0,1,1
"22878","9e414f5f5c479cdf65c1beb24c2d8734",145,101,70,14.5,126,19,3,3
"22879","9e485e9768da94af2dfca079a5e4d368",70,45,63,7.77777777777778,22,48,2,1
"22880","9e4871c3d4eff645d915393cb0a9e24b",38,35,53,5.0188679245283,38,0,2,1
"22881","9e4957afd85721a018bb67859b14309b",39,39,0,39,39,0,1,2
"22882","9e4a143f9f4435127fe007e72cc9cecd",114,86,63,12.6666666666667,114,0,3,3
"22883","9e4df4076cbcf2f6319822513bd634fd",49,35,42,8.16666666666667,49,0,2,1
"22884","9e4e43741b104246877b60993e7c08a1",59,48,47,8.78723404255319,59,0,2,1
"22885","9e4f9098d1573c8584038519c8b6f7d6",34,34,0,34,34,0,1,2
"22886","9e50a8d2c2cad12cfbf841f7a945135d",20,20,0,20,20,0,1,2
"22887","9e5107e003c4f283e0fc49ae68f7c0c4",37,37,0,37,37,0,1,2
"22888","9e5152178c46a4ceaca5d5d8e1b278d1",27,27,0,27,27,0,1,2
"22889","9e5658b6a3b0816ee368411ea230a5ad",63,40,26,16.9615384615385,24,39,2,1
"22890","9e58a8cfdac8d65d0c017250f10affe7",44,41,15,20.5333333333333,44,0,1,1
"22891","9e59bedba464f91621e92901093e69e7",151,88,74,14.2837837837838,109,42,3,3
"22892","9e5afe1ae09edf4e9014636789027857",20,20,0,20,20,0,1,2
"22893","9e5c41e3b79f236175bc4f6942cf756e",10,10,0,10,10,0,1,2
"22894","9e62c3a16f7893590966d08930d4d853",11,11,0,11,0,11,1,2
"22895","9e64ed5d0377b90c717809d97b429407",27,27,0,27,27,0,1,2
"22896","9e66a454a6d5bb3353ebb4b08d095604",22,22,0,22,0,22,1,2
"22897","9e672ebf022e440b37d5780719d98d54",72,62,44,11.4545454545455,72,0,2,3
"22898","9e682d83b8748f04adb2d1cc00d3898d",116,82,15,54.1333333333333,116,0,3,2
"22899","9e6b204fddc10933e818d63849971aea",14,14,0,14,14,0,1,2
"22900","9e6b6468b7ca2a935bb66d522f8f8d3d",164,73,68,16.8823529411765,111,53,3,3
"22901","9e6c29f838a434c7bf94ca2883138920",35,28,64,3.828125,35,0,2,1
"22902","9e6db5392e7b99567fcf0851fb398f4e",22,22,0,22,22,0,1,2
"22903","9e6fdef1290e444a16656885c764eb18",167,83,64,18.265625,167,0,3,3
"22904","9e75694a266b47d552b3cf5955963ee8",43,43,0,43,0,43,1,2
"22905","9e75be0fd36b4d7cf7659446421425b1",14,14,0,14,14,0,1,2
"22906","9e75da039f13b83daf514c7966022eb2",31,31,0,31,31,0,1,2
"22907","9e7702b7f267adfbda009a7655d21020",83,60,42,13.8333333333333,83,0,2,3
"22908","9e810fe2e1b713fb8887414db956032c",46,46,0,46,0,46,1,2
"22909","9e820e9a086c072c0228b81b9085ed01",46,46,0,46,46,0,1,2
"22910","9e82812657f0f82d5adf79ab055902ce",40,34,48,5.83333333333333,23,17,2,1
"22911","9e83090c0e312de651e6db4eab4f8b69",33,33,0,33,0,33,1,2
"22912","9e85121a37db1d68c1650de508315f62",24,24,0,24,24,0,1,2
"22913","9e87ee933fec172378d844355d39e05e",19,19,0,19,19,0,1,2
"22914","9e88a525bd9ae4ae3bf0469908e9dc1c",47,42,15,21.9333333333333,47,0,1,1
"22915","9e8bbf45fd4df96e711b1e2519f495a2",40,40,0,40,0,40,1,2
"22916","9e8fe1a6890be417e3ae6dd74fc6f90c",42,42,0,42,42,0,1,2
"22917","9e90e7d0314408a655746b856ca7c6fd",132,88,54,17.1111111111111,132,0,3,3
"22918","9e961b12a719fd87ab3235c5a0bb1899",23,16,30,5.36666666666667,12,11,2,1
"22919","9e99eb4622c667735ab658d0b4d99963",98,61,83,8.26506024096386,98,0,2,3
"22920","9e9abeaf48e61b83df1c17f5fb1957c0",54,54,0,54,0,54,1,2
"22921","9e9b880c8ec43cb28ea01006bff6c461",203,117,57,24.9298245614035,203,0,3,3
"22922","9ea052ee6fc219352680273da7e45801",23,23,0,23,0,23,1,2
"22923","9ea2db65b9086b2376a7822f9ac5c73f",107,82,41,18.2682926829268,107,0,3,3
"22924","9ea401bbc4996e6688622becca63d8c3",68,43,77,6.18181818181818,68,0,2,1
"22925","9ea407932214aa8f286cec72ee5523c1",46,42,54,5.96296296296296,46,0,2,1
"22926","9ea64754b90b12f28c36045d984cb27d",85,75,84,7.08333333333333,85,0,2,3
"22927","9ea69fb2d9b007a178b59f462d839aca",3,3,0,3,3,0,1,2
"22928","9ea76a5a431bfd0069dc3d1ddbb926d6",53,42,35,10.6,0,53,2,1
"22929","9eaa85b16764509312bd47cba8c7c575",127,78,65,13.6769230769231,93,34,3,1
"22930","9eacdca6002527aa3075a6193fbdb304",17,17,0,17,17,0,1,2
"22931","9eada3723771fe074f21220353060491",20,20,0,20,20,0,1,2
"22932","9eafa31b419616b48ba996a3250ab6bc",120,56,72,11.6666666666667,120,0,3,3
"22933","9eafbfef6cdeebcd42eaad4818f2908a",15,15,0,15,0,15,1,2
"22934","9eb065f96158c9d9bd4ca921c67ee0fb",96,56,13,51.6923076923077,96,0,1,2
"22935","9eb163578eda8f832b5a1c648b59304d",27,27,0,27,27,0,1,2
"22936","9eb1c3c66d8e9a25f723486e950e32ca",207,83,68,21.3088235294118,207,0,3,3
"22937","9eb525de3b84b3c36b689262df98e830",24,24,0,24,24,0,1,2
"22938","9eb5510b380cb0c5ad8475d2d9c30b50",106,72,56,13.25,67,39,3,3
"22939","9eb669e92e1531365889af512803f4bb",99,80,22,31.5,51,48,3,3
"22940","9eb76bedea87898b7190fc1e6c785d30",34,29,16,14.875,34,0,1,1
"22941","9eb7879421a98e0722f7d02602c0b86c",17,17,0,17,17,0,1,2
"22942","9ebc71360d6fdf60dce41f2e99880500",40,34,68,4.11764705882353,40,0,2,1
"22943","9ebe8330ffd103cb1f7ef925529f54fc",143,88,84,11.9166666666667,129,14,3,3
"22944","9ec19bf5d3c64b931da054502f46999f",37,37,0,37,37,0,1,2
"22945","9ec4508f43cf065a1f1086f05b3f3de8",31,26,74,2.93243243243243,26,5,2,1
"22946","9ecb21394e11fa1a2321bb3872cb7b56",27,27,0,27,27,0,1,2
"22947","9ecd8479a9a8f555e4442dfedb526c74",19,19,0,19,0,19,1,2
"22948","9ecdca70f498fc2381e6d5129b36bf37",74,48,46,11.2608695652174,74,0,2,3
"22949","9ecf7dcd93182e4feb5b2e775354a1ed",217,124,64,23.734375,217,0,3,3
"22950","9ed0037536b9eb445a83e34b68acaeb0",61,33,71,6.01408450704225,61,0,2,1
"22951","9ed043f0efde4151bd8d15b08c8aa4ee",16,16,0,16,16,0,1,2
"22952","9ed052950486f3149343ea30cdfa4ac3",212,115,63,23.5555555555556,212,0,3,3
"22953","9ed152c42398a391070a7ff181ff3c4d",103,41,83,8.68674698795181,103,0,2,3
"22954","9ed1814a290f00fde055699670d4f8fc",91,62,48,13.2708333333333,91,0,2,3
"22955","9ed3c7cd2ad53c3572cd6f68faa700e1",30,30,0,30,30,0,1,2
"22956","9ed3d2ccc274d25371e5adbf68cc3ff2",4,4,0,4,0,4,1,2
"22957","9ed595f114ee34692da04e8076edb546",169,140,76,15.5657894736842,127,42,3,3
"22958","9edad307c1936266c213912bf7565fcd",111,78,63,12.3333333333333,111,0,3,3
"22959","9edeede06ad4fae4eb11b36fb63e83e6",11,11,31,2.48387096774194,7,4,2,1
"22960","9ee552d487f8e20696e8627e92a89ea4",51,51,0,51,51,0,1,2
"22961","9ee7232059b3caa96d7d8cae183fd39f",158,122,60,18.4333333333333,158,0,3,3
"22962","9ee7c0b4769a54db944ed2fbca461ae3",114,71,78,10.2307692307692,91,23,3,1
"22963","9eea23ae6c85105cc9cdba2a0770a209",19,19,0,19,19,0,1,2
"22964","9eebbcf66dc63f3523401558bc8f253e",10,10,0,10,10,0,1,2
"22965","9eeccebb8630d182bb49a6f48a6bd21c",26,26,0,26,26,0,1,2
"22966","9eed4cf0929fa8fe17f2d7996030cbe0",136,106,61,15.6065573770492,136,0,3,3
"22967","9eedfbabb65d7ef0c8981e9579d568c3",76,57,49,10.8571428571429,76,0,2,3
"22968","9eee79ac85c086b6851825cd296e65e1",85,73,33,18.030303030303,85,0,2,3
"22969","9eeeb9689a73d400eb85c9de0ef58c1b",82,64,14,41,82,0,1,2
"22970","9eef897a9c6e0bc9099a86615b78418a",46,46,0,46,46,0,1,2
"22971","9eef99e1554cf7532b355bb0774062a5",105,33,76,9.67105263157895,105,0,2,3
"22972","9ef058a42e5b8bc317c010b750a3dc2f",74,45,41,12.6341463414634,74,0,2,3
"22973","9ef2c715c31dc02f430847aa0ee611da",128,62,70,12.8,128,0,3,3
"22974","9ef9a2ec1ef1c492a9cda2ccd5d55957",220,105,82,18.780487804878,169,51,3,3
"22975","9efb130246c836c96ab8c205e6c20630",18,18,0,18,18,0,1,2
"22976","9efbf44f81140c484de48c327d26ae35",57,56,11,36.2727272727273,15,42,1,1
"22977","9efc4e12d78b5de488a29cf00e086cb0",53,38,59,6.28813559322034,53,0,2,1
"22978","9f019c6ed84b679b9ee11b13e5313670",54,44,57,6.63157894736842,41,13,2,1
"22979","9f03cb6a09d85f8ae808d515d477e20f",16,16,20,5.6,16,0,1,1
"22980","9f0489e909ed5f4542100b7560bb83be",69,52,67,7.2089552238806,51,18,2,1
"22981","9f070ba202f4d8986d79f7e983bf3e4d",58,47,25,16.24,44,14,2,1
"22982","9f076bad30a66dc7e68245dfc9f111e6",236,114,47,35.1489361702128,198,38,3,3
"22983","9f09a0ab5e20c083970c7d5d99c65571",17,17,0,17,17,0,1,2
"22984","9f09aafc65d4044ebe8ab2021cee0eb7",9,9,0,9,9,0,1,2
"22985","9f0ad2ea7f8e4381982943ae524f443c",96,50,49,13.7142857142857,96,0,2,3
"22986","9f0cb682e82483f99f7132b8ab4b7fd3",32,32,0,32,32,0,1,2
"22987","9f0fba71f527db11a82faff1037c4f22",46,46,0,46,46,0,1,2
"22988","9f0fcb04351699dd78845103670de6b4",10,10,0,10,10,0,1,2
"22989","9f107cbd59213d086a58b7c221930f2c",51,51,0,51,51,0,1,2
"22990","9f10a6eaeffa6105220a12c82337b430",45,45,0,45,45,0,1,2
"22991","9f1443768ef95da95184c3d6098c9775",46,46,0,46,46,0,1,2
"22992","9f1510bc4f752bea2aa1a711bdcd4e6d",145,110,38,26.7105263157895,145,0,3,3
"22993","9f159fb09fbea82384d9504e2a1aee03",143,87,76,13.1710526315789,102,41,3,3
"22994","9f1a69c4ff4d980a2115bb3f0d3eb762",35,35,0,35,35,0,1,2
"22995","9f1ac449d13aa0b78e77e465ea4c1aca",21,21,0,21,21,0,1,2
"22996","9f1fd3c15291cf935cd5a722dd5be02c",58,40,69,5.88405797101449,58,0,2,1
"22997","9f1fe1eef48f03fe152f79bc5daa53e7",93,60,63,10.3333333333333,93,0,2,3
"22998","9f2012c905e6e4b50aa1937d7e9a127f",89,82,33,18.8787878787879,89,0,2,3
"22999","9f224fa3390adf16cc7ef49002b7edaf",19,16,12,11.0833333333333,7,12,1,1
"23000","9f230757638314b7ccc1f3ae4b40f4c3",23,23,0,23,23,0,1,2
"23001","9f2618d2881eb00c760060db3c88a5b8",37,35,71,3.64788732394366,31,6,2,1
"23002","9f2731d946de421881b6b951a1de5b5c",59,47,52,7.94230769230769,59,0,2,1
"23003","9f274c15739c8f401b1e5be2b6213700",39,39,0,39,39,0,1,2
"23004","9f2839ee65ff28c7f19c207e921bc893",9,9,0,9,9,0,1,2
"23005","9f2b23bf61a188d484bf96737832eaef",85,57,46,12.9347826086957,85,0,2,3
"23006","9f2c2ee9d07c65943227ca0300ae248a",50,42,34,10.2941176470588,50,0,2,1
"23007","9f3736f0d96fb4e01855d387dee8735c",45,45,0,45,0,45,1,2
"23008","9f385a949acbd64a89487907b0006f22",8,6,40,1.4,8,0,2,1
"23009","9f3a73848e42d6dae1c8dbd85ca15e6d",26,26,0,26,26,0,1,2
"23010","9f3c874c1c8738b264ab1d20c7e6d903",13,13,0,13,0,13,1,2
"23011","9f408d44470d9056a0cf88504ae3875e",26,26,0,26,26,0,1,2
"23012","9f40dbd2545ac8ce1d7b3a205d69fcd7",107,71,55,13.6181818181818,107,0,3,3
"23013","9f4115b743aeff35d8eb38de71978c42",69,61,19,25.4210526315789,35,34,2,1
"23014","9f438b688fcd63b00d572b48579c8288",27,27,0,27,27,0,1,2
"23015","9f44108d0f784a814d150a882f82e959",17,13,79,1.50632911392405,13,4,2,1
"23016","9f46d83546d5b93b8c82f48066ce4101",44,23,75,4.10666666666667,44,0,2,1
"23017","9f49ff1719189865e529080309db9809",23,23,0,23,23,0,1,2
"23018","9f4a1fbed58ebb93aceeb3a44dd20495",106,84,69,10.7536231884058,106,0,3,3
"23019","9f4d9032237c2770569b26aa017bcfde",40,40,0,40,40,0,1,2
"23020","9f4ed19da30f6b99d229955d22eb1531",18,18,0,18,0,18,1,2
"23021","9f5042999c74876e56281031d6af4113",38,38,0,38,38,0,1,2
"23022","9f515404e99ebfe6e01fc69a22c300b6",47,47,0,47,47,0,1,2
"23023","9f515888017f170a575cc14054afca71",70,53,14,35,70,0,1,2
"23024","9f56673959644187ae6fe4a7c3b8ce60",33,33,0,33,0,33,1,2
"23025","9f568b391b25791ebf52f1804ea75d79",47,47,0,47,47,0,1,2
"23026","9f5736b20683113ce367ea1d099e299b",89,55,61,10.2131147540984,67,22,2,1
"23027","9f574fb3ba1e908e9504685a42d49291",42,42,0,42,42,0,1,2
"23028","9f57c31cdbfe1854c144de9e8e88747f",118,79,29,28.4827586206897,71,47,3,3
"23029","9f583e2d502c40960f0b4dd75a3b7f32",26,26,0,26,0,26,1,2
"23030","9f5969ebc20f149bd4ccd4104d0f485b",25,25,0,25,25,0,1,2
"23031","9f59c732e3e64fad5bdcac2eef218355",18,18,0,18,18,0,1,2
"23032","9f5cbd7f132a436b21e112c3a6c2d857",23,23,0,23,23,0,1,2
"23033","9f5ee31dc206df2d07ddade3ca3786cc",85,60,26,22.8846153846154,64,21,2,1
"23034","9f6445e60f5ffd38d6738fc138bb4691",41,25,82,3.5,41,0,2,1
"23035","9f65c50a0fa51d7b56410256d043f0bc",216,108,83,18.2168674698795,186,30,3,3
"23036","9f661de6df6710b34066f908fdcc6fb5",10,10,0,10,10,0,1,2
"23037","9f6726788e485e6107492f964fc45f54",151,69,53,19.9433962264151,120,31,3,3
"23038","9f69449e976304ca2b58f301925d8eec",37,37,0,37,37,0,1,2
"23039","9f69f76efd776d283b759b098ed82ea9",21,20,43,3.41860465116279,21,0,2,1
"23040","9f704a9bc65ecaa8d1404cfd224a9928",105,66,66,11.1363636363636,86,19,2,1
"23041","9f732fdd40dcc6de7f50a4fc03bfc7c2",25,18,34,5.14705882352941,25,0,2,1
"23042","9f76de45cfb671e1b4d789375deabe54",66,62,30,15.4,24,42,2,1
"23043","9f797e96ed0b6e7612c0c7dd8a9edf4d",50,34,40,8.75,33,17,2,1
"23044","9f7bcb0296aca8616da83a9fa6d517c4",43,43,0,43,0,43,1,2
"23045","9f7c8ee5acc321cbf372abeca9d74ada",51,46,35,10.2,51,0,2,1
"23046","9f845976e27261423ba9e5be06e557ec",30,30,0,30,30,0,1,2
"23047","9f867a34904aec7ed0f293a9f405f614",204,76,77,18.5454545454545,204,0,3,3
"23048","9f87405f131632c2fc3566b87be8f4ac",52,37,43,8.46511627906977,40,12,2,1
"23049","9f876422c9f1158b823c85cc5b426fb0",46,46,0,46,46,0,1,2
"23050","9f87a6e4375d29f975f0abc60f1191b7",109,94,81,9.41975308641975,109,0,3,3
"23051","9f89e0118a87c22f03c58ff919733350",16,9,64,1.75,16,0,2,1
"23052","9f8a010bb296e2d75d56edfeab04aba8",35,28,37,6.62162162162162,35,0,2,1
"23053","9f8afafe82ff07fd7d5617cba1a9f7c9",14,13,2,49,6,8,1,2
"23054","9f8c8b7f72a90c57847dbad87b5a1b50",43,43,0,43,43,0,1,2
"23055","9f8d617dd99407d03d57905a2a5feba1",15,15,0,15,15,0,1,2
"23056","9f8ebf6424fdb091856bc43dcf125638",31,31,0,31,31,0,1,2
"23057","9f906380797ba4eb90369cef84070b62",99,57,62,11.1774193548387,81,18,2,1
"23058","9f957361fffd0f8c52e4759ea39568d2",59,48,20,20.65,59,0,1,1
"23059","9f9b6e097a97b5fc9abf67e532f1c4e4",76,59,67,7.94029850746269,76,0,2,3
"23060","9f9e7a7ae9391d1405c4ac2eb4019784",9,9,0,9,0,9,1,2
"23061","9f9f0ed84e0f11e94c859d0f5b2cbde2",67,40,33,14.2121212121212,67,0,2,1
"23062","9fa05208e201728bd5e85e8478538a75",56,56,0,56,56,0,1,2
"23063","9fa27d799f7e1bcfda47ee699d8214bd",66,57,52,8.88461538461539,66,0,2,3
"23064","9fa3ae8cac283df04eb7100ed0daff28",29,29,0,29,29,0,1,2
"23065","9fa433d9271ff1150ef5d468fcaba13a",30,30,0,30,30,0,1,2
"23066","9fa4704026cf01deb678c0c8277ee6fc",108,70,78,9.69230769230769,61,47,3,3
"23067","9fa4c4f171a3258a46670ce61705317f",28,28,0,28,28,0,1,2
"23068","9fa676097b212c2cfbdfe143666a4316",30,30,0,30,30,0,1,2
"23069","9fa6db3ba08fd1bc5164f6de2dbd868e",22,7,71,2.16901408450704,22,0,2,1
"23070","9fa90546419676fd6dffe0c3676acc87",17,17,0,17,0,17,1,2
"23071","9fa97c506d49530abb02f94ce83f1274",34,29,28,8.5,34,0,2,1
"23072","9fabdc04605c332f3ff5ef0035bda0a4",24,24,0,24,24,0,1,2
"23073","9fad0637faa3e91ec92f69de18c5dc41",51,38,61,5.85245901639344,51,0,2,1
"23074","9faded887f121fc5ef8eaa05d3a3d779",21,21,0,21,21,0,1,2
"23075","9fadf72cf05fb17d764d44cd1fdd9155",212,121,84,17.6666666666667,212,0,3,3
"23076","9faed88661797276ac8c251245e12507",41,36,44,6.52272727272727,29,12,2,1
"23077","9fb89faeaf3913905f85eec35977ced8",28,28,0,28,28,0,1,2
"23078","9fbafa23e48b1c03286616e1197f323f",187,88,84,15.5833333333333,187,0,3,3
"23079","9fbb7af52f9e193bddc3579796faeb4c",20,20,0,20,20,0,1,2
"23080","9fbba902de76b34b16313e533c87f49f",186,122,75,17.36,186,0,3,3
"23081","9fbc5d217bf447695aaf788b503f8ed9",20,20,0,20,20,0,1,2
"23082","9fc4d21f89b054c3308315efaa6c1106",37,37,0,37,37,0,1,2
"23083","9fc52f97de66601f79609c6d8ee076ea",74,55,83,6.24096385542169,74,0,2,3
"23084","9fc6b3016b5de9946b80c00ee2b91387",23,23,0,23,23,0,1,2
"23085","9fc818ade00962f0162d9f198e64e902",54,54,0,54,0,54,1,2
"23086","9fcae4743255b4da09000bf1deb16910",169,88,86,13.7558139534884,169,0,3,3
"23087","9fcb8c59405a620223abe3c3fcd53a6f",78,47,77,7.09090909090909,63,15,2,1
"23088","9fcb92779482b96116d745d6c8de723b",19,19,0,19,19,0,1,2
"23089","9fcfa95ddc7921532ff6ea0c8e7e1176",91,53,56,11.375,67,24,2,1
"23090","9fd2a57804559053a7a76c20b6824d2b",24,24,0,24,24,0,1,2
"23091","9fd41fd8b5196a12d36d40b5e603e863",21,21,0,21,0,21,1,2
"23092","9fd59f693a845a8e08bf8a4027d282ca",82,59,50,11.48,82,0,2,3
"23093","9fd5d7fea25ba45744946b540fd9d45a",9,9,0,9,9,0,1,2
"23094","9fd6c472568af1a5ef3e75992d8ea7d0",26,26,0,26,26,0,1,2
"23095","9fd6eacb7b95d7da8156c6e34971270d",84,52,70,8.4,84,0,2,3
"23096","9fd7c5b8e4b804db71a92092d73ca6af",39,30,41,6.65853658536585,39,0,2,1
"23097","9fd802bab9d2a8a34b013d0a25e48a0a",21,21,0,21,21,0,1,2
"23098","9fd94e3a92973f5a2f43618488566c26",25,25,0,25,0,25,1,2
"23099","9fdb43d1b199e48f56bb3d14137ef54a",21,20,58,2.53448275862069,21,0,2,1
"23100","9fdf24e48e25d19834b7b6c69849ed6d",44,44,0,44,44,0,1,2
"23101","9fdf99a98086323e1aeeb33aab269a64",29,29,0,29,29,0,1,2
"23102","9fdfec19e1aef56852e698bf90a47c4e",24,24,0,24,24,0,1,2
"23103","9fe19cbcb5fe245054846852a8b359bd",44,44,0,44,0,44,1,2
"23104","9fe2489c359eccd0cf76dc08d1f82be4",52,52,0,52,52,0,1,2
"23105","9fe371b99464cde495e746d998229005",165,68,28,41.25,165,0,3,3
"23106","9fe440bd7c5bcf790dad2fe8c639b20f",99,70,50,13.86,99,0,2,3
"23107","9fe6d05a17a478258b7ce38eed5dd2df",26,26,0,26,26,0,1,2
"23108","9febd0cc8e98ed24b475a470a5706e87",36,36,0,36,36,0,1,2
"23109","9febe026b2a2d059494e9dd260c1723d",23,23,0,23,23,0,1,2
"23110","9fec8daa6b0c810516f6c0c566d9b68f",79,41,38,14.5526315789474,79,0,2,3
"23111","9fecd5526953d67b99410ab68d81b3d7",10,10,0,10,10,0,1,2
"23112","9fecfea6c61869e44a7844e25a76904b",86,34,65,9.26153846153846,73,13,2,1
"23113","9fede8b27775a83d84234c8d852586b1",52,47,44,8.27272727272727,52,0,2,1
"23114","9fee1aa21642c225f62eb337354b89cb",176,108,64,19.25,176,0,3,3
"23115","9ff002858d2df4c1e09a33098824ccaa",138,93,52,18.5769230769231,138,0,3,3
"23116","9ff1516075a3525bca0d712add7181ef",15,15,0,15,15,0,1,2
"23117","9ff18b999773a189dcfacd4ba9df2136",173,89,24,50.4583333333333,125,48,3,3
"23118","9ff1beeb43395e3bace595b2730186dc",82,70,60,9.56666666666667,58,24,2,1
"23119","9ff22b67b1856bb6ae38a73888d3c521",111,85,37,21,62,49,3,3
"23120","9ff60f2daed3cdff55d6d1575cc73682",39,39,0,39,39,0,1,2
"23121","9ff730c5126914496f36990bb697da26",80,68,36,15.5555555555556,80,0,2,3
"23122","9ffb9718785da1301ff4d16e20917956",236,77,85,19.4352941176471,216,20,3,3
"23123","9ffbd2b2b0139037e4c9d088b88b9e0b",212,87,63,23.5555555555556,212,0,3,3
"23124","9ffedd297dbf162017f8d3e1c5c59dba",31,31,0,31,31,0,1,2
"23125","a000d698468683471a728e1b19ed0973",7,7,0,7,0,7,1,2
"23126","a002d78f3600ffbe2f968ab8aebae3f3",40,40,0,40,40,0,1,2
"23127","a0041b8ac93cf491ae5768add3875ab4",80,47,77,7.27272727272727,80,0,2,3
"23128","a004582f6df499238e93b229d849eff2",223,132,72,21.6805555555556,187,36,3,3
"23129","a00b50596c2b0d09231d72e0df0d63a4",62,42,23,18.8695652173913,62,0,2,1
"23130","a00e1498b36d1335a7ce21496fdd04c3",61,54,73,5.84931506849315,31,30,2,1
"23131","a00eeec275af2d6f1cd44ee9be84fe11",42,42,0,42,42,0,1,2
"23132","a0104858a4f7740cb1db8ed963031368",51,41,16,22.3125,51,0,1,1
"23133","a0124d16ba2eb0fde0fc10072da78245",13,13,0,13,13,0,1,2
"23134","a012cf03bac8791893848a4b4be0b04b",49,46,27,12.7037037037037,49,0,2,1
"23135","a013c984b0046a1f8bb36852fe1c1e96",120,79,39,21.5384615384615,82,38,3,3
"23136","a0148758ff2e85d596e907c5bfd264f1",20,20,0,20,0,20,1,2
"23137","a014a7991a7ace8b603449337d27be14",103,87,21,34.3333333333333,103,0,3,3
"23138","a015d6babafcc2d19002382ccac96714",43,38,12,25.0833333333333,13,30,1,2
"23139","a017155046ec524918daa2291455829f",203,86,77,18.4545454545455,203,0,3,3
"23140","a017394a6cb64f17cefe77c27c6c1501",140,79,64,15.3125,124,16,3,3
"23141","a0174f0f578eb6cadf540de1e27e872c",40,28,76,3.68421052631579,22,18,2,1
"23142","a01961f130f81ab061c6a20d38162265",10,8,50,1.4,10,0,2,1
"23143","a01ba00b74056d8607c6bed4c10ad934",40,22,85,3.29411764705882,40,0,2,1
"23144","a01bcc3bf7810a62cac2b693393f5d2e",33,33,0,33,33,0,1,2
"23145","a01cf97cc035449be3aacac2e44c774c",107,95,41,18.2682926829268,107,0,3,3
"23146","a020a7070760a322b4c9bc72f16df767",55,46,33,11.6666666666667,55,0,2,1
"23147","a0212452a7e37f001417279f6eb19cd8",29,29,0,29,29,0,1,2
"23148","a0215ccc600afae57677c35571e2ef52",18,18,0,18,0,18,1,2
"23149","a0226c065be4d9ffef97d40c643a2669",24,24,0,24,24,0,1,2
"23150","a0232932fad81ded1baccc6a7764d4e8",153,88,75,14.28,105,48,3,3
"23151","a02496c991bb866a2301b4fa159bd077",50,50,0,50,0,50,1,2
"23152","a0262bcc88261027e37c58267706e7e9",118,67,63,13.1111111111111,118,0,3,3
"23153","a02651bf32275cc2368dc70ef96a4003",32,24,33,6.78787878787879,32,0,2,1
"23154","a0267993004bfdd9bbb20abe91e6cdc7",25,25,0,25,25,0,1,2
"23155","a0280febb5090e280dec6b6d2e625b33",18,18,0,18,18,0,1,2
"23156","a029a4f5f4c2c4e44989f4cc2846acfe",154,116,83,12.9879518072289,135,19,3,3
"23157","a02b7c3d4262433c9f21738611eef8bd",196,132,55,24.9454545454545,196,0,3,3
"23158","a02c56ad1dfdac2b081816a5047a819f",51,46,22,16.2272727272727,23,28,2,1
"23159","a033012ea7ca074e083a80547025fd10",14,14,0,14,14,0,1,2
"23160","a034523c64cd98d00a01f48cf65f6bbc",32,32,0,32,32,0,1,2
"23161","a036fa3e45d8e1ebbd20140ad12aaf3a",100,74,83,8.43373493975904,100,0,3,3
"23162","a037be7c373a60fc1dea2f15786b9529",207,137,85,17.0470588235294,207,0,3,3
"23163","a03cb959af51b5ce2cf71b6e2749ca5c",104,77,83,8.7710843373494,104,0,3,3
"23164","a04207bcf73f311e08fb4307edaf9a6f",29,29,0,29,29,0,1,2
"23165","a0420fdc02fdf5becda5123b1ca9b9b4",54,54,0,54,54,0,1,2
"23166","a04273a4a55dcba000b2a0c6b84d1b0e",43,43,0,43,0,43,1,2
"23167","a04456cb79338ac35d44103f1f5f9fc0",113,74,19,41.6315789473684,113,0,3,3
"23168","a045f176189033d0b75371c6c9d4ffd0",30,26,4,52.5,4,26,1,2
"23169","a0482efef32605698c56856aa75e729c",25,20,15,11.6666666666667,11,14,1,1
"23170","a049d2f5bb21080c59863c03d4f4a63d",100,72,75,9.33333333333333,100,0,3,3
"23171","a04b1397635dd8c8afcdb1bc9d7fa3ec",163,88,79,14.4430379746835,132,31,3,3
"23172","a04b2bd8b6d803d78f6d9e5c773a30ae",104,59,75,9.70666666666667,52,52,2,3
"23173","a0516d44195c45a924b1bd8b0506ae5d",140,59,65,15.0769230769231,140,0,3,3
"23174","a056082dd87bf420bbf481f41b1497fd",67,44,42,11.1666666666667,67,0,2,1
"23175","a05994644464513c521b19c01ec4f2e8",172,92,89,13.5280898876404,172,0,3,3
"23176","a05c952b37a767e9bc1c6772b1381d7f",123,99,56,15.375,123,0,3,3
"23177","a05ca071fa407a94163fc935591ed187",74,61,54,9.59259259259259,48,26,2,1
"23178","a05d2e6eb5a8841064114165a6cec4a6",67,53,35,13.4,67,0,2,1
"23179","a05e4d8e1270d78b49b4f79cba16e22d",19,17,76,1.75,13,6,2,1
"23180","a05f583c6dc662089e739c8a6c87d7d5",25,25,0,25,0,25,1,2
"23181","a063defddc9eda192e9fb8ff05ed844b",31,31,0,31,31,0,1,2
"23182","a063eec220722eb2cc7a2615146df67a",20,17,36,3.88888888888889,20,0,2,1
"23183","a0675b8e8d4fb46f03848295d031c7cb",120,65,73,11.5068493150685,120,0,3,3
"23184","a06780df4f8007e76ec39907adb0ea33",61,49,11,38.8181818181818,61,0,1,2
"23185","a06a79ccd2b89f7c38b981325c55511a",138,75,79,12.2278481012658,138,0,3,3
"23186","a06e4778a7a2e42d6da2e1a7eb2b5525",37,37,0,37,37,0,1,2
"23187","a06e972737db31c29ddb248c173102c6",35,20,68,3.60294117647059,30,5,2,1
"23188","a06fd41e7184c8aec3fddf6239ed777c",91,69,77,8.27272727272727,91,0,2,3
"23189","a071d72bbeb303ecaeffe838a1450532",25,25,0,25,0,25,1,2
"23190","a074856a766cc003886a949fd55451da",99,74,84,8.25,99,0,3,3
"23191","a074d7e1ae9c26ee0bfdaa13767ec28b",64,44,39,11.4871794871795,64,0,2,1
"23192","a075048557a482b308347a1b346742b8",34,34,0,34,0,34,1,2
"23193","a083509584c6276ef3de068acde8c0db",112,82,86,9.11627906976744,72,40,3,3
"23194","a0853e77eb43eca3b506ef3f7a36305a",105,65,36,20.4166666666667,105,0,3,3
"23195","a0856b294adede638893af9bf20ee6a6",28,28,0,28,28,0,1,2
"23196","a085fb66978962ffe604305fe6964a02",35,35,0,35,35,0,1,2
"23197","a0893c47dcdae9a421726244bd953727",75,60,25,21,75,0,2,1
"23198","a08bb2fbbe094daa58c6271bcdd8a867",28,28,0,28,0,28,1,2
"23199","a08c175836d4c7555ffa998d70077551",122,105,31,27.5483870967742,122,0,3,3
"23200","a08e14b36b591f488d8bb9a4bd138ebf",200,89,53,26.4150943396226,200,0,3,3
"23201","a090c759188ce9b4cc9ece40eb0d32ca",226,119,83,19.0602409638554,214,12,3,3
"23202","a0921219f7faae5874152b36b841c6fc",36,36,0,36,36,0,1,2
"23203","a0929991b6989e0c5d5c8a86cd472eca",111,51,72,10.7916666666667,111,0,2,3
"23204","a096419bc279e6ee2eeb03bb89f0377d",44,34,26,11.8461538461538,20,24,2,1
"23205","a0966f0000bac16776b64779ff17d786",49,38,19,18.0526315789474,49,0,1,1
"23206","a097fa628e4e58812e50913c55f59b8e",84,77,29,20.2758620689655,84,0,2,3
"23207","a09824737317a12eb374f2f875b56732",11,10,64,1.203125,9,2,2,1
"23208","a09942703c165d6fcdaf36d51764d926",26,26,0,26,26,0,1,2
"23209","a099e56d344259359928b842d8ae970e",58,46,76,5.34210526315789,58,0,2,1
"23210","a09abec8e4c82965aa6c821f0165d181",64,60,43,10.4186046511628,64,0,2,3
"23211","a09d27a2bcda5949d37ade40eed074ff",62,39,29,14.9655172413793,62,0,2,1
"23212","a09f5bac087e774d413b3e94673bbfa3",107,88,26,28.8076923076923,58,49,3,3
"23213","a0a1030a796ee94e975a5e2f4dc655a2",33,32,6,38.5,14,19,1,2
"23214","a0a30a1345f522bca20961d72147c326",78,35,53,10.3018867924528,78,0,2,3
"23215","a0a46494ef74de4b51a4f39bed28efc3",39,32,39,7,39,0,2,1
"23216","a0ab1939d8d2f0ba47863c53db7e048b",160,100,81,13.8271604938272,112,48,3,3
"23217","a0ac757bfd2b8f4e81f8b6d19e8ca8f7",13,6,62,1.46774193548387,13,0,2,1
"23218","a0ad162a6bd27877980eb677c5b56016",113,83,70,11.3,113,0,3,3
"23219","a0b11dcc658a49f2493d01d582e1d11c",6,6,0,6,6,0,1,2
"23220","a0b32ab06a85a4ab6be15306867a3774",102,91,77,9.27272727272727,102,0,3,3
"23221","a0b47f3d6583febdd585e7f70d5f6b83",97,65,35,19.4,97,0,2,3
"23222","a0b49a349a32662e6f64f8cd03862280",197,99,70,19.7,197,0,3,3
"23223","a0b8852d4898752605998c55b3657c04",41,38,14,20.5,41,0,1,1
"23224","a0bdabe5c687446d69e3c06683668b0f",1,1,0,1,1,0,1,2
"23225","a0bf16d89142172bfb315c7f910d1c95",62,45,49,8.85714285714286,62,0,2,1
"23226","a0bfc7c36cd81618e1c7b63ec5961906",138,91,38,25.4210526315789,138,0,3,3
"23227","a0c05dff29b31edf7a56cf61aa2cc4e4",107,76,30,24.9666666666667,71,36,3,3
"23228","a0c3c8b8777636c87c5350436667097a",70,47,27,18.1481481481481,70,0,2,1
"23229","a0c3d4d325edcdd5bfce6b62aec3c914",70,61,38,12.8947368421053,70,0,2,3
"23230","a0c4cde9858b7218b0199495fee04dd7",149,69,85,12.2705882352941,149,0,3,3
"23231","a0c6d92734259c6040e1fce24be8f8ca",16,16,0,16,16,0,1,2
"23232","a0c7af8da87785be3eff900956443494",29,19,62,3.2741935483871,18,11,2,1
"23233","a0c8172c0b45313c877579a08e0296db",174,98,53,22.9811320754717,122,52,3,3
"23234","a0cc6525fa197f9da43214581b9aaea1",85,51,57,10.4385964912281,85,0,2,3
"23235","a0cee38e6f39d9f07637c0c9a57445f3",29,29,0,29,29,0,1,2
"23236","a0cfeccdd9e6195aebfc7652ee8c8d4c",32,26,19,11.7894736842105,32,0,1,1
"23237","a0d035dd066da1157e04db0965c6b54e",9,9,0,9,9,0,1,2
"23238","a0d188eaf4b496d111c611fd716489e2",43,43,0,43,43,0,1,2
"23239","a0d2c81f0436913947937956570835dd",150,75,60,17.5,150,0,3,3
"23240","a0d91efaf339521e2f1d8ee5420c4ecf",106,98,28,26.5,106,0,3,3
"23241","a0da31001da30c50c59b8804e9f58cdf",29,24,57,3.56140350877193,29,0,2,1
"23242","a0dc20f68db8cbf05c899890af902436",139,80,80,12.1625,139,0,3,3
"23243","a0dc43b3d89a9ae49e8b788087d032b6",40,40,0,40,40,0,1,2
"23244","a0dd153287cd6ad5acf232a2d1c5668a",111,87,63,12.3333333333333,111,0,3,3
"23245","a0dfc3601ed60a119279746f2cd378c3",30,30,0,30,30,0,1,2
"23246","a0e02e825bd846206cfe0a799a0bc039",49,49,0,49,49,0,1,2
"23247","a0e0d44e01086df263e349691e980887",90,59,72,8.75,62,28,2,1
"23248","a0e309da3e11cf9631613f296d02c468",54,37,70,5.4,54,0,2,1
"23249","a0e43b5fbc2519828934437c2e728e54",52,43,31,11.741935483871,28,24,2,1
"23250","a0e6d1f7c97fafcc7b4941cc1e6e8116",114,70,52,15.3461538461538,74,40,3,3
"23251","a0ee03d12de138a191b0eeb29a8b0fcc",165,75,82,14.0853658536585,165,0,3,3
"23252","a0ef38a12b46d3639b1686467e56d3de",9,9,0,9,9,0,1,2
"23253","a0f05efda36080768412867496bd5f9d",21,21,0,21,21,0,1,2
"23254","a0f72f4aad50e34753e7192625438e0d",107,62,81,9.24691358024691,107,0,3,3
"23255","a0f85a9b09b5128a3c988894eb40af04",17,17,0,17,17,0,1,2
"23256","a0f9ef68409f9c7bcecb48e8688b8a0d",10,10,0,10,10,0,1,2
"23257","a0fa0bb91069a0a664475eba0fd17ba9",24,24,0,24,0,24,1,2
"23258","a0fcab8ebb157f46623c323ee1393e48",150,80,48,21.875,150,0,3,3
"23259","a0fdcd030aa6e27f49ee5561712b8bce",11,11,0,11,11,0,1,2
"23260","a104a356de0fd3035e3f3821b2e6391c",79,70,28,19.75,79,0,2,3
"23261","a1073139acb2a73052e07a01c7590f76",29,29,0,29,29,0,1,2
"23262","a109bc8a1f7a7839fd8e282c5d3d7ea5",20,20,0,20,20,0,1,2
"23263","a10a46a401b9455774afb0f1c6f43d12",4,4,0,4,4,0,1,2
"23264","a10b3f406426ce097dca9a4546233dae",18,18,0,18,18,0,1,2
"23265","a10d2237d380168e64b7744af09dfbe3",131,52,72,12.7361111111111,131,0,3,3
"23266","a10e608a44ed1ed75952d7db047b2a8d",32,26,49,4.57142857142857,32,0,2,1
"23267","a11019c8be78ac672b2c8eff7ae175b4",65,58,70,6.5,65,0,2,3
"23268","a1114dc43462507997a84a63a00e6dc6",137,95,82,11.6951219512195,109,28,3,3
"23269","a1156542ed8280f672460734835dd186",60,44,17,24.7058823529412,31,29,1,1
"23270","a1179646c84e10ae5bc3ff8b58028e97",10,10,0,10,10,0,1,2
"23271","a11966aba51e6abcbf0ea22fb26c02e7",27,27,0,27,27,0,1,2
"23272","a119edac0b1643d094522291eb6ac420",41,35,21,13.6666666666667,0,41,2,1
"23273","a11d9857757f5670a3397c71d5539a7e",24,24,0,24,24,0,1,2
"23274","a11f0df1d1dd55677e40c9a4390340ca",38,38,0,38,38,0,1,2
"23275","a11ff6f237fbfca787dd1f3d03b18b4d",70,46,56,8.75,70,0,2,3
"23276","a120d2d810f1b037662cfa9e6b83ed47",76,63,30,17.7333333333333,76,0,2,1
"23277","a121972b5c88c837b97c89f49d86a08a",56,46,53,7.39622641509434,56,0,2,1
"23278","a122c1567da0825426103334e1312191",93,66,49,13.2857142857143,93,0,2,3
"23279","a1233fb7ff3d30294564cd84419a64e2",84,66,22,26.7272727272727,84,0,2,2
"23280","a1238983fe817b50df70039a4dcdc92d",98,70,45,15.2444444444444,98,0,2,3
"23281","a1238fcbeb40e26ac04fc7036e151bc3",79,62,19,29.1052631578947,31,48,1,3
"23282","a126c449447a0e7be34782a850490a12",30,30,0,30,30,0,1,2
"23283","a1282c677afbf69ed6387126f0b1897a",163,94,81,14.0864197530864,127,36,3,3
"23284","a1290d46059e29c5c22fe8e989b80a54",35,35,0,35,35,0,1,2
"23285","a12af0060cc1e4f7a049ef90bf9ca426",3,3,0,3,3,0,1,2
"23286","a12e371e7e748945910eed4e456a0719",186,90,44,29.5909090909091,144,42,3,3
"23287","a1301fd213a60952f5657e114aaea9b5",140,70,69,14.2028985507246,106,34,3,3
"23288","a130c48a3da546cd0541b830846f91d3",16,16,0,16,16,0,1,2
"23289","a132e4bdbb26f60f1f97242ceb977316",26,25,31,5.87096774193548,26,0,2,1
"23290","a132f9c63ad46109a191a65c19eb5085",30,30,0,30,30,0,1,2
"23291","a134ea3d73ce179e29aa480734794680",22,22,0,22,22,0,1,2
"23292","a135c264c7117aea5425a2f0718fec55",51,44,33,10.8181818181818,18,33,2,1
"23293","a1368d7634bb8e104f76158d31088c74",13,13,0,13,13,0,1,2
"23294","a13d07ce8d4745a4114944fdfd0c3a5c",238,114,62,26.8709677419355,186,52,3,3
"23295","a13da9ac9d21b73c9ddbf830809950c2",20,20,0,20,20,0,1,2
"23296","a1404abdbe3ffdc9c647a488b5d5d719",24,24,0,24,24,0,1,2
"23297","a14085390289b69f192082369ac39b38",38,27,26,10.2307692307692,28,10,2,1
"23298","a14365db2cdafc9930cfe6e7b48db2bd",24,21,13,12.9230769230769,24,0,1,1
"23299","a14442474e66edc9b29e3234686d76f2",49,41,49,7,49,0,2,1
"23300","a1451a8df0dae046b1b29dfaa05c0bb3",2,2,0,2,2,0,1,2
"23301","a147b711e8b3eeefdec2f3300f33c4e2",30,30,0,30,30,0,1,2
"23302","a14b0883f7e1321b976b8aab6f3e6f22",43,30,43,7,43,0,2,1
"23303","a14d8688cc3dbbf578028d58a2dd35d3",66,58,55,8.4,66,0,2,3
"23304","a14e5a3bdf8f17f55447839560a4cd67",10,10,0,10,10,0,1,2
"23305","a14e6bc5691c8a1917217db877f5d58a",44,44,0,44,44,0,1,2
"23306","a154cd7df6fdf4b64f6d804253ba5930",102,69,62,11.5161290322581,102,0,3,3
"23307","a157998a44f1294320f2f7e7acd3bff7",111,66,64,12.140625,86,25,3,1
"23308","a159ca09c26ceae17e955d3d43aab2ce",62,52,63,6.88888888888889,62,0,2,3
"23309","a15a151148fd0d6cf403e0fe5c6cd6cb",32,20,45,4.97777777777778,32,0,2,1
"23310","a15adcda332ecf1f7ba26321fb8986ad",11,9,42,1.83333333333333,11,0,2,1
"23311","a15b052c254e6442c8acecab9e82cb7f",28,28,0,28,28,0,1,2
"23312","a15bedcf47de6a11831fc8fb5e74c75f",15,15,0,15,15,0,1,2
"23313","a15c2b075f90391dea415a492414836f",74,70,53,9.77358490566038,74,0,2,3
"23314","a15ce82f0658804b7634456588cf0aa3",13,13,0,13,13,0,1,2
"23315","a15e54c05690dc5a280db90b3cb347f9",4,4,0,4,4,0,1,2
"23316","a1602b355b3829a5d8ccae481afd00ca",18,18,0,18,18,0,1,2
"23317","a160fd15c5e6bcfb524aff6ef77fe942",137,89,55,17.4363636363636,137,0,3,3
"23318","a161bf55f4ce373ce05e412e571a8762",17,17,0,17,17,0,1,2
"23319","a16439b67641a28f3ac27d8396023968",66,37,74,6.24324324324324,66,0,2,1
"23320","a164e65738b504605ddf7abc0bab6666",65,56,13,35,24,41,1,1
"23321","a16537492fbd95686940850b1c172260",52,52,0,52,52,0,1,2
"23322","a1654c5302b66933c43706cdfd1850ce",34,28,42,5.66666666666667,34,0,2,1
"23323","a16590917fb092489fef063b6c14b005",75,67,51,10.2941176470588,75,0,2,3
"23324","a16687ef4b1fd5a7aa034d3da3999d3f",99,68,62,11.1774193548387,99,0,2,3
"23325","a166fac93bffc29af763a66d468e936d",1,1,0,1,0,1,1,2
"23326","a16c3255f68c20b1014d48a703a7e929",27,27,0,27,0,27,1,2
"23327","a16f6743540658fc1b7ce516b6391f1c",89,56,63,9.88888888888889,63,26,2,1
"23328","a174f283aa5566e61d55003b048c7e57",118,62,48,17.2083333333333,118,0,3,3
"23329","a1750c8e075fd7a036cb2048056e0586",46,45,6,53.6666666666667,46,0,1,2
"23330","a177632b4d15ed77ab3063845d491d9f",65,58,55,8.27272727272727,65,0,2,3
"23331","a17895143acb3420aad2c41213c3a17f",15,15,0,15,15,0,1,2
"23332","a178bd98bfb64f5e03bd64d1f862850d",32,32,0,32,32,0,1,2
"23333","a17980623735a2d77f24ebeba560bbb1",28,28,0,28,28,0,1,2
"23334","a17a6397d6129fbc4c1da122b7e8bd43",110,45,70,11,110,0,2,3
"23335","a181a8651852bf41146fad1c3b7f3e84",23,23,0,23,23,0,1,2
"23336","a1829253604dde68c24ff9805412247f",80,69,51,10.9803921568627,57,23,2,1
"23337","a182949eded6bb6be430acb08d91f97c",43,43,0,43,43,0,1,2
"23338","a18383a75d2138a6a09e6e21ee343e16",30,30,0,30,30,0,1,2
"23339","a1843fe099276720bceb537b2081a6e1",97,71,66,10.2878787878788,97,0,2,3
"23340","a186b79aab5dfd4e41f5bab42bde5515",40,40,0,40,40,0,1,2
"23341","a189830fc2cf2f902b1d1f5e4c9802b6",26,26,0,26,26,0,1,2
"23342","a191e9c3130487bf2702b125f1dc8206",19,16,30,4.43333333333333,19,0,2,1
"23343","a19315099938308bb4e65a1e8bb2fb9e",87,70,35,17.4,87,0,2,3
"23344","a19708642e45ce08c7e093bdf0b641c2",45,39,31,10.1612903225806,45,0,2,1
"23345","a1975abcab10b9da3879d571890d2713",43,33,36,8.36111111111111,43,0,2,1
"23346","a19d9e0783c2fe411694479ab190da4e",103,63,50,14.42,103,0,2,3
"23347","a19e471591a41e7855bc3f57699b45eb",129,93,39,23.1538461538462,129,0,3,3
"23348","a1a1f9f439d1470ae64006306790d26b",43,43,0,43,43,0,1,2
"23349","a1a1fdd7e46f49d4b55450b70e859d36",73,59,58,8.81034482758621,73,0,2,3
"23350","a1a2dc0223a35de6a0b098d0d1f321f9",24,20,0,24,24,0,1,2
"23351","a1a36b4f22f14a2d0f93213c4d1d345f",70,60,20,24.5,70,0,1,2
"23352","a1a54244d797f0adbb7b78de9a950339",65,49,43,10.5813953488372,65,0,2,3
"23353","a1a625a2a7edbe6d0cdd84a23f9bb3b4",86,76,14,43,86,0,1,2
"23354","a1a9a50ddd59df271d21b5652367715b",61,54,78,5.47435897435897,61,0,2,3
"23355","a1ad1d7a4aaae691301fdb0f3f334933",30,25,63,3.33333333333333,0,30,2,1
"23356","a1ad746cf426a030245d416ada3fe4e1",81,60,49,11.5714285714286,53,28,2,1
"23357","a1aedb70951dad1bb0f021540584aadc",37,33,53,4.88679245283019,37,0,2,1
"23358","a1b1915be5aedb2772e40d171bb1154a",54,33,73,5.17808219178082,39,15,2,1
"23359","a1b4ce5ec90cd3a041ab3d1fe53b22af",166,53,76,15.2894736842105,166,0,3,3
"23360","a1b50f6063f06bab0cedc3e74b70b48f",3,3,0,3,3,0,1,2
"23361","a1b7a8ba68c4dacf6e8c61039fb05b1a",146,93,68,15.0294117647059,92,54,3,3
"23362","a1b9e66d2af7dca9c0d7d9011d6c37f2",34,34,0,34,34,0,1,2
"23363","a1ba196960df0cad9667d3f918832da0",63,52,70,6.3,63,0,2,3
"23364","a1bb084799f944c3fb974e8a14c53e17",51,36,57,6.26315789473684,51,0,2,1
"23365","a1bd099d087dbef1fb347416e690d651",33,31,24,9.625,23,10,2,1
"23366","a1bda1cfe41f0caf9ac6a713e0f3d212",81,69,22,25.7727272727273,81,0,2,2
"23367","a1bf4099681fd94e2c6aa2da09f52ccc",31,31,0,31,31,0,1,2
"23368","a1bf4fd182a13f33f6e6e86d34e96884",17,17,0,17,17,0,1,2
"23369","a1c0d9aac27b45423c3deb4f0d02ec1f",183,61,77,16.6363636363636,183,0,3,3
"23370","a1c1585d405760d9d9a1e416c26b6bea",74,49,49,10.5714285714286,57,17,2,1
"23371","a1c1a690c9e212913f19522856fbe481",19,19,0,19,19,0,1,2
"23372","a1c4991a11a5dd96524f1c8611151095",18,18,0,18,18,0,1,2
"23373","a1c71a844d671c351868c7af919f66c4",35,35,0,35,35,0,1,2
"23374","a1c7a270ddff06be797d22a180ac024c",50,50,0,50,50,0,1,2
"23375","a1c9d22ec73adcf4c950d0774c0d42a0",85,63,26,22.8846153846154,85,0,2,3
"23376","a1ca689b94cfce9ad5e3fb1ec5e27d79",95,73,78,8.52564102564103,95,0,2,3
"23377","a1cc9843159506374cd7b267eede6b63",9,9,0,9,9,0,1,2
"23378","a1ccea50dd318476712fe0595e866194",75,28,70,7.5,75,0,2,1
"23379","a1d10af2427843e2a8290f66e2247949",21,9,71,2.07042253521127,21,0,2,1
"23380","a1d4b9fea1ee5928fa2e68f373f3dd6b",59,33,52,7.94230769230769,59,0,2,1
"23381","a1d87d45622d3ca75c7121a7920b6c13",149,90,63,16.5555555555556,113,36,3,3
"23382","a1d910b2376fcf465865e64a87c02d0a",218,126,79,19.3164556962025,218,0,3,3
"23383","a1d9a746657001f174adc7cd4a596ae9",90,68,78,8.07692307692308,90,0,2,3
"23384","a1da3e4eb851115de99ea45c7e5327d6",43,43,0,43,43,0,1,2
"23385","a1da713bbc98f03b3808e0686fcd279d",21,21,0,21,21,0,1,2
"23386","a1dfcc25db5b4c7bb83b774032b8aed7",43,31,51,5.90196078431373,26,17,2,1
"23387","a1e12ae87f77f687c486f36319f177bc",1,1,0,1,1,0,1,2
"23388","a1e17c0518f8c4d8a2d4f2e2ce7097c4",99,55,76,9.11842105263158,87,12,2,1
"23389","a1e69b335d50b4f5313a88c5870b200c",115,89,60,13.4166666666667,115,0,3,3
"23390","a1e86aa3d9ab898e713e90962c040d26",67,44,28,16.75,67,0,2,1
"23391","a1e954139b27806db2201a4e6e0ba9de",108,71,56,13.5,82,26,3,1
"23392","a1ecaed765b5d6ebef5ab9cc279a39f4",15,15,0,15,15,0,1,2
"23393","a1ecc750e6b1e16d353895dc4bc98878",12,9,35,2.4,12,0,2,1
"23394","a1ee4424cd9b7e7779af935cdff1de48",25,25,0,25,25,0,1,2
"23395","a1eefcd16ad5d7384cd9eb4c2571552e",59,52,20,20.65,30,29,2,1
"23396","a1efda83ba0fe8022f51ddf38115a3ba",32,32,0,32,32,0,1,2
"23397","a1fb59c8d671864def99b566a7e4384d",237,103,69,24.0434782608696,202,35,3,3
"23398","a1fc2ed9c624f8a5a4471ff2603d1f9a",62,54,13,33.3846153846154,62,0,1,2
"23399","a1fc926eac3e78ecbdd1a23adb1e410a",20,20,0,20,0,20,1,2
"23400","a2008c6dee772e253d5ca07b0d3d4527",106,72,42,17.6666666666667,106,0,3,3
"23401","a200a4706eae53205074082bbef836b2",157,95,65,16.9076923076923,112,45,3,3
"23402","a200b5a0eecd3c132ea120a0b1ae4ac3",60,41,25,16.8,60,0,2,1
"23403","a201a18b110b60cccf273b467c6055e2",126,66,62,14.2258064516129,126,0,3,3
"23404","a20375e9bb91d995623909af0286d1f1",123,99,54,15.9444444444444,123,0,3,3
"23405","a203ca0c78e2047a186fc928f886ec81",125,86,63,13.8888888888889,125,0,3,3
"23406","a20515532ce167b93e40eb6e7d489aef",143,84,71,14.0985915492958,143,0,3,3
"23407","a2051e79a3991cf8324ee0384f5f75f3",134,88,71,13.2112676056338,134,0,3,3
"23408","a2053d489c334c646801fecf00fdca07",65,58,49,9.28571428571429,65,0,2,3
"23409","a20541632e0cc1961743eb7efd0da09d",14,14,0,14,0,14,1,2
"23410","a205f1c7b6ad4c07cec8757ff5f1931e",31,23,31,7,15,16,2,1
"23411","a2094813d6f81b91f97ab3a2f65f549e",19,19,0,19,19,0,1,2
"23412","a209a5d43e68c2167c5132ecc5a8d564",22,22,0,22,22,0,1,2
"23413","a20b9bf3b6235d81cf419481ac80f98f",98,66,57,12.0350877192982,98,0,2,3
"23414","a20dd40275d33fdc866a0942dd74e83d",49,48,40,8.575,16,33,2,1
"23415","a20de9c2e17eeae50554123f349aed40",58,42,27,15.037037037037,58,0,2,1
"23416","a2121dce2c9100ca1cb0d0bbb9dda7d0",43,43,0,43,43,0,1,2
"23417","a21264b47f10cc6cd47d534a2b82969a",66,44,74,6.24324324324324,28,38,2,1
"23418","a212ca5b400856b4901d2c7da4d4ab7e",46,46,0,46,46,0,1,2
"23419","a2130297ddaf3e220f612676149d38fd",79,63,49,11.2857142857143,79,0,2,3
"23420","a2135ead564fcca7bae2d34b2f8225af",97,63,36,18.8611111111111,97,0,2,3
"23421","a2140a1d35aa5619f37beecf34f2fdc8",98,64,73,9.3972602739726,98,0,2,3
"23422","a214fc229da749b07293f70d2bee241b",118,87,35,23.6,118,0,3,3
"23423","a2156f362a79051988a35232a60412ac",30,30,0,30,30,0,1,2
"23424","a215ae980289fe1fb8696f2048920f97",152,104,35,30.4,152,0,3,3
"23425","a219cc66630cb77b8a7e315ca650bc65",37,33,34,7.61764705882353,37,0,2,1
"23426","a21a35556f30ae8a27c2b3a95d3b7613",28,28,0,28,28,0,1,2
"23427","a21a786b6451b26661fbc697f74504c5",76,53,35,15.2,76,0,2,1
"23428","a22476c286e49d33c1505d765d4d942c",158,61,56,19.75,158,0,3,3
"23429","a2247e216b7d008def736f1582e67481",94,69,44,14.9545454545455,46,48,2,3
"23430","a224db1e61073cd53ec9aca7c04b9f1a",67,34,62,7.56451612903226,67,0,2,1
"23431","a225b0cdb95a18fa1e8769b41b1e6de4",40,40,0,40,40,0,1,2
"23432","a226f1cdc5a5445686cc7fe79d5b139c",28,28,0,28,28,0,1,2
"23433","a22a6b29fcdd15f1fa80dd532b88202c",164,111,47,24.4255319148936,164,0,3,3
"23434","a22a715d54e618a6c7cb96b241d7fc60",5,3,46,0.760869565217391,5,0,2,1
"23435","a22acbcc2fd39f985a9e0bd40055ddd8",31,31,0,31,31,0,1,2
"23436","a22d46e730ebea6446a6d13fdc987669",35,35,0,35,0,35,1,2
"23437","a22dc6e4825aceb386da3fa21fb28aea",101,73,64,11.046875,64,37,2,3
"23438","a22dc79761aada2534064bda24f95e52",99,84,24,28.875,49,50,3,3
"23439","a22f2b7a668a638264dca6612a2ef7db",12,12,0,12,12,0,1,2
"23440","a232c1ee61f1f2749fc5490ef4dd0bc2",11,11,0,11,11,0,1,2
"23441","a232e1a1336e035a971f5edc1ab9fa23",12,12,0,12,12,0,1,2
"23442","a23a93a1791efcd3b52c207885daeebd",20,20,0,20,0,20,1,2
"23443","a23b80efe336c37da38a955d9af28a9a",16,16,0,16,16,0,1,2
"23444","a23dd6fdb49dbbbda8a6e6680afcd0de",49,49,0,49,49,0,1,2
"23445","a23e26658ae73b32025601b6054511ee",50,41,49,7.14285714285714,50,0,2,1
"23446","a244230aaf52edddbdda54d60adddcd3",49,49,0,49,49,0,1,2
"23447","a24480fdb44cfcaff7d79fe43e672f55",15,15,0,15,15,0,1,2
"23448","a2457e32f1a00b6f6d7909e510c93dce",30,30,0,30,30,0,1,2
"23449","a24788e3fc2cddc2e22db24b1291ebeb",113,57,68,11.6323529411765,113,0,3,3
"23450","a247fc6be5c9dbcb21777db3dce7e2c9",39,39,0,39,39,0,1,2
"23451","a248054ce481a2c5e07cafdfe08566b2",28,28,0,28,28,0,1,2
"23452","a2480eed3011edea3092719eb27a1b7d",121,83,66,12.8333333333333,121,0,3,3
"23453","a2490806b17b0b300639212c53dca3d3",17,17,0,17,17,0,1,2
"23454","a24d62cde77899746237d904f4fa3678",32,32,0,32,32,0,1,2
"23455","a24dedf24d8da3ef4061c13e0ee40054",17,15,40,2.975,17,0,2,1
"23456","a24e2347a20fb6bad6e5dacbce4c7bac",117,62,61,13.4262295081967,94,23,3,1
"23457","a24e4e46d2d0984b912a0049b77f8056",66,61,36,12.8333333333333,66,0,2,3
"23458","a24ecca7573443c0e2d3d242b46630fc",91,66,24,26.5416666666667,91,0,2,3
"23459","a251d8b6b2e0c1963772ad33906eebe9",44,44,0,44,44,0,1,2
"23460","a252b0d0ded753bce653654318e52947",156,94,59,18.5084745762712,156,0,3,3
"23461","a253409fa11c16f565f31adec1cbf7e9",23,23,0,23,23,0,1,2
"23462","a254b1d364c3ec75d250c6528c2b59cd",172,105,79,15.2405063291139,154,18,3,3
"23463","a25620071c725545b18bad4af31b7453",45,36,49,6.42857142857143,45,0,2,1
"23464","a2564216c5c1ccb810f76cfa49abd5b5",63,54,88,5.01136363636364,63,0,2,3
"23465","a25655cf59410cfebb1bac722946c63d",26,26,0,26,26,0,1,2
"23466","a257cffe2f5571132353a1b6077ab263",17,10,56,2.125,17,0,2,1
"23467","a25876d7d7eb2dd91e5a1e90661980cd",19,19,0,19,19,0,1,2
"23468","a258b8d441a961fe125da85635d20a9f",35,35,0,35,35,0,1,2
"23469","a25b32277e9d14ba38e22a4297bd5d42",19,19,0,19,19,0,1,2
"23470","a25ed1f4a70627c898cf73e5582c14a0",129,93,76,11.8815789473684,129,0,3,3
"23471","a262b8d6a87d160779377788eff18c66",102,57,64,11.15625,102,0,2,3
"23472","a262c12b5df1053829f7898f5554fee6",230,112,78,20.6410256410256,203,27,3,3
"23473","a2653aa21afe266c1ef224bd2dea2fbb",97,52,55,12.3454545454545,71,26,2,1
"23474","a265cb6464d47a9696407bf1858008ff",156,126,63,17.3333333333333,156,0,3,3
"23475","a2680fb442438a5cb8057a9a1b27c11a",85,75,42,14.1666666666667,85,0,2,3
"23476","a26893352466f88c240e03723ae0a558",126,84,62,14.2258064516129,85,41,3,3
"23477","a26c601500d1596323b99fea85b61829",64,46,46,9.73913043478261,33,31,2,1
"23478","a26f47df8d076c805e294ba26372679e",112,78,62,12.6451612903226,112,0,3,3
"23479","a26f4db530d4d0094fd28ae1d9d939ef",27,27,0,27,27,0,1,2
"23480","a2736c9e6eed87e18e958a974fe0a7e0",14,14,0,14,14,0,1,2
"23481","a274d6590990e3c6c28f255ca6f751a8",139,95,64,15.203125,139,0,3,3
"23482","a27996583c93f9896112112a5615f54d",185,121,58,22.3275862068965,130,55,3,3
"23483","a279c0d2060cf0ad908bd14372e9eec7",78,56,63,8.66666666666667,78,0,2,3
"23484","a27ba27d5796545221e7219e948d39b9",12,12,0,12,12,0,1,2
"23485","a27be0ad8ea1a96352ce6ba24d1bfe1e",21,14,72,2.04166666666667,21,0,2,1
"23486","a27c9d065c520889448020ac444b5c91",98,77,62,11.0645161290323,98,0,3,3
"23487","a281e39fbb5592ffb3c3fb45169dd41c",30,30,0,30,30,0,1,2
"23488","a283e17b3993d9406267631cf16e3b92",85,59,63,9.44444444444444,85,0,2,3
"23489","a28470eefae8b0a880a74ed130db6c19",94,65,53,12.4150943396226,63,31,2,1
"23490","a286302991cb06741bfd45077fb3ef34",2,2,0,2,0,2,1,2
"23491","a28673ca9783cc442ca1fd6898cf8fcd",143,94,54,18.537037037037,143,0,3,3
"23492","a288312558bba6672bab23d1cf897426",98,71,50,13.72,98,0,2,3
"23493","a28906fdad0ff1aa9f8c5fa7ec687e69",70,59,15,32.6666666666667,70,0,1,2
"23494","a28a6b90c2151fb123875565a4cdde8c",86,67,51,11.8039215686275,86,0,2,3
"23495","a28b5db8d7e05688014664f06c8b8a92",53,53,0,53,53,0,1,2
"23496","a28b7c020f4772924ec54a596fd0e169",12,12,0,12,12,0,1,2
"23497","a28b998b100447c16eefe957ec5f25a0",46,31,78,4.12820512820513,46,0,2,1
"23498","a28e2a133c336ce06ac4adfd90606236",215,125,55,27.3636363636364,215,0,3,3
"23499","a28f00fac82424ccfd4595d3d1c04a8f",17,17,0,17,17,0,1,2
"23500","a28f0e7f45933824e6cace7a040b16d1",110,63,69,11.1594202898551,110,0,3,3
"23501","a2919a61f30e40109ba3c6137765625c",31,31,0,31,31,0,1,2
"23502","a291c94f01fcc604668cbf516869ca4f",41,41,0,41,41,0,1,2
"23503","a29239a55065d2b51d70f348fcb36169",17,16,10,11.9,17,0,1,2
"23504","a2934626a2b99464f4cb6a79d1c069b9",31,25,56,3.875,31,0,2,1
"23505","a2948ac686716c5fca1e126eb20d552b",40,33,25,11.2,40,0,2,1
"23506","a2951d68a2e5bec29703b60dae616788",22,22,0,22,22,0,1,2
"23507","a2962260645ca522c69e3481eb98c743",19,19,0,19,0,19,1,2
"23508","a29793a0afcf3af8792444040ff95934",10,6,48,1.45833333333333,10,0,2,1
"23509","a29a64668380ff3faa187b154bee9cf7",22,22,0,22,0,22,1,2
"23510","a29df1460d6993497934854a72b6426f",23,19,53,3.0377358490566,23,0,2,1
"23511","a2a0f8f985d25b8a601e42b060903d2c",53,53,0,53,53,0,1,2
"23512","a2a234e11ca6de319f67e9ab7603c55d",206,100,73,19.7534246575342,206,0,3,3
"23513","a2a2ecdda16b2f1e913c644fd3310f98",39,37,7,39,39,0,1,2
"23514","a2a483938056847ac657231b007fe321",5,5,0,5,5,0,1,2
"23515","a2a50d8fe8c8eee060dd4f64a5edb88f",48,48,0,48,48,0,1,2
"23516","a2a73150a9bf2ee3ccc17424e03d1e00",73,42,55,9.29090909090909,73,0,2,3
"23517","a2ab1072bf6ac01833485817ee7cebb6",105,67,54,13.6111111111111,105,0,3,3
"23518","a2af4d15dea6801ffb5c8067d388af4f",28,28,0,28,28,0,1,2
"23519","a2b5603381b72942bac1a5698be54209",54,41,20,18.9,54,0,1,1
"23520","a2b6203db5584c6f9a3116834399b85d",149,92,58,17.9827586206897,112,37,3,3
"23521","a2b86d7ca0fdb8c04ff413104a999194",182,114,28,45.5,182,0,3,3
"23522","a2b8784158260b7d069aaa871514ecc4",33,33,0,33,33,0,1,2
"23523","a2b9d6bcbe04703cf61f35756201860e",8,8,0,8,8,0,1,2
"23524","a2bb625dccf8da48e2dbb060447e9a98",84,48,61,9.63934426229508,84,0,2,3
"23525","a2bb73e51fd31ae5d4bf347e7d2e26f3",35,35,0,35,35,0,1,2
"23526","a2bb7b1fdc62ed324a390467839eb127",53,44,44,8.43181818181818,22,31,2,1
"23527","a2bbb2b47f86d6513d78abc5cb34ebb0",27,27,0,27,27,0,1,2
"23528","a2bc0f3f195c85355c5d5faae3d047c0",196,95,62,22.1290322580645,196,0,3,3
"23529","a2bcc8b8f3342af26e3efbe7ac069f24",54,54,0,54,0,54,1,2
"23530","a2bd062f4dfc2f24251c3e5d953cd540",7,7,0,7,7,0,1,2
"23531","a2bd25c72df86daddc9548ca929760b5",35,35,0,35,35,0,1,2
"23532","a2be06d1a63bf666c4404b90024c352e",11,11,0,11,11,0,1,2
"23533","a2bf2f7c1606b843701cf4706aeb0d2c",31,31,0,31,31,0,1,2
"23534","a2c10bb8d35fdee7e8f098b5bd2cbe9d",203,116,76,18.6973684210526,171,32,3,3
"23535","a2c3ca072c1755a89b558e7310267b77",28,28,0,28,28,0,1,2
"23536","a2c3cdf28233de3b697beaf03f1b9dfc",187,113,32,40.90625,187,0,3,3
"23537","a2cb7cc2c2d698ea8630337a5aaedcf4",38,38,0,38,38,0,1,2
"23538","a2ce9a9af802b6de0c5d15fcc114225d",66,46,65,7.10769230769231,66,0,2,3
"23539","a2d1d48a14cf3a556452837b1c5ece13",25,25,0,25,0,25,1,2
"23540","a2d28125ef06fd656576b995b04c0f94",44,36,41,7.51219512195122,44,0,2,1
"23541","a2d3b130a4ee7307bfa7a23f3943135b",168,59,71,16.5633802816901,144,24,3,3
"23542","a2d3c869d5edb3f1ce8fd2448a4f7761",37,20,78,3.32051282051282,37,0,2,1
"23543","a2d714bf5ca57a42e07ab4bbbe7ff931",14,14,0,14,14,0,1,2
"23544","a2d88c761f29f2f76fbd83c00047ec9a",14,14,0,14,14,0,1,2
"23545","a2d952849584e744883494b97c232c72",27,27,0,27,0,27,1,2
"23546","a2dbcd88b51ddea6715703fe1669eb50",36,31,39,6.46153846153846,18,18,2,1
"23547","a2de2916046fc89e3dfa7f3cd525219b",16,16,0,16,0,16,1,2
"23548","a2deacfcf880097f81081faade7061b4",100,73,35,20,100,0,3,3
"23549","a2e1b2ca68fe5e8f39d23cd7db7616d4",134,82,60,15.6333333333333,88,46,3,3
"23550","a2e55fde741101140f2d100947944630",8,8,0,8,8,0,1,2
"23551","a2e5ce2011744cc9b9ca6661bd943ebd",25,25,0,25,25,0,1,2
"23552","a2e5d4df587e4f166cd913e5b8ba3721",11,11,0,11,11,0,1,2
"23553","a2e6343669bd0fdcf63af45d728f2c8b",28,24,17,11.5294117647059,14,14,1,1
"23554","a2e63c9504baa213ad700db0bb217874",19,19,0,19,19,0,1,2
"23555","a2e68ac1165236b3742f119dbc9976dc",9,9,0,9,9,0,1,2
"23556","a2e93a5596a29ee6927b281cbc241763",26,26,0,26,26,0,1,2
"23557","a2ebcf409892b9ce4f5157ec841ef5ca",67,54,61,7.68852459016393,38,29,2,1
"23558","a2eee8cf4fbf8cbcfcac6348c0982cea",39,31,86,3.17441860465116,16,23,2,1
"23559","a2ef174a436bec27b02c10402aa6c049",27,27,0,27,27,0,1,2
"23560","a2f3e2d741f95e7a97c02b291d3e2556",102,63,77,9.27272727272727,102,0,2,3
"23561","a2f3fe54d3a10ed234fe95eeef66c280",50,50,0,50,50,0,1,2
"23562","a2f80b8dca6a9bb41f8ef39c21817cd5",42,42,0,42,42,0,1,2
"23563","a2f91f269b74f597a4da3d93c4168018",22,22,0,22,22,0,1,2
"23564","a2fdabc6d0caa5f75614bde1df9d8c69",30,26,6,35,30,0,1,2
"23565","a2fe466755a76c5c19782201a1b5ff9b",20,20,0,20,20,0,1,2
"23566","a2ffa6509dde5da8889638e45850034f",68,47,40,11.9,68,0,2,3
"23567","a30025f1e45827280a173618e4c1612a",18,18,0,18,18,0,1,2
"23568","a300685c30f55934c36322d19922bf77",11,11,0,11,11,0,1,2
"23569","a3008a888caf3cb36415510a9b88ee2b",51,44,23,15.5217391304348,51,0,2,1
"23570","a3013613ff80988ee697dea7c62f0bd6",2,2,0,2,2,0,1,2
"23571","a302d7ccb42635ced5148ee00034757a",97,73,36,18.8611111111111,97,0,3,3
"23572","a3067de52e479fdab286ab78dc12c87b",37,27,24,10.7916666666667,21,16,2,1
"23573","a30714e3dfc006c5c7ce5928f9a398ac",4,3,57,0.491228070175439,4,0,2,1
"23574","a309dcbeac613ca4ea8fefabcce2675e",20,20,0,20,20,0,1,2
"23575","a30e37c6a74f4bcce84dc00a098684a5",27,25,13,14.5384615384615,27,0,1,1
"23576","a310183270c2d47ff62e30738c357be6",18,18,0,18,18,0,1,2
"23577","a3130120d85d395f4f4aef745ee5f157",26,26,0,26,26,0,1,2
"23578","a3145abc199952945a4295a306f39d7d",16,15,6,18.6666666666667,16,0,1,2
"23579","a314a418b3e0740396671c57fab65981",98,80,70,9.8,98,0,3,3
"23580","a3170b7ea3fec7ee8633da92946d3be8",139,79,77,12.6363636363636,107,32,3,3
"23581","a319a354702ac37f9fa4cad4b285c9a7",51,33,8,44.625,51,0,1,2
"23582","a31b2da2ee03330c09690545daf46cb2",73,58,14,36.5,73,0,1,2
"23583","a31e08e2ad570e5009107fda04ce4b4e",165,87,71,16.2676056338028,148,17,3,3
"23584","a31eb9c86c9486a90bc98005875e1081",15,13,46,2.28260869565217,11,4,2,1
"23585","a3249300a994558ce756d1db0907eb60",89,56,79,7.88607594936709,51,38,2,3
"23586","a3253b8b1ca982305f3a58f867f559af",127,87,29,30.6551724137931,127,0,3,3
"23587","a32a8a256645f5f0716368e4bd622a13",27,20,37,5.10810810810811,27,0,2,1
"23588","a32e5d89a2132f808142ca84e2de9d33",21,21,0,21,21,0,1,2
"23589","a32efb7c4349631c17ed1d3b2940f5d8",111,71,42,18.5,111,0,3,3
"23590","a32f2a265fd8525e8e332ef504f01068",146,75,60,17.0333333333333,118,28,3,3
"23591","a32f63ccc5bc8f767cf8ac620b5ac40c",60,57,34,12.3529411764706,60,0,2,3
"23592","a331e5aa19bed143219a44080dd16fca",21,21,0,21,21,0,1,2
"23593","a3374bc01508344adac7c737bca86a35",1,1,0,1,1,0,1,2
"23594","a3377a9927e4f62c767997f5519f6e17",242,103,81,20.9135802469136,208,34,3,3
"23595","a33bf5e4e620d610abb8efc303c1a348",39,38,5,54.6,39,0,1,2
"23596","a33fcd82db5b6ba1f56c7ee315cfb858",32,32,0,32,32,0,1,2
"23597","a343a04ef40ab8fec62a85365392fde6",135,97,49,19.2857142857143,135,0,3,3
"23598","a34442bb5766d48fdb1ac5e651a6007a",6,5,5,8.4,6,0,1,2
"23599","a34c61d5fa7218d762b11aba30192c8d",119,83,49,17,72,47,3,3
"23600","a34f7ab81637b822f20377721fdb639f",128,96,82,10.9268292682927,95,33,3,3
"23601","a34fa6b5583df6ac8ac3a8a2ec8b8456",26,26,0,26,26,0,1,2
"23602","a35229df9cf026db3cc39efe57581d84",56,47,20,19.6,56,0,1,1
"23603","a3537f8b50b771eb228319aa24724ce0",26,26,0,26,26,0,1,2
"23604","a357f6758e52250f1a11a209ca4cfebc",38,38,0,38,0,38,1,2
"23605","a35966745187425c55b49f4b9a57c56a",62,47,67,6.47761194029851,62,0,2,1
"23606","a35c9e5bf465bd9ce0f5d76b25107cd0",138,55,70,13.8,138,0,3,3
"23607","a35cc0d1a4d5cdd577ecd22cc3d64a17",83,59,61,9.52459016393443,83,0,2,3
"23608","a35f5087e6ac25bffd79299d8541d8b0",60,27,75,5.6,60,0,2,1
"23609","a35f59e85a804fd25b83dfe3749490d8",121,84,69,12.2753623188406,121,0,3,3
"23610","a35fabcfe6369321c1702d5fac749a4e",38,38,0,38,38,0,1,2
"23611","a360721505fdc113675c92c5d5804e9d",211,96,85,17.3764705882353,211,0,3,3
"23612","a366d66a3276ba9840e9d64678a2f6ab",13,13,0,13,13,0,1,2
"23613","a36b43558da9edb819c1fe3b7fe8b274",89,65,63,9.88888888888889,89,0,2,3
"23614","a36e29221cfa49d0e98d3eea1e09477f",39,39,0,39,39,0,1,2
"23615","a36e3de0613ec7a336267893c7d907d3",194,102,63,21.5555555555556,194,0,3,3
"23616","a36ecbd88c5d1a0a6c76f8addd702c19",72,45,54,9.33333333333333,40,32,2,1
"23617","a36f5e92140f51a9e93cd9ad57097a2a",30,26,5,42,30,0,1,2
"23618","a36fce999c1848a5536889a856198422",14,14,0,14,14,0,1,2
"23619","a3703f664c9eb32b7adff3d575bbe032",39,31,33,8.27272727272727,39,0,2,1
"23620","a371828ce18a08aba9ed9770e9cda720",14,14,0,14,14,0,1,2
"23621","a3722b5b1068d40a2ffc52da378f5e2e",20,20,0,20,20,0,1,2
"23622","a373fb9a569759ec141c4757510bb43f",24,24,0,24,24,0,1,2
"23623","a374e275df8fae8cc2ff5d0ffe2b02c6",64,52,63,7.11111111111111,64,0,2,3
"23624","a378fb92afede0050ddae6d474361009",21,21,0,21,0,21,1,2
"23625","a379abda7def9350a9e5b5be66680ef9",145,98,43,23.6046511627907,145,0,3,3
"23626","a37a0aeba58776fd70b7170ee17151fa",9,8,57,1.10526315789474,9,0,2,1
"23627","a37a9f9c21f2a4b9f68953d2aa3e7f6b",10,10,0,10,10,0,1,2
"23628","a37dde07abe970f05b6fb7e6131b41cd",10,10,0,10,10,0,1,2
"23629","a37eee6ef9e5c3b4b6cbc8e8ca3250c2",79,62,44,12.5681818181818,50,29,2,1
"23630","a37f23ac7c4dd666b060d3936b77af38",35,35,0,35,35,0,1,2
"23631","a3804ee407ff099c9e297a7ae6b0358e",28,28,0,28,28,0,1,2
"23632","a385ae42c775d9076fc479f2127f4f12",32,32,0,32,32,0,1,2
"23633","a387a41e8c10df559e233b2add5a64a5",130,94,77,11.8181818181818,109,21,3,3
"23634","a389f09838eeee4e4421e94a81a73c23",102,61,71,10.056338028169,102,0,2,3
"23635","a38a0f1f6c748ec2e7ea91abadf891f6",118,73,63,13.1111111111111,118,0,3,3
"23636","a38a411e24271a07d4f83fa645a99c5f",7,7,0,7,7,0,1,2
"23637","a38aa5e4ebfbc6ae12891fb669cc2ce3",33,33,0,33,0,33,1,2
"23638","a38dd9474c9116b5f59242dcb377f67f",56,46,14,28,56,0,1,1
"23639","a38de7a37b2cb90e21fa32d8f85b0087",65,39,37,12.2972972972973,65,0,2,1
"23640","a38ebcab3404358422c057ea78d61105",57,49,36,11.0833333333333,15,42,2,1
"23641","a393aaf747f53fb23d59f4d97e873e52",23,23,0,23,23,0,1,2
"23642","a39403e0e189bc198bde9c89035c9419",1,1,0,1,1,0,1,2
"23643","a3992df951f3fa9cad9b36ab214d4261",27,27,0,27,0,27,1,2
"23644","a39a725e964785095fafb66b1dcb9843",200,106,85,16.4705882352941,166,34,3,3
"23645","a39b56a4c5517359194dc9ccf01ac49d",196,105,84,16.3333333333333,159,37,3,3
"23646","a39c9a699806901aff814613a60eb035",31,31,0,31,31,0,1,2
"23647","a39ef73335d132bc19fa94b0ded24b1c",29,29,0,29,29,0,1,2
"23648","a3a08e4af2d45bcc8771045e2a8f751d",44,23,70,4.4,44,0,2,1
"23649","a3a1c68d347b13dbf8c1fc6775c05341",18,18,0,18,18,0,1,2
"23650","a3a2d656dfc0db24989a0c0ecc83529a",74,43,56,9.25,74,0,2,3
"23651","a3abea716c331ce246e41fb74f058c73",34,34,0,34,34,0,1,2
"23652","a3ae7186da6406dd8cab553c356f079d",149,107,64,16.296875,126,23,3,3
"23653","a3ae833f953ed3588786112c6d450481",205,113,82,17.5,190,15,3,3
"23654","a3b07620072af21658805b44c730b34b",13,13,0,13,0,13,1,2
"23655","a3b4467a799f55c505e5a3eca752994d",21,19,34,4.32352941176471,21,0,2,1
"23656","a3b9cb7773ec050524d18f7a14009661",18,18,0,18,18,0,1,2
"23657","a3bbb70f67a58cc8c6da57047274d9f7",103,86,38,18.9736842105263,103,0,3,3
"23658","a3bbf0122192d7e9b94dc65b3581be73",31,31,0,31,31,0,1,2
"23659","a3bc0829bca4818a4accc24750da00ce",92,47,50,12.88,92,0,2,3
"23660","a3bffb6996dab8a3389d141ee6d0c171",148,97,77,13.4545454545455,148,0,3,3
"23661","a3c1de8d0c7ddb476c5902d8ec252762",178,74,76,16.3947368421053,178,0,3,3
"23662","a3c48cc51e7a49d4504069c4a3b8de3c",68,50,56,8.5,68,0,2,1
"23663","a3c6a50e3b05c0118473c9b892a77503",123,85,40,21.525,79,44,3,3
"23664","a3c6e730661a52f30d76a638342af39f",19,19,0,19,19,0,1,2
"23665","a3c83fb042bed80e31dd2756047c666f",165,102,65,17.7692307692308,165,0,3,3
"23666","a3cba0fbc05bcc5e06faa920221e29fd",61,51,15,28.4666666666667,61,0,1,2
"23667","a3d21ebe463b030c43c5663227bf0848",25,18,58,3.01724137931034,21,4,2,1
"23668","a3d23b02e4ec047f667f27e10be46ddd",60,47,64,6.5625,60,0,2,3
"23669","a3d5f486643d9931c575b7c1514d99bf",15,12,33,3.18181818181818,15,0,2,1
"23670","a3d8fa23183043bab73fd67b1d513303",49,49,0,49,0,49,1,2
"23671","a3d971bd95f8c15e38b95598eb82a839",17,17,0,17,17,0,1,2
"23672","a3de3ae2f53aca4d970d846e9550f8c3",43,43,0,43,43,0,1,2
"23673","a3e41502d5db5d3130c5d77b38dc447c",78,54,46,11.8695652173913,78,0,2,3
"23674","a3e8a78bbf610f415bb4d1f4c6eee43b",144,76,56,18,144,0,3,3
"23675","a3eb523e2242b0d6d5ceac65196651cf",59,44,50,8.26,59,0,2,1
"23676","a3eb93245a8e8fab79510a7c540f854a",31,31,0,31,31,0,1,2
"23677","a3f0f1ae29fa2ffbc41943662edc112b",89,66,24,25.9583333333333,89,0,2,3
"23678","a3f96fd1bee594c74a53c6da0888a2b7",25,18,57,3.07017543859649,15,10,2,1
"23679","a3f9e4a0b8b757b4a56c399faf692da9",17,17,0,17,17,0,1,2
"23680","a3fb612059dc34070133af871bd02e78",18,12,35,3.6,18,0,2,1
"23681","a3fb9f146f3016a24f8c5731025eb397",26,26,0,26,26,0,1,2
"23682","a3fd5c2261e157ec2deca93d51f64a13",172,102,75,16.0533333333333,172,0,3,3
"23683","a3fd6a8fb6f0c4401dbaa961b88bfb0c",25,25,0,25,25,0,1,2
"23684","a400047f914b64ada9f3db1f94645eff",34,29,62,3.83870967741935,34,0,2,1
"23685","a4014c0443cefcc6f053f575759896d0",66,60,47,9.82978723404255,55,11,2,1
"23686","a4045d27909d53a7c3d411f60626ef3f",9,4,61,1.0327868852459,9,0,2,1
"23687","a4077844c34f3f9a2fc0f3c038a891bf",38,35,14,19,0,38,1,1
"23688","a408b046d134c43d6975bae455fbf4e0",34,34,0,34,34,0,1,2
"23689","a40a7d353c397f7198433fe9c422df20",12,12,0,12,12,0,1,2
"23690","a40b693c7a262f3b59bd358c66e0d70e",23,18,35,4.6,23,0,2,1
"23691","a40c0eb4b989bb1fb8833d82e4ef04f5",132,85,76,12.1578947368421,83,49,3,3
"23692","a40c7227c0e509d8e1ab55024a57c1e0",82,69,43,13.3488372093023,82,0,2,3
"23693","a40d868d694a724c6bc64989b7e9e91d",22,21,3,51.3333333333333,1,21,1,2
"23694","a40e75cf73b531420a584c39a2d747d9",41,29,77,3.72727272727273,41,0,2,1
"23695","a40fadf260306ed078a0caae94c8e377",53,27,56,6.625,53,0,2,1
"23696","a410ffef77139546a39121db053e7eeb",10,10,0,10,10,0,1,2
"23697","a414549bd0def799857db6e235be2d55",32,32,0,32,32,0,1,2
"23698","a4157bb72b7191ea111a9b4909cf88c3",112,79,53,14.7924528301887,112,0,3,3
"23699","a416465a0bb67e7c380e901228066ed2",49,47,17,20.1764705882353,20,29,1,1
"23700","a416ea14471b40e7f3dffc1c3d308e80",204,77,69,20.695652173913,204,0,3,3
"23701","a418298caa4c151f6db5a7d8f125150f",39,39,0,39,39,0,1,2
"23702","a419278066311e1f5aaa35162c951adb",157,68,70,15.7,157,0,3,3
"23703","a41a994f20a6d32bc662a1d67dad933d",75,57,65,8.07692307692308,75,0,2,3
"23704","a41bf1e4db29149afa768d26fc446d83",34,34,0,34,34,0,1,2
"23705","a41c0d48ce26811ad7fb07e808ce8287",142,55,79,12.5822784810127,142,0,3,3
"23706","a41e09da558a3531501ba3d820d70ba2",81,54,45,12.6,57,24,2,1
"23707","a4202169f19f68236e1ed0fae3bf5c87",66,55,28,16.5,66,0,2,1
"23708","a423ed4c4d43bd391fa62042a140f95c",51,38,73,4.89041095890411,51,0,2,1
"23709","a425128528e374920735ab38a0d19d4a",29,29,0,29,29,0,1,2
"23710","a4259a167b979b3c531c09b378bf925a",38,34,20,13.3,18,20,2,1
"23711","a426e7585b8a1b39979a8067b8d905a9",27,27,0,27,27,0,1,2
"23712","a427a05d69ed17c72a334b0048782bc0",10,10,0,10,0,10,1,2
"23713","a429fe17f5f4e828fe2494bdfc16bec1",172,102,49,24.5714285714286,130,42,3,3
"23714","a42a1c8698b91280fc17e91c438d8d9a",23,23,0,23,23,0,1,2
"23715","a42adacd411a766c553347f904b4a843",58,53,56,7.25,58,0,2,1
"23716","a42e922f1972fafe1921af3eba12fd61",37,37,0,37,37,0,1,2
"23717","a42f7e30ac85af555b88f6670969a1f2",127,87,54,16.462962962963,127,0,3,3
"23718","a42ff99c291dd19c6a0b778be73c0903",237,106,79,21,200,37,3,3
"23719","a4301fc86b94d74dd3e57dd263c96443",1,1,0,1,1,0,1,2
"23720","a430b87bbe41b45c0a680b59e1585ab2",14,14,0,14,0,14,1,2
"23721","a430ef0ca5116351ca42d01a7fd0cad4",72,52,21,24,72,0,1,1
"23722","a4352217d2781cbe46190cf0da7c961d",4,4,0,4,4,0,1,2
"23723","a437866101c8e1195816675041de05d3",114,92,32,24.9375,114,0,3,3
"23724","a438b108ec6a548a9a9da48f007348b0",51,44,27,13.2222222222222,21,30,2,1
"23725","a43b69e528706f2131f9d2f7a08939b9",44,44,0,44,44,0,1,2
"23726","a4413da5d843a409e0fa008e9d2682da",90,59,60,10.5,62,28,2,1
"23727","a441fb2c73bf2873c7dc310fbbaa650f",15,13,31,3.38709677419355,6,9,2,1
"23728","a443a4be271e7b2ce50029f633e38151",17,17,0,17,17,0,1,2
"23729","a446b70dca59e6fa63ee4f4e341fd45c",107,62,85,8.81176470588235,86,21,2,1
"23730","a4474a0501724b48db209bd7605d4399",219,93,83,18.4698795180723,197,22,3,3
"23731","a447686b116415d0fb83f590d5d97ff7",51,51,14,25.5,51,0,1,1
"23732","a4494ba845729bce04ed274e38d666b3",82,66,81,7.08641975308642,82,0,2,3
"23733","a44a7739254d8401240c8d9aaf42494b",144,101,63,16,144,0,3,3
"23734","a44db31a1988cc8af34725bb4a37d99f",177,112,74,16.7432432432432,177,0,3,3
"23735","a45199e274b9964952f9c10b0e797d21",26,26,0,26,26,0,1,2
"23736","a4519d600d56026df48095093ca9ba59",97,61,81,8.38271604938272,71,26,2,1
"23737","a452b9065df2a56006c60fe534558a77",32,32,0,32,0,32,1,2
"23738","a45321fcd4944dccdc76e1538c0c09c2",54,54,0,54,0,54,1,2
"23739","a45596add5043255dde5c93d6da0fec6",22,22,0,22,0,22,1,2
"23740","a456811500618c228662cef3fcf06cf8",47,37,8,41.125,47,0,1,2
"23741","a4585568830368234629161990da2d3a",50,35,7,50,50,0,1,2
"23742","a459914e26e70b9acee8949c7885e3d4",207,103,65,22.2923076923077,173,34,3,3
"23743","a459ea652c039673dddaf9f9a47c9a5a",179,86,71,17.6478873239437,179,0,3,3
"23744","a45a2d290729bea08a5c96dfa9e22366",158,71,73,15.1506849315068,158,0,3,3
"23745","a45fac58255df20c2bae9f380c7d8e44",135,52,78,12.1153846153846,114,21,3,3
"23746","a4608506b1865fe408ac95d7e0a3e405",13,13,0,13,13,0,1,2
"23747","a460ba40022ed0049e9f16f70d3a1c31",69,53,34,14.2058823529412,69,0,2,1
"23748","a463eb2a9b87b777e191e73bc6a701b5",29,26,48,4.22916666666667,29,0,2,1
"23749","a464aa705c2380050345b3d731962bc4",112,86,38,20.6315789473684,85,27,3,3
"23750","a465285ee20dcf9c1f96400ec5c1f1af",85,71,37,16.0810810810811,85,0,2,3
"23751","a465c28a1d16d2ddffbf14480ac6f904",21,21,0,21,21,0,1,2
"23752","a466e51959eaa63f34e7bd8ce3c5b7da",110,80,59,13.0508474576271,110,0,3,3
"23753","a46946afd135ee4d8e08a131a491555e",85,65,43,13.8372093023256,85,0,2,3
"23754","a46a94f73232d57644d9909c7a2e53d6",22,22,0,22,22,0,1,2
"23755","a46bd0557214ddb0961450372d9c1a61",15,15,13,8.07692307692308,15,0,1,1
"23756","a46d45f45b3a716212554e22562287e7",99,43,61,11.3606557377049,99,0,2,3
"23757","a4703bb994aeb51f86a279408e80aec4",40,30,67,4.17910447761194,40,0,2,1
"23758","a4714380570ccdee91cc702e0adf18f6",127,56,68,13.0735294117647,127,0,3,3
"23759","a4716059e292a3341d531358ef6b747c",34,34,0,34,34,0,1,2
"23760","a472f58186273779c798886498cbe8df",206,138,61,23.6393442622951,206,0,3,3
"23761","a479684190dba18bfa0ddfebea4c5c58",26,26,0,26,26,0,1,2
"23762","a481844b3c811943078a0758786a4ad5",19,19,0,19,19,0,1,2
"23763","a483af3694f2d6f3bb39c277640b31dc",101,67,58,12.1896551724138,101,0,2,3
"23764","a484cc326b4f220366755dceb7a2a717",147,90,76,13.5394736842105,147,0,3,3
"23765","a488326986c639dbaf60b92626155643",36,36,0,36,0,36,1,2
"23766","a488752f1f27852c9b2be99d00fc88c8",23,23,0,23,23,0,1,2
"23767","a488a91ab08dd3e3927f76496108b6ad",45,45,0,45,45,0,1,2
"23768","a48c30b001ac5317cdab9780be84e601",95,51,45,14.7777777777778,66,29,2,1
"23769","a48fb24aefe1ffc742e8532bab4fc845",22,22,0,22,22,0,1,2
"23770","a492797b4f9e891677a04d98122a432a",128,69,70,12.8,128,0,3,3
"23771","a495c1d57bedb5e7aca8a45f67e418e5",70,25,11,44.5454545454545,70,0,1,2
"23772","a4968878ba9b255c1b91959f2dfd17da",45,45,0,45,45,0,1,2
"23773","a496eeb1da9e1bfa88f65b91bd74b683",53,20,76,4.88157894736842,53,0,2,1
"23774","a49773628838e15fc20ad266dc07d10a",207,74,77,18.8181818181818,207,0,3,3
"23775","a4996fd51b242365012c4b9346e895f6",53,44,21,17.6666666666667,53,0,1,1
"23776","a499d60191fb50cac99dd685b7bab1e7",49,49,0,49,49,0,1,2
"23777","a49a8854aac8692061860db353954415",56,42,63,6.22222222222222,56,0,2,1
"23778","a49a9b29cf53a15679b86e869fe6f339",40,31,53,5.28301886792453,40,0,2,1
"23779","a49cf670878ec67c654b5c5c5867e895",2,2,0,2,2,0,1,2
"23780","a49ed5018ef68633fe8e58dc7ff1b711",30,30,0,30,0,30,1,2
"23781","a49f85ae9b04e890ba67f8931cee67af",40,39,13,21.5384615384615,40,0,1,1
"23782","a4a025037abc100b1213ce1c99e5e79c",24,24,0,24,24,0,1,2
"23783","a4a43d8ad0a174f0a21bd04b871ea8f1",112,87,43,18.2325581395349,112,0,3,3
"23784","a4a67f3eea523591cc1a0aabd081e69b",69,35,88,5.48863636363636,47,22,2,1
"23785","a4aa7816d437b4c89f3992ecc86dff15",121,76,52,16.2884615384615,79,42,3,3
"23786","a4aac05c0e7fa10dc9d000d91070c8a0",172,38,84,14.3333333333333,172,0,3,3
"23787","a4ab3bb7c5c84c95b1081716dd2951f5",24,24,0,24,24,0,1,2
"23788","a4ac32929b4834c7a953b86272295979",16,5,63,1.77777777777778,16,0,2,1
"23789","a4b1aa1493a6edc99ed7add22084ac36",22,22,0,22,22,0,1,2
"23790","a4b324c068e75611a70b587bd6d63f49",38,31,36,7.38888888888889,38,0,2,1
"23791","a4b40ea07d99b4019accb1e82fccc65f",132,91,53,17.4339622641509,82,50,3,3
"23792","a4b4f3f14de5dcc3a43245803a2a9585",28,28,0,28,0,28,1,2
"23793","a4b584ad062f3b3fdbf2a9f5072db8e2",163,124,71,16.0704225352113,117,46,3,3
"23794","a4b587ff21293ee52ffe2b81712c318d",33,33,0,33,33,0,1,2
"23795","a4b5b6ed5e4f38057c0ab1db3e6e42c3",154,102,73,14.7671232876712,120,34,3,3
"23796","a4b741b9d2c798e3ea2ba98120f73fd4",19,19,0,19,19,0,1,2
"23797","a4b7dd019ac4a33901af3b2a1024816f",135,64,57,16.5789473684211,135,0,3,3
"23798","a4b8ef880a6192a82756f9764b3bdafb",137,90,49,19.5714285714286,137,0,3,3
"23799","a4ba413fe1a36996bf922a4db8f083a4",62,41,42,10.3333333333333,62,0,2,1
"23800","a4bd7c0818ae988e23cdb1761fc8fb21",22,22,0,22,0,22,1,2
"23801","a4c14ad9295ec7a55a8b2ed0e0c809f3",17,17,0,17,17,0,1,2
"23802","a4c1abbc602a0983f437d6b1aab9a292",114,80,70,11.4,98,16,3,1
"23803","a4c73899a4ac0d93c79f265d3690fba8",46,44,64,5.03125,46,0,2,1
"23804","a4c9f27f7422d612adce25905186da12",50,44,11,31.8181818181818,21,29,1,2
"23805","a4cb1ed26ce5c8427b0a4faaf49fdd6a",22,22,0,22,22,0,1,2
"23806","a4cf9c1d3c80e8c7c7b002a42e6f5241",58,48,58,7,58,0,2,1
"23807","a4d0bb782fb443f6ec5cfd3a00316ed7",188,99,66,19.9393939393939,188,0,3,3
"23808","a4d0c0bb5d1774abc6f8d5d0ad8240d2",263,113,63,29.2222222222222,210,53,3,3
"23809","a4d119160bf5f6b4f66a69d1f8a82f4e",33,33,0,33,33,0,1,2
"23810","a4d170dc5c61e663d3262700f87f006b",28,26,33,5.93939393939394,28,0,2,1
"23811","a4d279f7788ccc0475394422a226831d",39,39,0,39,39,0,1,2
"23812","a4d753ea92da4f76b4cf6392d5e2e190",21,21,0,21,21,0,1,2
"23813","a4d9c27d9f1ea5e3feb6fa0e3e2925ec",21,21,0,21,0,21,1,2
"23814","a4dd1f534d788a5ac21cc5663bd5e039",18,18,0,18,0,18,1,2
"23815","a4dd5e324e2f48d116a1b7c57bbaa55e",117,61,65,12.6,87,30,3,1
"23816","a4e169adb5fe49024847109661e25cef",66,53,78,5.92307692307692,30,36,2,1
"23817","a4e2fa73ab08b222b9248bb259a46cfc",62,53,29,14.9655172413793,62,0,2,1
"23818","a4e8a84b3c98c145b92bb4e35da2915b",43,43,0,43,43,0,1,2
"23819","a4eb1c889b9ec171f4d9754442832125",165,51,81,14.2592592592593,144,21,3,3
"23820","a4edb73021b27104b36dd3e3f94f8852",65,48,49,9.28571428571429,65,0,2,3
"23821","a4ee5c240f559bf83051ba8cda3e3247",90,49,46,13.695652173913,90,0,2,3
"23822","a4eebf9b91eaf0273bd6eb1454e21758",68,58,62,7.67741935483871,34,34,2,1
"23823","a4eebfbc17c249f2a1ca8cfb6ad69040",82,52,57,10.0701754385965,82,0,2,3
"23824","a4eed3374f2b8cf62fcab939c8403583",242,90,71,23.8591549295775,210,32,3,3
"23825","a4f0175f84846a60d6529d54426aae82",81,58,33,17.1818181818182,81,0,2,1
"23826","a4f0b6d773b9cba6be0eeab8ec8544d7",27,27,0,27,0,27,1,2
"23827","a4f1a604bf213a71c79795c9dc295e8f",11,11,0,11,11,0,1,2
"23828","a4f2890fa598287afa53c4d85bb3eec7",18,18,0,18,18,0,1,2
"23829","a4f417d7b3d8109ec76975a1cd3aa461",41,41,0,41,41,0,1,2
"23830","a4f5576e50a9b7f632a46f90fa3d076e",154,88,37,29.1351351351351,115,39,3,3
"23831","a4f5cabefeed29d7e162c18713522679",29,29,0,29,29,0,1,2
"23832","a4f77ad260ff256d610414b684201990",45,37,83,3.79518072289157,18,27,2,1
"23833","a4f7aec29bd9adfb531d1d1642f8e2f1",141,84,61,16.1803278688525,99,42,3,3
"23834","a4fb36215675fa811f499a5ea239109d",41,30,28,10.25,0,41,2,1
"23835","a4fb4f878d5fe59a3a51d49ad19e0773",203,81,79,17.9873417721519,170,33,3,3
"23836","a4fc65104aa9c5217c3e88e986574e26",47,47,0,47,47,0,1,2
"23837","a4ff4f21cd48e2ca512d61e0408c35b0",33,33,0,33,33,0,1,2
"23838","a5000a386daf9fc26294eb80d312ca59",23,23,0,23,23,0,1,2
"23839","a504a71ab10daa34eb8cb67800bf20e7",133,41,70,13.3,133,0,3,3
"23840","a504b414d141076620abeb62c83ddbb5",117,82,43,19.046511627907,117,0,3,3
"23841","a5061ef7def21b754170d71bec8782fc",43,43,0,43,43,0,1,2
"23842","a5074db823dfe83ecb55977bbd89ffc8",140,88,82,11.9512195121951,140,0,3,3
"23843","a509ff5858393c43def4d5e0038d5040",90,72,29,21.7241379310345,90,0,2,3
"23844","a50a0f8c049794ae55a089aa8a2ec921",88,66,31,19.8709677419355,39,49,2,1
"23845","a50b3782f96380f35fd79e92d84ef0e3",20,20,0,20,20,0,1,2
"23846","a50bba1901cfdc1d8a34c6a25e93a836",163,96,61,18.7049180327869,110,53,3,3
"23847","a50dc0abffacae55411732b1a62ece52",28,28,0,28,28,0,1,2
"23848","a50fed4f0ae1f126cc89f8561f3eef2e",50,38,69,5.07246376811594,50,0,2,1
"23849","a50ff83708e731efbcfe311e0864f79a",30,30,0,30,0,30,1,2
"23850","a512698bbaed6706fec8ebe054eda111",19,19,0,19,19,0,1,2
"23851","a512ea13439ed455ad7c99bf93b05a57",57,46,26,15.3461538461538,23,34,2,1
"23852","a51315681f8057ceffabcedb1518c9a8",103,52,76,9.48684210526316,103,0,2,3
"23853","a517446c46bf6eac1a42f3df18a6a4bd",15,15,0,15,15,0,1,2
"23854","a51813ae642fbdb7a66969cec893fa73",16,16,0,16,16,0,1,2
"23855","a518b3b41a438d493a727bd30f1efa98",21,21,0,21,21,0,1,2
"23856","a51995c0efeede2639c6abb89b088dcf",30,30,0,30,30,0,1,2
"23857","a51cdb73d904990c61712865f2e9d2ca",45,45,0,45,45,0,1,2
"23858","a51cefa714222a7e26c2e0d86f5e635f",19,19,0,19,19,0,1,2
"23859","a51e24ab7d9ec54239f2a724d1852297",142,97,85,11.6941176470588,142,0,3,3
"23860","a51e8575d09170930fd0cfad2fa792f2",34,34,0,34,34,0,1,2
"23861","a51f140a746669bbe8fa01ff35e3e040",66,59,16,28.875,66,0,1,2
"23862","a51f8c5df06a1981509cee6d51f3464b",37,37,0,37,37,0,1,2
"23863","a52341f26835bffcc35a4f8f5c5c93b8",28,28,0,28,28,0,1,2
"23864","a5246f2e63e3601d005e75f679bdfdf6",83,52,74,7.85135135135135,71,12,2,1
"23865","a52663ad52f9cf5ac272d5430b5c286f",95,78,69,9.63768115942029,69,26,2,1
"23866","a5269d9e803bfe057fca7b0a9e47ee46",82,41,51,11.2549019607843,82,0,2,3
"23867","a527baef40f4ab83a0eeb077bf753e3c",45,36,41,7.68292682926829,45,0,2,1
"23868","a52a2f4732e2ac327e57e6192c7b2813",28,28,0,28,28,0,1,2
"23869","a52de90ac49cf75cc98d37ddab67377c",44,44,0,44,44,0,1,2
"23870","a53003358671bc49f348b7848ce2c6f6",26,24,40,4.55,9,17,2,1
"23871","a5301ab5f87880b25359da5ad9e2c8fa",36,36,0,36,36,0,1,2
"23872","a53778f14fa69bc3363105f2ddfa9e52",167,98,79,14.7974683544304,123,44,3,3
"23873","a53f1de5aed6a0c8cdb56aec8f507bfa",158,92,62,17.8387096774194,158,0,3,3
"23874","a54846a5ed9471d925588db3a468baa1",44,34,61,5.04918032786885,18,26,2,1
"23875","a548980dfe3b50f79f5e3572baeb9561",65,32,56,8.125,50,15,2,1
"23876","a54dc4bc29d1c1a2b1e3a76f6b8ba639",49,49,0,49,49,0,1,2
"23877","a54e5b17ff4971203298ec50dc8768dd",86,55,37,16.2702702702703,86,0,2,1
"23878","a550c140515c681c9511740141d3756a",74,30,63,8.22222222222222,74,0,2,3
"23879","a5514bc43c1c2176167de1d119a167bd",23,23,0,23,0,23,1,2
"23880","a55453d55b63c88dc130b6bcea932530",69,59,67,7.2089552238806,69,0,2,3
"23881","a5573fda439a62c0d005f7f076fda5c2",6,6,0,6,6,0,1,2
"23882","a558fdb02a0c4535b087ef9995a75439",135,87,29,32.5862068965517,135,0,3,3
"23883","a55a780273e62517fb7e8dee3cec5ecd",68,51,39,12.2051282051282,33,35,2,1
"23884","a55acf8a480d19749531708d26244580",43,36,30,10.0333333333333,24,19,2,1
"23885","a55eddb25b2536dc894540ee25a89fb7",68,44,28,17,67,1,2,1
"23886","a55f242bbbee516443918c6df7eea101",31,31,0,31,31,0,1,2
"23887","a560b59087dce9d6e5fe241324995e02",19,15,40,3.325,19,0,2,1
"23888","a560ff23e300ec8d372f61ae83819f0a",25,25,0,25,25,0,1,2
"23889","a56446b7000119647986d5cabe3b2c2b",44,44,0,44,44,0,1,2
"23890","a5654caf5ead5b10eac296882ff46456",21,21,0,21,21,0,1,2
"23891","a5665c9f6b845828ebc2c0681cfe7cc3",123,79,50,17.22,123,0,3,3
"23892","a5669d5eb1f86c13f616e3431d91f8b6",31,31,0,31,0,31,1,2
"23893","a5671931c67a05ac022e19c6cbc3011b",47,47,0,47,0,47,1,2
"23894","a568a22488a8bf61ce69a6a453d64493",29,29,0,29,29,0,1,2
"23895","a56a5734167bd22b8ef5ebaf89d7a319",184,82,88,14.6363636363636,184,0,3,3
"23896","a56bfa237e7d7726bfc27018d4b0033a",66,56,17,27.1764705882353,31,35,1,1
"23897","a56d4825cc44b585db7b1c54d8daf3ed",55,44,51,7.54901960784314,55,0,2,1
"23898","a56e1d0c58d0260b84826a143bcc105c",14,14,0,14,14,0,1,2
"23899","a56eeca3e99570f55ee23c9d0c84befb",53,53,0,53,53,0,1,2
"23900","a5702a86fa35a7ebe1b410427140cf70",25,25,0,25,25,0,1,2
"23901","a571d7fa9b305f298e9bd0f139f6ab28",27,27,0,27,0,27,1,2
"23902","a573fa3347d4269c8d8c60f86756dcb8",35,35,0,35,35,0,1,2
"23903","a5746fb39a741bf33eaeb30d7167daf1",95,73,36,18.4722222222222,50,45,2,3
"23904","a5778e6085d6e4f3c3a6baa0d6b77ad7",32,24,21,10.6666666666667,32,0,1,1
"23905","a5789d6b98c59192b7f592d498b3a5d1",10,10,0,10,10,0,1,2
"23906","a57938025d714b65612bf2cfde12136d",70,54,46,10.6521739130435,26,44,2,1
"23907","a57fde13a7c1631f73949e5af07d8fe2",30,30,0,30,0,30,1,2
"23908","a5801e6252fbdc1ab588821436d50e7e",83,35,88,6.60227272727273,59,24,2,1
"23909","a5844568701bc1694d2299c21a560428",177,109,63,19.6666666666667,147,30,3,3
"23910","a58585959a9d5a80a4c59766a92d13f9",33,30,18,12.8333333333333,11,22,1,1
"23911","a58720bdd3b811d8ad7be4c868992060",191,130,49,27.2857142857143,191,0,3,3
"23912","a58aa95a3c2d77f5a276524d456f5dfa",43,40,32,9.40625,43,0,2,1
"23913","a58d189818e2cf02549e0970e2d8011b",173,94,58,20.8793103448276,173,0,3,3
"23914","a58f6c15900f64ec5f8e27ee9fe7e60c",104,67,54,13.4814814814815,104,0,3,3
"23915","a593b2b1d8d4eb9cf19fc524bbcf6a5c",117,84,83,9.86746987951807,117,0,3,3
"23916","a5941e2fb1ea658d4e694f436a40a070",46,38,45,7.15555555555556,46,0,2,1
"23917","a594d926bf0b03b902dc9c32ae3eeb3a",27,27,0,27,27,0,1,2
"23918","a595e14cabc96f3e0deabbfcd0daec38",15,12,10,10.5,15,0,1,2
"23919","a5994200f8b73d48c3bd940ef73f3323",37,37,0,37,37,0,1,2
"23920","a599954fd306a9e3013f7329d6278b91",68,53,49,9.71428571428571,68,0,2,3
"23921","a59bf7b54b747729f2843ba52730916d",79,56,56,9.875,79,0,2,3
"23922","a59fef8e43092b568adb43de9288cd45",28,23,39,5.02564102564103,8,20,2,1
"23923","a5a2cdb13ab0e4bcfa3b15726ffbd06d",92,63,53,12.1509433962264,92,0,2,3
"23924","a5a334228e1e0b3032dcb6da612aee5d",76,61,21,25.3333333333333,76,0,2,2
"23925","a5a344dc8b63cf83291bb3872d824dbd",28,28,0,28,28,0,1,2
"23926","a5a36259fc24dae44c4734e4cd461189",26,26,0,26,26,0,1,2
"23927","a5a3aed492f746a475e34bfe61ed5b31",168,105,46,25.5652173913043,168,0,3,3
"23928","a5a68f4580cf6bd60b52b4a16ae13d2c",34,34,0,34,34,0,1,2
"23929","a5a91fd0b522c1027f1fa3dbc5967388",98,78,68,10.0882352941176,48,50,2,3
"23930","a5aa9c50b8bc8775d1b27f16c4b58093",29,29,0,29,29,0,1,2
"23931","a5ad75832ac58ff1c7ef360b8cc247c4",66,54,37,12.4864864864865,33,33,2,1
"23932","a5ae2a0ef24073069df00a3ac49e07af",48,38,26,12.9230769230769,48,0,2,1
"23933","a5aee03362c66b8f4f6124ae4de01398",29,29,0,29,29,0,1,2
"23934","a5b194ad9ef5afb1719436de657e6422",47,26,71,4.63380281690141,47,0,2,1
"23935","a5b28b072ff451509065a348616d24ed",110,84,84,9.16666666666667,110,0,3,3
"23936","a5b31c745171fe6fbbbaac8e98c132c1",27,27,0,27,27,0,1,2
"23937","a5b435587067ca19c42010496ba443a0",38,38,0,38,38,0,1,2
"23938","a5b7020baa87e8517c5e808f35efaa7a",51,24,64,5.578125,51,0,2,1
"23939","a5b7bc3bf4297b9601da4083ae9eb36c",30,30,0,30,30,0,1,2
"23940","a5b8e8f4723503c285b8c79cb12bdb75",92,37,70,9.2,79,13,2,1
"23941","a5ba3efe1203f47594af60dea3708c98",47,42,36,9.13888888888889,47,0,2,1
"23942","a5bc7fe3177c726e232549e04c6f6616",29,29,0,29,0,29,1,2
"23943","a5c016be8610f5528a7ae3fb84c62ff3",37,37,0,37,37,0,1,2
"23944","a5c0927dbce710b02eac666583c299d8",94,72,79,8.32911392405063,94,0,2,3
"23945","a5c0aeacdb9a749bbff7760632bd5360",34,31,62,3.83870967741935,34,0,2,1
"23946","a5c0e86d01a90cdd6b50a367112648e5",21,21,0,21,21,0,1,2
"23947","a5c1edd1ad08e004c4f915d388d233d2",29,29,0,29,29,0,1,2
"23948","a5c410ba2f4e43f5627e3975bf9a3532",88,70,55,11.2,88,0,2,3
"23949","a5c5958f407e86f65f69abfee3446849",194,113,59,23.0169491525424,194,0,3,3
"23950","a5c5ad739a7f5b661b27f9cfd132d4fe",37,29,21,12.3333333333333,37,0,1,1
"23951","a5c7018e5995b9f9fed5943e0b1d09d0",97,73,36,18.8611111111111,97,0,3,3
"23952","a5c7de14b8fd743dcf75dce9cc51ce82",17,17,0,17,17,0,1,2
"23953","a5c898cf87ae9a67c7f14dbf1381a077",125,59,59,14.8305084745763,87,38,3,3
"23954","a5c9c0ad590a51fa9b3c2b37e3aa6fbe",25,20,29,6.03448275862069,25,0,2,1
"23955","a5c9d42519d608080ff12a0263d3f9de",30,30,26,8.07692307692308,30,0,2,1
"23956","a5ca38f51d07b7e31e18125d36916d6e",20,20,0,20,20,0,1,2
"23957","a5cc15f55ec263a06bf704d8049190c1",12,12,0,12,12,0,1,2
"23958","a5ce81c8304e122987e5dc74f7ff8bb9",26,26,0,26,26,0,1,2
"23959","a5d04f34b06cc09951fa86948b18c35a",47,47,0,47,47,0,1,2
"23960","a5d365a63f8a8752f2852e720d3436de",41,41,0,41,41,0,1,2
"23961","a5d4b77eccb8af8330a8e4a1a58d76f2",14,8,63,1.55555555555556,14,0,2,1
"23962","a5d819353edd57d0c526f27a17cbcc39",96,56,64,10.5,96,0,2,3
"23963","a5d880b15114864a3389dc9cd68b18e8",165,105,74,15.6081081081081,165,0,3,3
"23964","a5d8f7682e1554b6d8e3f06c9baafc8f",144,90,64,15.75,104,40,3,3
"23965","a5d91e2d7069f56bac58002923d1bf93",27,27,0,27,27,0,1,2
"23966","a5d94096b0a0f6a38fc4c7e556058c25",70,66,63,7.77777777777778,70,0,2,3
"23967","a5d9997016d6b296a660dcd96b42913e",89,50,54,11.537037037037,64,25,2,1
"23968","a5ddadc383c38c64c40413674e537daa",70,57,47,10.4255319148936,70,0,2,3
"23969","a5def00dac54bef4217d34730f4320f1",184,105,84,15.3333333333333,157,27,3,3
"23970","a5dff36b9c493500cbb1c94ec972b44b",16,16,0,16,16,0,1,2
"23971","a5ec4ea8e95cd23e0bd6b91b9837839d",121,80,48,17.6458333333333,107,14,3,1
"23972","a5ecf26d7319c70ba1749ee9f1710ca2",18,18,0,18,18,0,1,2
"23973","a5efd9437d3394a96f1816808b528237",206,107,66,21.8484848484848,157,49,3,3
"23974","a5f6b72a2e2aaf6393f18da06b1fb12c",11,11,0,11,11,0,1,2
"23975","a5f988794c1793a845e1cb4162b5a2dd",76,39,67,7.94029850746269,76,0,2,3
"23976","a5fa3ff736103132676fdc3a041d8bb4",34,27,49,4.85714285714286,34,0,2,1
"23977","a5fac428254d35f74be922e89551d37e",71,47,67,7.41791044776119,71,0,2,3
"23978","a5fb72b6f83eb459977046edd04ec5e9",22,22,0,22,22,0,1,2
"23979","a5fba27070f4a094779c570b7b5792fc",52,52,0,52,52,0,1,2
"23980","a5fbd501c7ebb8e55030135c9b2df185",89,59,78,7.98717948717949,89,0,2,3
"23981","a5fc290bacce85a2e5b010f7a583a5b6",109,47,78,9.78205128205128,66,43,2,3
"23982","a5ffe5b15044749f92604f6a00ced6ae",93,58,43,15.1395348837209,71,22,2,1
"23983","a60035522811577faf2002da30081ce1",31,31,0,31,31,0,1,2
"23984","a60315a43de05cff1f3d2fd1f7c84bd4",79,70,61,9.0655737704918,65,14,2,1
"23985","a60569b887f1ae4f807ccad9a8f344e7",22,22,0,22,22,0,1,2
"23986","a6069ebaf58c8b93933bee0d88e2dd03",5,5,0,5,5,0,1,2
"23987","a606ccfc7a0e3dcc3ee1e05a0d76610e",31,31,0,31,31,0,1,2
"23988","a607452c02ef3f921d4b3e69630a6687",128,87,78,11.4871794871795,128,0,3,3
"23989","a60ad9e9cfd7ed9405cdee958912c5a6",15,15,0,15,0,15,1,2
"23990","a60baac7cefcfb3f6aaceb64e7e1cdec",32,32,0,32,0,32,1,2
"23991","a60fde20f5bcfabf856734d8b67fec4d",69,65,36,13.4166666666667,69,0,2,3
"23992","a61193c6d19964c61473332d2b22cb69",7,7,0,7,7,0,1,2
"23993","a61504ee97aad3967d16c88ca10e71e7",36,36,0,36,36,0,1,2
"23994","a619b9cc4b29124b5df22916c6a8ff33",26,23,54,3.37037037037037,26,0,2,1
"23995","a61b3827058b05137368749a9a4c7522",43,43,0,43,43,0,1,2
"23996","a61b642fa403c5a096eebc6aa42015bf",17,17,0,17,17,0,1,2
"23997","a61b845e87157133b33cb9b6344fe4a9",54,54,0,54,54,0,1,2
"23998","a61cd48d6ffdcf6acd497def3843cb9a",48,42,37,9.08108108108108,24,24,2,1
"23999","a61cde800e08cce9099697f5c4dd30f5",45,45,0,45,45,0,1,2
"24000","a61cf9e8ff285632b863a35e7a81d5df",59,52,79,5.22784810126582,59,0,2,3
"24001","a61cfed92ea8344ada425d5bb0edf446",126,75,28,31.5,126,0,3,3
"24002","a61edd22c206fa80f381b8af23f9698a",71,50,58,8.56896551724138,30,41,2,1
"24003","a61f219aa0e83c3d47ff930b89e3abb4",48,48,0,48,48,0,1,2
"24004","a620b37dd12b19e62b1de21c5478b655",17,17,0,17,17,0,1,2
"24005","a6257c843a9ea9a6ae8ea2498cd63bfe",22,22,0,22,22,0,1,2
"24006","a62658a7105712f32d527327110bb890",136,82,84,11.3333333333333,107,29,3,3
"24007","a6285ddf5d32e7d007331e0ba2fd0a14",25,25,0,25,0,25,1,2
"24008","a629f06b7160e4a3b5768f5fe71d77eb",21,21,0,21,21,0,1,2
"24009","a62bfa07a37e454b495780b767063556",12,12,0,12,12,0,1,2
"24010","a62d523007f6f7f12683c8c1ef675adc",105,47,54,13.6111111111111,105,0,2,3
"24011","a62de72dd2ce3eaa4aebee91b32c4d0b",38,23,55,4.83636363636364,21,17,2,1
"24012","a62f12653ce397cdf1f8a89ae5ac8e0c",37,37,0,37,37,0,1,2
"24013","a63295736ea030dcbf559c4f9da07b53",40,40,0,40,40,0,1,2
"24014","a63491e71ac24510a331b446624c0821",156,109,56,19.5,156,0,3,3
"24015","a63e7442e50445c9fb93ec015cb3d62c",69,63,32,15.09375,69,0,2,1
"24016","a640c151193d58531be5ed18e2636015",40,40,0,40,40,0,1,2
"24017","a644415fb0647a7eb5a5f60a05621622",45,45,0,45,45,0,1,2
"24018","a6488f108aca00e94ca9cc3c96674d0c",117,73,80,10.2375,117,0,3,3
"24019","a64a4a3268ba23f9bbf0139495430390",10,10,0,10,10,0,1,2
"24020","a64c7698200f199bd4e004cd3027eeb4",107,79,65,11.5230769230769,107,0,3,3
"24021","a64ec3dabb4ea998edda03773096dc10",19,19,0,19,0,19,1,2
"24022","a651330daa9d5153a2076e963064aeb3",14,11,54,1.81481481481481,14,0,2,1
"24023","a653960247dc3a6f8f0a589ce24df9e1",40,33,28,10,0,40,2,1
"24024","a653aa100422787daa2a374ddb588795",114,87,87,9.17241379310345,114,0,3,3
"24025","a6556dc1a52d7de2585e97d2475900ab",19,15,22,6.04545454545455,12,7,2,1
"24026","a657687b2177a737ab451865b141d625",160,82,67,16.7164179104478,160,0,3,3
"24027","a65b0e9f4eb7168ad1c7cb8dac96f6fd",26,26,0,26,26,0,1,2
"24028","a65cdbd80d5a078ae1b5c20c7c3a1bbb",118,79,61,13.5409836065574,118,0,3,3
"24029","a65f2e728ec15d7a79e6119c3c9197de",55,38,49,7.85714285714286,55,0,2,1
"24030","a65f631da72a99e86fb2f145527b3d75",78,64,60,9.1,78,0,2,3
"24031","a65f911d74a4a05f4a6ac61986250429",46,46,0,46,46,0,1,2
"24032","a66103a599d361046f098e52a201dbb3",19,19,0,19,19,0,1,2
"24033","a662049063244c5583d0b7771f2a77f7",16,16,0,16,16,0,1,2
"24034","a665320d7acfc63ab107f1a0c07acf8c",8,8,0,8,8,0,1,2
"24035","a66699563694d6a35addf616de93fac8",9,9,0,9,9,0,1,2
"24036","a6691b0d15117be3606ea5980ec65f67",40,40,0,40,40,0,1,2
"24037","a66a247ceffb0ae69067d7ee1ddd0865",1,1,0,1,1,0,1,2
"24038","a66ce823a32d9826f98d44d5ba64c38b",34,34,0,34,0,34,1,2
"24039","a66d33999aead2a5aabaceab114d24b4",54,46,38,9.94736842105263,54,0,2,1
"24040","a66ecad5fc85aa37f184e31a63025fa4",24,24,0,24,24,0,1,2
"24041","a66fb0126f8e6d7315b20f1b82864d82",22,22,0,22,22,0,1,2
"24042","a6707e754280837414275d63309976fd",38,23,69,3.85507246376812,38,0,2,1
"24043","a67258cd42896910978e900bccd96a97",138,103,49,19.7142857142857,138,0,3,3
"24044","a674751ae1a9abb760bcd39aac897e82",43,37,11,27.3636363636364,43,0,1,1
"24045","a6752436fd7a5a409d3773edfb7e3c5b",23,23,0,23,0,23,1,2
"24046","a676221d1820809bfc939c56675a051b",22,22,0,22,22,0,1,2
"24047","a6765738259b70a24ab57f096bea4f30",176,89,73,16.8767123287671,151,25,3,3
"24048","a676b8b9958b0b1a264cf7905b55669d",127,63,73,12.1780821917808,92,35,3,3
"24049","a67817e8962556dbab573fa5ab00031a",28,28,0,28,28,0,1,2
"24050","a67960ea4518e97be1fd5d2692f0df90",97,76,64,10.609375,97,0,3,3
"24051","a6798556e0b6ccae1040f3ca2beb9739",17,17,0,17,17,0,1,2
"24052","a67e024dbf4fefd4235751c17395a1c4",131,101,63,14.5555555555556,131,0,3,3
"24053","a6826bd1b7ce8328d6e709eb7ef34fcd",101,78,27,26.1851851851852,101,0,3,3
"24054","a686370bf82add52161a12c2f07b971a",47,47,0,47,47,0,1,2
"24055","a689cccf66367de5d342c516c2fc5273",2,2,0,2,2,0,1,2
"24056","a68a464139b8b529240e538bcc70e544",45,36,30,10.5,45,0,2,1
"24057","a68b60cc384b7a25a26c70ff47a84e08",20,20,0,20,20,0,1,2
"24058","a68d09ba484a43ae5c05d37a652fd9cc",22,22,0,22,22,0,1,2
"24059","a68e30e8fa777b6a8a259e166bd60d9c",73,52,81,6.30864197530864,58,15,2,1
"24060","a68e741ea9201147303f8e3ede17f263",105,66,57,12.8947368421053,105,0,3,3
"24061","a6915c911597abbaa90a62bed3ad5d5f",98,52,42,16.3333333333333,98,0,2,3
"24062","a696e3e7217fd0f7237d47a3192cd74e",14,14,0,14,0,14,1,2
"24063","a69986ff55a7a432a22a3ed8776289b4",85,65,45,13.2222222222222,85,0,2,3
"24064","a69af15bad35786262b236d594711fd0",112,90,70,11.2,112,0,3,3
"24065","a69d9531bce96571e6ae4678051e8c47",107,81,63,11.8888888888889,55,52,3,3
"24066","a69f8a04d0782df2e662dfe2403ad8ca",51,19,63,5.66666666666667,51,0,2,1
"24067","a6a03d5c7131d5ac9898e4c059447113",28,28,0,28,28,0,1,2
"24068","a6a0463a8ab2c2a4d2cdd243035a5a28",38,38,0,38,38,0,1,2
"24069","a6a1c1833f11d499e6672040f65b1925",40,40,0,40,40,0,1,2
"24070","a6a4127cc728866878624e664e70aa26",15,15,0,15,15,0,1,2
"24071","a6a470921f45e2e6d5b8ad900de4ff30",42,42,0,42,42,0,1,2
"24072","a6a6adaf54bf7b1a4f74deeadb1e8691",115,75,78,10.3205128205128,115,0,3,3
"24073","a6a894e188c31600698728748f8a9227",24,24,0,24,24,0,1,2
"24074","a6aab2e82a90d4b1d5535e41edb622c1",181,84,56,22.625,181,0,3,3
"24075","a6abe1c012f8fa5c9d57757a78518045",6,6,0,6,6,0,1,2
"24076","a6ac278d27f6a9ca431ca51e45d25da1",21,21,0,21,21,0,1,2
"24077","a6ad2febcd1d8be5fe097438eb7ac613",24,24,0,24,0,24,1,2
"24078","a6ad33957e294602bbbaafd682999292",31,31,41,5.29268292682927,31,0,2,1
"24079","a6af2d0b86eb069c394b375d08af2d63",105,83,62,11.8548387096774,105,0,3,3
"24080","a6afb0945e6d2eab8365540b96ca1c27",15,15,0,15,15,0,1,2
"24081","a6b02a1a0d8a99f03cb86f74989f3184",155,62,82,13.2317073170732,155,0,3,3
"24082","a6b2086e82f5965bafe28ada8b2e791b",11,11,0,11,11,0,1,2
"24083","a6b25668fe827c2d2af9a3421fe3bf3b",89,77,25,24.92,89,0,2,3
"24084","a6b4edd14922c7ffe733763b3d501a69",83,54,56,10.375,83,0,2,3
"24085","a6b5c172e0c7befe7c5fb23ee7ac5d60",161,80,89,12.6629213483146,124,37,3,3
"24086","a6b6bbb54d9d11ede21a8ad400952a1a",149,92,75,13.9066666666667,107,42,3,3
"24087","a6b94137d7499032f856aa22ad7ca082",37,37,0,37,0,37,1,2
"24088","a6be9b61e19a6efb2a9a1b14f2e85af7",1,1,0,1,1,0,1,2
"24089","a6c08ac2308dd7dd88398a00e3d1c03d",39,31,59,4.6271186440678,18,21,2,1
"24090","a6c6b5719ca547e8402ed34a54285be2",153,108,43,24.906976744186,153,0,3,3
"24091","a6c6cb38592ad803a69201fcadbbd33f",59,38,61,6.77049180327869,31,28,2,1
"24092","a6c9e214ac9b5b5ca74c081c37c1a040",16,16,0,16,16,0,1,2
"24093","a6cb81126303fcc130c61dcf9cb9b203",193,108,88,15.3522727272727,147,46,3,3
"24094","a6cc5206dc3865f8beb214a7768772f8",42,42,0,42,0,42,1,2
"24095","a6d32db7d6b0148c08da846ea627655e",124,84,81,10.716049382716,96,28,3,3
"24096","a6d5914aecc12366e1f6b5fa4e3dfba0",28,18,34,5.76470588235294,28,0,2,1
"24097","a6d62a54deba198dd1ea170fa0c4b37c",146,83,73,14,146,0,3,3
"24098","a6d8e1a1606427a479cb7c83a28c1a90",25,25,0,25,0,25,1,2
"24099","a6d8ed14d3b4ba410100a0509cf310f5",160,84,84,13.3333333333333,124,36,3,3
"24100","a6dac9130d48af4e7962ae21eb6e5de0",222,101,64,24.28125,172,50,3,3
"24101","a6dcc9c71ee3f0ccbde2a6308698eb17",27,12,81,2.33333333333333,27,0,2,1
"24102","a6dced6e1c3a843b1577757ffdb54f56",88,54,77,8,88,0,2,3
"24103","a6de9ec869f758e6facf780db241bb43",14,14,0,14,14,0,1,2
"24104","a6deaa8969a1ff064eee2294a529dab6",127,51,56,15.875,110,17,3,1
"24105","a6deca10c1d977589636312d4cb59908",50,45,54,6.48148148148148,50,0,2,1
"24106","a6e0c847b947fe9beb8d739647774abf",230,131,49,32.8571428571429,197,33,3,3
"24107","a6e1b18357d81e5e136128c21e5400f6",91,78,52,12.25,91,0,2,3
"24108","a6e2361404ec1ba240b7f044486d771a",29,29,0,29,29,0,1,2
"24109","a6e35455b8813ab7e49245a1b7f19dd7",26,26,0,26,26,0,1,2
"24110","a6e386ce96849cd9285e4c83a93e4731",14,14,0,14,14,0,1,2
"24111","a6e4c9ea704967a4b6500092fd69d40b",61,45,42,10.1666666666667,61,0,2,1
"24112","a6e7dce8fbac54f3f292eff699bc3460",24,24,0,24,24,0,1,2
"24113","a6e9af5b46d6bff36640739366aa42ae",26,26,0,26,26,0,1,2
"24114","a6eca72f2d044de74df58ef7ce30daaf",74,62,78,6.64102564102564,48,26,2,1
"24115","a6ed52dc158285634e795a902738c01a",111,83,78,9.96153846153846,111,0,3,3
"24116","a6f04109b066c3975e9ee43a0d199660",112,81,77,10.1818181818182,112,0,3,3
"24117","a6f2d04f663e0f427730f20255af83d3",34,34,0,34,34,0,1,2
"24118","a6f599ccd0366243dd03ffc3989b8b42",80,75,62,9.03225806451613,80,0,2,3
"24119","a6f6375e68fbeb4a7fc9e522312d61d3",100,71,50,14,100,0,2,3
"24120","a6f9dfb1dae23de504ac77ed8621c177",44,41,48,6.41666666666667,44,0,2,1
"24121","a6fcca712d849122af5fd338676aa869",102,63,76,9.39473684210526,102,0,2,3
"24122","a7019a44d27408a400740200678eb566",55,52,64,6.015625,55,0,2,3
"24123","a70235b23901bf0f68aafc6cde73b83d",25,25,27,6.48148148148148,25,0,2,1
"24124","a702547a1154244ec7ec707a3ff392de",28,28,0,28,28,0,1,2
"24125","a7042dc1f7d633d91ff281233c1e4269",39,39,0,39,39,0,1,2
"24126","a70984d0672960ba132e101ae78a7445",31,21,40,5.425,16,15,2,1
"24127","a709fa18b35a1bc6fc9128848e0580de",1,1,0,1,1,0,1,2
"24128","a70b9c44e36629c139583f663b8952fb",65,53,30,15.1666666666667,65,0,2,1
"24129","a70f913b47d48b1bf33dcba6d9db1d30",26,26,0,26,26,0,1,2
"24130","a71022243e9621ac68ea57c7866bcbf8",167,126,61,19.1639344262295,167,0,3,3
"24131","a71364be54f5f0a27a8e45174e879138",113,78,57,13.8771929824561,113,0,3,3
"24132","a717257362ca7a352905237fa8b5020a",97,57,70,9.7,66,31,2,1
"24133","a71898a2131b5dc60e0ca69251c87d6c",53,53,0,53,53,0,1,2
"24134","a71a9323b269bee6f3fcef67ef152bd8",46,46,0,46,46,0,1,2
"24135","a71af27f251a87783b40eb62ff04215b",14,14,0,14,14,0,1,2
"24136","a720401a123610b7d5fa6c55ebf5a844",14,14,0,14,14,0,1,2
"24137","a721bbdbddfd1afd954d9c36dca50614",86,56,61,9.8688524590164,61,25,2,1
"24138","a725b2ad587f549bf338809e3b2e3ced",92,72,35,18.4,92,0,2,3
"24139","a7261d1377d195180a531fe94dcfa5b9",129,53,68,13.2794117647059,129,0,3,3
"24140","a726a3e33c31a39e81c803e81177e8f8",20,20,0,20,20,0,1,2
"24141","a7295d7e4f109a207c27e9425a2e6a3e",65,48,31,14.6774193548387,65,0,2,1
"24142","a73226b75fea6ed1a3a02ae2b4595eeb",64,48,47,9.53191489361702,64,0,2,3
"24143","a73324290c805728cb4598d8ec95ac41",8,8,0,8,8,0,1,2
"24144","a733ab1788e43b4bb0c7b22061b28b1d",178,102,80,15.575,178,0,3,3
"24145","a734a2725207034a7dbf9325cee64392",93,76,56,11.625,93,0,2,3
"24146","a737bf24b35725535be793269e500cb7",13,13,0,13,13,0,1,2
"24147","a73d4b9cd884d2bc510ab1e837d4b64f",8,6,39,1.43589743589744,8,0,2,1
"24148","a73db77875544b372e9e6f409c0e0099",20,20,0,20,20,0,1,2
"24149","a74065c167cf3a4f8e8621ba36659d39",23,23,0,23,23,0,1,2
"24150","a7448bbc6e2f730651267d3205cd325b",14,14,0,14,14,0,1,2
"24151","a74638d80849ddb4b20362939c003ce9",98,57,61,11.2459016393443,98,0,2,3
"24152","a7485d70e807fa0a9a813cd1a12525ef",44,36,28,11,44,0,2,1
"24153","a74bf8790bb815b9cd94b4323881f892",32,32,0,32,0,32,1,2
"24154","a74db64ad7a0cd45025ec6d62cac5827",177,125,70,17.7,126,51,3,3
"24155","a74f62ff9874062d21e8a7d8329f44ef",180,87,84,15,180,0,3,3
"24156","a75215ea5da37d3ef7a2180e676b6cf9",33,33,0,33,0,33,1,2
"24157","a7542f9ed9555abc83b5d1360ac09906",22,22,0,22,22,0,1,2
"24158","a755146fc12aa176801aac8b6f4d675d",152,122,62,17.1612903225806,152,0,3,3
"24159","a75a561277ed7cadaa4ee81bcaf3ec63",27,24,23,8.21739130434783,27,0,2,1
"24160","a75adf8c2b8e3d5dd3467596377d32ab",49,37,56,6.125,49,0,2,1
"24161","a75e3caefe9f2d0453cafcd6f11473d8",49,49,0,49,49,0,1,2
"24162","a760a79dab4f1497b714114e1ed8cfc6",67,54,70,6.7,67,0,2,3
"24163","a7614bb6a7d488edf5a37463b27b2e63",38,38,0,38,0,38,1,2
"24164","a765a8396ae163d800fddb02d5868376",55,45,37,10.4054054054054,55,0,2,1
"24165","a76728a392965ad38b9578d8fb4305c3",74,67,35,14.8,74,0,2,3
"24166","a768ac6617d953c09a10913586349766",60,39,54,7.77777777777778,60,0,2,1
"24167","a76c9f6d697cc378398006a451dccdd5",182,67,79,16.126582278481,161,21,3,3
"24168","a76ce61714ac17275579525ff33c8321",3,3,0,3,3,0,1,2
"24169","a76f179e35d9d405899a81df9ef07b94",84,59,62,9.48387096774193,84,0,2,3
"24170","a77151ae389139fd9a38b9e9d8cd1ee5",159,115,37,30.0810810810811,159,0,3,3
"24171","a772764eb890e9b8004f414b1682c64f",153,90,64,16.734375,153,0,3,3
"24172","a7736c1a7251776e30e938aface58bf7",29,29,0,29,29,0,1,2
"24173","a775ec4a18027522c811a45bd2f8eb37",57,48,83,4.80722891566265,57,0,2,1
"24174","a778b2515408067ac358db5f52880086",26,26,0,26,26,0,1,2
"24175","a778ca5112ee1f080da14c53d8cac6c2",2,2,0,2,0,2,1,2
"24176","a778f807d9a33efbc24d2706b70b3eb0",34,34,0,34,34,0,1,2
"24177","a77948172202450e2e8df4c9cda367db",71,53,21,23.6666666666667,71,0,1,1
"24178","a77a433eb20ca998de562994e6dc0c90",37,37,0,37,37,0,1,2
"24179","a77a6d6e94b1d182ea07bf8f32a2a8bc",72,56,52,9.69230769230769,72,0,2,3
"24180","a77b1da12c5e43b175671c2db339e067",6,6,0,6,0,6,1,2
"24181","a77f321a2727563e95ab9970fbaca74e",66,47,17,27.1764705882353,66,0,1,1
"24182","a785e658b48929094d530267cd9aba27",23,23,0,23,23,0,1,2
"24183","a7874d02bd1c1d3fc85a278d00c08406",19,19,0,19,19,0,1,2
"24184","a78b3bd302eb8e389ad8c31dd82a1e37",37,23,18,14.3888888888889,37,0,1,1
"24185","a78d1f9652d591f5099ae8fd577f3cbe",47,24,51,6.45098039215686,47,0,2,1
"24186","a78ddf802785e859e82b2a02c3f8f93a",95,43,72,9.23611111111111,70,25,2,1
"24187","a7900aa165f73d7df197f92c157e5c22",48,48,0,48,48,0,1,2
"24188","a79356892eff0c4324c9b8e535ba3438",116,66,74,10.972972972973,90,26,3,1
"24189","a7945126bfe672d09283d963ec686ca7",9,9,0,9,0,9,1,2
"24190","a7956e9cf75acbca88ba30b834bddcfe",12,9,42,2,12,0,2,1
"24191","a796c2e6b8ed7b793c9584e814163f90",60,53,39,10.7692307692308,49,11,2,1
"24192","a797a0f5694f30db88004af73876ec40",102,73,51,14,60,42,2,3
"24193","a79a159e6c3e083d6a85546352c751a7",29,23,57,3.56140350877193,29,0,2,1
"24194","a79a426a1f80c4bcfde48c175a61d52c",41,30,40,7.175,41,0,2,1
"24195","a79b217f28b81b9692815cf2ba9f6826",8,8,0,8,8,0,1,2
"24196","a79b9f98a59df3917040369e20759677",11,11,0,11,11,0,1,2
"24197","a79db74779dd2b1536b8d238ccd90821",207,105,71,20.4084507042254,207,0,3,3
"24198","a79fb6079755ef968ea19ad29cabfc8d",6,6,0,6,6,0,1,2
"24199","a7a112ea3d786e5adedb6c531e430119",70,60,56,8.75,70,0,2,3
"24200","a7a16279863c1cac2865051037081e7e",9,9,0,9,9,0,1,2
"24201","a7a46b61de70100eea5621b6b6d396e2",26,22,25,7.28,13,13,2,1
"24202","a7a4996564c0fd26e926381e44abde3f",79,60,38,14.5526315789474,61,18,2,1
"24203","a7a712e38e44e17b5623e543a5422f3b",17,17,0,17,0,17,1,2
"24204","a7a9b3827fe420722d12f8c5c7fca5b4",26,26,0,26,26,0,1,2
"24205","a7abd83fe4c2f95b8aa69c3d7549d8d4",85,69,27,22.037037037037,48,37,2,3
"24206","a7ad0155480c79c93189fabc1c47431a",47,40,14,23.5,0,47,1,1
"24207","a7afef6f279875d0fae54ef8094026c0",50,41,45,7.77777777777778,33,17,2,1
"24208","a7b17a9dc06e65e82cf9e7e30ef2391c",30,30,0,30,30,0,1,2
"24209","a7b184a4cb814a5312e0c6a956b8b112",35,35,0,35,35,0,1,2
"24210","a7b2c36bc7f67eaa02dff438818ebc05",51,40,77,4.63636363636364,35,16,2,1
"24211","a7b42eca45562e28db265ec6273d14d0",26,26,0,26,26,0,1,2
"24212","a7b52c3e9f39b92387278a90b8b99453",29,29,0,29,0,29,1,2
"24213","a7bbab74fcb9c6bc9fb71b267655caee",36,36,0,36,36,0,1,2
"24214","a7be17d7c35ee8cc827898f7e7ff8efd",198,140,59,23.4915254237288,198,0,3,3
"24215","a7be76b08958225fef88a8b2ba3ebaad",26,26,0,26,26,0,1,2
"24216","a7beba336b4cfd086d15a974df3d5019",7,7,0,7,7,0,1,2
"24217","a7c165d8a6099c78f091159620db0c91",20,20,0,20,20,0,1,2
"24218","a7c1f0df6a3645c62b3363d0e21cecac",33,33,0,33,33,0,1,2
"24219","a7c3b6c7439a65dbc335e63568b32307",13,13,0,13,13,0,1,2
"24220","a7c4a3224ab8d4e83ce729140c58e7f0",52,52,0,52,52,0,1,2
"24221","a7c4e8078a3cbc830b2881f450cc2356",14,14,0,14,14,0,1,2
"24222","a7c5344811db648e6d293a26247fae75",27,27,0,27,27,0,1,2
"24223","a7c644f1673f7287e29f9dcc4a15e1aa",44,35,14,22,44,0,1,1
"24224","a7c6465c76658eab7d19638904c4fb41",143,104,52,19.25,143,0,3,3
"24225","a7c6866aa0702ac5dfc7a80eb5e78f60",22,22,0,22,22,0,1,2
"24226","a7cac2735a2316a58dd7f3fa84cee190",45,45,0,45,45,0,1,2
"24227","a7cc67500fb6f9c8b5399e68521d38e8",13,11,29,3.13793103448276,13,0,2,1
"24228","a7cf6d6bfd5eb34ed7c778e2df7294bb",126,94,73,12.0821917808219,88,38,3,3
"24229","a7d0907c2e2532c56fb9044840865c23",100,61,50,14,100,0,2,3
"24230","a7d1d872e2f88bb0072194e8faf05aee",95,82,67,9.92537313432836,51,44,2,3
"24231","a7d2a3fcddbbaac8e50b27f6f2fa1069",85,76,63,9.44444444444444,46,39,2,3
"24232","a7d7f9860866faf21f671cec7eb1baa8",48,48,0,48,48,0,1,2
"24233","a7d8c79713ae6affd9236bce61b58821",118,72,61,13.5409836065574,84,34,3,3
"24234","a7d9979dab2b73c3ec7e963fbb41f1f9",171,74,77,15.5454545454545,171,0,3,3
"24235","a7dcd055500b47144797156ad6a53a14",40,35,21,13.3333333333333,40,0,1,1
"24236","a7dcd7387099f88e46073cca80129f83",27,27,0,27,27,0,1,2
"24237","a7df20de58841ce68044110f60b2fb96",28,28,0,28,28,0,1,2
"24238","a7e93838c115b505373cae768128c95d",40,39,28,10,40,0,2,1
"24239","a7ea3629427820a0b663f18c153b583b",115,69,33,24.3939393939394,115,0,3,3
"24240","a7eadaebab53fdcc89a6ac5bb8842d5a",34,34,0,34,34,0,1,2
"24241","a7ebb4a12c5cddbb602f0690598add33",45,30,28,11.25,45,0,2,1
"24242","a7ebfa8b6cfb511ed7c94187f3e52696",40,31,36,7.77777777777778,40,0,2,1
"24243","a7f1a88e3b6ac6cb1263e8efea016ec4",191,87,63,21.2222222222222,191,0,3,3
"24244","a7f2d8228ef926071a6f9ce4cb589a0f",20,20,0,20,20,0,1,2
"24245","a7f3d5490e0fb5d5caaf9fe87474b366",40,39,6,46.6666666666667,40,0,1,2
"24246","a7f4178995d93fc2cc500273ab214723",2,2,0,2,2,0,1,2
"24247","a7f625e029a46ded36274773d341a6dd",39,35,45,6.06666666666667,39,0,2,1
"24248","a7f6f95cd8ff4801ad836298af6c3d82",52,26,84,4.33333333333333,52,0,2,1
"24249","a7f8e105e824fef43fcba0f7810096d1",48,48,0,48,48,0,1,2
"24250","a7f9f1a09c5417e96d0ba455c59a5f5b",237,94,85,19.5176470588235,214,23,3,3
"24251","a7fddd736ab1e50579325b6cc4c3a689",157,99,85,12.9294117647059,157,0,3,3
"24252","a800cc119dc33c0f57ef2ffcf8b6c849",141,127,34,29.0294117647059,141,0,3,3
"24253","a800e4bdecfa2f074b5bac0493124702",65,38,67,6.7910447761194,51,14,2,1
"24254","a800fb4a5e76f163fb96f965720868c4",80,59,65,8.61538461538461,80,0,2,3
"24255","a8030652eb5efad56e2c7946f1b5c1b5",30,30,0,30,0,30,1,2
"24256","a809525fe25b3de695bc87e00bea215f",54,31,75,5.04,54,0,2,1
"24257","a80a08bf9e045498c73414d57735f6aa",53,53,0,53,53,0,1,2
"24258","a80e607db40a5a6f091d2347abfff193",55,55,0,55,55,0,1,2
"24259","a80f2d9b21fa680e1c8dc0a873b6d09c",100,55,40,17.5,100,0,2,3
"24260","a80f483c3ccf51b37040cbc54ae2bb3e",76,49,56,9.5,51,25,2,1
"24261","a80f8669be3da58be9d62a59ccfcc8ee",49,43,65,5.27692307692308,26,23,2,1
"24262","a80fa6a6e34abcf8ff37d707ec1b94ca",71,42,60,8.28333333333333,45,26,2,1
"24263","a812b272d93284a0dd58884bc6be4ee0",50,50,0,50,50,0,1,2
"24264","a81327f1d7d73642dcee6c6885fa42e9",179,146,47,26.6595744680851,136,43,3,3
"24265","a8154e8ce9868b541ccc30aa9248b9d5",32,32,0,32,32,0,1,2
"24266","a818e1e4eaca84d0adb84ebf52ab5e30",61,45,73,5.84931506849315,61,0,2,1
"24267","a8193680ffffafced2d55174f442b842",24,24,0,24,24,0,1,2
"24268","a81d605000e726a53ef96256eb2e3889",2,2,0,2,0,2,1,2
"24269","a81e267081f0e38e853898f846ba00e7",234,70,72,22.75,200,34,3,3
"24270","a821d892a6ed2aaa86b5e667a697d8a7",25,25,0,25,25,0,1,2
"24271","a8245ded396148779e2da64862a77113",81,59,33,17.1818181818182,81,0,2,1
"24272","a824b5830360a1415cacd9496fb7b47d",54,54,0,54,54,0,1,2
"24273","a82549babe75025993c002ea3aad2408",27,27,0,27,27,0,1,2
"24274","a8257cda929e29f707c89c369fd412b3",107,64,73,10.2602739726027,107,0,3,3
"24275","a8296740d2bf3564335be52d56117f11",17,17,0,17,17,0,1,2
"24276","a829b2218eade1a368e1f18b52bef56f",71,44,61,8.14754098360656,71,0,2,3
"24277","a829f26e17cde8b84a6ca6a3dd31af34",67,46,65,7.21538461538461,27,40,2,1
"24278","a82d185ad14f37c2047ef5fd3fc323af",19,19,0,19,19,0,1,2
"24279","a82df51c0f5150541cca3ed6801ab37b",19,19,0,19,19,0,1,2
"24280","a83024106960e81d92430ce001788460",20,20,0,20,20,0,1,2
"24281","a83198023dcb29fe6953daf94b339a45",49,38,33,10.3939393939394,49,0,2,1
"24282","a832f0b6c38b49784871b3ce0094360f",26,26,0,26,26,0,1,2
"24283","a833d60abd309bd2edf8a8487f9c082c",90,72,70,9,90,0,2,3
"24284","a8344dba2775bdf963fe9010dfa28757",59,45,44,9.38636363636364,59,0,2,1
"24285","a835799885b55cbb843a2197046b0d93",14,14,0,14,14,0,1,2
"24286","a83618dce0f53f0167e66850d02eef28",18,18,0,18,18,0,1,2
"24287","a8388e1e979d834d644b1d03897ba7c4",37,37,0,37,37,0,1,2
"24288","a839f85a3f3f916f5f3a5bf75fef71de",12,10,70,1.2,12,0,2,1
"24289","a83b0d2941e844372e1118481822ba60",98,85,40,17.15,50,48,3,3
"24290","a83d58c1841b838466547817bc1e512a",1,1,0,1,1,0,1,2
"24291","a83dc5a837df2e48be41a123f5fb9df6",28,28,0,28,28,0,1,2
"24292","a83e7fa419d24910d1dc999e98d8990d",15,15,0,15,15,0,1,2
"24293","a83f0646f3d6bce77f0826f897b13b04",3,3,0,3,3,0,1,2
"24294","a83ffc3b5bb272911ba592d821670f1a",5,5,0,5,5,0,1,2
"24295","a841be36a454ffe3421a9b7bad90c6bb",121,84,60,14.1166666666667,95,26,3,1
"24296","a847ca6871c20a789e08dc96aae77962",189,124,64,20.671875,142,47,3,3
"24297","a84aea44eb72e9364fe8f60ddf29651f",42,42,0,42,0,42,1,2
"24298","a84b1c79aa8cee0dd03d7bb9f5f6bf64",54,46,55,6.87272727272727,24,30,2,1
"24299","a84b3f4344bf7a1d4647a34733f5acfc",36,30,6,42,36,0,1,2
"24300","a84b7b1e5334c04286821ce187006bcd",22,22,0,22,0,22,1,2
"24301","a84cf8cfbc2b7c00176e3dd999f29d2d",26,26,0,26,0,26,1,2
"24302","a84cfb45d624362c1c9302f231bbee2a",33,30,47,4.91489361702128,11,22,2,1
"24303","a8520fe97df5e73ad2004dcde0863c36",25,25,0,25,25,0,1,2
"24304","a85248247cd710edda6cd729975a25fb",161,79,74,15.2297297297297,122,39,3,3
"24305","a85818d5be4992e484bdf83a405c407a",48,27,52,6.46153846153846,48,0,2,1
"24306","a85b44d69657947f5a628ef33581fceb",52,52,0,52,52,0,1,2
"24307","a85b7ab89f6374739e4152035cb2cc8c",135,83,60,15.75,135,0,3,3
"24308","a85d7265da7ff86a1e536ac0e220e2e3",46,36,45,7.15555555555556,46,0,2,1
"24309","a86077952276de628d8d2729c0dc5881",116,83,49,16.5714285714286,116,0,3,3
"24310","a86189c8a385204824d5c0f7458ba6ca",156,85,88,12.4090909090909,122,34,3,3
"24311","a862b18afc51473084f703fe1f77b849",103,73,54,13.3518518518519,103,0,3,3
"24312","a862b87b086ee310763cb7005b434444",76,47,84,6.33333333333333,58,18,2,1
"24313","a8667f64550eb699d187969bdff21aa1",68,47,41,11.609756097561,68,0,2,3
"24314","a8690d900ca3a15ee8d1377f6c6d2143",42,32,15,19.6,29,13,1,1
"24315","a86bd60cb2b056c1d808b67b00dc25db",111,61,67,11.5970149253731,75,36,2,1
"24316","a86c1cf82047753e1ef627de3645a910",54,37,63,6,54,0,2,1
"24317","a86c60723ecae93bb0f5fa6f201dca85",199,111,79,17.6329113924051,199,0,3,3
"24318","a86ef6c0850bc73b1131dc6ca032e84a",1,1,0,1,1,0,1,2
"24319","a8707201541689bfbad0cfac1733cdf9",59,38,74,5.58108108108108,41,18,2,1
"24320","a8719df1f5881f0904cd22d26b8f6c4d",15,15,0,15,15,0,1,2
"24321","a871ea63428e4dbd383d4e50d4bf32f9",46,46,0,46,46,0,1,2
"24322","a8765eccc956b2433f91e0c7d36522f0",119,82,66,12.6212121212121,119,0,3,3
"24323","a877d733950a2bbf16a6f0d581f5332b",46,46,0,46,46,0,1,2
"24324","a87a0965ffd6351c95b8b13cc3c552ad",26,23,26,7,26,0,2,1
"24325","a87e26c58e9aa5c75f1b43a40aa3610c",56,50,45,8.71111111111111,56,0,2,1
"24326","a87e87e87d2aba45895afb1b5914b14a",7,7,0,7,7,0,1,2
"24327","a88239135a26f934fdbf13dc4ff2459e",48,43,14,24,48,0,1,1
"24328","a8860554095df6630810781c45340719",187,114,82,15.9634146341463,187,0,3,3
"24329","a8867edfb6ee88de86e0de32308e6bd3",32,32,0,32,32,0,1,2
"24330","a886d12c0e2c565236717bd1d1209d00",178,89,37,33.6756756756757,178,0,3,3
"24331","a88e5a0526b6d4b82004a62dd6f0260d",20,12,64,2.1875,20,0,2,1
"24332","a88f6977277f63ccc160faba1b8b61e3",91,34,68,9.36764705882353,91,0,2,3
"24333","a8920240f0b00d465c104bc12dc6bccb",146,78,85,12.0235294117647,104,42,3,3
"24334","a892f62afb198695758914677d53e8ac",50,50,0,50,50,0,1,2
"24335","a893661789d3a24e3c6da3065c84e80e",89,54,56,11.125,89,0,2,3
"24336","a8943fce7b3fe25b98a1b2fea1a4abaf",30,30,0,30,30,0,1,2
"24337","a895152b33add212cc06e7a61845a3bd",45,45,0,45,45,0,1,2
"24338","a897aee0b6332ff8f911c08c53a92033",133,54,71,13.112676056338,89,44,3,3
"24339","a899737b81287175976654535bc4da52",60,47,66,6.36363636363636,60,0,2,1
"24340","a89af41a1fb2e56b8b96db5e6bfa3858",24,24,0,24,24,0,1,2
"24341","a89b892e765b6d2d47b3dfc6f11b022b",23,18,36,4.47222222222222,23,0,2,1
"24342","a89d280e8a8228da572cdc10d0212586",173,100,44,27.5227272727273,121,52,3,3
"24343","a89e7a1935db022f1db1bb551eeff77e",89,74,52,11.9807692307692,55,34,2,3
"24344","a89f9360a14ff400c4a0736f1aba4d2b",63,44,32,13.78125,30,33,2,1
"24345","a89fa59381fb2a9c2b0067946d894fd6",105,69,65,11.3076923076923,74,31,2,1
"24346","a89fb6c31fa22ae2c9e2ff1a5d722014",32,32,0,32,32,0,1,2
"24347","a8a16b0b76cb14783348e920a59588ed",203,133,75,18.9466666666667,203,0,3,3
"24348","a8a2e2716d1e8e5b0925af9628d24c03",22,22,0,22,22,0,1,2
"24349","a8a31c32e22aec12e7b5520d4d7ed717",17,17,0,17,17,0,1,2
"24350","a8a5f3504abc9aaeaa19a5c15cf3e339",46,46,0,46,46,0,1,2
"24351","a8a8c91c0ed374858761bd3623f4601d",26,26,0,26,26,0,1,2
"24352","a8aac2a9e239614cfe4a0f7a31770e12",32,27,77,2.90909090909091,0,32,2,1
"24353","a8ab6be1d4ff1a871061923264194f58",6,6,0,6,6,0,1,2
"24354","a8acb1373a395a7b550973a029ffe58f",107,85,81,9.24691358024691,107,0,3,3
"24355","a8acf3e21af9ac0603fd5b1c6730d97e",97,93,24,28.2916666666667,97,0,3,3
"24356","a8ade6ea49657b91c7c395a035a2407b",28,21,21,9.33333333333333,28,0,1,1
"24357","a8b1c8da502c6753d3b915e2af342471",27,25,43,4.3953488372093,27,0,2,1
"24358","a8b21913e207512375d05adce0174ef6",23,23,0,23,23,0,1,2
"24359","a8b2284ae5c5078f552ba9a4251baf56",70,56,16,30.625,70,0,1,2
"24360","a8b28f81a577bc9cc98b1cac5e3f9a54",1,1,0,1,1,0,1,2
"24361","a8b6d234d8a383b61f4f6497787a17c9",186,143,71,18.3380281690141,137,49,3,3
"24362","a8b6efdc31eb979c81d3b8ca850c0de0",3,3,0,3,3,0,1,2
"24363","a8bc3e499b45450dbf3ca3755125a3f5",86,57,61,9.8688524590164,86,0,2,3
"24364","a8bc4554f092a48c46836033f25cf2c7",35,35,0,35,35,0,1,2
"24365","a8bd12d94251ad55fb19075a0678fccb",55,55,0,55,55,0,1,2
"24366","a8bd5b90dd3bf735be2cd8275f2b7ab3",23,22,21,7.66666666666667,23,0,1,1
"24367","a8bf3e8f094b739c81f52399bd501195",68,40,50,9.52,49,19,2,1
"24368","a8c341882780cd90a7d2111aa322e1bf",22,22,0,22,22,0,1,2
"24369","a8c4242d7b7f0afcc6137aef30dba072",141,97,63,15.6666666666667,141,0,3,3
"24370","a8cbb20cdc11f05857a509dc506d654e",25,25,0,25,25,0,1,2
"24371","a8cc2302e8ca565d538e7bd6094e9f89",26,26,0,26,26,0,1,2
"24372","a8cda6ac1bfe08f74fe84b8fdb7fdcb4",52,42,35,10.4,52,0,2,1
"24373","a8cfe052235fb0a649755ebdf1045c56",25,25,0,25,25,0,1,2
"24374","a8d137b5f09324e01b330a79b3062bff",129,92,56,16.125,129,0,3,3
"24375","a8d1e29e21c96b2fc9c7d37eb46df749",29,29,0,29,29,0,1,2
"24376","a8d6dc868d3843d0031d25837f72eb98",26,26,0,26,0,26,1,2
"24377","a8d7517c7db5027a2a908b3e46f35d00",115,92,67,12.0149253731343,115,0,3,3
"24378","a8d77ae3a0f4113ececad16e0c16db0b",179,123,69,18.1594202898551,179,0,3,3
"24379","a8d91598ef48ffc3db79bbd7c59a8ce4",2,2,0,2,2,0,1,2
"24380","a8da821646df444b4ef2f6ae724301f5",119,63,84,9.91666666666667,86,33,3,1
"24381","a8db9139dc24604b38be52074413e162",15,15,0,15,15,0,1,2
"24382","a8dbc705d43b30d6101a9061c70367cf",98,78,37,18.5405405405405,98,0,3,3
"24383","a8de493e9395dff390d9318be793f670",41,41,0,41,41,0,1,2
"24384","a8df44332b4b498f22672c0bf1e0c16b",71,51,78,6.37179487179487,71,0,2,3
"24385","a8e1b9ff44b391409ab21ce54296a819",31,31,0,31,31,0,1,2
"24386","a8e2adc9bf170a171d9eb1f92122c398",50,45,15,23.3333333333333,50,0,1,1
"24387","a8e3b9c4ed844b386b8adae0c9e0ab12",28,28,0,28,28,0,1,2
"24388","a8e56730ca24c7310d219a9d770ba1ca",35,35,0,35,35,0,1,2
"24389","a8e86b6418c048454bfab80316bf898d",78,44,83,6.57831325301205,55,23,2,1
"24390","a8e95b05bde9b4b984c14ef18cd2e60c",91,71,30,21.2333333333333,42,49,2,1
"24391","a8eb021c156a85851d9ca75cd80bcec7",67,49,58,8.08620689655172,67,0,2,3
"24392","a8efad7309b45e23a14fc576e0197681",26,26,0,26,26,0,1,2
"24393","a8f71425215a11843886a37374c6ba9c",121,91,37,22.8918918918919,121,0,3,3
"24394","a8f89712d285240f172df6529943f526",120,86,64,13.125,74,46,3,3
"24395","a8f9ef912b167c125f4626a6bd7a149b",22,22,0,22,22,0,1,2
"24396","a8fcfc678f7ccfad143342121dc46f9f",21,21,0,21,21,0,1,2
"24397","a8ff4f0ac30509bf8e8f860b1b836cf9",125,90,62,14.1129032258065,125,0,3,3
"24398","a9001eaf99e141eb611569ed354af08d",74,55,22,23.5454545454545,74,0,2,1
"24399","a9062ad07c3b6c6ca9bd9388a6a8b117",75,52,38,13.8157894736842,75,0,2,1
"24400","a907d0a0666aeb8267fa4ebaa85b9f6b",18,18,0,18,18,0,1,2
"24401","a907e7aed20d2a4f3227fedcb4fbc3f1",108,75,82,9.21951219512195,95,13,3,1
"24402","a908013f251e43260b8a0e97c4760bb7",103,50,57,12.6491228070175,83,20,2,1
"24403","a90beb1c1bc997965de144168e03bcbd",30,30,0,30,0,30,1,2
"24404","a90c57d3363795a220aed9745b1a2520",72,51,73,6.9041095890411,39,33,2,1
"24405","a90c81b964ca5c637889fc707bfbba03",11,8,46,1.67391304347826,11,0,2,1
"24406","a9106d5297b55da83f35035e38377d93",30,30,0,30,30,0,1,2
"24407","a915ad7192c8dfab875e296d82b8ec30",204,135,80,17.85,204,0,3,3
"24408","a91775e45012f063d57f3c9f51dda5e9",28,26,13,15.0769230769231,28,0,1,1
"24409","a91822defb51fa147b7f1f82e060978d",5,5,0,5,5,0,1,2
"24410","a919c8ad749912ea8f06e3a3eb598154",55,47,30,12.8333333333333,29,26,2,1
"24411","a91a32804169bd67ed52da7cbf838828",25,25,0,25,25,0,1,2
"24412","a91ad995d4b7dc8f31bc12fc1b4cfbd8",20,20,0,20,20,0,1,2
"24413","a91ae429add77094a2aeccbd151d70cd",49,44,21,16.3333333333333,49,0,2,1
"24414","a91b2ad3b2629a10b1d03b2c4accef32",171,105,70,17.1,171,0,3,3
"24415","a91c1bb1b42ee4c9a26927d1dea6c33e",21,21,0,21,21,0,1,2
"24416","a91cd41eb2fb003dcfdaddcb9d94bc34",25,25,0,25,25,0,1,2
"24417","a91df4c583f5abfa0233e3aa4741c922",107,88,76,9.85526315789474,107,0,3,3
"24418","a91e8315ee0ee0266323666a177e1f89",40,40,14,20,40,0,1,1
"24419","a9204be0d94d207ba49d3e0960789669",55,50,38,10.1315789473684,55,0,2,1
"24420","a920a6e3b0751100804e5d639142344d",2,2,0,2,2,0,1,2
"24421","a921896d162f08c5d70ac5ab624d7e78",11,11,0,11,11,0,1,2
"24422","a92264d3a2b824ca81b393d27f3875d0",82,51,49,11.7142857142857,66,16,2,1
"24423","a923e4ebffdf3b07d38a5edacff81413",12,12,0,12,12,0,1,2
"24424","a924d67ebb2b5650a4b36210aa5b2113",105,77,28,26.25,105,0,3,3
"24425","a926fe728d993d6e6a3c7b049762d6bb",35,31,49,5,35,0,2,1
"24426","a929375aee58c108f5221fa336deb874",52,38,16,22.75,52,0,1,1
"24427","a92ab0cfcf0dd79f3e902c29b472937b",5,5,0,5,5,0,1,2
"24428","a92cb1896a8a261a3c7b53edb30d6977",71,40,49,10.1428571428571,40,31,2,1
"24429","a92df7aea05a12574eb0dabd391cd610",149,113,63,16.5555555555556,149,0,3,3
"24430","a92fe9ddd6733cb4f9913e3ad948eee8",19,19,0,19,19,0,1,2
"24431","a9314013c00ad575e6531ae14ffda31f",36,36,0,36,36,0,1,2
"24432","a93455596d37501d8aa75c0ca14f6e46",76,51,55,9.67272727272727,76,0,2,3
"24433","a937515ba8d4c18e57d946e881116cde",19,10,60,2.21666666666667,19,0,2,1
"24434","a93a7078f8f3bdda0d63bbd0a2e2cee7",21,21,0,21,21,0,1,2
"24435","a93aeac5c01d8c8c9a513ad9283daebe",71,61,44,11.2954545454545,71,0,2,3
"24436","a93f93af197b5826ecd9f787bf11fd82",48,48,0,48,48,0,1,2
"24437","a940cc9c91aa6f41fcf7021c1b646807",5,5,0,5,5,0,1,2
"24438","a941b7a89e12cd30babb64df88e290ad",13,11,59,1.54237288135593,11,2,2,1
"24439","a942dccb3ebdffad483c50fb46ebc471",99,41,59,11.7457627118644,99,0,2,3
"24440","a9436776eee6fa51a4c4faef8667817b",96,64,74,9.08108108108108,96,0,2,3
"24441","a945508619921c7c0c3766eebceab28e",41,33,33,8.6969696969697,18,23,2,1
"24442","a9489ed31156108cd744c14f732e7168",33,33,0,33,33,0,1,2
"24443","a94a7192ddabe7876b247cae5e9fd9ec",70,62,37,13.2432432432432,28,42,2,1
"24444","a94aeb321130ef044fbaaac68efcd60f",90,89,73,8.63013698630137,90,0,3,3
"24445","a94efed09838234c0a543ec5bf883cbe",9,9,0,9,9,0,1,2
"24446","a9523b086e1beb32739b52e149b65784",43,38,26,11.5769230769231,21,22,2,1
"24447","a953dd5d8faf510d11d49b404ff484d5",8,8,0,8,8,0,1,2
"24448","a954aa281d782117a6f136a0ac930f9b",15,15,0,15,15,0,1,2
"24449","a95621332b88bf8af9a00c4533156570",35,32,28,8.75,35,0,2,1
"24450","a95654575964c47755b870d3cfbc55ef",36,36,0,36,36,0,1,2
"24451","a959bdd43c52a00643b7e75bf36daef4",24,24,0,24,24,0,1,2
"24452","a95b030ef50ca85c86db9d7146851c0f",21,21,0,21,21,0,1,2
"24453","a95b126984cfbcb42e165735ade92c1d",53,53,0,53,53,0,1,2
"24454","a95db56346ee7514d029bcf21bf40e43",56,49,13,30.1538461538462,33,23,1,2
"24455","a95ecfc5c23b5d49eda0be78f67b5de4",25,25,0,25,25,0,1,2
"24456","a95ef3e236624bee2740ada8fdd70bd4",27,27,0,27,27,0,1,2
"24457","a96147b180326c17b58e06263773157f",30,13,60,3.5,30,0,2,1
"24458","a96232301fabdc98f36033ae3c0220aa",25,25,0,25,25,0,1,2
"24459","a963753fa745107642f8b295338f1273",56,38,32,12.25,24,32,2,1
"24460","a967e9d5c6cc1dbcb29826e5b74c13da",127,85,82,10.8414634146341,127,0,3,3
"24461","a9686267788ad7bc86a61470fe572ffe",131,79,53,17.3018867924528,131,0,3,3
"24462","a9693d256770ab61f1bfb27d5fc460aa",128,71,58,15.448275862069,128,0,3,3
"24463","a96a0b494b8a01bacba47612c68767bc",40,40,0,40,40,0,1,2
"24464","a96aad1cfc9ce13c08ad2bde0175bae5",216,109,76,19.8947368421053,201,15,3,3
"24465","a97104960c3c654180fe362899c529fe",13,13,0,13,13,0,1,2
"24466","a9717f7aee2935bb008316fa97e4f73c",26,26,0,26,26,0,1,2
"24467","a9737b69b38ab586ea6ea6d7020940f1",10,10,0,10,0,10,1,2
"24468","a97606ce85cb73adee815e5aad996422",193,117,60,22.5166666666667,193,0,3,3
"24469","a9764ff0600626e20b44982ddc8417d4",65,59,40,11.375,65,0,2,3
"24470","a976a29ba6b598da7d07073ba3831335",68,40,62,7.67741935483871,68,0,2,1
"24471","a9770a3a5e027a2a50cfd873ad696ed6",59,44,70,5.9,59,0,2,1
"24472","a97788628d6d6d161b930b5b5d8da279",90,70,32,19.6875,90,0,2,3
"24473","a978cc4c30fe3c12e70f2890ebb8b09a",79,59,54,10.2407407407407,42,37,2,1
"24474","a97911d89f27c8bc65e79a86971704b7",118,67,62,13.3225806451613,118,0,3,3
"24475","a97c09cfdea1ba696599bc469deb763b",140,91,62,15.8064516129032,140,0,3,3
"24476","a97ff2c8e8b33c67d1f04aeaee288148",134,79,80,11.725,134,0,3,3
"24477","a98049f673f1b380465f8ff7bf87372d",71,49,74,6.71621621621622,47,24,2,1
"24478","a9818696ada207f7c6eb5595c0555682",118,69,59,14,104,14,3,1
"24479","a984f8e670cb6ec154d7d414a2162024",206,124,68,21.2058823529412,206,0,3,3
"24480","a9853f3184bb756543113b85ce921824",45,36,66,4.77272727272727,45,0,2,1
"24481","a98541c3f5620ffc8b83b1ef15c8d747",148,79,67,15.4626865671642,148,0,3,3
"24482","a98769ebd2a0a57e5d0ed49ffbeebea3",47,47,0,47,47,0,1,2
"24483","a9885686df58f995187d8cef5b9547dc",57,48,45,8.86666666666667,57,0,2,1
"24484","a9897c1ee27b381a9e07a44e4926e2ea",36,33,61,4.13114754098361,36,0,2,1
"24485","a98b8970ec4e0cab43badaf14d32e8eb",32,32,0,32,32,0,1,2
"24486","a98dc2c93f3f9616aaf5165a70954ef0",18,18,0,18,18,0,1,2
"24487","a98e3f8c12e3223d84980ac4241446d4",69,60,59,8.1864406779661,35,34,2,1
"24488","a98ff81fb34f502c0f76a17d0cd3c76e",32,32,0,32,32,0,1,2
"24489","a9914ff67ad35c3041c61a750ee29386",56,43,36,10.8888888888889,56,0,2,1
"24490","a992e34648ad4970af21678c30746970",101,74,63,11.2222222222222,101,0,3,3
"24491","a995bf73b149340a46a31be93e361148",110,83,28,27.5,110,0,3,3
"24492","a9977f28df9334cf4885d1518dec1c69",105,65,69,10.6521739130435,70,35,2,3
"24493","a99e87279c589f8784ced023739b3b7f",36,36,0,36,36,0,1,2
"24494","a9a18233e3990023c24d15d8aa40304c",11,8,18,4.27777777777778,11,0,1,1
"24495","a9a3b5f8562f4ab72235fe50ba9eae33",22,22,0,22,22,0,1,2
"24496","a9a68e1e55c2b1c2ff3f22a63c029e24",29,26,58,3.5,15,14,2,1
"24497","a9a6c9402b0c158e8b986f7aa0813d81",81,59,53,10.6981132075472,81,0,2,3
"24498","a9ab7ba83af3484a9814b254bfb44955",82,56,63,9.11111111111111,82,0,2,3
"24499","a9ab92e23a24c35cf670a0663562cfc4",33,28,30,7.7,19,14,2,1
"24500","a9ab95ad814585eedbb8fbaf0317a4aa",15,15,0,15,0,15,1,2
"24501","a9ade8863129e5cef951cc5a4e4d2302",70,37,84,5.83333333333333,70,0,2,1
"24502","a9ae9e738f211ad74c39a784aef1f4b9",17,17,0,17,0,17,1,2
"24503","a9aef6d7824ba3759738f82e1780a1df",27,13,71,2.66197183098592,27,0,2,1
"24504","a9b41a324718fc1fe182659c15f7da63",27,27,0,27,27,0,1,2
"24505","a9b881412792c54d66baa40d98bf46a4",65,53,75,6.06666666666667,65,0,2,3
"24506","a9b981588ad6b6910f7c535290197b73",203,116,77,18.4545454545455,158,45,3,3
"24507","a9b9951f21db48d98d27a7354690179a",3,3,0,3,3,0,1,2
"24508","a9bb0c1add6ddb84f03ee4efb490e0e4",108,63,84,9,108,0,3,3
"24509","a9bc52313ff548d2e0ce476b7f29a548",5,4,0,5,5,0,1,2
"24510","a9bf75a2c9bba1b41ef2f299cffa4d19",21,21,0,21,21,0,1,2
"24511","a9c0619226aa5930b4e8ea0d972f38ce",119,75,59,14.1186440677966,80,39,3,3
"24512","a9c17d9cd767b75d76da44744af8a0df",143,98,79,12.6708860759494,91,52,3,3
"24513","a9c2718524beb0354a5e94881beac057",71,62,14,35.5,71,0,1,2
"24514","a9c3a55b56fe41468d78a0d103ec82e6",109,71,58,13.1551724137931,76,33,3,3
"24515","a9c4cb40efff89f5f690fa31337af97a",132,82,79,11.6962025316456,79,53,3,3
"24516","a9c78174905b01b3350b50e7ab749b47",215,123,68,22.1323529411765,189,26,3,3
"24517","a9c88294bfb36978c77161e35b836eb8",39,39,0,39,39,0,1,2
"24518","a9cbafcdcaba9ea9adeb23c12c7d12d8",15,15,0,15,15,0,1,2
"24519","a9d145385e1cbc7731f1f5757597b446",16,16,0,16,16,0,1,2
"24520","a9d2af99f6626ff467ea52c00f3dbd34",31,25,68,3.19117647058824,31,0,2,1
"24521","a9d2d31cf2cc1e63b5477246ead5052c",94,84,38,17.3157894736842,94,0,3,3
"24522","a9d63c96760099f7d2c0ecd6eb03d2c3",12,12,0,12,12,0,1,2
"24523","a9d6454b066c994bfc99b9d9df45b9d6",33,33,0,33,33,0,1,2
"24524","a9d64cbd583d2dc72d23f85cdfbe1006",76,61,58,9.17241379310345,45,31,2,1
"24525","a9d7a8d4e2888c24710778c84997a3af",24,24,0,24,24,0,1,2
"24526","a9d88eae4a5bc7f1444f40480582dee3",43,26,70,4.3,43,0,2,1
"24527","a9d99ee72f684adbcb09318f3747d4ea",28,28,0,28,28,0,1,2
"24528","a9daf6883f80e303364c3595982be3b4",98,72,74,9.27027027027027,98,0,2,3
"24529","a9dc5624ffd7386604964fa9d8a623f7",80,57,36,15.5555555555556,80,0,2,1
"24530","a9ddc32acc59b342a16dcf90fb0fe528",35,25,23,10.6521739130435,35,0,2,1
"24531","a9dddb0837cd7e7867bb10f6250eb15c",27,24,56,3.375,27,0,2,1
"24532","a9de4e3ee4ab820570380dd8e44ad025",88,43,57,10.8070175438596,88,0,2,3
"24533","a9df04e4e69f3d8a0c77236b5e116022",14,14,0,14,14,0,1,2
"24534","a9df37682ceeae8172011e35f309eb7f",19,19,0,19,19,0,1,2
"24535","a9e0203b2a3f503820bbc7e389e07e34",70,38,53,9.24528301886792,43,27,2,1
"24536","a9e09aa7a905aa0ec93d0b74c7e645f4",59,50,52,7.94230769230769,59,0,2,1
"24537","a9e120023f7f392f9747c6f93b845b8a",36,31,32,7.875,16,20,2,1
"24538","a9e25e6d8f07d400f970f56c489d99bc",63,55,12,36.75,63,0,1,2
"24539","a9e46beb7a7a33966b72f995d590d723",70,66,21,23.3333333333333,70,0,2,2
"24540","a9e6b077c550046ba3549ad9718ba68e",15,15,0,15,15,0,1,2
"24541","a9e7a8fea85692fce344308e5d3d807d",16,16,0,16,16,0,1,2
"24542","a9e7c7273e4255a05c0f0d04a440f3b3",81,64,37,15.3243243243243,36,45,2,1
"24543","a9ea431eef658f9d9528d33cd9fb6d82",17,17,0,17,17,0,1,2
"24544","a9ead3c3e42a6f0d3f7c9e2e15dc69b3",46,46,0,46,46,0,1,2
"24545","a9eb894db96bbd4f74e4dcb8d196a912",174,96,68,17.9117647058824,174,0,3,3
"24546","a9ecc1b508e24c1e24dfa3cbb52099a3",45,37,27,11.6666666666667,45,0,2,1
"24547","a9efea7c6fc0059d53bf289093896a33",25,25,0,25,25,0,1,2
"24548","a9f00e9405888238fb4c9d829729a908",181,100,75,16.8933333333333,169,12,3,3
"24549","a9f0a8534eddabbeee0976284610a273",129,95,71,12.7183098591549,129,0,3,3
"24550","a9f0cd1fec804af63ee4c3ce28691ab2",18,18,0,18,0,18,1,2
"24551","a9f5faef181ff95c3862c6d7a1a01a92",30,30,0,30,30,0,1,2
"24552","a9f6603568078727cd8c2bda675b702d",45,38,33,9.54545454545454,45,0,2,1
"24553","a9f75d037153fce7b65316240eb50621",29,28,56,3.625,29,0,2,1
"24554","a9f93ecb244a675a7dd77593ce2b69a5",34,25,46,5.17391304347826,22,12,2,1
"24555","a9fa57481df0f52bbff40bd4f1ed06e4",57,52,26,15.3461538461538,33,24,2,1
"24556","a9fc5ca4a89b86b2e662d647994a81fe",91,68,30,21.2333333333333,39,52,2,1
"24557","a9febae77a89e2d43bf16d6212b535d8",65,59,16,28.4375,65,0,1,2
"24558","a9fec2648af04bf065372199d25ca9d5",76,58,28,19,76,0,2,1
"24559","a9ff97156a65f3067fd2f582e7d4114c",11,3,68,1.13235294117647,11,0,2,1
"24560","aa00cda292ffe065a755cdb4484e59be",182,91,81,15.7283950617284,182,0,3,3
"24561","aa01d8de19b6acc608503ff229c4369a",48,48,0,48,0,48,1,2
"24562","aa02e179788357d05c9d47ca7482914e",36,23,32,7.875,36,0,2,1
"24563","aa0305e45846dc059a1eb5897270e244",55,44,42,9.16666666666667,55,0,2,1
"24564","aa0617ff2c4acd53ccdc9b18c4ece282",86,57,58,10.3793103448276,40,46,2,1
"24565","aa07bc0b3db509913eec2e4ced92b546",32,32,0,32,32,0,1,2
"24566","aa0a8a286026bab8103c9af9764a1c22",104,80,16,45.5,104,0,3,2
"24567","aa0b25812d2073805b5ab7add69cb23b",26,26,0,26,26,0,1,2
"24568","aa11a443ea607e57f6b5d076351d77a5",3,3,0,3,3,0,1,2
"24569","aa1358568d078b7bef15c60a0d3cb0b6",23,23,0,23,0,23,1,2
"24570","aa13dde33584c0355a8b2c0440ac377d",79,64,41,13.4878048780488,79,0,2,3
"24571","aa15516493010ac950e605410a429122",27,26,81,2.33333333333333,27,0,2,1
"24572","aa1a637417d28bcf8d90af578b37d4d4",64,53,80,5.6,64,0,2,3
"24573","aa1c28f827be92873db772e63ffff2ba",55,47,35,11,55,0,2,1
"24574","aa1d040382b4e952adeb32039088f853",23,23,0,23,23,0,1,2
"24575","aa1d6537ea7a0998b62884f207e35ab7",54,47,11,34.3636363636364,31,23,1,2
"24576","aa1e485ebc5d9b742ea4be6dc657fc61",84,70,56,10.5,84,0,2,3
"24577","aa1f237a590411e1c1ab1718d69ce052",103,72,49,14.7142857142857,103,0,3,3
"24578","aa20045067df0d595ad783cf331e1ce1",174,88,48,25.375,174,0,3,3
"24579","aa24da8380055069bd4364b2a36ec440",17,17,0,17,17,0,1,2
"24580","aa2734d96ac02e7b7173b7de17fddca3",146,107,63,16.2222222222222,146,0,3,3
"24581","aa273856611a48f28c697694235c08cf",115,90,83,9.69879518072289,66,49,3,3
"24582","aa281ff76773250a3a467941822271fc",138,89,64,15.09375,138,0,3,3
"24583","aa28ed5ec7f681b272685085f1af7015",96,80,26,25.8461538461538,96,0,3,3
"24584","aa2ac84bb8787674a227739f8956d39d",187,97,52,25.1730769230769,137,50,3,3
"24585","aa2b450051cd6157aaf12c829296f5b4",86,69,46,13.0869565217391,86,0,2,3
"24586","aa2d6ae47296168d89eab97de77ba9b7",29,29,0,29,29,0,1,2
"24587","aa2e6be834f25c66102c6d3410088bc3",23,23,0,23,0,23,1,2
"24588","aa2f6eea0ce4032119149a3ac09f6c88",32,32,0,32,32,0,1,2
"24589","aa30b2152baa18dca5a7601ffa431112",141,103,54,18.2777777777778,141,0,3,3
"24590","aa31e77f5f6064d3e93c65cfc8d66e41",219,117,67,22.8805970149254,219,0,3,3
"24591","aa363c485187c83e24208bbdd6e95638",98,59,69,9.94202898550725,98,0,2,3
"24592","aa38e1363da9757f2eadd675cac3e306",49,33,62,5.53225806451613,49,0,2,1
"24593","aa3ac028b54ef39fdd4e487dc3bc1fdc",27,27,0,27,27,0,1,2
"24594","aa3ca0f988cf72b6eaf1224b3162ed58",43,35,39,7.71794871794872,28,15,2,1
"24595","aa3d9d98922dbbf5cebd0d8190e4e973",26,26,0,26,0,26,1,2
"24596","aa3e35d3cb0169488bb559661d6fb640",103,35,79,9.12658227848101,103,0,2,3
"24597","aa3ed160ab77fb6146c876ea6bca23a1",43,43,0,43,0,43,1,2
"24598","aa4249f6e32193fa5c898466ad976708",88,69,41,15.0243902439024,88,0,2,3
"24599","aa4685642e16931dad012ea32ffeaf66",31,31,0,31,31,0,1,2
"24600","aa4a797c10220ff40e7bd2a26c652db4",32,32,0,32,32,0,1,2
"24601","aa4c4de4dd385d48490005fddae09451",34,34,0,34,34,0,1,2
"24602","aa4d46e880f2e7115a0ef8f8e7802c67",36,36,0,36,36,0,1,2
"24603","aa4e68e0a6f3cdd3a9013453c670497b",48,40,42,8,48,0,2,1
"24604","aa4ead4aa04d3a79ae63d429d4afca9d",9,9,0,9,9,0,1,2
"24605","aa4f8efbe93c19ab6c2c90d7b9349a51",48,43,10,33.6,48,0,1,2
"24606","aa503f9a903542d7e944378ef1030f50",48,48,0,48,48,0,1,2
"24607","aa54a29dd32227840329ea3b246cba08",80,70,44,12.7272727272727,39,41,2,1
"24608","aa565db275c71d86e1ce56580e9407fa",35,35,0,35,35,0,1,2
"24609","aa5675b76c4eff6df355b81073b91178",10,10,0,10,0,10,1,2
"24610","aa592eda302a1af435e0018cfe19ffc8",32,26,18,12.4444444444444,32,0,1,1
"24611","aa5b98510ae28d3169b17ca6ef3d1ba6",66,57,58,7.96551724137931,29,37,2,1
"24612","aa5edcf79f1f152fe28bb51ccd27501d",14,14,0,14,14,0,1,2
"24613","aa68936dfb196bcd2af6efe179f403fc",108,75,33,22.9090909090909,54,54,3,3
"24614","aa69407e1e7b9c10d5212d1a7a76489b",119,88,56,14.875,119,0,3,3
"24615","aa6af5f0c56c09944bfa9157148ea698",40,40,0,40,40,0,1,2
"24616","aa6b49220ee9598d477e83df43d6c1c1",156,68,70,15.6,124,32,3,3
"24617","aa6d85081a2a7227996c46f734a84cea",36,34,9,28,22,14,1,2
"24618","aa6f1431af080e14e51c75beafa6ae06",185,94,51,25.3921568627451,185,0,3,3
"24619","aa6fbbb2c84f01cba935b013b849f7d4",27,25,36,5.25,27,0,2,1
"24620","aa71bd0e87fd1b34837bf6a5ee0c7733",34,29,12,19.8333333333333,34,0,1,1
"24621","aa77529d07ff9cf83ca663189f961c52",59,57,29,14.2413793103448,17,42,2,1
"24622","aa7823b8c2954b3ed6ad3240d66a4c2f",26,26,0,26,26,0,1,2
"24623","aa783c102b3d69bfd4d89f5fc2ba8ae6",84,73,48,12.25,84,0,2,3
"24624","aa7862ea264c84649f5b78c120a2aaf8",175,80,83,14.7590361445783,175,0,3,3
"24625","aa799130a97d4f27868122e6c9312e6c",13,13,0,13,13,0,1,2
"24626","aa7f9629776bfd1888b17e881d2b1f8b",14,14,0,14,14,0,1,2
"24627","aa802e25c6833e819ad32588f1d77096",26,26,0,26,0,26,1,2
"24628","aa81ce4aa4c9823fd651f2b37b701b0e",39,34,32,8.53125,17,22,2,1
"24629","aa862f0d6551327339efc89830740b17",73,53,52,9.82692307692308,36,37,2,1
"24630","aa88184fc4765b189c4fec7ee9db8ea4",91,68,39,16.3333333333333,91,0,2,3
"24631","aa8872a1e2d799fac3ac476567aecb00",21,15,37,3.97297297297297,21,0,2,1
"24632","aa89c287f708c6937062e6a6dbe37d8f",50,44,20,17.5,50,0,1,1
"24633","aa89faae6333e087faeea7f70cd07821",128,62,70,12.8,128,0,3,3
"24634","aa8c58fb0d16e6e45af008702383b1c7",157,115,57,19.280701754386,157,0,3,3
"24635","aa8c94be5b583aebe0ffd1ab882ffaf5",84,58,74,7.94594594594595,84,0,2,3
"24636","aa917e5998bb673c8ce87d1d00528ac9",18,18,0,18,18,0,1,2
"24637","aa91ab3bbe5a7c5c5f74fdaad8784698",172,123,48,25.0833333333333,172,0,3,3
"24638","aa9711f3747aaea100530f7ef7db51c6",21,21,0,21,21,0,1,2
"24639","aa975ad6bbcee189228cb2e8516df0e1",81,62,46,12.3260869565217,81,0,2,3
"24640","aa985cf01d45209d3f7069be493fe85c",16,16,0,16,16,0,1,2
"24641","aa99a72756b1bb2f6c263b30b1fb38d1",160,113,63,17.7777777777778,137,23,3,3
"24642","aa9a0a8315522f2ad8a8f36281afdfe4",168,66,83,14.1686746987952,168,0,3,3
"24643","aa9d60329b01396d67b7492625ac1ef5",44,44,0,44,0,44,1,2
"24644","aa9ecad28c94090a5bb4d9a834d15db5",25,12,59,2.96610169491525,25,0,2,1
"24645","aaa01112894b2b8c2084eabb5d77e4ae",105,79,54,13.6111111111111,105,0,3,3
"24646","aaa4b7d0309e7a8b4b8e693d19b3048e",28,28,0,28,28,0,1,2
"24647","aaa52f692c1a644342a34abfa820feb0",29,29,0,29,0,29,1,2
"24648","aaa8628221cc564afacd6bb2c34b55ba",38,38,0,38,38,0,1,2
"24649","aaaa084f4cf0cd24604c0dd725614443",15,15,0,15,15,0,1,2
"24650","aaaa9708899f9cf09c42b9365c2ff3a9",106,61,68,10.9117647058824,106,0,2,3
"24651","aaaf0cca454eca2aeca67650117faae4",144,103,70,14.4,144,0,3,3
"24652","aaaf67b63529eb61521a400ae91b3994",33,31,7,33,0,33,1,2
"24653","aab735b75817fbd6486e2f3ad98c7f97",45,35,23,13.695652173913,45,0,2,1
"24654","aabdbbb3b2b4b74c0530cd1da87e2949",37,30,14,18.5,37,0,1,1
"24655","aaca5af161c363633178bba751878fb5",235,101,72,22.8472222222222,212,23,3,3
"24656","aacae01109986040f174ee3b4b0994f0",24,24,0,24,24,0,1,2
"24657","aacb8c41dda8bfeabda8d6eb8e11552f",196,113,79,17.3670886075949,196,0,3,3
"24658","aaccc75cb7a4be29d7cdd641cc4a16ce",54,49,13,29.0769230769231,24,30,1,1
"24659","aacddc3feadf26fe57c31ff4edae7d5d",21,21,0,21,21,0,1,2
"24660","aacfd7032dda6887dd0e1a2c99a6a1a3",143,86,84,11.9166666666667,112,31,3,3
"24661","aad0977945ea91397d35ba5db3ce32e5",42,42,0,42,42,0,1,2
"24662","aad303ec99df6b51e8d8f6306605879e",92,65,55,11.7090909090909,92,0,2,3
"24663","aad5bdccf18b2c89a8e7567ae688cfcf",172,92,84,14.3333333333333,172,0,3,3
"24664","aad7806e34c4d403622b32ee0efc5f77",19,19,0,19,0,19,1,2
"24665","aada2909a82e2d35b37154eef6f16a1c",21,21,0,21,21,0,1,2
"24666","aada3d01bc254ca22d7d649ef5912457",12,12,0,12,12,0,1,2
"24667","aae1d05521240599e5717ce889596b30",162,84,57,19.8947368421053,162,0,3,3
"24668","aae4944aebad760ccddddf4c0e28cc79",132,109,56,16.5,132,0,3,3
"24669","aae936c7ab6d604a71bac0f12893be8a",40,37,17,16.4705882352941,15,25,1,1
"24670","aaea0ed9a5fbd3c7c18d1589159ee751",84,55,40,14.7,84,0,2,3
"24671","aaec396265b6717667f17ef1b5035463",33,33,0,33,33,0,1,2
"24672","aaedfc1b24d0f43956bf8e12b697860c",42,30,15,19.6,42,0,1,1
"24673","aaf08c14e44a4c9278bda7f6ee64257e",41,41,0,41,41,0,1,2
"24674","aaf17af8fd0552400138a9b5cd5ff8cd",146,89,64,15.96875,146,0,3,3
"24675","aaf18432886aa19d8b35dc97407bb46f",43,34,48,6.27083333333333,43,0,2,1
"24676","aaf1ecd6dd8670a803fd8e0262f33fed",83,63,60,9.68333333333333,31,52,2,3
"24677","aaf26a94dd27a136d8a36f41a8bb0b88",106,77,54,13.7407407407407,106,0,3,3
"24678","aaf29c3aee76963cd0ce4696aaa6c832",23,22,17,9.47058823529412,23,0,1,1
"24679","aaf4940bc8ab50c37b6cb7122adc4279",30,30,0,30,30,0,1,2
"24680","aaf58f705dbe3dca73024b499113e882",167,72,77,15.1818181818182,144,23,3,3
"24681","aaf5a7a85691247d4dd4f9d060cb6071",104,81,41,17.7560975609756,104,0,3,3
"24682","aaf6324ae7afe6d10133e4b2c399d272",63,54,39,11.3076923076923,63,0,2,3
"24683","aaf7a90b85294f475441f293e88b0f33",71,57,39,12.7435897435897,54,17,2,1
"24684","aaf88c205071a8fe626b0105e366453c",20,20,0,20,20,0,1,2
"24685","aaf8fe2fc0c92f0cdaa5fd91cfda7091",14,14,0,14,14,0,1,2
"24686","aaf8ffcf95accaa1c9826be592e22cd0",59,52,44,9.38636363636364,59,0,2,3
"24687","aafaaf2e2b5d9161fd99b6ef2604c732",30,30,0,30,30,0,1,2
"24688","aafbdc12ebce14d3b941b7c16c047f50",90,63,35,18,90,0,2,3
"24689","aafd79ef3b92f27c3c5d509383e48e6d",118,67,73,11.3150684931507,118,0,3,3
"24690","aafe3444d79ba5751fca2e86dcb1e28b",132,86,62,14.9032258064516,84,48,3,3
"24691","aafea7934934e48271174e528d8177b2",37,31,53,4.88679245283019,20,17,2,1
"24692","ab0171cd0e94a85802ab1f121a34699b",12,12,0,12,12,0,1,2
"24693","ab01f8cfe160aaf2e9632535d486353f",8,8,0,8,8,0,1,2
"24694","ab068e0982325ad35cf7a6c89336dcb9",29,29,0,29,29,0,1,2
"24695","ab09f10aff7783684b876125d5dc935b",20,20,0,20,20,0,1,2
"24696","ab0fee5b08070b2bd6816ee923edec63",5,5,0,5,5,0,1,2
"24697","ab10418227dd7fe312ff17b9e549f087",64,44,36,12.4444444444444,33,31,2,1
"24698","ab10a5b5d9454f3d1475cacf70716970",5,4,75,0.466666666666667,1,4,2,1
"24699","ab10f0177676185a1aaa28f81ed6446e",11,11,0,11,11,0,1,2
"24700","ab1180c5a2b69f6f48df6af48ee1204b",42,42,0,42,42,0,1,2
"24701","ab1275b3c8977c27b4a6f979b8b4182f",27,27,0,27,27,0,1,2
"24702","ab13acb019a57564e3de0183cdd2e394",99,39,72,9.625,99,0,2,3
"24703","ab1636a422d14743ed738a2c54999171",41,37,46,6.23913043478261,41,0,2,1
"24704","ab17f8cfde326d7c725009ede76de57e",59,46,59,7,59,0,2,1
"24705","ab18b15edca34884f78ba697cf04094f",191,119,56,23.875,191,0,3,3
"24706","ab2032fcac976c1c3e73c108f8dcb164",37,31,17,15.2352941176471,16,21,1,1
"24707","ab20fd7b3431aecc99ebb0d295dadc04",37,37,0,37,37,0,1,2
"24708","ab218fad2c0cfc742ac4e27ececc2e59",37,37,0,37,37,0,1,2
"24709","ab27b12e6d688c8566c9d21792428aac",119,75,77,10.8181818181818,119,0,3,3
"24710","ab2acbb902cb58b75ceec7d7eb4675f4",46,46,0,46,46,0,1,2
"24711","ab2b8eafc90a02a71186b11190b56411",110,67,58,13.2758620689655,110,0,3,3
"24712","ab306d34030eb740f60e21f289dfd885",154,73,58,18.5862068965517,154,0,3,3
"24713","ab3197e864860f32c2e9a6e5a3348c9a",22,22,0,22,0,22,1,2
"24714","ab326500accf6b513d175c9d4512cba3",205,116,76,18.8815789473684,150,55,3,3
"24715","ab3269198f314d607e68b058fec98d4b",35,35,0,35,35,0,1,2
"24716","ab332fbf12e803190c367b2b09f1c9ca",54,48,51,7.41176470588235,54,0,2,1
"24717","ab33572313e60025bce76caf6f2effcf",26,22,69,2.63768115942029,26,0,2,1
"24718","ab340d03c3c99ba61208db878b770780",3,3,0,3,3,0,1,2
"24719","ab341e446c6d327faa60097301d054e3",161,95,66,17.0757575757576,132,29,3,3
"24720","ab347751febea550cf50e9a2ad2b0b67",156,56,76,14.3684210526316,156,0,3,3
"24721","ab37fb079ca6ca60de370901ca03dd0c",18,18,0,18,18,0,1,2
"24722","ab3a16addd9301cb608d0915cc5c9da1",181,104,69,18.3623188405797,181,0,3,3
"24723","ab3bb40c1efbf2ac105c3c042637c8cd",150,85,77,13.6363636363636,150,0,3,3
"24724","ab3c9b28f99d87fd195aca2958c9c131",57,52,77,5.18181818181818,57,0,2,3
"24725","ab3d71414d9c09a06b86f8737758dd39",41,40,20,14.35,41,0,1,1
"24726","ab3d7b5a1d7cc37bd1f5b268497e86d0",50,50,0,50,50,0,1,2
"24727","ab3e17f9912a3061efaa494d2becdb91",36,36,0,36,36,0,1,2
"24728","ab41ce84eb248479357033ba4e4709fa",16,16,0,16,16,0,1,2
"24729","ab41d78785a34749a9c9a7c147740908",146,94,58,17.6206896551724,94,52,3,3
"24730","ab428a1525c0f4f3d450380e4e675bea",23,23,0,23,23,0,1,2
"24731","ab429292c8c2c47dec0035afa104eaef",11,11,0,11,11,0,1,2
"24732","ab44441ff3346edd1cb550ef1408c709",8,8,0,8,8,0,1,2
"24733","ab4700dc082d60ee02f96b16537281d8",6,6,0,6,6,0,1,2
"24734","ab48531e55209cd64e1536e8b239af3b",66,47,35,13.2,66,0,2,1
"24735","ab48fac50a24f3a8d54f7c9307b3bc0d",17,17,0,17,17,0,1,2
"24736","ab496461668b16032ec30540086e8dcf",18,18,0,18,18,0,1,2
"24737","ab4adc2230efc095d837262fdde7e8e6",15,15,0,15,15,0,1,2
"24738","ab510881c8019741025c1b88944deb04",10,10,0,10,10,0,1,2
"24739","ab53bc53720e9ed13eabdb636d3695a2",38,38,0,38,38,0,1,2
"24740","ab557d585232a957cfed23f0eca7426b",158,102,89,12.4269662921348,108,50,3,3
"24741","ab57133c8abf0dae413b8a5d505ab527",19,19,0,19,19,0,1,2
"24742","ab581e4a51779aca1886fe9b1ddb13f6",78,47,70,7.8,78,0,2,3
"24743","ab5976881b47108cdc5cba3dd855b7b7",33,33,0,33,33,0,1,2
"24744","ab5d4423f2dd26788cd282680aa6b922",33,25,40,5.775,33,0,2,1
"24745","ab5e5e510a24519b7bb5efb8d027e719",95,74,79,8.41772151898734,95,0,2,3
"24746","ab5f6f1478e0880ba15d6d2d210aaae4",60,50,46,9.1304347826087,60,0,2,1
"24747","ab610a6cbf67ccb2e1b04c1d4757a75a",69,44,75,6.44,60,9,2,1
"24748","ab61963dd1b126cd4baab67a5d86f431",11,11,0,11,11,0,1,2
"24749","ab626afb1e676996ee2d3e0eb0e6d930",86,62,85,7.08235294117647,86,0,2,3
"24750","ab630d1ee39b3a6b7d1a9d4f038ac3fd",21,21,0,21,21,0,1,2
"24751","ab640514700e28468bd25424c437c666",38,38,0,38,38,0,1,2
"24752","ab648a08c60e828cc2f2c0175e9b75b7",12,12,0,12,12,0,1,2
"24753","ab667235a45deb4abf098f8ad70c03c8",1,1,0,1,1,0,1,2
"24754","ab66e4a762eb6b5869be9759e5f2cc48",61,11,84,5.08333333333333,55,6,2,1
"24755","ab6832e8cbd969631314ff488967cdf0",26,26,0,26,26,0,1,2
"24756","ab6a3a8264c0637b480133c9632196f2",44,44,0,44,44,0,1,2
"24757","ab6c1c5db22effc8cfc5d4c8fd9943d8",44,44,0,44,44,0,1,2
"24758","ab6e8ef78722bfa8ecfc55492ec91136",41,33,65,4.41538461538461,29,12,2,1
"24759","ab705081cf672991b08c42a5cdc27522",2,2,0,2,2,0,1,2
"24760","ab710416bb075de2f6237b5f9a0f12d8",20,20,0,20,20,0,1,2
"24761","ab7168167616c3b973fc7c17cdc20014",77,61,43,12.5348837209302,52,25,2,1
"24762","ab7380db2de8d9e660e43ca1be21260c",53,53,0,53,53,0,1,2
"24763","ab7453f30b180a9cd64b595c3555eb5b",56,43,41,9.5609756097561,32,24,2,1
"24764","ab75ae89f7132e0255e010e0edb9c112",77,63,28,19.25,77,0,2,1
"24765","ab7a1a8ad90c27eb7bab5f51e8ffe522",76,65,17,31.2941176470588,76,0,1,2
"24766","ab7a8039c5a2a408c8e9494aa0f2b482",31,31,0,31,0,31,1,2
"24767","ab7cdd6347c7eb466d90daaea5b136e5",185,90,58,22.3275862068965,185,0,3,3
"24768","ab7ff75174cbe0378a1c4a0a56646032",95,48,64,10.390625,95,0,2,3
"24769","ab7ffbe039c1f7663dc05f99b637eb17",56,42,31,12.6451612903226,56,0,2,1
"24770","ab8303fe7fd4f99da80f97532548f1ca",31,31,0,31,31,0,1,2
"24771","ab8412c0710e561858494ba09903763d",47,47,0,47,47,0,1,2
"24772","ab84a020f158a8aa3198dbcfd3cd707c",12,7,31,2.70967741935484,12,0,2,1
"24773","ab86c77b7d3f12e5b1d98d4f42d510e1",18,18,0,18,18,0,1,2
"24774","ab882e9711edcbbf3f8cfddf7643c7c7",88,51,71,8.67605633802817,88,0,2,3
"24775","ab89d3ed4a947cd909a6ae86fc212f59",33,33,0,33,33,0,1,2
"24776","ab8a755a1e672a0c2424d538825e15e7",148,87,65,15.9384615384615,148,0,3,3
"24777","ab8ac1cb680381c70a9fadcd13399a83",30,27,32,6.5625,30,0,2,1
"24778","ab8d45a327a7a1b535f8c0b618fe411d",172,100,82,14.6829268292683,123,49,3,3
"24779","ab8fc499e25846e982d13f0c196832a6",98,84,20,34.3,98,0,3,3
"24780","ab91913b20e2e22dd647787cc1b46500",31,31,0,31,31,0,1,2
"24781","ab91b50781bacef5b3e76e9ca6c78cd1",27,27,0,27,27,0,1,2
"24782","ab92226ccd3a97d22e8cd1ec77709dfa",52,45,65,5.6,35,17,2,1
"24783","ab94962b78fc4f9775b91eeae68e77dc",87,73,55,11.0727272727273,87,0,2,3
"24784","ab9502188d0780c1598f3fd47da6e8fd",29,29,0,29,29,0,1,2
"24785","ab9671210a7dc602325c6f80b34088bf",30,26,41,5.1219512195122,30,0,2,1
"24786","ab991e298b808d8ab0d731247d31adea",20,20,0,20,20,0,1,2
"24787","ab9abd29385ec74c1443889c1d2d1e7e",34,30,32,7.4375,34,0,2,1
"24788","ab9bdd999d9243d76d5ad93c777eb6e0",145,75,84,12.0833333333333,105,40,3,3
"24789","ab9eabfa0dc30d424a2b7f71c4ca2405",15,12,45,2.33333333333333,15,0,2,1
"24790","aba1c23cdef0ef56c0df7c3fb2eb3b57",30,26,34,6.17647058823529,30,0,2,1
"24791","aba225da14bb4e2793cdd9ad06384474",146,80,78,13.1025641025641,105,41,3,3
"24792","aba32c7094c49a5fdf03e261fdcdf4c1",45,28,71,4.43661971830986,15,30,2,1
"24793","aba46792d419b835c3c36c5ea63110b8",134,74,63,14.8888888888889,134,0,3,3
"24794","aba4a8b9c66c1f38367cf762f014d30e",89,67,57,10.9298245614035,89,0,2,3
"24795","aba7ebab17f6911fd8c29df5d76b4c69",24,24,0,24,24,0,1,2
"24796","abaae5211dba16b6f3f277db3ea18ece",17,17,0,17,17,0,1,2
"24797","abab09e6c2278b14317f8010ac87b332",127,54,85,10.4588235294118,127,0,3,3
"24798","abac8f00adbee5586e21cd527f54cb13",43,39,26,11.5769230769231,26,17,2,1
"24799","abacf6bc09e8e73110b15093c590be8a",190,44,90,14.7777777777778,141,49,3,3
"24800","abad2b102a80ff4d4acab6a7a4d84546",176,129,63,19.5555555555556,163,13,3,3
"24801","abb01930ea77cc738aed1a9aeb6a4d2b",16,15,5,22.4,16,0,1,2
"24802","abb193aeb6e0d840eb49bde2388f5a99",12,12,0,12,12,0,1,2
"24803","abb224d70bd2618b85e2839da59e005c",239,144,67,24.9701492537313,189,50,3,3
"24804","abb23f86f4877d70b2567e99ff8b658f",95,62,60,11.0833333333333,95,0,2,3
"24805","abb3424eb9a0b1b34553e71bb8efff88",21,21,0,21,0,21,1,2
"24806","abb757a036910823958f301ef742a507",136,96,82,11.609756097561,86,50,3,3
"24807","abb8c683109b99572e2c2d9965441309",76,54,25,21.28,76,0,2,1
"24808","abb9569ce91a14ef9e70f5958e5ff21f",166,86,68,17.0882352941176,166,0,3,3
"24809","abb988dfc3516ea3463cd1428129d287",39,39,0,39,39,0,1,2
"24810","abb9a7b51959fa0149668e79740ad48a",137,91,63,15.2222222222222,137,0,3,3
"24811","abbb24a5253f55e4e87c97c324819b4e",1,1,0,1,1,0,1,2
"24812","abbe3138f6acaff940c86147beb73afa",48,41,49,6.85714285714286,48,0,2,1
"24813","abbf81c957d209d861ba905fbfd80826",17,17,0,17,0,17,1,2
"24814","abc2b7ed27241997ca05832d3f9f4761",113,65,89,8.8876404494382,113,0,3,3
"24815","abc2f81bcb6000995d7f71c4b956a718",27,27,0,27,27,0,1,2
"24816","abc6a2808d9f4315d488520a5a1a0584",128,100,56,16,128,0,3,3
"24817","abc6d4a3856c2b67df062a3e0423d993",8,5,68,0.823529411764706,8,0,2,1
"24818","abcb1714194a0e80d25fe5fd7e964ea9",118,86,75,11.0133333333333,118,0,3,3
"24819","abcff2b37e6451257c92352cc97f83b8",77,65,22,24.5,40,37,2,1
"24820","abd02639aa9d58a7e6c4377ee38c863c",20,20,0,20,20,0,1,2
"24821","abd182678a2255f87e95ba1a15400d44",29,29,0,29,29,0,1,2
"24822","abd1a281a6bc8c90906ba69dfd7716e7",41,37,42,6.83333333333333,41,0,2,1
"24823","abd72eff4fe7eca529700ad8969f450c",50,40,40,8.75,22,28,2,1
"24824","abd76517bb3ad017412de0306c28a251",173,115,81,14.9506172839506,128,45,3,3
"24825","abd875ad3e363893d9842f43900c6f68",18,18,0,18,18,0,1,2
"24826","abdacea018c87fe46efd13212d90ae95",106,74,77,9.63636363636364,106,0,3,3
"24827","abdb09470f0d22ea0aef6711fe1f704c",17,17,0,17,17,0,1,2
"24828","abdd0405deb9446b42c11eab39dfe72b",8,4,55,1.01818181818182,8,0,2,1
"24829","abdfc1d0227b72d804e63504db1cbdc2",76,49,52,10.2307692307692,76,0,2,3
"24830","abe1d3045a43432fc93fc47602cc0a24",72,50,37,13.6216216216216,53,19,2,1
"24831","abe20bc17f4aafb2c6d89ebc4ae11c8d",54,54,0,54,54,0,1,2
"24832","abe578c59477beb712d60e13e1cda43b",120,78,63,13.3333333333333,120,0,3,3
"24833","abe81c7c0ae7b97c7c39df8ff42e9a54",48,33,65,5.16923076923077,48,0,2,1
"24834","abe8ee152566f3cb8eae59cf2dbbb06f",138,78,63,15.3333333333333,138,0,3,3
"24835","abe8f77fde82ef9e31d5f9cab8ac409c",69,44,71,6.80281690140845,69,0,2,1
"24836","abea7fdb6cbe92ecfb909dce82b0de8f",31,31,0,31,31,0,1,2
"24837","abed6e41626024e439d8fca7abdd14b0",67,52,57,8.2280701754386,67,0,2,1
"24838","abef33a2ee61b2d2188bf43cf8175fe1",96,50,71,9.46478873239437,45,51,2,3
"24839","abf003cd10a2f2c91984af0744548385",55,46,25,15.4,55,0,2,1
"24840","abf00e66f695851e6650959e507ad765",18,18,0,18,18,0,1,2
"24841","abf3885ed705320fff4ffd54fdc9e2bb",5,5,0,5,5,0,1,2
"24842","abf4bd1d861a9edd2b4b9ae63b553bad",15,15,0,15,15,0,1,2
"24843","abf4c8376d7f3c75c8d5cb7426d5d712",161,102,55,20.4909090909091,161,0,3,3
"24844","abf652d9286f62afa4355a2e7f8745aa",56,52,61,6.42622950819672,56,0,2,1
"24845","abf6c1b9f9fbb288e4c1ec74055b37dc",15,12,54,1.94444444444444,15,0,2,1
"24846","abfa5c7fe3f3e5aa74974087e99503a8",46,39,23,14,46,0,2,1
"24847","abfc942c0e97a49d52723d965aa044e3",81,62,24,23.625,81,0,2,3
"24848","abfd27a3233b5197ba64a2868629093e",7,7,0,7,0,7,1,2
"24849","abfe1ce8456a3b77a687c47bc6fc7c1d",36,36,0,36,36,0,1,2
"24850","ac00a5a61c871ea2aff1f541bf9891a0",97,78,34,19.9705882352941,97,0,3,3
"24851","ac08f7a9bb103939a62fbc1336834501",48,48,0,48,0,48,1,2
"24852","ac09b7508a25bdb6b0ceca0eb731fd02",179,92,43,29.1395348837209,146,33,3,3
"24853","ac0a747492fb40e9794175ec38ea6fc8",164,128,28,41,164,0,3,3
"24854","ac0c754c1bf39c36e80f6ed9fd3e3fe5",65,61,52,8.75,46,19,2,1
"24855","ac0d2d5cf541c8b36f8ad24deff58200",13,13,0,13,13,0,1,2
"24856","ac0df733f1cbdf4e05481cc7d8266e88",15,15,0,15,15,0,1,2
"24857","ac0eb4bc807291fb2455a530f86bc1fa",110,74,82,9.39024390243902,110,0,3,3
"24858","ac0fc3431a695bd444dceca7cdb4960e",32,32,0,32,32,0,1,2
"24859","ac1383ec386871d12b41f7973d1d854b",33,33,0,33,33,0,1,2
"24860","ac16660349c0c1380c2d9afc4fb9e150",35,35,0,35,35,0,1,2
"24861","ac1abbf6f498d4b0e1163b65ebfe9623",53,53,0,53,53,0,1,2
"24862","ac1d2aaed6d6c094cab7e9396c8de54e",49,48,26,13.1923076923077,16,33,2,1
"24863","ac1e6f7455be95d84d40bfb68f35445f",163,84,78,14.6282051282051,163,0,3,3
"24864","ac2006a24d91aa41a1e94d3dfeabf073",26,26,0,26,26,0,1,2
"24865","ac245badd3bb36bd855712f05f432aa6",177,111,69,17.9565217391304,177,0,3,3
"24866","ac25a0cd9380f3b5f9558b873daeefb9",35,30,56,4.375,35,0,2,1
"24867","ac2862c4eda00d06369a1c4129a46086",13,13,0,13,0,13,1,2
"24868","ac2886ed0249257f2c33152eb96d6886",239,126,61,27.4262295081967,203,36,3,3
"24869","ac2af6da263cc6d302f12adfd4ee02f4",94,61,64,10.28125,67,27,2,1
"24870","ac2bfd048f142b3ef7007df62bfaa488",85,65,22,27.0454545454545,85,0,2,2
"24871","ac2eee4e73a314a8d933d7beb4047066",37,37,0,37,37,0,1,2
"24872","ac2f9a45e2812ad8521f233335b726e8",13,13,0,13,13,0,1,2
"24873","ac307e22656240fa6d85286fed9e4e6f",141,53,70,14.1,141,0,3,3
"24874","ac3099758e7b7f8b19c9502920b0518d",112,68,75,10.4533333333333,112,0,3,3
"24875","ac32d0468e42495f7146c6b728676276",145,70,62,16.3709677419355,145,0,3,3
"24876","ac36ac08484b6df53af30ac047520642",39,33,12,22.75,14,25,1,1
"24877","ac397f88f5d99c4f82f4449122565499",27,27,0,27,27,0,1,2
"24878","ac3a63649a254dfbb36c747e10240add",46,46,0,46,46,0,1,2
"24879","ac3e46d3694b55e08a213e171540ea49",113,85,17,46.5294117647059,68,45,3,3
"24880","ac3e8ce8cb2df6343b1a0627aefe6582",122,77,58,14.7241379310345,122,0,3,3
"24881","ac422074bb1c708ce6b5b99286be71d8",39,34,62,4.40322580645161,39,0,2,1
"24882","ac43a73e2e3999878e59043879aa3690",39,39,0,39,39,0,1,2
"24883","ac4489cb5ed07a93ddf23a2ce4446eb3",75,60,15,35,75,0,1,2
"24884","ac4663555f7977df4a28da9222165748",57,45,41,9.73170731707317,57,0,2,1
"24885","ac47ee5f3ca28f044b5af48ce6d9286a",116,84,31,26.1935483870968,116,0,3,3
"24886","ac4b80106dfc065e7e3efc60a5cccfad",1,1,0,1,0,1,1,2
"24887","ac4e7298d0e0fff0d3f8374c4fa326b0",152,101,62,17.1612903225806,152,0,3,3
"24888","ac4e9608e280ed1a2cabe8de949a7dd0",39,39,0,39,0,39,1,2
"24889","ac524323f588ddbc9db090e9f5b49364",54,34,28,13.5,54,0,2,1
"24890","ac54ff0edc055b2a9cf190b561154afa",182,93,65,19.6,182,0,3,3
"24891","ac5504ae3d1ae4ce8a32e18ca0610d4f",11,11,0,11,11,0,1,2
"24892","ac5579b21c3c0b50c7f8e77b882f6cfb",1,1,0,1,1,0,1,2
"24893","ac58fa4f124d2289b241ca4e66569e7b",13,13,0,13,13,0,1,2
"24894","ac5cec3d6348331c20ffcc77c24d8f82",111,73,57,13.6315789473684,83,28,3,1
"24895","ac5d8c0ede982e08b162c23446a98cbe",132,82,77,12,132,0,3,3
"24896","ac5ef2f17b49e7b07bcd8235ae671d7d",15,15,0,15,15,0,1,2
"24897","ac611e1cb22cbcf17b7394cb45d6813e",70,37,57,8.59649122807018,70,0,2,1
"24898","ac624c8088e95331c6638ac35d75435e",103,73,40,18.025,103,0,3,3
"24899","ac646afad24ca2292bedb9c7aeb47c4e",97,74,20,33.95,97,0,3,3
"24900","ac658cb1ba87735f69f7989ee4e062cd",214,134,75,19.9733333333333,214,0,3,3
"24901","ac66f36dd972520312877a1743f561bc",15,15,0,15,15,0,1,2
"24902","ac6735ccef1f024b8ecfa65e49fc573b",18,18,0,18,18,0,1,2
"24903","ac689d310f860a2d29a46f5131c2647b",22,19,64,2.40625,22,0,2,1
"24904","ac69f13cc70f13fddcf44549810133cd",111,87,75,10.36,111,0,3,3
"24905","ac6b8418184e9d7e3e83fcb94e133fd4",12,12,0,12,0,12,1,2
"24906","ac6d7802aee36129bcc3036a37c3e30c",15,15,0,15,15,0,1,2
"24907","ac6ed3032f49727e28a7cc93bc250b52",31,31,0,31,31,0,1,2
"24908","ac6ef40cef437d723bf410d3a324c2b8",69,58,69,7,69,0,2,3
"24909","ac70d7b19bfbe775f8eb2f4a856a5c03",11,11,0,11,11,0,1,2
"24910","ac7156edd0540affce72b950454ecdfd",35,25,56,4.375,35,0,2,1
"24911","ac755641b2de13b734f857a868f8d737",104,81,35,20.8,104,0,3,3
"24912","ac75ad7c4c93890815fe3f99014572ab",16,16,0,16,16,0,1,2
"24913","ac7606347ad25478eaaa9825b703d65a",40,40,0,40,40,0,1,2
"24914","ac792876092bbbe92a4510f4a3ddfa84",15,13,31,3.38709677419355,15,0,2,1
"24915","ac7c8fa51b4fc6855b7fbdb946a6582f",27,27,0,27,27,0,1,2
"24916","ac7d29e3cf8430e748c823fa58812b65",36,36,0,36,36,0,1,2
"24917","ac7d4a421f69248a8d3b982d76e67a38",96,72,57,11.7894736842105,96,0,2,3
"24918","ac811be2c0f0fa55a626ba9604eaf3f5",143,90,84,11.9166666666667,125,18,3,3
"24919","ac821cd67fd60a9df21c8ca6a7678776",45,45,0,45,0,45,1,2
"24920","ac8504d0ba4ac094025496bd3e051354",20,20,0,20,20,0,1,2
"24921","ac860ccf35aeb201ec20b16205a24cf0",40,37,50,5.6,40,0,2,1
"24922","ac866ac759268918b13b2af0a5373bf5",44,44,0,44,44,0,1,2
"24923","ac86f38569c6f489755e274a6f62a65f",73,69,24,21.2916666666667,33,40,2,1
"24924","ac893cbe646de35213777bbf7ae34668",32,32,0,32,32,0,1,2
"24925","ac8c65a212ff65bb77741f1632e4c172",93,70,35,18.6,93,0,2,3
"24926","ac8fa4bf557f5951b0dc981a900b011d",32,32,0,32,32,0,1,2
"24927","ac90321207012dcab8b8b649bd8fd821",6,4,74,0.567567567567568,6,0,2,1
"24928","ac916222d0800520517990cb91514d8d",20,16,6,23.3333333333333,20,0,1,2
"24929","ac931ec127761ee57e636cf3d390748b",45,45,0,45,45,0,1,2
"24930","ac932454a4f044405152f6e2a8ab8c45",15,15,0,15,0,15,1,2
"24931","ac96b5c71845a701158289b0191e3160",50,40,42,8.33333333333333,50,0,2,1
"24932","ac9730b0b4ccdf05ba0ff7f3c3267886",34,34,0,34,34,0,1,2
"24933","ac9771a1bdbbae881abdc1d0ca6efc6d",30,30,0,30,30,0,1,2
"24934","ac978ce65058018a498c9e44ccc58d70",127,84,71,12.5211267605634,79,48,3,3
"24935","ac986effc439b7c49c51863bc2cc62a9",107,73,77,9.72727272727273,107,0,3,3
"24936","ac9aa48e37eb32b0804ef797aa19d3a3",35,35,0,35,35,0,1,2
"24937","ac9ef4b7a3f200bb0f7c14cf0eeb3ede",14,11,74,1.32432432432432,14,0,2,1
"24938","aca30afae48ff77044e7a465ab884b3d",30,30,0,30,30,0,1,2
"24939","aca3a92b32249df156eaba6bf11667a0",20,20,0,20,20,0,1,2
"24940","aca5d2b7a6fb1c8fb88fc3e98406ea45",49,43,78,4.3974358974359,49,0,2,1
"24941","acaa578821c8db622a6d2e16c7c2ee99",61,35,80,5.3375,61,0,2,1
"24942","acab9aa157e098aac7aa56c9f834ab70",126,113,38,23.2105263157895,126,0,3,3
"24943","acabbc82c6176d616916b8633315f566",98,67,61,11.2459016393443,72,26,2,1
"24944","acacfb75b40b300f973bd64e90d29cf4",28,21,25,7.84,28,0,2,1
"24945","acad4314033ccd275c9100235a7c2be5",193,120,67,20.1641791044776,193,0,3,3
"24946","acadefd3c0bcec066c3ca65fc2e02a56",50,50,0,50,50,0,1,2
"24947","acae70766318be220dd2b5eb35a3d230",10,10,0,10,10,0,1,2
"24948","acaf5844363de37faaa7a195e575c1c4",22,22,0,22,22,0,1,2
"24949","acb07ec6a2abe4f3514c9b7ba6aba45a",50,50,0,50,50,0,1,2
"24950","acb2e1333d2dc4d4a304b1b05752a137",11,8,43,1.7906976744186,11,0,2,1
"24951","acb35f72ea81b210e5a162d04c6dbc70",9,9,0,9,9,0,1,2
"24952","acb3d0106497141c2044e66176a114d3",47,47,0,47,47,0,1,2
"24953","acb7599ce41f7d02b3fbcb728e5cdb31",20,20,0,20,20,0,1,2
"24954","acbd0f667c775552dbd7f993ff504dcf",20,20,0,20,20,0,1,2
"24955","acbd9cd1a4a5194fe98d546962ddfdec",49,36,70,4.9,49,0,2,1
"24956","acbda8b1351372dba0311f4f89176ddb",156,46,85,12.8470588235294,134,22,3,3
"24957","acbed9ec5efefe5ae82d123be090658a",28,28,0,28,28,0,1,2
"24958","acbef70e765c94914e0f7d761542121c",73,59,70,7.3,73,0,2,3
"24959","acbf61167131f78b947f1d8661f1b36d",50,50,0,50,50,0,1,2
"24960","acbfcf58de5aae51ff867bab76cd6f8d",93,65,63,10.3333333333333,93,0,2,3
"24961","acc1e1a4bde8310710f1eb19249abde0",51,51,0,51,51,0,1,2
"24962","acc6cd73a84067d04192b79c0f2974ff",16,16,0,16,16,0,1,2
"24963","acc73a9da75690745a6804e1d390e3df",23,23,0,23,23,0,1,2
"24964","acc789302b0cc063bcc2f19d274fe8cc",48,29,6,56,48,0,1,2
"24965","acc7c00e8bcece2a2ab886a3fad59b40",73,42,35,14.6,73,0,2,3
"24966","acc7da6a888441618063bf866278a73c",19,19,0,19,0,19,1,2
"24967","acc8ddb7f9c79f2b4c1757654b2f4760",106,66,22,33.7272727272727,106,0,3,3
"24968","acc907802574c534df834b8d477aa817",33,33,0,33,33,0,1,2
"24969","acc986cd336ed8bef5ea85f8fd542e46",63,38,56,7.875,63,0,2,1
"24970","acca34e73c8584cc39a779c9c5b37d2c",4,4,0,4,4,0,1,2
"24971","acca8885493fd61c4d5a07089a870883",20,20,0,20,20,0,1,2
"24972","accc8116ca900de0c7eeed7b39f6a7da",14,14,0,14,14,0,1,2
"24973","accf896ab31e47e75788af93fbfffccf",24,24,0,24,24,0,1,2
"24974","acd22fb20056a76a68baa9b04aa46b1c",47,47,0,47,47,0,1,2
"24975","acd3223893add09c0f6e4f151067ddee",10,10,0,10,10,0,1,2
"24976","acd3c669ff6160c2f9f44876390140c2",41,38,63,4.55555555555556,30,11,2,1
"24977","acd70379bbee83acbf7cd8e3b364471c",135,102,68,13.8970588235294,135,0,3,3
"24978","acd7620a5c6bbad31c5cdff7ec0da87c",26,26,0,26,26,0,1,2
"24979","acda2c056a69eb0cb73436607d35af08",144,115,62,16.258064516129,144,0,3,3
"24980","acdb33e6624123c19c884da57edcf504",95,85,64,10.390625,95,0,3,3
"24981","acdb655d384760fae14e81ad6e2b1b92",33,33,0,33,0,33,1,2
"24982","acdb804cf0d0628eb4fd154b2b4e8737",44,39,33,9.33333333333333,22,22,2,1
"24983","acdfa9e3c55cd5c531f4bbb48af12ac8",223,98,71,21.9859154929577,187,36,3,3
"24984","ace28a68b07f8634403290e14113ae63",103,86,48,15.0208333333333,58,45,3,3
"24985","ace2a0e85c4710c66485aa2f7821d032",40,40,0,40,40,0,1,2
"24986","ace51db13bec22ef487041c0c79552ba",157,105,85,12.9294117647059,157,0,3,3
"24987","ace67cb16da068f7396288e162e8454a",2,1,52,0.269230769230769,2,0,2,1
"24988","ace885e58560cd85ad78d10a08afb744",170,94,55,21.6363636363636,170,0,3,3
"24989","ace93589fdcf13ec56cc14c10af0e6e2",116,97,54,15.037037037037,116,0,3,3
"24990","acea51e0ddc6ce3d2b94e956f4e56583",98,90,42,16.3333333333333,71,27,3,1
"24991","aceb97c84e39ad5912be68628b4c9cc5",109,99,63,12.1111111111111,109,0,3,3
"24992","acec3d7de665722e7605e56ab4eb1cd4",16,16,0,16,16,0,1,2
"24993","aced83b2b12b20d3a3c6c45a65397ae6",31,23,13,16.6923076923077,31,0,1,1
"24994","acef5542d4516d14e7b2c101bbf40661",33,33,0,33,33,0,1,2
"24995","acefc068174a0c8d5aad4909738b60df",80,58,69,8.11594202898551,80,0,2,3
"24996","acf25227eb11fcc65a300ada593dcb74",2,2,0,2,2,0,1,2
"24997","acf28f0d1ad1a76e775e480cac437023",37,37,0,37,37,0,1,2
"24998","acf2a4377b64f6c9353b8f9ef13c1abc",2,2,0,2,0,2,1,2
"24999","acf4e0f74dca4617937577cea55792a9",122,80,48,17.7916666666667,93,29,3,3
"25000","acf6b1014d01c93af98a9694a6b0400c",133,86,81,11.4938271604938,80,53,3,3
"25001","acf6f71d29ed5f24788033ed86af629e",113,75,50,15.82,113,0,3,3
"25002","acf7c85b96437d2ecf31b77e4a882253",160,69,75,14.9333333333333,120,40,3,3
"25003","acf9f7eb3a1bf7008bb6c2961b862e74",76,52,61,8.72131147540984,50,26,2,1
"25004","acfa6e1010eb67d38a01b6b3fe367c1f",90,77,49,12.8571428571429,90,0,2,3
"25005","acfd0786fe03f68e05c6dcb323d19727",19,19,0,19,19,0,1,2
"25006","acfd3281f8ed2f1e5db0be4f37cab95b",25,25,0,25,25,0,1,2
"25007","ad00059a7f2e241ae46f5e93b98027fe",52,52,7,52,52,0,1,2
"25008","ad00896e303b61e98b5f912e67c0c3d5",27,27,0,27,27,0,1,2
"25009","ad01610fe60bda661e1b0d9dc951c831",182,114,27,47.1851851851852,182,0,3,3
"25010","ad02043f48c2f2325ebbcabb920ddb8a",100,57,57,12.280701754386,100,0,2,3
"25011","ad022f39a7c5ef0060f50b33beffe245",15,15,0,15,15,0,1,2
"25012","ad03f816913749b6552e713cfa962d96",3,3,0,3,0,3,1,2
"25013","ad0945afeda74bd47408a382c63d530a",49,42,35,9.8,0,49,2,1
"25014","ad095adb2ce10c8797bcdd1e285f8214",56,32,82,4.78048780487805,56,0,2,1
"25015","ad0c0c1a2af6b8953f0a147dbe04445b",71,56,39,12.7435897435897,71,0,2,3
"25016","ad0dd16e4c80f26a5324ebe319bd5218",157,70,75,14.6533333333333,157,0,3,3
"25017","ad0fabd1fbb311a3096c92c116354696",38,38,0,38,38,0,1,2
"25018","ad102986e8aae15711352282493fc8a2",96,73,37,18.1621621621622,52,44,2,3
"25019","ad12c6ecd292beb21cb4cd666077b672",97,69,81,8.38271604938272,84,13,2,1
"25020","ad164a9f70f26000569317803c8c5c8b",52,43,64,5.6875,52,0,2,1
"25021","ad1710b6df454b1cdb13599401fd0df4",9,9,0,9,9,0,1,2
"25022","ad187c04b0efecd9821e7e3feba97f78",15,15,0,15,15,0,1,2
"25023","ad197395547c5be2e22d5476b2c11936",25,25,0,25,0,25,1,2
"25024","ad199b596c572cbc714b06aebb930477",29,27,28,7.25,29,0,2,1
"25025","ad1e3532207c51cea777f85a6e00f18a",29,29,0,29,29,0,1,2
"25026","ad1fbd9396a94a329563ac0c59b474e6",15,15,0,15,15,0,1,2
"25027","ad1fccb10d6f9bc38663bf943a0be7a8",78,56,17,32.1176470588235,78,0,1,2
"25028","ad204d130be42b90c7c41393be907084",17,17,0,17,17,0,1,2
"25029","ad250321875c3a15f0cb46618c0cc829",32,22,57,3.92982456140351,32,0,2,1
"25030","ad250e4fffaffecd7138430a89b82cef",53,53,0,53,53,0,1,2
"25031","ad257a8e1a81672465c3da1bb9e49d76",21,21,0,21,21,0,1,2
"25032","ad264660eb75fc834fcfa2deccb21d7c",214,88,63,23.7777777777778,214,0,3,3
"25033","ad28fe33fb6d17725a163bb2fb7cf422",20,20,0,20,20,0,1,2
"25034","ad2ce5a2b2a70924db1177e2017ae59d",71,60,34,14.6176470588235,71,0,2,3
"25035","ad2d124d51a944a1d4ff72dffb7495df",91,55,63,10.1111111111111,91,0,2,3
"25036","ad2de96f12e5a0546bf224cf4528e80e",72,52,50,10.08,72,0,2,3
"25037","ad310f176ea8ad472d7ebec72096e616",22,22,0,22,22,0,1,2
"25038","ad31d13fa9e122391e01583d26b6b37a",113,100,77,10.2727272727273,113,0,3,3
"25039","ad31eb944862461dfddbda0a425ea1ab",69,50,25,19.32,31,38,2,1
"25040","ad343149cc133e244dd9d286b123ca32",37,28,68,3.80882352941176,37,0,2,1
"25041","ad35b97b631be0410be5c1dbf22740cc",28,28,0,28,28,0,1,2
"25042","ad363a001215624d050ffc1834e00926",43,43,0,43,43,0,1,2
"25043","ad3735b5f365eaec418b7faaa07d1452",29,29,0,29,29,0,1,2
"25044","ad3791a0e7d9a1d0787b88675f88b1e1",20,17,19,7.36842105263158,12,8,1,1
"25045","ad3ca770f7389f0fe4ef6174d04f976a",152,76,72,14.7777777777778,152,0,3,3
"25046","ad3d0cc5308ccf9c5f322d6c516097dc",14,14,0,14,14,0,1,2
"25047","ad3f6dee80a60fe7a8fda8c44b06e453",32,25,28,8,0,32,2,1
"25048","ad40191e0321785ebbbe41d1542894de",39,39,0,39,0,39,1,2
"25049","ad40991ba5efaa9a3105a53f9c3af705",102,79,17,42,102,0,3,2
"25050","ad43a25845cc1a2fa6680fa179433da7",145,76,89,11.4044943820225,103,42,3,3
"25051","ad4743c5c951c9806d19f332142f4f2a",45,45,0,45,45,0,1,2
"25052","ad47cb4b02e9ab337a79621f7b3d1fc0",178,102,56,22.25,138,40,3,3
"25053","ad495d0cd8002940dcc793853faa20ad",12,12,0,12,0,12,1,2
"25054","ad52c57b6b206a104fc3f3a59f3f06a5",26,26,0,26,26,0,1,2
"25055","ad55f1c1af33d7a14f552c73aad8f001",84,75,49,12,84,0,2,3
"25056","ad5b184c6c8e0601314c2dacd78eec64",171,99,81,14.7777777777778,157,14,3,3
"25057","ad5f14ec7495c07345b9feaebc024f8f",52,42,26,14,24,28,2,1
"25058","ad61765a3ae93a9cd29e27e18f990dbc",142,111,71,14,142,0,3,3
"25059","ad62a70b3a652e18fc713772a72ae2a5",53,34,42,8.83333333333333,53,0,2,1
"25060","ad62e5de8ba98133daad0f39168af1f4",23,23,0,23,23,0,1,2
"25061","ad63500452d74ee8c1d36193d5ffdd95",133,85,49,19,133,0,3,3
"25062","ad63f49a3eec8f587853de72fc47fa12",15,15,0,15,15,0,1,2
"25063","ad669cf1d384600fb528c9ae44ddccfa",76,57,37,14.3783783783784,58,18,2,1
"25064","ad680a132372141deede5d6e2cf5cd78",32,32,0,32,32,0,1,2
"25065","ad69e9b716e34cf4833ec3c9e898ce2d",61,46,63,6.77777777777778,61,0,2,3
"25066","ad6f0dca4c121f7bfb8977eb42d0bada",126,92,56,15.75,126,0,3,3
"25067","ad710462be606c7083759ce13ec30088",26,26,0,26,26,0,1,2
"25068","ad72b7d793d4ea2b27664501dfc62401",13,8,68,1.33823529411765,10,3,2,1
"25069","ad74c3f9d319006fbe3cf3cdcb7607cb",113,66,77,10.2727272727273,113,0,3,3
"25070","ad7e058089c00f8d37115b14b1b8fb4c",62,38,40,10.85,62,0,2,1
"25071","ad7e2889e74c8ced07051d8b0911bdd3",31,31,0,31,31,0,1,2
"25072","ad7e5133636c3cf9aeddbbac913e7e9b",102,71,38,18.7894736842105,49,53,2,3
"25073","ad7f59e5775dfb586751dcc2774144c0",30,23,39,5.38461538461539,30,0,2,1
"25074","ad7fa0e0d1ede09d00de0f0061ee479e",29,29,0,29,29,0,1,2
"25075","ad801585287878dec9cece52e4b1f38d",22,22,0,22,22,0,1,2
"25076","ad822db84d3965942b2b8966a0ef6e4a",28,28,0,28,28,0,1,2
"25077","ad823b21b0e0cbedea979889a9b4d3ea",88,76,71,8.67605633802817,88,0,2,3
"25078","ad82dccbafe0f5999711375952b07e56",52,52,0,52,52,0,1,2
"25079","ad8530002c688ff4fc39155d1960c320",150,107,87,12.0689655172414,150,0,3,3
"25080","ad878540b8172d46e25a569bf87b0532",40,33,55,5.09090909090909,40,0,2,1
"25081","ad8a6e6e1fb1b9b582fdcf1b18486615",39,39,0,39,39,0,1,2
"25082","ad8aaa179b8b7e3157de267d5a495434",110,81,61,12.6229508196721,110,0,3,3
"25083","ad8ae3e2a26a27b0fbfeb57227834cba",32,32,0,32,32,0,1,2
"25084","ad8c4e1f4f4e1181e0b23602305d01fc",110,82,66,11.6666666666667,110,0,3,3
"25085","ad8d50525f3a27739e6c1570ec9079f3",44,44,0,44,44,0,1,2
"25086","ad8ee145c2ae0bbb5b6f917f97f2b7e7",30,22,59,3.5593220338983,24,6,2,1
"25087","ad8fd42de4d2eef4df57050dc42a2c98",218,94,58,26.3103448275862,218,0,3,3
"25088","ad901f8f221756b0bfe5408f52759d43",34,34,0,34,0,34,1,2
"25089","ad92c790f3cb8976776c6d5abb21c95b",20,20,0,20,20,0,1,2
"25090","ad9448a3c85162626729287fcbcfe174",32,32,0,32,32,0,1,2
"25091","ad94777285c34182ac314abc4bece523",37,37,0,37,37,0,1,2
"25092","ad962e878b91cdc95eda2102f66e7357",34,34,0,34,34,0,1,2
"25093","ad963b4ba603df3a5cc6fbc1be108f62",125,63,68,12.8676470588235,125,0,3,3
"25094","ad976216ea97626fb1f4b1e8798d38d8",34,34,0,34,0,34,1,2
"25095","ad97e6cd0f24623a6e9b13d07eafa817",10,9,64,1.09375,10,0,2,1
"25096","ad9ebb783e7d6c4d137ecee246f23f36",21,21,0,21,21,0,1,2
"25097","ad9f9c6f14ef431acfd2b801261464b7",52,52,0,52,52,0,1,2
"25098","ada2c4c9e3932cc3bc9f9b12d7b3d55b",30,30,0,30,30,0,1,2
"25099","ada3a9e8b099f93fd20bfd634a2a4f3f",21,21,0,21,21,0,1,2
"25100","ada6d91a5202c8e3179d06d57fe69a14",135,73,83,11.3855421686747,135,0,3,3
"25101","ada77a33f015db5288acf19b4548f281",36,36,0,36,36,0,1,2
"25102","ada7d6ee08cb97a32ce638353cf9d3b7",10,10,0,10,10,0,1,2
"25103","ada831414e128c4ca12ff4ccadda4688",62,43,44,9.86363636363636,62,0,2,1
"25104","adab215fe651b5ea2c9eba3519fc5697",20,20,0,20,20,0,1,2
"25105","adab614526eb1dbcc76744e75bfa129d",19,19,0,19,19,0,1,2
"25106","adab9d91d2e8fef6ea57f7bbf19dc36d",74,50,27,19.1851851851852,74,0,2,1
"25107","adac617bc05d2c163204cf24958d3ccd",25,25,0,25,25,0,1,2
"25108","adac7bf6a5c44c0389237218bb7515f9",183,100,55,23.2909090909091,183,0,3,3
"25109","adad0e36de90c10f9c8040c8c51cc0bf",53,53,0,53,53,0,1,2
"25110","adb137d16e10cea520bf70d15681e8c0",95,76,70,9.5,60,35,2,3
"25111","adb157624fd2103807e3d79a14d6d64a",96,37,75,8.96,96,0,2,3
"25112","adb24c3606b474118e2a17c0f6c4f234",16,16,0,16,16,0,1,2
"25113","adb2bf4116ac022aaf42d775ccb93fe7",36,36,0,36,36,0,1,2
"25114","adb3f63b0406fc90fb49a83e9e2cb25a",48,48,0,48,48,0,1,2
"25115","adb77396a2b4069b6aea8b32a4b983a7",36,36,0,36,36,0,1,2
"25116","adb843dfeb7935b5222e07c5c4a8d386",105,62,89,8.25842696629214,105,0,2,3
"25117","adb9abcb98f14c8729898fcacf8a94d7",95,62,57,11.6666666666667,95,0,2,3
"25118","adba64bbe019e5141257fcaa88f849a9",19,19,0,19,0,19,1,2
"25119","adbaccce3af675c9037f1dce7a0df571",52,44,33,11.030303030303,52,0,2,1
"25120","adbb8d54bc69f23d4ca583b15f7e17c4",51,51,0,51,51,0,1,2
"25121","adbbcf56e0621e3b5a07e93d84da948e",28,28,0,28,28,0,1,2
"25122","adbbfb1953bf9c1b66316a5b960415c6",110,77,53,14.5283018867925,110,0,3,3
"25123","adbed4339c9bd74202c6f395a6bdf4f6",13,13,0,13,13,0,1,2
"25124","adbf3a78bbdf9674d77c2de157e5b96f",59,34,61,6.77049180327869,19,40,2,1
"25125","adc0989ba513d1841e1b4702e942d300",74,64,37,14,46,28,2,1
"25126","adc1299e1895eedf84315533b3791eb3",22,18,14,11,10,12,1,1
"25127","adc51bcdbe0c15c97b4c6c5ffbdcba10",137,73,74,12.9594594594595,89,48,3,3
"25128","adc7f13c65e76732a86fb1350fea7037",53,48,37,10.027027027027,53,0,2,1
"25129","adcb15c764e2b564f8160f238c72d943",205,108,84,17.0833333333333,205,0,3,3
"25130","adcbc64b5ed4bb1bc9bd92fbe334d37b",241,90,58,29.0862068965517,196,45,3,3
"25131","adcc88aa47e817f5cfefe6794e05f3df",41,41,0,41,41,0,1,2
"25132","adcca79ccf3ffe565366c4c557753020",25,25,0,25,25,0,1,2
"25133","adcfa7af34e2d869acd5c44eb97e6770",232,95,63,25.7777777777778,211,21,3,3
"25134","adcfdaa6ee68c87629d90dda8ab97848",25,15,75,2.33333333333333,25,0,2,1
"25135","add50b5790a8866ca9cbf2d39269bf07",73,64,67,7.62686567164179,73,0,2,3
"25136","add5ca64968f770cdbf4543cd29af491",77,44,67,8.04477611940299,77,0,2,3
"25137","add6b43af8cdf17641fc8326f783219f",80,64,43,13.0232558139535,80,0,2,3
"25138","add70ed2a36c68ac56256fe762f9549f",44,42,67,4.59701492537313,44,0,2,1
"25139","add78d0fd45ef06645bee01728a00fed",151,92,75,14.0933333333333,109,42,3,3
"25140","add8007f7cc2ea0f4daddf3113d59e00",12,12,0,12,12,0,1,2
"25141","add97a8d7aa1097c2127564e4f1ec31f",122,85,71,12.0281690140845,105,17,3,3
"25142","addccb62370430993c9a416d3f18ec3e",44,35,38,8.10526315789474,44,0,2,1
"25143","addd5694b552a7c83891a4bd99f985b1",39,39,0,39,39,0,1,2
"25144","addefc41b2cb6e8de70f234f67b05fa5",62,42,48,9.04166666666667,62,0,2,1
"25145","addf0b61370b45308e79b884c87876a1",25,25,0,25,0,25,1,2
"25146","addfb00e1520d9a7ea3813228f6d37a0",22,22,0,22,22,0,1,2
"25147","ade0bd603ed29442d7d62a98bdc2775b",26,26,0,26,26,0,1,2
"25148","ade27593876ae0ca6defcf08a300c5c1",68,59,78,6.1025641025641,68,0,2,3
"25149","ade48efa9f8efff30cf59316b800af87",38,38,0,38,38,0,1,2
"25150","ade828cdda7cabeae0273c34e3b5967f",17,17,0,17,17,0,1,2
"25151","ade8460438f9cf18a3a099dea7529e1a",33,33,0,33,33,0,1,2
"25152","ade870cc5cbdfbec29b0e552e2a32b8e",23,23,0,23,23,0,1,2
"25153","adecd222ad083c64c4dbc32bb1622c9a",31,31,0,31,31,0,1,2
"25154","adef8899c5b7d9412e6e2cd7d34f1704",12,12,0,12,12,0,1,2
"25155","adf0fcd11f024702eae5e09dc61dddc1",38,25,67,3.97014925373134,20,18,2,1
"25156","adf1d14e018708c10a4b4b27d278a101",32,20,62,3.61290322580645,29,3,2,1
"25157","adf2cc25c883f45d791ae778da14c15c",142,91,44,22.5909090909091,105,37,3,3
"25158","adf3b62606b8e7eccc7df585ea9ae67a",22,22,0,22,0,22,1,2
"25159","adf3fe457fc74ad8b6252ea5b2bd25d7",123,56,90,9.56666666666667,123,0,3,3
"25160","adf5a4795b5c251e9e2aab0ea5ee4967",87,58,61,9.98360655737705,52,35,2,1
"25161","adf79bd0fad6591a0a61a856054850a2",15,15,0,15,15,0,1,2
"25162","adf7fcdb67818dd750e606f3d4c06638",220,110,89,17.3033707865169,194,26,3,3
"25163","adf85efc87c1eab154b4bcd210bff626",15,13,9,11.6666666666667,15,0,1,2
"25164","adfa925c003e39cb8504c1e74f35463e",123,70,57,15.1052631578947,123,0,3,3
"25165","adfbf796f2059619f53d6a0d243f906d",72,52,31,16.258064516129,37,35,2,1
"25166","adfccc3ae7c82088df20563f7da1ebc4",2,2,0,2,2,0,1,2
"25167","adfdb28eac619aa2b4bf6d0f6d903ba2",188,86,57,23.0877192982456,188,0,3,3
"25168","adfe28d74a171ffc6e81178e648bc236",175,138,76,16.1184210526316,153,22,3,3
"25169","ae01b39b04c252d755a2579544d588af",52,52,0,52,52,0,1,2
"25170","ae02f202d97adb934c414e5c22d43735",33,33,0,33,33,0,1,2
"25171","ae08275a072dd7e0f1344117fd8a6b58",24,24,0,24,24,0,1,2
"25172","ae08a2e22c74f1e9ba54aa58ef31a34e",35,35,0,35,35,0,1,2
"25173","ae0a277093c43109be6a165ef8ccb7a8",42,42,0,42,0,42,1,2
"25174","ae0a44d33c4ed7fd0e55a8567f0e1219",8,8,0,8,8,0,1,2
"25175","ae0a9ba28c41084d9c654e164ec3fac7",28,28,0,28,28,0,1,2
"25176","ae0b5f9b38642e48bdc806b4452dcc22",92,75,27,23.8518518518519,92,0,2,3
"25177","ae0b78274ff51d36e13e0e961c62eb59",25,24,6,29.1666666666667,25,0,1,2
"25178","ae0d5571ab37f891d071692dceb0b0c9",40,35,22,12.7272727272727,20,20,2,1
"25179","ae0d570e21b74a4f58ddbe1a7c18dda0",42,37,29,10.1379310344828,42,0,2,1
"25180","ae0f50c0316687eda209f0c65e7236d8",38,23,56,4.75,38,0,2,1
"25181","ae0fe113ce6b1fdeed2d1ef3b9f3be7f",26,26,0,26,26,0,1,2
"25182","ae11413bdc073e765fa3462daac65837",20,20,0,20,0,20,1,2
"25183","ae1444bc8a4b62b9a7ff6b4ccfc2356b",97,75,13,52.2307692307692,97,0,1,2
"25184","ae165dbc8093a66b6c9913801165dc60",33,23,34,6.79411764705882,33,0,2,1
"25185","ae1b225c31bca1ada68b24561f8b9995",44,44,0,44,44,0,1,2
"25186","ae1dfe71ed583b49001e739cfaec0f5b",24,24,0,24,0,24,1,2
"25187","ae20e86a95efc668190fa1bf616212c9",27,25,19,9.94736842105263,27,0,1,1
"25188","ae238017225ebd0dee1c0f4cbf8d927a",23,23,0,23,23,0,1,2
"25189","ae293664599e9eced2b3258e0b4a675c",46,46,0,46,46,0,1,2
"25190","ae298bca9fe79b232c37647cbfcf55a4",49,42,24,14.2916666666667,49,0,2,1
"25191","ae2a49294daa5e23965345c2eebbd379",22,22,0,22,0,22,1,2
"25192","ae2b489cba679fd015533d80efaef6c3",235,91,76,21.6447368421053,206,29,3,3
"25193","ae3360c6f26cbfcbff5fea7e62311ec2",80,45,61,9.18032786885246,56,24,2,1
"25194","ae34332265bc3d11c73321aedf273a41",29,29,0,29,29,0,1,2
"25195","ae38a3a36b0c64b0ba313455cd1cd559",9,3,62,1.01612903225806,9,0,2,1
"25196","ae39707d16c07d8ad6d1d4bba67ec039",5,5,0,5,5,0,1,2
"25197","ae3c1dfd3a45638a4c1a926ace5ec4bd",69,57,14,34.5,69,0,1,2
"25198","ae3df7132f25a023b11f508f528153a9",15,15,0,15,0,15,1,2
"25199","ae42a765c848b95fa8baf77d6a875488",32,32,0,32,32,0,1,2
"25200","ae440caa66887bb793eb752fbddee148",16,16,0,16,16,0,1,2
"25201","ae4563a747fe539cec8073e178cc590d",213,86,80,18.6375,174,39,3,3
"25202","ae4615806748f79bad31e80191776653",52,25,56,6.5,43,9,2,1
"25203","ae483f949a0a590cb96cae5544c80086",84,55,36,16.3333333333333,84,0,2,1
"25204","ae48d04082c241339392c37aae19486d",31,31,0,31,31,0,1,2
"25205","ae4a8a25c14d94e2ee14c5990de75a8f",39,39,0,39,39,0,1,2
"25206","ae4db00c5ed4ec4c2889ae9d39fb6519",163,95,62,18.4032258064516,163,0,3,3
"25207","ae4df843a513fa858521ff6d456c6ae5",201,114,63,22.3333333333333,164,37,3,3
"25208","ae4e028749cf4b73c4f50014ed2035ea",82,64,23,24.9565217391304,82,0,2,2
"25209","ae4ecc39df5b88045106601ce2278fe6",30,25,28,7.5,30,0,2,1
"25210","ae51139352953bf0d3cc22cbd3b6c6d2",15,15,0,15,15,0,1,2
"25211","ae52ef189ba6a61c0b2e3d4308140790",13,13,0,13,0,13,1,2
"25212","ae52fe9a0e095468a3f2e24fc70bd57e",26,26,0,26,26,0,1,2
"25213","ae563d6049c78395ad873cf73fb2151c",1,1,0,1,1,0,1,2
"25214","ae5700df6e150dbf2a04818a6d1e9018",41,30,45,6.37777777777778,22,19,2,1
"25215","ae5773954453ecb22455979401917e11",18,18,0,18,18,0,1,2
"25216","ae59b2c855c64bfe94eedbc59e626bfe",67,47,53,8.84905660377358,51,16,2,1
"25217","ae5a9690948c25f280243684debb1801",83,74,28,20.75,83,0,2,3
"25218","ae5e4ce90082484fc38cd2ed13900532",111,76,58,13.3965517241379,111,0,3,3
"25219","ae5ef28cf55f6fada58b4e3e8d6d7f1b",12,12,0,12,12,0,1,2
"25220","ae60ee857928dd10440bf4e3720bf1a7",148,84,45,23.0222222222222,148,0,3,3
"25221","ae6304f4811394a8044cbcf8dbef4c38",18,18,0,18,0,18,1,2
"25222","ae6b1b641cd176c696a470c8bf6c05fb",33,33,0,33,33,0,1,2
"25223","ae6be2983549c24f160886a7f3312b87",56,42,55,7.12727272727273,56,0,2,1
"25224","ae6d913515de981162ada84e1d8e7175",52,52,0,52,52,0,1,2
"25225","ae6f1d2e81b39e005c0abfcbd94d6e86",84,54,41,14.3414634146341,84,0,2,3
"25226","ae72d569817427c7bc40053c009a1ddd",32,26,47,4.76595744680851,22,10,2,1
"25227","ae758f6e2aed87d7942c993d57f09450",37,37,0,37,0,37,1,2
"25228","ae77d6cd4fad024001d7c67a6e08a1f6",69,49,38,12.7105263157895,37,32,2,1
"25229","ae7830c0f7393b4f04ad9514828e47ca",31,31,0,31,31,0,1,2
"25230","ae7bca878bce69606a4e833e81f8781e",33,29,40,5.775,33,0,2,1
"25231","ae7bfdd1a7b4d32d3cc3890bccefd698",174,113,68,17.9117647058824,133,41,3,3
"25232","ae81e493bb36509e00aacfa1210d935c",107,67,75,9.98666666666667,107,0,3,3
"25233","ae87c086ffdb9bc71b9a204d92e8760c",85,61,71,8.38028169014085,85,0,2,3
"25234","ae8bb6ac8583c4327fe1d020f89b0d4a",15,15,0,15,0,15,1,2
"25235","ae8ec5675f969cbe3995461ab40e658e",34,25,48,4.95833333333333,23,11,2,1
"25236","ae901fe0304674a95adce893b89fa549",61,53,62,6.88709677419355,61,0,2,3
"25237","ae9046fc40c65330c40ee9da7fafc1db",15,9,56,1.875,4,11,2,1
"25238","ae9232234019b33f81df63ae93544acc",54,54,0,54,54,0,1,2
"25239","ae93a671557f716ae091e076918335b7",161,60,75,15.0266666666667,161,0,3,3
"25240","ae93d530f0ae2c87b797782b72a3de14",171,88,62,19.3064516129032,171,0,3,3
"25241","ae9672c1a8f58f3e700ae1f86dbe9206",84,63,61,9.63934426229508,84,0,2,3
"25242","ae98814552327e01d2ff592254703193",27,27,0,27,27,0,1,2
"25243","ae99339d19202743a068fc9c1dbf9918",61,55,43,9.93023255813953,61,0,2,3
"25244","ae998a950e657be8ee5fe3388adc0f0a",50,19,35,10,50,0,2,1
"25245","ae99efb845f2bd3a77edcb6d2f5a6476",81,68,43,13.1860465116279,40,41,2,1
"25246","ae99f6c8dda6fc150f7aa2af988aab49",90,72,55,11.4545454545455,90,0,2,3
"25247","ae9f32c2cb4e6dc907378bf862735141",23,15,41,3.92682926829268,12,11,2,1
"25248","aea170946b7ec6a48a2fe772c76953bb",82,44,76,7.55263157894737,82,0,2,3
"25249","aea171c96f4b0d96642b213fff63e1c2",22,22,0,22,22,0,1,2
"25250","aea2d1a058e73d6024395685571415e3",66,59,59,7.83050847457627,20,46,2,1
"25251","aea4db729395d90e793e96139dc8220f",26,21,14,13,26,0,1,1
"25252","aea59c1056307607984c9a4c84d946b0",33,33,0,33,33,0,1,2
"25253","aea5cc259e5e91fb2ae8bb8a0508a2e5",16,16,0,16,16,0,1,2
"25254","aea627ed15a31249949eb51afab04a0c",24,24,0,24,24,0,1,2
"25255","aea809c7bf6fbdabdc8baabeea1bf775",37,37,0,37,37,0,1,2
"25256","aeaacf125688434fd85b9311dec74ba6",83,65,32,18.15625,83,0,2,3
"25257","aead7b1eca0b2569cd6e68d96159cd1c",158,95,43,25.7209302325581,158,0,3,3
"25258","aeaebe1d5d43ce14326c321e94da8f57",46,31,42,7.66666666666667,46,0,2,1
"25259","aeafe1e0c7eebf3b7f59092790faabab",53,36,46,8.06521739130435,53,0,2,1
"25260","aeaff0e1e7764c737cf4d4d008a13a3c",30,17,59,3.5593220338983,23,7,2,1
"25261","aeb430bfbad96fb682fbeb5c1d1eca32",6,6,0,6,6,0,1,2
"25262","aeb461f7723f8847eadf6303bd016a2e",24,24,0,24,24,0,1,2
"25263","aeb4fa5903a36362486f761287d2473b",48,48,0,48,48,0,1,2
"25264","aeb849b86694c742638ab453178049c0",82,65,63,9.11111111111111,82,0,2,3
"25265","aeb96c3b1da6d94b32002fc110631555",128,63,79,11.3417721518987,128,0,3,3
"25266","aebc088c09a7830efb9e105af659a9e3",15,15,0,15,15,0,1,2
"25267","aec168db8c956a255612f72db8bbe1ba",194,91,89,15.2584269662921,194,0,3,3
"25268","aec3d954b92ee283fcdd3e13982d8328",45,36,62,5.08064516129032,45,0,2,1
"25269","aec3e86c5d913e1c46cc19d49453d77a",4,4,0,4,4,0,1,2
"25270","aec60563513567a54cb290ba9d2b006c",142,88,41,24.2439024390244,87,55,3,3
"25271","aec94d9ce6d9f83ac4e32e8c74291cdd",20,20,0,20,0,20,1,2
"25272","aecabc648328a0ac331e6a24459cdeea",48,42,64,5.25,48,0,2,1
"25273","aecbda0b0c6f689ad4c476fd41e94346",180,101,84,15,180,0,3,3
"25274","aecea7dec89405ccae7296d8ac21f376",93,61,53,12.2830188679245,44,49,2,1
"25275","aeceb07e2b4b1bfed0b2b31edb85b61b",44,44,0,44,44,0,1,2
"25276","aed095bfeb4130609463da29e75be1a3",41,31,50,5.74,41,0,2,1
"25277","aed377d8cd9e28af4c9ec6aaae98e256",25,25,0,25,25,0,1,2
"25278","aed56d2b5ab308f1f6e550fcc9c3af89",77,71,10,53.9,77,0,1,2
"25279","aed59c89500d566bbe3f37c6cacc916d",21,21,0,21,21,0,1,2
"25280","aed7acf2a84470343861e5284e3f9d73",24,24,0,24,24,0,1,2
"25281","aed949a67972203503ca10c15f3bf66b",34,34,0,34,34,0,1,2
"25282","aedaf13799fbb3013dc79f84b4a6e479",190,121,69,19.2753623188406,190,0,3,3
"25283","aedb49872e5304fe8c4644dae980675a",4,4,0,4,4,0,1,2
"25284","aee3565b7df32392278ce35905a41fdd",29,29,0,29,29,0,1,2
"25285","aee3a1553e3c46d23226666607e37fce",15,15,0,15,15,0,1,2
"25286","aee4c285dcac237293cacc856c77432f",89,74,25,24.92,89,0,2,3
"25287","aee7c431fdb9f9d493ee98e1d53bb7ac",45,45,0,45,45,0,1,2
"25288","aee87d183e670158bc68dbe3ba5aa8f1",161,57,84,13.4166666666667,161,0,3,3
"25289","aee8f1e54b0debb683e0129019ca3e06",31,31,0,31,31,0,1,2
"25290","aee95b9988d87a56e4d60d8b24829aef",55,36,86,4.47674418604651,55,0,2,1
"25291","aee968d78a58d7a1eccc1f12c02046f1",100,77,87,8.04597701149425,58,42,2,3
"25292","aef061c3ec436abb348b80e2a3357268",136,72,49,19.4285714285714,136,0,3,3
"25293","aef2266838ca84718ad23bc42327f518",44,38,42,7.33333333333333,44,0,2,1
"25294","aefb80576a1369b4aa17e257165ea408",151,74,37,28.5675675675676,151,0,3,3
"25295","aefe999c4f65ee55bc6b2858690af1d2",5,3,69,0.507246376811594,5,0,2,1
"25296","af08742b8d3b35f673ff6ffb6c4a5f4c",21,21,0,21,0,21,1,2
"25297","af0ec59913afcfeff3b06d714a5f52be",53,39,55,6.74545454545455,53,0,2,1
"25298","af0ff39b33f27ae5a9e3eff34bcc467f",72,59,24,21,72,0,2,1
"25299","af109007de3ff047d90a00a9dfcd844f",124,91,57,15.2280701754386,84,40,3,3
"25300","af14bbf930e492a8ebf97e58040d3c6d",96,77,24,28,96,0,3,3
"25301","af17749bea432a0219616338b6469a65",15,15,0,15,0,15,1,2
"25302","af1d0d2ae178f58669c968e380d80f78",13,13,0,13,13,0,1,2
"25303","af222eadb290fbb7b153a337a951a1f9",38,36,29,9.17241379310345,38,0,2,1
"25304","af23d8cec0237f27107edb35069bc589",14,14,0,14,14,0,1,2
"25305","af2a5556406b8b4b5b1009e777a08f38",144,74,79,12.7594936708861,144,0,3,3
"25306","af2b5033a653b65137a3d219befcff07",7,7,0,7,0,7,1,2
"25307","af2d313463d230d97575ef0b4ee40799",45,45,0,45,45,0,1,2
"25308","af2e923d4626156caea0cc73d7c20b3e",24,24,0,24,24,0,1,2
"25309","af2e9b14c5869fd0f4aa1b96f50ee0e9",24,24,0,24,24,0,1,2
"25310","af2fc0833767e9bf987a818ad4177d7e",55,46,49,7.85714285714286,0,55,2,1
"25311","af30d404e282749ccd5f5ad0c8e834c7",26,26,0,26,0,26,1,2
"25312","af3364d3f914b77f86e5ae37b43408fa",18,18,0,18,18,0,1,2
"25313","af3366d36fabb0e6a50a93243c93e072",81,70,15,37.8,45,36,1,1
"25314","af33b750cf099fb8aa2bd499209a27d7",180,91,61,20.655737704918,180,0,3,3
"25315","af348b0229ad876b28ef3d3a6c668ed9",66,48,37,12.4864864864865,32,34,2,1
"25316","af353cbc0884ec4106be1f83a41e8a6f",22,22,0,22,22,0,1,2
"25317","af36c275bb507e9d7315e93a7a973a5b",166,78,39,29.7948717948718,166,0,3,3
"25318","af3749d349b745e3a75b0b690b872cb9",13,13,0,13,13,0,1,2
"25319","af3a1a695acabbd4b8610e3df52b0a1a",120,91,37,22.7027027027027,73,47,3,3
"25320","af3a5df1e41ccf07ec15bd3702996be7",93,80,36,18.0833333333333,39,54,2,3
"25321","af3b10ab985b61088b3e9de2cd800eb0",20,20,0,20,0,20,1,2
"25322","af3bdb2b524911f921fab9e13735e7f6",20,20,0,20,0,20,1,2
"25323","af4261434c48311eaaf2eaa19327758d",113,85,66,11.9848484848485,68,45,3,3
"25324","af42acb77d456f71bab70d3d576994d5",31,31,0,31,31,0,1,2
"25325","af437ec0984a987cbc1a134d7af432ea",17,16,10,11.9,17,0,1,2
"25326","af43ddadb861b0d1729f397f36b4c3f3",66,61,51,9.05882352941176,66,0,2,3
"25327","af46d51f63247701224e13bdcfe7ac09",162,114,68,16.6764705882353,162,0,3,3
"25328","af48091b7746507c57d123f93a4411dc",46,37,25,12.88,46,0,2,1
"25329","af4be4343b3cde8c85f4d653f2b0d270",44,33,28,11,44,0,2,1
"25330","af4bff4742578e24bccf017ed27cab55",27,27,0,27,27,0,1,2
"25331","af4dec35ec3188fcaf4c65a3ca005386",1,1,0,1,1,0,1,2
"25332","af4deecc27bf5cdae46eb168b079cb00",115,80,76,10.5921052631579,115,0,3,3
"25333","af563d84af0887c7943a2331c9729f36",132,49,57,16.2105263157895,132,0,3,3
"25334","af57d4644ffe5a1f680c5a24d74e16e9",45,38,63,5,45,0,2,1
"25335","af5b640b4303a7513ff4fffef9a35fd3",177,54,65,19.0615384615385,125,52,3,3
"25336","af5bb1775b1fe870f5f265d985c1e270",75,67,45,11.6666666666667,75,0,2,3
"25337","af5d79ca3337f107694e9b7fd397f457",16,16,0,16,16,0,1,2
"25338","af5ea94736146d2953b10ead312f2f59",117,75,49,16.7142857142857,117,0,3,3
"25339","af5fc48d603efa2f3bcd5917bac8f284",113,78,38,20.8157894736842,78,35,3,3
"25340","af638a27d9102add291e117f3e431dd2",60,52,40,10.5,60,0,2,3
"25341","af6440a5c1c0c440df5a239fcbf4725c",61,44,54,7.90740740740741,61,0,2,1
"25342","af655cd8904e9e83b8bd66cc07a7b2d7",95,66,42,15.8333333333333,95,0,2,3
"25343","af67d8a69574dc259599d53852bf6b4a",53,50,53,7,53,0,2,1
"25344","af6c94e911d07d931d0e62ab21c7cb9e",253,79,82,21.5975609756098,207,46,3,3
"25345","af6cc6f2ddd58fc79524c1dec9cc4227",83,58,28,20.75,83,0,2,3
"25346","af6db25daaa440c09aefc7e52f661737",52,52,0,52,52,0,1,2
"25347","af6fba88b32b1fef9c545cab89aaf853",30,30,0,30,30,0,1,2
"25348","af7001fd62f1e7495156ddd3b9c9384b",59,39,35,11.8,59,0,2,1
"25349","af71abd9fe643da989a90f263009e358",69,46,34,14.2058823529412,69,0,2,1
"25350","af72fd1ff641d0c449a29b08b822d0f1",59,52,8,51.625,59,0,1,2
"25351","af759fc744fbc505fa313d3490d2ec2f",25,25,0,25,25,0,1,2
"25352","af7734ee19d63c39cbd581b293e791c3",112,72,65,12.0615384615385,62,50,3,3
"25353","af77a744152ea8aba062b123979ccb5d",21,21,0,21,21,0,1,2
"25354","af7883d528a79caae8b2469947347199",1,1,0,1,1,0,1,2
"25355","af7acde905b775cb99173c53f6820a56",30,30,0,30,30,0,1,2
"25356","af7ae0e703cdf2bcc8e1f5409fb97716",42,42,0,42,42,0,1,2
"25357","af7cdaf48b2187fc1eeac11690a95339",24,24,0,24,0,24,1,2
"25358","af7d51116a6617012d467187bed862eb",72,52,76,6.63157894736842,72,0,2,3
"25359","af82a61dfe04fc4dec6d2ef25fb246c1",87,76,61,9.98360655737705,46,41,2,3
"25360","af85484a7d281626f669608cdf2e7b3e",11,11,0,11,11,0,1,2
"25361","af85931f267448c66fe7eea7edca28ae",70,58,48,10.2083333333333,70,0,2,3
"25362","af8d0de83cfe761d967a95f9f37a9751",54,41,53,7.13207547169811,41,13,2,1
"25363","af9032d21c8d3ed3906f68794e264e87",36,36,0,36,36,0,1,2
"25364","af9417ee4294a8eff720b6f3be1b371e",20,20,0,20,20,0,1,2
"25365","af94ac75578698d09eb303b5f417267a",19,19,0,19,19,0,1,2
"25366","af960abcf45893bba20e7a27c858e984",148,98,84,12.3333333333333,107,41,3,3
"25367","af96fea1bc0e2d5693fe4666b93fffb2",132,73,67,13.7910447761194,88,44,3,3
"25368","af9716670fecc19705a05eaff0880ed2",24,24,0,24,24,0,1,2
"25369","af9865b9e548920add65cec4249c9f7b",43,31,58,5.18965517241379,43,0,2,1
"25370","af9a992944fe9ed625893f48c68c51ba",37,37,0,37,37,0,1,2
"25371","af9ca6b7f2899470096b15b8b3f9fd5a",164,68,56,20.5,135,29,3,3
"25372","af9e9b5479326158a6521cda3a78fd3a",40,31,19,14.7368421052632,40,0,1,1
"25373","af9f359318f62cd4b47482bad1f72950",25,25,0,25,0,25,1,2
"25374","af9fc80cce6dc41752cf99da4d8b5b2e",35,35,0,35,35,0,1,2
"25375","afa082d1b76a572ea3536b84c7f315b0",68,36,55,8.65454545454545,68,0,2,1
"25376","afa0b9c2e74066e84e668c40199d522c",20,20,0,20,20,0,1,2
"25377","afa59a4b913bbabae68c691393f5de03",74,55,71,7.29577464788732,74,0,2,3
"25378","afa5b49162ecf2518b241101dab9fa9b",72,53,80,6.3,31,41,2,1
"25379","afa6301890bd8b5107213a322ad15db3",38,35,36,7.38888888888889,38,0,2,1
"25380","afa680c243505d86623a1387f0e30491",88,79,22,28,88,0,3,3
"25381","afa74748a01798f2ba5df851252fa7da",13,13,0,13,13,0,1,2
"25382","afa82cabc13c929d6ee0f47e5ad8efc9",28,25,33,5.93939393939394,10,18,2,1
"25383","afabb3ce1befd5e1e5359a60fe52ee72",20,20,0,20,0,20,1,2
"25384","afabfa27b314d606152d5da621cfac06",48,48,0,48,48,0,1,2
"25385","afac9d4afeff6e3e22b47473f41d1372",25,25,0,25,25,0,1,2
"25386","afb105065f4c210e1be22112e194319c",37,34,21,12.3333333333333,37,0,2,1
"25387","afb24c206d948cd4bff2ebbddc0a9698",44,44,0,44,44,0,1,2
"25388","afb3fe36601893284515bcbb3cd98b69",27,27,0,27,27,0,1,2
"25389","afb67b3dc5bd118f925d70ae4d4fe9b0",87,70,56,10.875,87,0,2,3
"25390","afb691465b15bb99e32327db74e5bf30",16,13,48,2.33333333333333,16,0,2,1
"25391","afb9998cb38e35e4bd245ca8dabd796f",185,123,35,37,166,19,3,3
"25392","afbf047ea16dc9c54fd74eda8ad307cb",31,31,0,31,0,31,1,2
"25393","afbf45b889ce3581ea9b1e0f443b05fd",25,25,0,25,25,0,1,2
"25394","afbfe8a70aa85976fc0ad35ff54a770d",100,55,42,16.6666666666667,100,0,2,3
"25395","afc190f065ef0d4bccd4e8b40b64d2e3",37,28,48,5.39583333333333,37,0,2,1
"25396","afc27bd264184c7db3db1189ced0c4ab",50,34,23,15.2173913043478,50,0,2,1
"25397","afc3fb2cd1aa5f14d1b6ae5c122c1e61",218,111,59,25.864406779661,218,0,3,3
"25398","afc555a66783cdb991049826afd4004c",40,31,44,6.36363636363636,40,0,2,1
"25399","afc58bdb037894c070d5519e3928815a",45,45,0,45,0,45,1,2
"25400","afc5b77002141e2445ef42705d4d7900",10,10,0,10,10,0,1,2
"25401","afc5d01cc62e3d04c9db0d8b13117334",17,17,0,17,0,17,1,2
"25402","afc67730fac14769b3b799d6fa465b8b",28,28,0,28,28,0,1,2
"25403","afc9ad94fe4f5c2ce92183a64b61a003",21,21,51,2.88235294117647,13,8,2,1
"25404","afcd4f85acc8959fdfb800ed703d0e59",27,27,0,27,27,0,1,2
"25405","afd0260101abc76b820c753a6802550e",50,30,49,7.14285714285714,50,0,2,1
"25406","afd17523b7427a6f71d7b5b795c7b2de",15,15,0,15,15,0,1,2
"25407","afd1bc8443cb3d351bfc10b101a6ad2c",22,22,0,22,22,0,1,2
"25408","afd581904555174bbeb8add1dd690459",20,20,0,20,20,0,1,2
"25409","afd5e621575b59aa5fb820adfd5a05af",19,19,41,3.24390243902439,19,0,2,1
"25410","afd605ab0bc28c6f36b1bcae7a9e6bb8",59,50,19,21.7368421052632,59,0,1,1
"25411","afd876b79fa2decfd3527b262ebd4800",57,38,28,14.25,57,0,2,1
"25412","afdf280687dabdf6319649c9e5993b1d",36,36,0,36,36,0,1,2
"25413","afe1fc5a592664b53f57c30c7f989438",49,49,0,49,49,0,1,2
"25414","afe3589b16ca7372eb734e8eefac6837",12,5,59,1.42372881355932,12,0,2,1
"25415","afe4aa63f39da288140e8507302f5c19",85,64,23,25.8695652173913,85,0,2,2
"25416","afe6394e2c9b6fa88c0e4f26f402b700",32,32,0,32,32,0,1,2
"25417","afe7339afa7d8bbee0249b2e30c0eb61",72,49,35,14.4,72,0,2,1
"25418","afecf8f0170c9d41373f782e1867e71b",34,34,0,34,34,0,1,2
"25419","afed844d1850a764bb10b1b61d4c3a6c",85,68,64,9.296875,85,0,2,3
"25420","afede06557e678cfbff51c4d9a09b509",122,83,31,27.5483870967742,102,20,3,3
"25421","aff51370f87c6df708ec1fca39c24204",30,30,0,30,30,0,1,2
"25422","aff5532fc355a4fc6715764d76b4c732",38,38,0,38,38,0,1,2
"25423","aff5e475d0a55442fc122ab8c118a58d",35,33,14,17.5,35,0,1,1
"25424","aff6066ba568bc82e72cf1cd2431915e",9,9,0,9,9,0,1,2
"25425","affb85c1786fa989ab014cbd886c8db7",31,22,62,3.5,31,0,2,1
"25426","affbb26088ea4561971683453594e5fb",32,32,0,32,0,32,1,2
"25427","affc9cad8829889ae6e630c93e5a9711",171,71,81,14.7777777777778,171,0,3,3
"25428","afff10ee30a0ae678f4464a64f6be920",40,40,0,40,40,0,1,2
"25429","afffca1b43d7d038123df80f2b1751dd",9,9,0,9,9,0,1,2
"25430","b0027e09c23f586375f1feee54b72091",65,54,34,13.3823529411765,65,0,2,3
"25431","b004b4bb70b4b995564baa2e0594cb9a",43,43,0,43,43,0,1,2
"25432","b00934ea645b1a7e8afedeaa48af128d",94,57,72,9.13888888888889,94,0,2,3
"25433","b009dd29926715cda5616986cad7732b",8,8,0,8,8,0,1,2
"25434","b00a570b4aae6dc037be069b1a2ed034",4,2,64,0.4375,4,0,2,1
"25435","b00c55c628b7ac0e52bb00fb28df39e6",7,7,0,7,7,0,1,2
"25436","b00d8254649b5e90f79749c1709e9e2d",79,47,57,9.70175438596491,79,0,2,3
"25437","b00e21c9e0342270ac37969015f6a429",35,35,10,24.5,35,0,1,2
"25438","b010756caf72b9abff1217e9c0aab0bf",56,41,54,7.25925925925926,56,0,2,1
"25439","b01179e3d7dd84e2ec38fe8ec679e0b6",179,119,65,19.2769230769231,179,0,3,3
"25440","b01630d6cb1994d63947f8d4ee117834",71,43,59,8.42372881355932,47,24,2,1
"25441","b0176229f6ac313c29f64832df64d40c",125,104,78,11.2179487179487,86,39,3,3
"25442","b018e024b182b708cbdd75d35ebef5d4",42,42,0,42,0,42,1,2
"25443","b0195194a9fc5c1ed300b48d8cfea8f5",194,104,63,21.5555555555556,194,0,3,3
"25444","b019b7853052274818ddf2cabe1565a3",35,35,0,35,35,0,1,2
"25445","b01a769b751b392b6656978031213325",32,32,0,32,32,0,1,2
"25446","b01af7dbf514c9745e5c9c403fcaa9a6",20,20,0,20,20,0,1,2
"25447","b01b77fb01c6ee05366868c0dc4ef786",31,31,0,31,31,0,1,2
"25448","b0206ab9f6b8bf7bb93f1149c35320ae",64,52,31,14.4516129032258,64,0,2,1
"25449","b020f80d772b191fc9ea9e48df3e4ab1",84,58,82,7.17073170731707,64,20,2,1
"25450","b021c80b84b73f72bdaf93e3fdf37886",79,57,79,7,79,0,2,3
"25451","b022bd8d6e7661608098eed2b61a2782",31,31,0,31,31,0,1,2
"25452","b0244c04afd43ae28394284f39687dd9",196,106,70,19.6,196,0,3,3
"25453","b0258cff175fb8d2de074ff599dd4afd",70,60,46,10.6521739130435,70,0,2,3
"25454","b0291f53b941632e44578c5544441407",28,28,0,28,28,0,1,2
"25455","b02b3cbee732d41f681354aa0fed41d1",19,19,0,19,19,0,1,2
"25456","b02b5df7254dd3e21e71a013a90f3dcb",16,16,0,16,0,16,1,2
"25457","b02b820be867b20ca873217d602ce918",29,24,9,22.5555555555556,11,18,1,1
"25458","b02bb0a07bf7b99974e1b66dae14ecbd",11,11,0,11,11,0,1,2
"25459","b02d3a1f44dbd1b11b5c1ff136917fa6",95,69,45,14.7777777777778,95,0,2,3
"25460","b035408a5536643b3722425ff4ab32d6",54,54,0,54,54,0,1,2
"25461","b035a44531df4393c31eed860e8dea2a",22,22,0,22,22,0,1,2
"25462","b037d5b8edad570ff3b47dcc51c6aae6",46,46,0,46,0,46,1,2
"25463","b0387a3c12651edc67693d5f01a70880",49,41,19,18.0526315789474,21,28,1,1
"25464","b039c94241d2e61e7bb7674bb1839a1f",1,1,0,1,1,0,1,2
"25465","b03ab3097267a7933d25c7afde18541d",7,7,0,7,7,0,1,2
"25466","b03afbcaaead27ff16ccb5d37ff3ffc9",134,99,69,13.5942028985507,134,0,3,3
"25467","b03b6faa74b59a0dec54188fa5897532",33,32,10,23.1,33,0,1,2
"25468","b03fdc9d3cb05beb1c0d36f095d8dd04",21,21,0,21,21,0,1,2
"25469","b0408c5483e4da17b416169dd5668c87",4,4,0,4,4,0,1,2
"25470","b041a2c1f73e47569a86cca745045e14",4,4,0,4,4,0,1,2
"25471","b04329f5190c825f26a08622077d371f",18,18,0,18,18,0,1,2
"25472","b04796877128a7dcf90036868dd8c5ad",19,19,0,19,0,19,1,2
"25473","b048e0f13f9a8c12dccf2d9fdcfb4a91",65,47,12,37.9166666666667,33,32,1,2
"25474","b04b49c05a0c3995c328d0b47d4bb0db",63,47,69,6.39130434782609,63,0,2,1
"25475","b04d3187d94f7b15fc5d03e5d00a8066",34,34,0,34,34,0,1,2
"25476","b04d3a237b7716f695f72efdc590723d",196,111,72,19.0555555555556,171,25,3,3
"25477","b04f0a9618d6ef078f93fd652eb8ba29",230,132,76,21.1842105263158,203,27,3,3
"25478","b050dd182929f6e0a55d33832144cedf",15,15,0,15,15,0,1,2
"25479","b05534eed923dfb1a95808852e2c1387",36,36,0,36,0,36,1,2
"25480","b055850ac04bf6a7e35d7f194080e7ac",1,1,0,1,1,0,1,2
"25481","b05ca7372e3dfcddfb8082441cf8088e",55,23,70,5.5,55,0,2,1
"25482","b05cbb127d7d5a3bbee32f5aaf96aead",52,43,13,28,52,0,1,1
"25483","b05f147d0296ce4b2318d6f49f1bbb78",22,15,71,2.16901408450704,22,0,2,1
"25484","b06036821030b48058e51574215250bf",184,110,42,30.6666666666667,184,0,3,3
"25485","b061b1df105cee912c52224e8ca3b8c7",24,24,0,24,24,0,1,2
"25486","b06302a57c2f21f1d0f627678e824e25",17,17,0,17,17,0,1,2
"25487","b063f65b8b20ec93ed49a626cc3f9a26",204,135,82,17.4146341463415,163,41,3,3
"25488","b0666325bb6ed02e4ef31147bfceb1c0",11,6,60,1.28333333333333,11,0,2,1
"25489","b06792aa10c576932b5744a509209624",35,35,0,35,35,0,1,2
"25490","b06b549116f7e7a36e1dd0d5883852bc",100,39,61,11.4754098360656,81,19,2,1
"25491","b06bac8149c7bbb25f989e20d5ced57c",55,43,15,25.6666666666667,55,0,1,1
"25492","b06e3e40a3fc49f3efd71c7e6fa44d60",16,16,0,16,16,0,1,2
"25493","b06f625714877389d910422d9fc7334b",42,34,35,8.4,0,42,2,1
"25494","b07038592ecb0cb9e4b2a2741c1e61c7",45,45,0,45,45,0,1,2
"25495","b071517989c07823d998a640c44a7247",38,38,0,38,38,0,1,2
"25496","b0717dc6497dfff428fb64c7c9374db0",19,19,0,19,19,0,1,2
"25497","b07518c39c1991d59a5046dbab9f2079",79,61,33,16.7575757575758,34,45,2,1
"25498","b076dea9200ae869e18be5736cc39366",70,50,75,6.53333333333333,70,0,2,3
"25499","b077898866dcb21a44403581c151d3a8",139,103,89,10.9325842696629,139,0,3,3
"25500","b07af7ed7900dfdfcfeb40c107512e34",109,68,83,9.19277108433735,109,0,3,3
"25501","b07daf35b50216c8cdf58269c4c90f76",38,31,61,4.36065573770492,21,17,2,1
"25502","b07eabb61b750f2cc343f1c526ac1dea",37,30,21,12.3333333333333,37,0,1,1
"25503","b07f0528480a96428badb42a030d98ab",43,43,0,43,43,0,1,2
"25504","b0837407e8e8eae7e304c1b43745c8ad",47,34,24,13.7083333333333,26,21,2,1
"25505","b08416c6b66886a6dc46c69c2655cbb6",249,129,79,22.0632911392405,212,37,3,3
"25506","b08465ae6341926576595975355ea68e",23,23,0,23,23,0,1,2
"25507","b0859067c7dc670bd02b11b5a6848af7",21,21,0,21,21,0,1,2
"25508","b085aa81bb953b6cd707a4d3e7de8cd0",88,70,53,11.622641509434,51,37,2,1
"25509","b0880ebc60300eb0129918b2e2bab6a4",35,35,0,35,0,35,1,2
"25510","b08c362ba252621a600937cb935d3454",14,14,0,14,14,0,1,2
"25511","b08f8ac37032a48cfbb8fb552c7601db",11,11,0,11,11,0,1,2
"25512","b0907d20a0cb68608283c11acbf6ae0b",78,55,49,11.1428571428571,78,0,2,3
"25513","b092e4af1d8f5fee11aa7862a0ceade3",10,10,0,10,10,0,1,2
"25514","b09326efc71c9c76432a5493b8d1876f",77,66,23,23.4347826086957,77,0,2,2
"25515","b099a077c70658cdbe13f6aeda983e05",52,46,11,33.0909090909091,31,21,1,2
"25516","b09a3caebe6526882d7411553c775c7e",42,42,0,42,42,0,1,2
"25517","b09a48ad402690e65d5fa9ba0472d487",52,38,49,7.42857142857143,52,0,2,1
"25518","b09cbbe2631063be640552906e3f9154",53,47,32,11.59375,53,0,2,1
"25519","b09e47e613bba2998e0c0e80cd82a6c6",46,46,0,46,46,0,1,2
"25520","b0a383abf66348b3804a06cf14273ee3",31,25,19,11.4210526315789,31,0,1,1
"25521","b0a477e1d53e9b337e7fc060748d2609",30,30,0,30,30,0,1,2
"25522","b0a55e9f719949ae1fa29b69e86cb391",31,31,0,31,31,0,1,2
"25523","b0a7d952d4e5021f0ca9f3e594705d95",30,30,0,30,30,0,1,2
"25524","b0a8d963924dfd0de5701f20606beaf9",23,23,0,23,0,23,1,2
"25525","b0a944b2ca48737d863c579842fe6b85",51,41,33,10.8181818181818,51,0,2,1
"25526","b0aacab18faccba80dd3878d3010d4d2",20,20,0,20,20,0,1,2
"25527","b0ab7dd1fda8e131e6a9af8619be7c73",59,49,63,6.55555555555556,59,0,2,3
"25528","b0aefba35fdf6a96bcc8cf926fb8718f",26,26,0,26,0,26,1,2
"25529","b0b09ad7fd77a77a08f79b6604077c5d",10,10,0,10,10,0,1,2
"25530","b0b438821924ac693bafc42ec0eb1df7",23,23,0,23,23,0,1,2
"25531","b0b48994935e1fafc242d341679da4c5",20,20,0,20,20,0,1,2
"25532","b0b4a60cd15759bd700edf5a00a8aa58",23,23,0,23,23,0,1,2
"25533","b0b4b9826cce99bee6d0279a747c44f2",129,97,34,26.5588235294118,129,0,3,3
"25534","b0b4ffe3a64714c1fa85a60cabad0315",80,61,80,7,62,18,2,1
"25535","b0b5296dd5a9f1cfee0291ce7ba1db58",27,27,0,27,27,0,1,2
"25536","b0b5b47a2a304d6995733d80c531ab7c",33,30,21,11,0,33,2,1
"25537","b0b5d2126f393e2a313264f93e3a734c",24,24,0,24,24,0,1,2
"25538","b0b85496790182e6c8deb6cb22496bce",42,40,7,42,0,42,1,2
"25539","b0b99e82cc33f0e084f1c76b7cec69a3",47,17,54,6.09259259259259,15,32,2,1
"25540","b0bdf12abb039ab2a08174fdf2d98932",48,48,0,48,48,0,1,2
"25541","b0c12f2de623d1a5279546a97bf5546d",13,13,0,13,13,0,1,2
"25542","b0c234a4d62a8583adc238e00e952196",27,23,35,5.4,27,0,2,1
"25543","b0c2c3b08e4523e5042f6c73d55f688c",186,51,75,17.36,186,0,3,3
"25544","b0c31d399fe36b99c0dc6452ea0ed3d3",157,74,75,14.6533333333333,157,0,3,3
"25545","b0c6a49f3c4f7291a2c6da88d13525ba",11,11,0,11,11,0,1,2
"25546","b0c85381eba5fa844233c060bc5a20dc",77,59,64,8.421875,45,32,2,1
"25547","b0c90540864fef6beceea60c2bd4f442",16,16,0,16,16,0,1,2
"25548","b0ca4c128e738c75da11450d0a869c5b",18,18,0,18,18,0,1,2
"25549","b0ced32cfb433e270a59b706210fc80d",31,26,40,5.425,12,19,2,1
"25550","b0d21eaeea23d7d2d2f43c8076472afa",22,22,0,22,22,0,1,2
"25551","b0d336e346e5c4227b74dd2bb91f406f",25,19,84,2.08333333333333,25,0,2,1
"25552","b0d3bd197eef21c33e98fd0da83dda07",103,66,87,8.28735632183908,103,0,3,3
"25553","b0d405073a81baaa83b0b320d3a2d72d",183,83,63,20.3333333333333,154,29,3,3
"25554","b0d424ad35a77d02361f1f83acc63569",103,63,31,23.258064516129,67,36,2,3
"25555","b0d6ccd2434411d0cf53dcd6e51697ac",68,57,77,6.18181818181818,68,0,2,3
"25556","b0d7320df73b7a6f4a790269364de4fc",75,67,31,16.9354838709677,38,37,2,1
"25557","b0d95b4fa8b7f120c1ad2204d025182c",37,25,25,10.36,37,0,2,1
"25558","b0dae5efd7805ed6b7ba49053bd51a05",50,50,0,50,50,0,1,2
"25559","b0dc8c29116d05bfd684b35ff7892916",85,58,28,21.25,85,0,2,3
"25560","b0df78b784c8760ccf21d5ab2f392e60",23,20,60,2.68333333333333,23,0,2,1
"25561","b0e134da58526cde30259a732f584218",15,15,0,15,15,0,1,2
"25562","b0e1a7ebe7657fac73631c8f2c5ba0cd",19,19,0,19,0,19,1,2
"25563","b0e31083a0e6a09358d5210761a77daf",213,119,71,21,213,0,3,3
"25564","b0e77b3c936c5db55da2300bfc8e9aff",2,2,0,2,2,0,1,2
"25565","b0e9d20e4c62a8ad8b8f6f49bd1a92ce",164,80,77,14.9090909090909,164,0,3,3
"25566","b0eb97a945dd15039eb2bcebe9283398",34,32,9,26.4444444444444,12,22,1,2
"25567","b0ee3449c37c969b72ae0d5d1ca25f4d",79,59,41,13.4878048780488,79,0,2,3
"25568","b0eed593616d4f555c784f06b9a66437",20,20,0,20,0,20,1,2
"25569","b0f27b1c787134c6b7d791ac38cc402a",187,94,75,17.4533333333333,187,0,3,3
"25570","b0f2fe5852eea9909444183c401e2a4c",56,48,21,18.6666666666667,56,0,2,1
"25571","b0f4f08bab178f3729fda22649cd3757",41,41,0,41,41,0,1,2
"25572","b0f7217112746d0a644bb06de37d5ea4",15,15,0,15,15,0,1,2
"25573","b0f7695d49c042cae3aae85a2d5900db",14,14,0,14,14,0,1,2
"25574","b0fa194311ac0b7e9fccde932f4842b4",32,22,21,10.6666666666667,32,0,1,1
"25575","b0fc965d762dd0bb4f63c04c23b71ac4",40,40,0,40,0,40,1,2
"25576","b0fea5093e45ff488ff9a805cac04151",35,27,82,2.98780487804878,35,0,2,1
"25577","b103ba83f53d1bf55c79a5e88b761e14",130,67,64,14.21875,130,0,3,3
"25578","b104e2681f597baf986bc081de95a0c5",102,68,90,7.93333333333333,102,0,3,3
"25579","b107ba5eac8c6d1856b69a6bf6efc69f",29,24,39,5.20512820512821,29,0,2,1
"25580","b10a0fdf6166c15793a593f3fc863da8",79,53,66,8.37878787878788,79,0,2,3
"25581","b10ba254f838e27f22c4679005bdf018",194,104,67,20.2686567164179,163,31,3,3
"25582","b10bfbbd9efe0aefd58b106134325fcd",115,66,70,11.5,115,0,3,3
"25583","b10cd8846f866bdd62740bb9e842d1e2",36,29,54,4.66666666666667,36,0,2,1
"25584","b10f936da129bc2576934e550a63299a",20,19,66,2.12121212121212,20,0,2,1
"25585","b1111e3a6016a4a938bdb157ca98ed43",182,114,74,17.2162162162162,182,0,3,3
"25586","b113d8bbbe080a3a159d20b0b9c448e5",12,12,0,12,0,12,1,2
"25587","b113ee4406dbb4faaa9c9840b74498e8",29,29,0,29,29,0,1,2
"25588","b11433c0e7c8f8ae2341e31fefe37867",23,23,0,23,23,0,1,2
"25589","b1153024231706182d60cd9712a5ec2c",29,29,0,29,29,0,1,2
"25590","b11972c5a4149b7a8733722c5eb8b0c8",44,29,35,8.8,44,0,2,1
"25591","b11c1816f56c057a6e455256b8b00417",90,58,70,9,90,0,2,3
"25592","b12244a01e9b834ed651d923276e8279",2,1,48,0.291666666666667,1,1,2,1
"25593","b123c3d264b8647b613a854e4ffa5f92",43,43,21,14.3333333333333,0,43,2,1
"25594","b126520b09f06f72489de6efd29d6808",89,69,51,12.2156862745098,89,0,2,3
"25595","b12798276f7b23b8ceb7d1b07c356253",163,116,68,16.7794117647059,163,0,3,3
"25596","b127d095e060f5e39b8343fd5c4f0033",26,26,0,26,26,0,1,2
"25597","b12b87a06747198c20956edbf06f61cf",38,38,0,38,38,0,1,2
"25598","b12c51777263ea78d13e6f0f6718caee",47,32,67,4.91044776119403,22,25,2,1
"25599","b12d15fed999c47adf00c354c2bc35b6",33,33,0,33,33,0,1,2
"25600","b12e79d665879a8a16b91ad1b785a1e0",126,107,72,12.25,126,0,3,3
"25601","b130c1923d492faf1e1e0f97d5ada28b",140,72,62,15.8064516129032,140,0,3,3
"25602","b130d092fe1c05d1918c43373281c987",24,24,0,24,24,0,1,2
"25603","b132835173469242f6b64b49fa89039b",81,57,49,11.5714285714286,81,0,2,3
"25604","b1328ca14e63b123270c571d34eec15f",164,104,57,20.140350877193,164,0,3,3
"25605","b132e6bbde99685f73438922f147619b",115,64,61,13.1967213114754,92,23,3,1
"25606","b133c6d755ba149a52b00991bc907a43",177,86,73,16.972602739726,177,0,3,3
"25607","b13694291d2b934585b8626f10f84b36",146,86,55,18.5818181818182,146,0,3,3
"25608","b1380beaa7bcc234dac3cb76876c7930",103,86,22,32.7727272727273,103,0,3,3
"25609","b1398759e86d2390d7e745da2d51daa5",46,46,0,46,0,46,1,2
"25610","b139a2949b06c7e751c9efdd2a05195e",31,31,0,31,31,0,1,2
"25611","b13afc8d6e8723ba9a4a152a82a6a1af",125,100,42,20.8333333333333,125,0,3,3
"25612","b13bdbfdec09c0e95c7ccbb72af2b7d9",71,40,49,10.1428571428571,71,0,2,3
"25613","b13c1bd65deedf260c67b2a33c157195",68,56,33,14.4242424242424,37,31,2,1
"25614","b13d10ea2268a32a686b14893f5c2f1a",15,15,0,15,15,0,1,2
"25615","b13da0bcce98c3357e77e92333a6e64c",10,10,0,10,10,0,1,2
"25616","b13f482ac73d75ad5cd5ee417f2845c6",24,23,69,2.43478260869565,24,0,2,1
"25617","b13fe6c920dedf75274f4f845c390cd0",125,109,25,35,125,0,3,3
"25618","b1407a94f026d6539f2a344b8ab4eed4",166,119,61,19.0491803278689,134,32,3,3
"25619","b14207e9a1937ba0a3e4fb83382da490",84,68,35,16.8,84,0,2,3
"25620","b142431358bd80875b1b12d3a424d7c7",134,71,58,16.1724137931034,134,0,3,3
"25621","b14252689957b446415fc1f1b571d782",63,52,52,8.48076923076923,63,0,2,3
"25622","b144a851c453784f95448dc2ac36abc7",93,86,48,13.5625,44,49,2,3
"25623","b1453abf085aab91e8f1a9b536789291",112,76,62,12.6451612903226,72,40,3,3
"25624","b14955793f50fa4b8f3274f01ef02a27",30,30,0,30,0,30,1,2
"25625","b14a222c835bf6d3eddd73ad08bb6360",20,20,0,20,20,0,1,2
"25626","b14a23965677442370a1ffd9ffa14582",19,19,0,19,19,0,1,2
"25627","b14b99898100b8d289cbbe7ac8853daf",71,57,68,7.30882352941177,71,0,2,3
"25628","b14e59f0f8972eb3ab0b64bd3377f512",4,4,0,4,4,0,1,2
"25629","b1546682ccf2a0c41a45dcd02d3748d2",172,82,62,19.4193548387097,172,0,3,3
"25630","b15473f42eceb884cc880754a40df653",37,37,0,37,37,0,1,2
"25631","b1557015b17c786ba27cc2faff526b6e",84,55,76,7.73684210526316,68,16,2,1
"25632","b155b6afc099bf28dfd2bb1ebc48cb99",21,21,0,21,21,0,1,2
"25633","b1567e0e61ef545b214863bd73ed8265",21,21,0,21,21,0,1,2
"25634","b15686cd4ef206e2ea1efce4a25842fd",28,24,52,3.76923076923077,28,0,2,1
"25635","b156e76373c864001e9f341450f9ee0c",23,23,0,23,0,23,1,2
"25636","b15a7c169466430eb84c44fe0ce9812e",14,14,0,14,14,0,1,2
"25637","b15b34344d4f941b126b20b1eca1aba6",15,13,67,1.56716417910448,15,0,2,1
"25638","b15faac4c0f8dd3872032cbf38e61c2d",116,88,34,23.8823529411765,116,0,3,3
"25639","b1602df0897298422909bb83e9f13625",19,19,0,19,19,0,1,2
"25640","b160728237dd72edb997fbfaa9f83c5a",54,54,0,54,54,0,1,2
"25641","b1626fcc84c3f1212712789ed6b40fd2",43,43,0,43,43,0,1,2
"25642","b162a62c088afca49710501520c9087d",25,15,57,3.07017543859649,25,0,2,1
"25643","b16305bb57102a03af4330d5a1c3588b",109,70,77,9.90909090909091,109,0,3,3
"25644","b163ab208cf75c9cfeaa826bf4561f94",50,33,41,8.53658536585366,29,21,2,1
"25645","b163da20d81d8c37636a5e445fab2536",108,78,62,12.1935483870968,108,0,3,3
"25646","b1659c72b42d3551c2717f0982f9a747",55,46,61,6.31147540983607,55,0,2,1
"25647","b168461461f2a470c064440480c451a4",139,90,59,16.4915254237288,94,45,3,3
"25648","b1692d37b727d41c252e7da3c86657de",59,41,53,7.79245283018868,59,0,2,1
"25649","b16a72348e4527cfaa13946bbed05335",163,87,83,13.7469879518072,163,0,3,3
"25650","b16c44410a73b26acaf389c9c8701608",118,35,89,9.28089887640449,106,12,2,1
"25651","b16d3b04112a995c3daae466dc9c19e7",9,9,0,9,9,0,1,2
"25652","b16f8cd0e84f123b5d0adb42c4252acb",86,69,49,12.2857142857143,86,0,2,3
"25653","b16fa96963c5fbd9db243213cc900359",120,79,43,19.5348837209302,120,0,3,3
"25654","b16fbb4bd85825f0fba30584d25f644b",174,71,71,17.1549295774648,174,0,3,3
"25655","b1709a2733b0654cfa347ede789afaaf",141,78,68,14.5147058823529,141,0,3,3
"25656","b1733dd7a7cb638666bac25f1bfc4323",36,36,0,36,0,36,1,2
"25657","b173892b6697aca29849df9349edc925",19,19,0,19,0,19,1,2
"25658","b173d542a233c29fa272e1fe96ea4d2d",16,16,0,16,16,0,1,2
"25659","b175de0bd2e88f94e0be939fa161d16d",115,70,30,26.8333333333333,115,0,3,3
"25660","b177781892e2cee49dfc2ada8df61172",34,34,0,34,34,0,1,2
"25661","b17797ccf7a5bb056ffdcac07d7736c6",13,13,0,13,13,0,1,2
"25662","b178926298fa4633b56d89a1e29ee2f7",44,25,53,5.81132075471698,44,0,2,1
"25663","b17b5d2fd0b5ea92b200e7314a97abed",65,54,12,37.9166666666667,65,0,1,2
"25664","b17c981e532a2323968d5e84c0532b3b",139,74,64,15.203125,139,0,3,3
"25665","b17cec3847a5c4eaa66e95a823173f2e",94,70,69,9.53623188405797,94,0,2,3
"25666","b17d99f30f58aaa5a9294132a67d0766",25,25,0,25,25,0,1,2
"25667","b17e2dad2df04e9f800ea7976ae21a10",24,24,0,24,24,0,1,2
"25668","b180642806ab43778adab233e9f00c84",3,3,0,3,3,0,1,2
"25669","b182304ed11ae5b71f3668ef43eee844",54,32,58,6.51724137931034,53,1,2,1
"25670","b188f5d594f71b276efb23ef329cf2c5",12,12,0,12,12,0,1,2
"25671","b189597f3c592404ea1af1fd4064c7a5",133,79,66,14.1060606060606,133,0,3,3
"25672","b18989d6682309265dd25d1cdc1bd457",77,60,56,9.625,77,0,2,3
"25673","b18d5cd4403e733d3813032395c57bc8",18,13,76,1.65789473684211,18,0,2,1
"25674","b18e26e0f5a2abdb65c070842f09d545",71,42,79,6.29113924050633,46,25,2,1
"25675","b18e451b9189e537de3573b9711c6941",18,15,75,1.68,18,0,2,1
"25676","b190e24a2faa4d87e79628bca27c5614",131,90,74,12.3918918918919,131,0,3,3
"25677","b192294f5af9c454063b08931214150c",168,113,26,45.2307692307692,148,20,3,3
"25678","b1946c3d1d22d95a08c5d8274e529ece",26,24,40,4.55,7,19,2,1
"25679","b1977798faa34d51e01af46065a52ff0",101,71,51,13.8627450980392,101,0,3,3
"25680","b197b0d42f6ba2f9db08c89b9c092fb4",47,47,0,47,47,0,1,2
"25681","b19a325caf088703de42a42286458829",2,2,0,2,2,0,1,2
"25682","b19a632755d4b256b660e83fe6c40094",178,84,80,15.575,150,28,3,3
"25683","b19c87550bca90072735496dbf6f4678",192,147,71,18.9295774647887,152,40,3,3
"25684","b19e45f0bbce3a62a4242954ae9ebcaf",20,20,0,20,20,0,1,2
"25685","b19ef59631d80a77049c49f11ff3abde",15,15,0,15,0,15,1,2
"25686","b1a02869a51b47b76c258bcd4317af5a",68,40,63,7.55555555555556,49,19,2,1
"25687","b1a0b15c40171211bbfed3283b512efe",30,30,0,30,30,0,1,2
"25688","b1a108b2e7bb4a5c3c4ecce7bc8819f1",191,87,75,17.8266666666667,191,0,3,3
"25689","b1a635cef5e8948230a00db307eb23b1",103,80,31,23.258064516129,103,0,3,3
"25690","b1a7cdeb2af69c7f6fce9330096ab21f",38,32,6,44.3333333333333,38,0,1,2
"25691","b1aba449a55459931117293f5f26f52f",83,73,63,9.22222222222222,83,0,2,3
"25692","b1ad5a8967b8727e4c3e11d1590576ac",94,72,60,10.9666666666667,94,0,2,3
"25693","b1aecb35b0394cec0d5fb9af1d73c18f",102,54,39,18.3076923076923,72,30,2,1
"25694","b1afc394db308b46f4823ef2442c4d0f",92,57,70,9.2,92,0,2,3
"25695","b1b04bd20c01e09f5ec36c4cf6b7139e",8,8,0,8,8,0,1,2
"25696","b1b3a05a0539ccd3a8e540886dd2b66a",22,22,0,22,22,0,1,2
"25697","b1b55c111f74f6592e83e1f33ffa403b",73,46,26,19.6538461538462,39,34,2,1
"25698","b1b60c23078565df603a38e49139b38f",31,31,0,31,31,0,1,2
"25699","b1b87b47e5b075732868e43f8bf89f75",35,35,0,35,35,0,1,2
"25700","b1bbcd153e57891a818d60257e332af8",26,25,32,5.6875,15,11,2,1
"25701","b1bf930fb4eaf89a3439376006bee8cd",28,28,37,5.2972972972973,28,0,2,1
"25702","b1c0e04d12c367c01eec61e47a2159c9",84,50,71,8.28169014084507,59,25,2,1
"25703","b1c48870682f4f3d176107a426c2debe",131,96,58,15.8103448275862,131,0,3,3
"25704","b1c52fccdf3403dc7fdd99aeb63e8be1",34,34,0,34,0,34,1,2
"25705","b1c5872f87a91ccbfe4ecb55b8d88e19",42,42,0,42,42,0,1,2
"25706","b1c96a6e3e5c377db819e8727a6b06d0",109,82,33,23.1212121212121,73,36,3,3
"25707","b1cba55959572d9b7e75a712a18860d3",16,14,78,1.43589743589744,10,6,2,1
"25708","b1ceadd4738d1b117bb1a9d0a2ca720e",173,110,64,18.921875,173,0,3,3
"25709","b1cf8ffb893300df14453f675ddeb0ba",39,39,0,39,0,39,1,2
"25710","b1d086aa788d192aac2029a8659f194e",173,72,67,18.0746268656716,173,0,3,3
"25711","b1d2fb5c54b5cd853ae04c4b791ff8ba",21,21,0,21,21,0,1,2
"25712","b1d329ca94e0da9b262260a36050f55d",77,57,26,20.7307692307692,77,0,2,1
"25713","b1d3f54973105f40b38ef3d19e6c8789",27,27,0,27,27,0,1,2
"25714","b1d5263c8796035d9bda7a43680e2e90",49,39,61,5.62295081967213,49,0,2,1
"25715","b1d946641d800b9e1ac2186e826d5d6e",85,53,64,9.296875,85,0,2,3
"25716","b1da58761073d873b7f9517492853d62",36,36,0,36,36,0,1,2
"25717","b1dcf40e3de42b6075c3b78e6f820f19",50,33,63,5.55555555555556,50,0,2,1
"25718","b1e1a29099d61b775e829f36699c9cdf",20,20,0,20,20,0,1,2
"25719","b1e46fee91a47cb62ca05c4ad858df39",88,73,35,17.6,88,0,2,3
"25720","b1e7634c6c510e288b9fca5d06d81ed9",121,71,58,14.6034482758621,94,27,3,1
"25721","b1ec089e412f11cc6ffb6fd27c4fbf2e",127,64,78,11.3974358974359,88,39,3,3
"25722","b1ee1789def955c56f9b2894df4299ab",22,21,6,25.6666666666667,22,0,1,2
"25723","b1ee6e388c5036716dc38abb1520d540",106,89,36,20.6111111111111,106,0,3,3
"25724","b1f015a44627b696be8d11a658527a01",116,74,61,13.3114754098361,74,42,3,3
"25725","b1f42704d9ceab36bde72034547effa6",43,43,0,43,43,0,1,2
"25726","b1f5cf8f31896f442cbac6a6c9bf09b6",174,121,63,19.3333333333333,174,0,3,3
"25727","b1f8ca8b4eace0a27d903d2db402eece",124,76,63,13.7777777777778,124,0,3,3
"25728","b1fba05d78bb0e67cac5f2f524315c58",19,19,0,19,19,0,1,2
"25729","b1fdbd2e5ad3f863bc169bd505f9ad15",48,48,0,48,48,0,1,2
"25730","b200bac904e30ea96251c6cb4d4aa210",34,34,0,34,34,0,1,2
"25731","b200d5eda85bcad1a3554d20e3b505dd",172,98,48,25.0833333333333,128,44,3,3
"25732","b201a93fe2730c2b835f890c4a7c9dd3",48,48,0,48,48,0,1,2
"25733","b20247653ad48e06dd0ead6e0d5d25ee",196,87,71,19.3239436619718,196,0,3,3
"25734","b202d97b2f6e73facb0eee05077e2a4b",162,117,36,31.5,162,0,3,3
"25735","b204b6cd276ec948eb69701d7524115a",14,14,0,14,14,0,1,2
"25736","b206a328dfaae08dd30a6018ab42136b",106,73,14,53,106,0,1,2
"25737","b208658f9f86324fedebf3ea95cf3864",67,43,62,7.56451612903226,67,0,2,3
"25738","b20abc891446534e07872d031927c6b2",1,1,0,1,1,0,1,2
"25739","b20bf035fad0d9e7e3748c9ff7bb6c0d",31,24,33,6.57575757575758,31,0,2,1
"25740","b20d55fff803a8a219a0391f800f8fda",71,54,54,9.2037037037037,71,0,2,3
"25741","b20e0a312179bb0ceb7b526a99f33c7b",168,114,64,18.375,116,52,3,3
"25742","b210097eeb4650ec810ea00caaae095e",18,18,0,18,18,0,1,2
"25743","b21286c7d8708cd992157f733f07462c",19,19,0,19,19,0,1,2
"25744","b21506bb92acbadf2e4d051ddee00972",93,47,64,10.171875,93,0,2,3
"25745","b21971f542d6755a3b5f921e8da617a8",30,30,0,30,30,0,1,2
"25746","b21a400f2770fe014d05d671859da1ac",51,51,0,51,51,0,1,2
"25747","b21bb6af849859e11410880263473470",168,80,77,15.2727272727273,168,0,3,3
"25748","b21ded4a4857a5823742a711826c5ac8",61,52,51,8.37254901960784,34,27,2,1
"25749","b21e9a60659e8e8d3bbc433acf205899",31,31,0,31,31,0,1,2
"25750","b21fc0f5d88aac69d98f2af96da58387",23,23,0,23,23,0,1,2
"25751","b2206b62fe6c74e3731e161ad1d33663",52,52,0,52,52,0,1,2
"25752","b221c0a6d92a8aecd7fd87070b51cc1e",30,30,0,30,30,0,1,2
"25753","b2239c43578bd8f9d24efae1ea3a980c",47,46,21,15.6666666666667,47,0,2,1
"25754","b223d51898559c961ba1df3ab3b24318",2,1,28,0.5,2,0,2,1
"25755","b225d5a0ad7530e52e8ab507e57c81ac",9,9,0,9,9,0,1,2
"25756","b226b80919bce0cc1694eb5079dbdeee",89,58,85,7.32941176470588,89,0,2,3
"25757","b2275c702e06f8d74e5f5599361ccebd",2,2,0,2,2,0,1,2
"25758","b228174a901f17d580feb37a86d5b74f",33,32,54,4.27777777777778,33,0,2,1
"25759","b228faf1cda0246fdf84060ecc007822",25,25,0,25,25,0,1,2
"25760","b22a09346de9f9da3b464b259ef53811",161,93,76,14.8289473684211,161,0,3,3
"25761","b22d6fd43dd019b404efa7791e20704f",15,13,10,10.5,15,0,1,2
"25762","b231f9440f3f75620f7adcc7c0f7bfe2",26,26,0,26,26,0,1,2
"25763","b2336770b73583fb25432617abaf8f59",7,7,0,7,7,0,1,2
"25764","b234da439514239f8b1a3c7fcc693ccb",53,53,0,53,53,0,1,2
"25765","b2385a432c8901642a5eebfdaf33b388",149,89,82,12.719512195122,149,0,3,3
"25766","b23b37a5411c813c16b45b47fb1cb8b0",172,80,59,20.4067796610169,172,0,3,3
"25767","b23c7aa4e253dab8baa087474485ec81",156,77,80,13.65,156,0,3,3
"25768","b23da6bcc06d1dfcff9c391e36542c23",45,45,0,45,0,45,1,2
"25769","b23eac83fad1d291a2d01eef6532a25c",12,12,0,12,0,12,1,2
"25770","b23f16b8c016b8c7e44b50d6ec30e968",8,8,0,8,8,0,1,2
"25771","b23fe155875a4ff065f7011c4df907ea",10,10,0,10,10,0,1,2
"25772","b241613c598fcdc791820795fe84d81b",36,36,0,36,36,0,1,2
"25773","b24255dca9648ceb4115edb62be16784",16,16,0,16,16,0,1,2
"25774","b24606a9be6af45fa58e9c884152141a",70,23,74,6.62162162162162,58,12,2,1
"25775","b24659d259deda8a4b5a7034c5b730bd",37,32,24,10.7916666666667,37,0,2,1
"25776","b246eeabe2ddd1726d102f1a525a2f83",26,17,83,2.19277108433735,26,0,2,1
"25777","b249f7dcf6c2a1e4bb5bc1c03d15562a",8,8,0,8,8,0,1,2
"25778","b24a2ed076d7e68d8c1639dfe4285020",120,87,63,13.3333333333333,120,0,3,3
"25779","b24a875692665dab9de4c16251261116",35,35,0,35,35,0,1,2
"25780","b24bd4fd68f7dc9a1ad165136b7e5b32",28,28,0,28,28,0,1,2
"25781","b24c9e378219a859f3fe6f3065a9347a",42,35,72,4.08333333333333,42,0,2,1
"25782","b251b2c5f9a9aa61d4d2f5347ee9314e",64,51,82,5.46341463414634,44,20,2,1
"25783","b255251e3650f9f01ac3c8a88d92da5c",39,39,0,39,39,0,1,2
"25784","b2555ebaab50466b02c8749010d9f74c",11,11,0,11,0,11,1,2
"25785","b25ada3d7403b54be90c8756a64fef77",37,37,0,37,0,37,1,2
"25786","b260e176d309f1cb928d2460dc7ace06",55,55,0,55,55,0,1,2
"25787","b261ac80c4ac9d8c4c10d19caa8938af",130,79,37,24.5945945945946,99,31,3,3
"25788","b2688922983508f88037efe068582399",35,20,59,4.15254237288136,28,7,2,1
"25789","b26b58eb93e2108714b8e01857fe43a7",24,24,0,24,24,0,1,2
"25790","b26bf647a94b0b5165c1f2e4c0dddd19",7,7,0,7,7,0,1,2
"25791","b26caf3b4e16b4ba2b408e76fd8b5609",137,84,38,25.2368421052632,94,43,3,3
"25792","b26cd9e17a4318e15eb7af4ac7dde577",50,31,56,6.25,50,0,2,1
"25793","b26e502822d2a36a5f8e0cfabe0b1311",51,51,0,51,51,0,1,2
"25794","b26f3a66ee78c8d512e2990f3edf1a6d",16,16,0,16,16,0,1,2
"25795","b26f76c8b931af48ad66c7ea0b847f14",1,1,0,1,0,1,1,2
"25796","b26fd42a2362a1232be7d1352137c917",89,54,56,11.125,63,26,2,1
"25797","b2755185b43dd72d125c3346c0445630",13,13,0,13,13,0,1,2
"25798","b27749aa53fc523ef18146b038294d2e",67,54,25,18.76,67,0,2,1
"25799","b2775b37943b0245e022f1ce50efd379",22,22,0,22,22,0,1,2
"25800","b2785f7bf19016b87a61df51213045d8",28,28,0,28,28,0,1,2
"25801","b27979ba7ce70078d76b45e529c638eb",62,44,20,21.7,62,0,1,1
"25802","b27a8bcf727307168ea82c60af874eb6",32,32,0,32,0,32,1,2
"25803","b27ade3e1551b1d2bec7294a59cff840",54,42,35,10.8,54,0,2,1
"25804","b27b59169d211511f932e75ced71896c",22,22,0,22,22,0,1,2
"25805","b27c24dcbc03aaf10fb6f8012a3fd03a",170,83,89,13.3707865168539,170,0,3,3
"25806","b27d1efe45f88c232b270a392e72a691",30,25,22,9.54545454545454,30,0,2,1
"25807","b27e42905d630c03845786afa0692133",16,16,0,16,16,0,1,2
"25808","b27f35efd961f2478d7a5fd33deeaa35",39,39,0,39,39,0,1,2
"25809","b2802e115e3dcb7d0d5fde0abc2dd7be",9,9,0,9,9,0,1,2
"25810","b2813464aeab23b626e0b1378c2e5369",3,2,28,0.75,0,3,2,1
"25811","b283cd3969ffc49c781a7b635355c64c",24,24,0,24,24,0,1,2
"25812","b28492b66e59838630c83b1c9e664695",105,73,69,10.6521739130435,53,52,2,3
"25813","b2857a61bd4f81de452e511cbfc8bf1d",31,31,0,31,31,0,1,2
"25814","b286300c0087ab1c302774ec52e79613",153,54,82,13.0609756097561,137,16,3,1
"25815","b2894a3092af03a83d0976f1c4e5c53e",22,22,0,22,22,0,1,2
"25816","b289d30b319d274907cbd3bf9b4d575b",19,14,78,1.70512820512821,19,0,2,1
"25817","b28d175a3c8f9d9161371a14965b2de2",126,72,76,11.6052631578947,126,0,3,3
"25818","b28e552f50335d226573ed22a027bd6f",146,93,67,15.2537313432836,146,0,3,3
"25819","b28f86b21ae7a5144232e22037aabfec",151,108,35,30.2,151,0,3,3
"25820","b29013b7a84ac97a1166fde8780c222c",60,54,13,32.3076923076923,34,26,1,2
"25821","b290d7a5e0ccbe2e8df1ec40fbe7a38b",24,24,0,24,24,0,1,2
"25822","b292cb7140c567aab4e0b88ff9e7e191",30,30,0,30,30,0,1,2
"25823","b293a23c45870944fcecf81b94a26c46",4,3,22,1.27272727272727,4,0,1,1
"25824","b2945748e9366fa77179014dce5abc18",72,56,17,29.6470588235294,33,39,1,1
"25825","b2959b5594561e04ffc907d88171e98d",34,32,38,6.26315789473684,15,19,2,1
"25826","b29a7af455ecc9b95a8984d3d954226e",126,64,82,10.7560975609756,110,16,3,1
"25827","b29b33ce8876ce65890b8813aec58d96",1,1,0,1,1,0,1,2
"25828","b29d55232a4daa9e7a6a80a4c3708096",37,37,0,37,37,0,1,2
"25829","b29da0fe9f37906ca323f86a278fb1b2",10,8,35,2,10,0,2,1
"25830","b29e045626196f43ac0824723211e8a6",50,42,42,8.33333333333333,50,0,2,1
"25831","b2a13f68f8aead0356b219cb98b6154f",2,2,0,2,2,0,1,2
"25832","b2a3dfca00598eee956d5a1a663798f2",24,24,0,24,24,0,1,2
"25833","b2a689e11f4f0d5f743556059bf185b1",7,7,0,7,7,0,1,2
"25834","b2a778f8de690f486168ef04a6c10a51",22,22,0,22,22,0,1,2
"25835","b2abdc8ca4bc4557fa15a26bac83587d",156,65,74,14.7567567567568,156,0,3,3
"25836","b2acfd66943c69c1c0340a2e3e057a81",180,124,74,17.027027027027,180,0,3,3
"25837","b2acfe95a3e786da3ff43be92e0e3c7a",158,105,70,15.8,158,0,3,3
"25838","b2ae3cb97a9b9b32cb7a76b9e83146a0",13,13,0,13,13,0,1,2
"25839","b2afda53dcfeee3aad19565014f255b7",27,27,0,27,27,0,1,2
"25840","b2b01cc3157f8bc258331883989362fc",17,17,0,17,17,0,1,2
"25841","b2b03d10ebbc29f45ebe087132b571e9",2,1,0,2,2,0,1,2
"25842","b2b166edf09334406a793933b0c39d88",31,31,0,31,31,0,1,2
"25843","b2b49cf88207f6f7e1429f18c4e7f959",153,103,70,15.3,153,0,3,3
"25844","b2b503211ec5cfb6a112eb860f64e697",111,88,60,12.95,75,36,3,3
"25845","b2b5558317dce35aad536de931439ddc",77,59,31,17.3870967741935,41,36,2,1
"25846","b2b79883c1adbfefab66e27988b8a2b8",23,23,0,23,23,0,1,2
"25847","b2b952c01a118278c614954c388566f6",41,41,0,41,41,0,1,2
"25848","b2c1aea63e7ded3bc75b752f5043812f",108,50,77,9.81818181818182,108,0,2,3
"25849","b2c38883b5829ccd13cc07ee874cb2e5",113,82,38,20.8157894736842,113,0,3,3
"25850","b2c57b12e3f7f8f1ec394c20ac3b7284",23,23,0,23,23,0,1,2
"25851","b2c818daa08b5f9f38ad365f5e43a16e",62,47,34,12.7647058823529,62,0,2,1
"25852","b2c83457998d6b0fe522e80b6b80d58a",115,66,46,17.5,115,0,3,3
"25853","b2c853131498d6c960fb786e630eeea8",45,36,47,6.70212765957447,45,0,2,1
"25854","b2c85b9e33eb34d9cf628e3edd30753c",22,22,0,22,22,0,1,2
"25855","b2caef920e29b49d706d45d89f83a178",40,34,33,8.48484848484848,40,0,2,1
"25856","b2cba3c3881ac7582227e3b8ad785d53",45,45,0,45,45,0,1,2
"25857","b2cc6fe35fafc8328fd348d2d29f39b3",44,44,0,44,44,0,1,2
"25858","b2cf86d13f0b94e50306e8c1bf692ca3",25,25,0,25,25,0,1,2
"25859","b2d529610579897f012e0d0384b69796",126,70,66,13.3636363636364,126,0,3,3
"25860","b2da0ee44f52b2d7a4d32f1ab1b2bbe5",117,95,41,19.9756097560976,68,49,3,3
"25861","b2daad370b3316943bd75dae42acb00b",9,9,0,9,9,0,1,2
"25862","b2dddad982a2175105de2667881547a1",11,11,0,11,11,0,1,2
"25863","b2e11368888311d788ecc8e9607b5c70",104,81,82,8.87804878048781,104,0,3,3
"25864","b2e144ac28804f4c006372cf44ea772f",151,77,57,18.5438596491228,151,0,3,3
"25865","b2e1ae81a443273a30d1dcbc5ff670f4",42,42,0,42,42,0,1,2
"25866","b2e27dfcd17196414f8c29d1558f7670",5,3,49,0.714285714285714,5,0,2,1
"25867","b2e2c52a75bd71de9015ea33c74a7e1c",36,30,16,15.75,36,0,1,1
"25868","b2e6bbc7543902abfc6a13b33aa795f5",142,87,61,16.2950819672131,106,36,3,3
"25869","b2e7f35e4d10438ac8ef89a0aae5de9e",6,6,0,6,6,0,1,2
"25870","b2e8f28d58ec72ac3881d91af3cae205",113,54,76,10.4078947368421,72,41,2,3
"25871","b2e9625480866a84c72f65acefd9735c",47,32,56,5.875,47,0,2,1
"25872","b2e9a0db4bc5322e18956f268345d781",6,6,0,6,6,0,1,2
"25873","b2ec78bdabc37e8d7a646d075d696fd1",23,23,0,23,23,0,1,2
"25874","b2ee30e9ff8196a46a8a5ada17ae3ff4",220,66,85,18.1176470588235,172,48,3,3
"25875","b2ee5c82db8f1887157a34d0775237fe",35,35,0,35,35,0,1,2
"25876","b2ef4e16f1b742681680b3c26525b395",11,11,0,11,11,0,1,2
"25877","b2f08860bb19957be8a0968c57f64e79",21,21,0,21,21,0,1,2
"25878","b2f10ee3ec2ad5853056d3a4325a8042",28,28,0,28,28,0,1,2
"25879","b2f153f2a3e05b6bfd71c7c98409efb0",7,7,0,7,7,0,1,2
"25880","b2f3aa5f17d03d5c2f1ac5062a0e66b4",28,21,7,28,28,0,1,2
"25881","b2f58f6d245e79c2a2bb3af441cdb28e",55,42,56,6.875,55,0,2,1
"25882","b2f5b24f78589fd23ffc68d0c09789fb",8,8,0,8,8,0,1,2
"25883","b2f713ff92f017ccdd7598c2bf552c32",75,67,14,37.5,75,0,1,2
"25884","b2f75ca4cb13bee5474ae80f8468c66f",56,43,63,6.22222222222222,56,0,2,1
"25885","b2f9fa61aaa9545fe3fd2f9ca4565363",43,35,46,6.54347826086957,43,0,2,1
"25886","b2fad5e6426e5eb421e177b76b57cfeb",11,11,0,11,11,0,1,2
"25887","b2fbec5c403d1bd7eeb67635b68152de",129,84,72,12.5416666666667,110,19,3,3
"25888","b2fd4edf34174d56a8715ca06adfdd3c",36,36,0,36,36,0,1,2
"25889","b2fe815cf9efeda87a0b276df29edc75",108,51,70,10.8,108,0,2,3
"25890","b2fef591e4e015f47757690ec17baab4",33,33,0,33,33,0,1,2
"25891","b303ef54c1121547dd663c14c7ec99f1",43,43,0,43,43,0,1,2
"25892","b3096e0a0f6c36b67059771ec2cce34a",45,27,73,4.31506849315068,42,3,2,1
"25893","b309c7868b3055f74ea60755cea423fc",22,22,0,22,22,0,1,2
"25894","b30a68337c6f7a363a39c9f04b761ea6",31,31,0,31,31,0,1,2
"25895","b30abe6b7e04855715c0744fedfc78c2",64,38,61,7.34426229508197,48,16,2,1
"25896","b30b14a61d976e47205a30975d7de583",30,30,0,30,30,0,1,2
"25897","b30f74a3b80ea4c42a9023821521d990",232,138,55,29.5272727272727,196,36,3,3
"25898","b31157a318c035547ef839f92ab168ad",63,56,27,16.3333333333333,63,0,2,1
"25899","b31215a386ea0b65da4b8d850093520c",33,33,0,33,33,0,1,2
"25900","b31244e0c085fd01ca704059d32a9bbd",219,105,74,20.7162162162162,219,0,3,3
"25901","b312bf52169c51b56dde85d8475f012b",22,22,0,22,22,0,1,2
"25902","b31400d9acbe7df895aa14dc3bcd5a50",29,29,0,29,29,0,1,2
"25903","b3179ab13b0bfc8e75c6b921f61dab4b",108,63,66,11.4545454545455,90,18,2,1
"25904","b3189dd7d406789eb76bc53ff8ecbe72",189,127,64,20.671875,189,0,3,3
"25905","b318b2d13377c95b9f669c476694dfbe",82,64,27,21.2592592592593,82,0,2,3
"25906","b31937493ccbf58cb7623eed21f478e8",237,95,77,21.5454545454545,206,31,3,3
"25907","b319e6c4f4551f02a70651dc7d8fe1a9",160,83,81,13.8271604938272,131,29,3,3
"25908","b31a5a4ec10cad9ce7ff03e92e73c8c2",12,12,0,12,12,0,1,2
"25909","b31b6ed181777529de1a5ebfa0013b08",89,67,16,38.9375,89,0,1,2
"25910","b31bc92d2fc7f12c7eea71d19a723fd5",41,35,13,22.0769230769231,41,0,1,1
"25911","b31d170dd3683ca05b4c2d9ef1c28f30",38,38,0,38,38,0,1,2
"25912","b31f6a775048d142859eca6599c6e908",148,88,69,15.0144927536232,148,0,3,3
"25913","b320eb42c1c1bcd2156879e67d4a4965",109,77,34,22.4411764705882,109,0,3,3
"25914","b32364588aaab3f766ef4fd7995bab7d",38,35,38,7,38,0,2,1
"25915","b32470358dca5388b3371bf0f541f4d0",40,40,0,40,40,0,1,2
"25916","b324cb2d828633e0b1acedd6990955ea",55,51,14,27.5,55,0,1,1
"25917","b32cf1518d939193bf97312a446edd10",60,39,57,7.36842105263158,60,0,2,1
"25918","b32f88b6f8f3bdbbc432469d736558cd",15,15,0,15,15,0,1,2
"25919","b32f9cf9a944a9f49e6bc6af465f7aa8",151,68,70,15.1,130,21,3,3
"25920","b33217dc1e70c5ee1f5543acf889b0df",32,21,64,3.5,13,19,2,1
"25921","b33375c44aa1702b49bcea7a159272d8",28,28,0,28,28,0,1,2
"25922","b334a51b1cab0aa6ba71b868b5ebcb06",21,21,0,21,0,21,1,2
"25923","b3358baef4c308afe5617da141808134",50,46,54,6.48148148148148,19,31,2,1
"25924","b336f5c381cb60dea753b7dd6f02ce76",182,113,56,22.75,182,0,3,3
"25925","b3384221624e2cb0896c00b5b33d4087",12,12,0,12,12,0,1,2
"25926","b3385c0c024347c80151e9f3fb5cf4c2",18,18,0,18,18,0,1,2
"25927","b33a6b1b3acd696c74127d9c90e23d65",28,28,0,28,28,0,1,2
"25928","b3416bc316664ff291d6405952ec5941",182,94,60,21.2333333333333,130,52,3,3
"25929","b34836164e53be5ca03096a83bda27f6",40,38,29,9.6551724137931,15,25,2,1
"25930","b34a88d2db60cff3f906a5a53501b637",23,23,0,23,23,0,1,2
"25931","b34bdbceb29162d95aa6e420c80c51a5",22,22,0,22,22,0,1,2
"25932","b350dece71e11ce41c8d52158fcd4758",7,5,63,0.777777777777778,7,0,2,1
"25933","b35330fc720163a108e8afed5a516c6b",39,39,0,39,0,39,1,2
"25934","b354088f6563dd27f42431eeb12643e9",24,23,56,3,24,0,2,1
"25935","b355e6cd59cf96593158b27c14516852",5,5,0,5,5,0,1,2
"25936","b3573445ca9c9f25ad77d213a95561c0",118,84,34,24.2941176470588,118,0,3,3
"25937","b3579d95a5c4a2b830c4de38e36fa997",12,12,0,12,12,0,1,2
"25938","b3583ca044aba7a614f2b82652a77e7d",42,29,57,5.15789473684211,42,0,2,1
"25939","b360baed12e01c378f9e1f80aae60d05",41,41,0,41,41,0,1,2
"25940","b362adbd80840fb5bed4298e3ef878b8",124,85,40,21.7,124,0,3,3
"25941","b363a70e86068bcbfec9fc46d08ff4bb",86,66,35,17.2,86,0,2,3
"25942","b364ce5d650f1b09ff90e1a0820e95d9",88,41,35,17.6,36,52,2,1
"25943","b3657ecf97ecf7bb2accd03b247bffd1",31,31,0,31,31,0,1,2
"25944","b365a49ebfbe12b3bfe8bcd1355c8d41",20,20,0,20,20,0,1,2
"25945","b365cdb7f1dc98a85b7c7be417fcf2bb",97,74,65,10.4461538461538,97,0,2,3
"25946","b367d6d2abd856944b83f14ecd6028ea",26,26,0,26,26,0,1,2
"25947","b36844282c9408ea53fd3839bacebba1",16,16,0,16,16,0,1,2
"25948","b36b14f586f5dc66b061cb2fcba6ab60",5,5,0,5,5,0,1,2
"25949","b36fb255f9eb9c40232771eee35dd3d9",59,49,18,22.9444444444444,59,0,1,1
"25950","b3731f2556528c95f20c42c316363ce3",103,72,65,11.0923076923077,81,22,3,1
"25951","b373b9265005b985f2eba1f80c2f0c38",122,85,88,9.70454545454546,122,0,3,3
"25952","b373ed57431dbfd3f6e6a405ebe5829e",47,47,0,47,47,0,1,2
"25953","b37595307ad4aab33513507f56b7c8ff",52,47,65,5.6,52,0,2,1
"25954","b37849ab950d96f9efbbeacb04a053b1",23,23,0,23,23,0,1,2
"25955","b378d83420a3cd6d5af4b308ded25e9e",86,79,26,23.1538461538462,86,0,2,3
"25956","b379aa0c7ac70eada4c80a6524aaa00c",35,35,0,35,35,0,1,2
"25957","b379f2a90a9e3164e5db51552ec42a9a",70,55,64,7.65625,70,0,2,3
"25958","b37ab6655d8959a4642ded07fc88c75f",17,17,0,17,17,0,1,2
"25959","b37becad6f2ba7a0135a972c80628c78",97,68,32,21.21875,51,46,2,3
"25960","b380430da4df7c40f1909cd387352010",18,18,0,18,18,0,1,2
"25961","b380ff073ececbb6449f06a38e94f9cd",156,61,61,17.9016393442623,156,0,3,3
"25962","b382faa9f5ef6b970e66ed3fdaedab58",13,13,0,13,13,0,1,2
"25963","b38529e509ceb97fece55a765c323217",40,30,49,5.71428571428571,40,0,2,1
"25964","b38aca116732e88441d5ab8a97e2dec5",120,75,84,10,120,0,3,3
"25965","b38babf0f70046186ce6b3d6af8e140a",10,10,0,10,10,0,1,2
"25966","b38c2f36e3ba90fa98fdcd3d8d9cb706",162,93,52,21.8076923076923,162,0,3,3
"25967","b391a0a6f4afa8a3cb18c67e8ef760e2",23,18,44,3.65909090909091,23,0,2,1
"25968","b39223f5803951805780e5390c8891a8",209,91,84,17.4166666666667,209,0,3,3
"25969","b39317c92243afa5c3174f6ca45c09f3",180,111,72,17.5,150,30,3,3
"25970","b3931e47e7b3eee4347cb4af47250b71",206,79,60,24.0333333333333,206,0,3,3
"25971","b3950abfd9f6dfb01b32c3d6b7d1621a",110,80,56,13.75,110,0,3,3
"25972","b3964f78700116cd6fcc239234dd78aa",19,19,0,19,0,19,1,2
"25973","b3978b9ab78b3662ac7da328f5c68a7e",25,25,0,25,25,0,1,2
"25974","b3988df699b9bba6816b0a65ee649d73",120,65,61,13.7704918032787,120,0,3,3
"25975","b39a0f8454b01ab55dc0f199e467c368",128,98,70,12.8,128,0,3,3
"25976","b39ade4df232b0c73e4a305ed41893f6",34,31,40,5.95,34,0,2,1
"25977","b39e6fbb776f555cac159b9d592d9182",44,30,43,7.16279069767442,44,0,2,1
"25978","b39e839fa69287d5b5a8acfd3b16f016",87,62,48,12.6875,87,0,2,3
"25979","b3a11e0e10216d7ac7836a888e410985",34,34,0,34,34,0,1,2
"25980","b3a18f330b3aa25f8e3c0d3fd8795d23",20,20,0,20,20,0,1,2
"25981","b3a967c9e833e7cd6e2ce3a4414e0dc8",12,12,0,12,0,12,1,2
"25982","b3aa121a2af5d028a6b3b38fa16f9130",20,20,0,20,20,0,1,2
"25983","b3af08e72c540589b030daadafe2a040",12,12,0,12,12,0,1,2
"25984","b3af68ea7407222bdc197b491b0c6ffb",81,47,35,16.2,81,0,2,1
"25985","b3b4ed6864b8bba05fcb2f5c225cf398",7,7,0,7,7,0,1,2
"25986","b3b584393c16ad4cca5c7935c4734d29",119,63,63,13.2222222222222,119,0,3,3
"25987","b3b6a41a80cec0e84e4e7e2aa06d0b9e",66,54,54,8.55555555555556,34,32,2,1
"25988","b3ba410d72e933777de7db968a915080",110,94,21,36.6666666666667,110,0,3,3
"25989","b3bb7f2bab20136ab61752dfd94463c3",72,58,74,6.81081081081081,72,0,2,3
"25990","b3bb80e6b5fb1865f4159854942552de",96,68,53,12.6792452830189,96,0,2,3
"25991","b3c00160927756183d8fce92a8404266",18,18,0,18,18,0,1,2
"25992","b3c06309661787602bf8c68303b0ef97",120,84,82,10.2439024390244,120,0,3,3
"25993","b3c4bc248dcd823a1e9d2cfdcd63cf4c",13,13,0,13,13,0,1,2
"25994","b3c63acbb380ff407be136e764628af8",36,30,28,9,36,0,2,1
"25995","b3c8ec4274927ca1b793b17087717a51",16,16,0,16,16,0,1,2
"25996","b3cef0cc10ada0257f5a9d27f4de2343",81,63,15,37.8,81,0,1,2
"25997","b3d12659086b11997bb6cf53f390c7a3",203,80,67,21.2089552238806,171,32,3,3
"25998","b3d32c39643401aba6432b64daf75013",49,49,0,49,0,49,1,2
"25999","b3d3f7793d444db7e46d3b69f6063c1d",26,26,0,26,26,0,1,2
"26000","b3d48b7c0d63027fe78092bd1672ed04",8,8,0,8,8,0,1,2
"26001","b3dd9a289af8be67d57df1f48af30532",98,80,28,24.5,98,0,3,3
"26002","b3deb1f65f4ec88aa577e7afceaaa34c",25,25,0,25,25,0,1,2
"26003","b3df08f87f62743ef21dc0776e4e87e9",28,28,0,28,0,28,1,2
"26004","b3dfa3ef7a207d64fbe4bf6cd85475a4",15,15,0,15,15,0,1,2
"26005","b3e189b2044561339c750f76394aa95d",98,74,60,11.4333333333333,98,0,2,3
"26006","b3e2f742517e4505410ccab60d42a958",152,93,62,17.1612903225806,152,0,3,3
"26007","b3e30e87abc06325a76d3cab80ec00fc",9,9,0,9,9,0,1,2
"26008","b3e8707c5b40ea07204eb91a3cf41105",189,95,78,16.9615384615385,189,0,3,3
"26009","b3e8ec66f431f31a797cf3b7885b5f5e",137,95,76,12.6184210526316,137,0,3,3
"26010","b3e94b6cd90ad9fb8be9f6fe3c0e1f99",92,67,62,10.3870967741935,92,0,2,3
"26011","b3e958bb16025553a02cb5fbcb9e3e40",39,27,58,4.70689655172414,22,17,2,1
"26012","b3eacd9108cf95817fd9d0153bfce05a",32,32,0,32,32,0,1,2
"26013","b3eb8381059e256cccf18a10de105c2e",17,17,0,17,17,0,1,2
"26014","b3ec2116792def1d1f64333508e2c3a5",57,49,54,7.38888888888889,33,24,2,1
"26015","b3ef8c3e3651c6299ae3526e44930279",48,48,0,48,48,0,1,2
"26016","b3f0f61584ae26f50af314c8bd036b90",44,33,31,9.93548387096774,4,40,2,1
"26017","b3f39f61d08dde99be5b14cc817eb296",68,52,41,11.609756097561,21,47,2,1
"26018","b3f4810221f5971e8f5c64cf8d7634f1",28,28,0,28,28,0,1,2
"26019","b3f5144b08267e37f831dd40b8fe3ee4",26,26,0,26,26,0,1,2
"26020","b3f7d8ace9c0aa822bfc4ba5ee36e059",23,23,0,23,23,0,1,2
"26021","b3f8c1a84f03c3a079c012efc0bb51a5",132,63,90,10.2666666666667,97,35,3,3
"26022","b3fadb5400c072e7787fc9b33e5840a8",36,36,0,36,36,0,1,2
"26023","b3fbcaa45bf05c8a7fb579b62a0ff432",13,12,22,4.13636363636364,13,0,1,1
"26024","b3fd020a7027675ee5284a42d6568ec3",87,72,45,13.5333333333333,87,0,2,3
"26025","b3feac9430e929767c357682cd76596f",31,29,28,7.75,31,0,2,1
"26026","b4006c5b43564b64b1178233efeb967a",57,49,63,6.33333333333333,57,0,2,3
"26027","b402cab3dea9a71c6bc0212ad7c8ac27",86,60,41,14.6829268292683,86,0,2,3
"26028","b403d53df943a00c5cac3c1441436aa0",67,40,57,8.2280701754386,67,0,2,1
"26029","b4046ac5b3ba426a05a6c6bbb0df966c",7,7,0,7,7,0,1,2
"26030","b405ba18d0d1971f6b22d1dde2583668",156,81,60,18.2,111,45,3,3
"26031","b406dde211d3dce49ffc2e243d510a01",7,7,0,7,7,0,1,2
"26032","b4075040d56e157892949edfafee3498",56,38,23,17.0434782608696,30,26,2,1
"26033","b4083b73d16a6c578dc59dac91e8d172",64,46,70,6.4,64,0,2,1
"26034","b408c15771605f2eb07eb11a0e0d95e9",98,77,48,14.2916666666667,98,0,3,3
"26035","b40b3f2b6cc9e4deaeed992f57bad772",51,43,39,9.15384615384616,51,0,2,1
"26036","b40cdb42b0484046897963fd79fe75a0",37,37,28,9.25,37,0,2,1
"26037","b40ec6efd92a2ee8bdf6baeb5a56b464",50,43,14,25,50,0,1,1
"26038","b4109d534b05f1e3fd533045d3180cc0",30,30,0,30,30,0,1,2
"26039","b410a94cb2b78965f3ac6630ee5c34a0",96,56,44,15.2727272727273,96,0,2,3
"26040","b4122ebeaa29904bfb2a8ad52f9d8f72",89,71,67,9.29850746268657,59,30,2,1
"26041","b41603387ed59b8ab2ddb0a6391a6eba",25,25,0,25,25,0,1,2
"26042","b41802f213c520c7dc4e40b5d11d91bd",109,80,69,11.0579710144928,109,0,3,3
"26043","b418eaca636c92e440909178af55bd2d",204,104,67,21.3134328358209,159,45,3,3
"26044","b4190d867ebfbb55208f0c33126a86ac",1,1,0,1,0,1,1,2
"26045","b41b9884f17d23fac58a380e40c0c348",31,31,0,31,31,0,1,2
"26046","b41d9fc7cd1947c161bbb0bcea973b60",39,39,0,39,39,0,1,2
"26047","b41dc8805e6707fe528d62d113f31672",84,61,76,7.73684210526316,34,50,2,3
"26048","b4248267a56a46d81fce3532ff7f577f",145,83,65,15.6153846153846,145,0,3,3
"26049","b425da80b9292945f2c9ea677a4e6288",36,36,0,36,36,0,1,2
"26050","b42976a89f75c1041dec2142fa3768cd",121,94,78,10.8589743589744,70,51,3,3
"26051","b429952e19dd0c7c5f4dd7bfbd3a6919",29,29,0,29,29,0,1,2
"26052","b42c39697fdc9e9b71c1f12a34276376",53,44,36,10.3055555555556,53,0,2,1
"26053","b42db38dfad1a534d756b7fcbc630ab9",38,38,0,38,38,0,1,2
"26054","b42f42fee4761795dc63dbafed483eff",156,99,59,18.5084745762712,121,35,3,3
"26055","b433dd55423d07701281a6214bf882e4",14,14,0,14,14,0,1,2
"26056","b4342bd23129ab63e2473b938767f3f4",178,95,82,15.1951219512195,146,32,3,3
"26057","b43509befd2ba33c3583f25c6fa37e79",1,1,0,1,1,0,1,2
"26058","b4378e413b3a62614e2aecee480524a5",8,8,0,8,8,0,1,2
"26059","b43901b6dd7fbee5b272c41751ee7103",46,39,18,17.8888888888889,46,0,1,1
"26060","b43b20be96abdba9b252229bdef8838c",8,4,76,0.736842105263158,8,0,2,1
"26061","b43cb658a909f3e988cb87e9ebc83811",7,4,38,1.28947368421053,4,3,2,1
"26062","b43dfa21ab85b52eb699f614ac4f5f9c",54,47,38,9.94736842105263,54,0,2,1
"26063","b43e263f1d92c9568b13955e84da6e11",148,94,78,13.2820512820513,148,0,3,3
"26064","b43eef5517a0f94b04a0f2b8cbb1c11e",47,25,43,7.65116279069767,47,0,2,1
"26065","b440c222ebbadd46ffa86b0a7ed75bf7",228,99,82,19.4634146341463,197,31,3,3
"26066","b4458a95033d53a5e1bf6e50d9ac9391",75,62,76,6.90789473684211,75,0,2,3
"26067","b44656aa23645f7d31e1cb556e83f022",180,101,62,20.3225806451613,180,0,3,3
"26068","b4471311fd45a8e9efe33627fdffbba2",85,58,68,8.75,85,0,2,3
"26069","b447e9367eee674d5406602598a76e64",29,29,0,29,29,0,1,2
"26070","b44bca197bfab13ab5cf0d19d1141367",33,33,0,33,33,0,1,2
"26071","b44d8c6960578ea318d8aa109bffeefa",152,101,42,25.3333333333333,152,0,3,3
"26072","b44db111f92b2d49de302e20cf2249ea",116,85,60,13.5333333333333,89,27,3,1
"26073","b44f647698aa120bf8e4792a08770968",41,29,66,4.34848484848485,41,0,2,1
"26074","b453ad18a2379fe794653cf8c943fbee",58,46,34,11.9411764705882,58,0,2,1
"26075","b45657aa97b941a5b4fd3076ba9f77a9",21,21,0,21,21,0,1,2
"26076","b45becc943c910c9b03e656535be6b3d",10,10,0,10,10,0,1,2
"26077","b45c825b0c86757f795d37c9db61c350",157,103,62,17.7258064516129,113,44,3,3
"26078","b45de3f03b5ffab841c464e7ee9a7ff9",118,71,49,16.8571428571429,118,0,3,3
"26079","b460d48e56c3d90d5f9b32e15f6cb99c",55,55,0,55,55,0,1,2
"26080","b462eae67d87b5aa74a9ccd48e74e28d",21,21,0,21,0,21,1,2
"26081","b463275040a947cfde94900931aa7fa3",21,21,0,21,21,0,1,2
"26082","b4661230350326467961bc3c30fefaca",20,20,0,20,0,20,1,2
"26083","b4668158874f1e380556173376043e5f",69,60,87,5.55172413793103,68,1,2,3
"26084","b46bae8404b20b981cc02a7253b57981",110,44,63,12.2222222222222,110,0,2,3
"26085","b46cf140619f94a127c42ba81ecdd5b1",15,9,46,2.28260869565217,15,0,2,1
"26086","b471a83e084da4583d7922ebde8a4cd8",66,38,82,5.63414634146342,53,13,2,1
"26087","b475ecd1a0ab95cc5d69c6ee17dc3a09",19,13,21,6.33333333333333,19,0,1,1
"26088","b476274116cc2c3fa2423c5cd7290a92",160,137,49,22.8571428571429,160,0,3,3
"26089","b4767a756e3f8d65c211d400562721f3",65,47,38,11.9736842105263,65,0,2,1
"26090","b477f4d5ca34367c66892299e8b6136b",183,59,84,15.25,183,0,3,3
"26091","b4787d451a3cc4e447af9eff1eb493bc",15,15,0,15,0,15,1,2
"26092","b47891be5d4230deaf7e5aa8acb9640a",121,60,76,11.1447368421053,121,0,3,3
"26093","b479d663b142e67a94a9122d599bba6c",22,19,74,2.08108108108108,22,0,2,1
"26094","b47c5aab31d878e1df61d78cc8e491f5",86,37,62,9.70967741935484,86,0,2,3
"26095","b47c5ec971fe59e3c8bc6f80892533c2",37,30,66,3.92424242424242,37,0,2,1
"26096","b47fb956633ed5e5f1d7d9a68d436f72",46,38,42,7.66666666666667,46,0,2,1
"26097","b4800891a3b5234bd86314d663da5901",47,30,45,7.31111111111111,26,21,2,1
"26098","b483b19696313907106dcda29eaef221",62,49,35,12.4,62,0,2,1
"26099","b483bd3a6bc93350d6ae124b051a7744",89,72,27,23.0740740740741,89,0,2,3
"26100","b4863719ad11af760fcad31961e8e3e3",92,80,39,16.5128205128205,47,45,2,3
"26101","b487afd0872d48c1a4a3991932cd667f",64,54,33,13.5757575757576,64,0,2,3
"26102","b488147d1e7aa1f5b9ea3d93b08434ca",18,18,0,18,18,0,1,2
"26103","b48c7be4cccf91eab610d2969fe6d12c",18,18,0,18,18,0,1,2
"26104","b48e00b61089b8a85c0c149cc530a52c",8,8,0,8,8,0,1,2
"26105","b48e0ed1500230fba48ba46dabcb621c",63,55,10,44.1,33,30,1,2
"26106","b490763268f47bf3f174f765a2b9e02c",25,25,0,25,25,0,1,2
"26107","b490cb9177a0803f5c43c3f29784a764",10,10,0,10,10,0,1,2
"26108","b4942ba36eb347074d5efd2d77b2c8bb",28,28,0,28,28,0,1,2
"26109","b4971f8ae57e462fda84e741bab27964",165,76,71,16.2676056338028,165,0,3,3
"26110","b49876f43e257dc5211bb8d2346346c8",36,33,32,7.875,21,15,2,1
"26111","b4991f0f517bf35593013a7c499e9a33",53,43,27,13.7407407407407,53,0,2,1
"26112","b49a93e2ed42d3a1e39a6e1506e0a1b5",31,31,0,31,31,0,1,2
"26113","b49b31ebb7cc71b7d356531fb48f725c",21,21,0,21,21,0,1,2
"26114","b49bb6f811ddce5ad6c21295676e72e9",128,106,40,22.4,128,0,3,3
"26115","b49eaf40a37a503acf8a7b469f91c7df",38,38,0,38,38,0,1,2
"26116","b4a0192842699cc640ed3fab71a6b905",23,23,0,23,23,0,1,2
"26117","b4a3a190fd6ef9f564894827fc9306da",99,72,79,8.77215189873418,99,0,3,3
"26118","b4a57ad171d5b25b5f3e0a35cefe9b92",95,71,58,11.4655172413793,51,44,2,3
"26119","b4a600479df1460ff12002922ed609cd",30,30,0,30,30,0,1,2
"26120","b4a6be878bbe12a923b7c06a2bad0bbf",59,26,70,5.9,59,0,2,1
"26121","b4a6bfaca186935cc24d6ae3e599b551",34,34,0,34,0,34,1,2
"26122","b4a9535b99067a05ec3d1c3aee759269",11,11,0,11,11,0,1,2
"26123","b4aaefde0b700c0ac991e1c174a7af14",27,22,69,2.73913043478261,27,0,2,1
"26124","b4adb9af9bccadaba11c3318453120d0",29,29,0,29,29,0,1,2
"26125","b4adcfc5ad4893f25409d2ec528ea193",48,24,85,3.95294117647059,39,9,2,1
"26126","b4aeee15a3ea721c855082e52ed53b4b",24,24,0,24,24,0,1,2
"26127","b4afd3f81f7a784058604a7b8075b08a",28,23,68,2.88235294117647,17,11,2,1
"26128","b4b0d866958ff3bf4653564933153e74",105,54,83,8.85542168674699,105,0,2,3
"26129","b4b1b50c98e12440ed9cd451f48139ff",13,13,0,13,13,0,1,2
"26130","b4b5edfda4e0eb60cd33ce7b67bf9239",13,13,0,13,13,0,1,2
"26131","b4b7a55848c109192acbf18a73601352",231,69,84,19.25,210,21,3,3
"26132","b4b7dfff7e1254479ab86b4e77d6dcfb",27,14,55,3.43636363636364,27,0,2,1
"26133","b4b80691f1aae251b06574682fa71fd5",125,83,57,15.3508771929825,125,0,3,3
"26134","b4bcb799f5b6e48c6b0f17ef903cad5e",25,25,0,25,25,0,1,2
"26135","b4bf4d242ed79de04dfc9e78aa0b614e",14,14,0,14,14,0,1,2
"26136","b4bf9c02d6411afedf1d8649815ebe8f",33,33,0,33,33,0,1,2
"26137","b4c05f66f10564a913f00f18dfae46d4",67,52,75,6.25333333333333,67,0,2,3
"26138","b4c065606aecbc1740b3510f3dfd9e50",164,113,69,16.6376811594203,164,0,3,3
"26139","b4c19d42fbe825675bd485206beaa21e",106,58,76,9.76315789473684,106,0,2,3
"26140","b4c25e2390adb32de2b52aeadf2634fe",46,34,28,11.5,46,0,2,1
"26141","b4c2fb231527186c2c115b0a94aa2bb7",56,37,38,10.3157894736842,25,31,2,1
"26142","b4c44777901d6cb8d935c1590de06a4d",45,41,62,5.08064516129032,45,0,2,1
"26143","b4c5d82edc7c3ba99fb71de6272f9981",19,19,0,19,19,0,1,2
"26144","b4c5f412388c812b1c36a5a30e51969b",101,54,68,10.3970588235294,66,35,2,1
"26145","b4c7531d91f085329a349b8232b64546",124,95,57,15.2280701754386,107,17,3,1
"26146","b4c9ca5386936b6ae65b6f1d4a932e95",3,3,0,3,3,0,1,2
"26147","b4ca4b68d6e1d11db129b704cf9e9998",23,23,0,23,23,0,1,2
"26148","b4caf60d5580ebc15fc13f7a7ecbf725",8,8,0,8,8,0,1,2
"26149","b4cc433347f9a03f1e16ed6e3178d42b",32,30,73,3.06849315068493,32,0,2,1
"26150","b4ccdec88e77fa2ecde33b40506b9dc2",251,140,71,24.7464788732394,208,43,3,3
"26151","b4d23366adf9d5d4bfc0a3feff9b682a",82,53,41,14,82,0,2,3
"26152","b4d37fe086809f510218c6a4193e2bff",21,21,0,21,21,0,1,2
"26153","b4d8d0b489e8c7beba0dfceeeb4d23f3",23,23,0,23,23,0,1,2
"26154","b4d9e4d5e2cd37843e663d71de705bc5",45,45,0,45,45,0,1,2
"26155","b4db34b2eef6e48af038f23e8eb54ad9",129,80,44,20.5227272727273,129,0,3,3
"26156","b4dc1ece554f4aaf4635a093a98924cf",1,1,0,1,1,0,1,2
"26157","b4dc4f9ee31ec20fbf230d56f07ec73d",32,32,0,32,32,0,1,2
"26158","b4dcf5420b685f3384f1fb1eddf4c8fb",24,19,56,3,24,0,2,1
"26159","b4e04063dfa794dcb298011f91d22f32",62,56,53,8.18867924528302,62,0,2,3
"26160","b4e0485499c9cf1e30ffb2db9732f260",18,18,0,18,18,0,1,2
"26161","b4e3029c40d21e0b2db35c299a10bcae",15,15,0,15,15,0,1,2
"26162","b4ebd26f399095458f4d0741c8601d71",53,39,59,6.28813559322034,53,0,2,1
"26163","b4ecfc01b77a91f388028954eb2e6b75",38,36,16,16.625,9,29,1,1
"26164","b4ee19517178a2279d03f67c24f5b654",92,42,58,11.1034482758621,65,27,2,1
"26165","b4eee5431282167b2c690ca5048226f8",33,33,0,33,33,0,1,2
"26166","b4f166d1b3dd7ab5a1916d3c0df250e8",75,49,46,11.4130434782609,75,0,2,3
"26167","b4f2b0cb35d38a931e0f564a31fe8750",32,25,38,5.89473684210526,21,11,2,1
"26168","b4f2b3ab6155de5a8a84ceb66cd2ca34",24,24,0,24,24,0,1,2
"26169","b4f3a9fe91106342dcecce85cebd7fc1",68,53,84,5.66666666666667,68,0,2,3
"26170","b4f635f4bc134a9d587c4e4cf2d30048",23,23,0,23,0,23,1,2
"26171","b4f96ae25883f182ac2197ad5457d823",26,18,63,2.88888888888889,26,0,2,1
"26172","b4f9848a287508cf84851d38c744817c",67,50,25,18.76,32,35,2,1
"26173","b4fa2ff08871358f7c9268aa3acba97f",140,103,42,23.3333333333333,103,37,3,3
"26174","b4fa816894a13484e897b1366988e680",21,21,0,21,21,0,1,2
"26175","b4fda3a7976e1d693e7f4b5ffc438f11",37,32,52,4.98076923076923,37,0,2,1
"26176","b4fdd7540131abfb8143f5997ab2794e",40,32,37,7.56756756756757,40,0,2,1
"26177","b4fdfe16399e36315b0d2e429365f010",109,46,63,12.1111111111111,109,0,2,3
"26178","b4fe2ffdeb06492469d211c2f98d8f12",11,11,0,11,11,0,1,2
"26179","b502bb682116bd0d9c2c212d36038326",103,75,67,10.7611940298507,103,0,3,3
"26180","b5037db13b77757c8b9e8b45d592c7f0",4,4,0,4,0,4,1,2
"26181","b5042eac5e139be345fa5b2ba9856614",5,5,0,5,5,0,1,2
"26182","b507b7ac7877c8bdf03e5d3af69b721f",1,1,0,1,1,0,1,2
"26183","b508421860bab0ca6dba8da3852363d2",70,57,30,16.3333333333333,70,0,2,1
"26184","b5093dca0eb65a4031607a2c788cf384",11,11,0,11,11,0,1,2
"26185","b50f6486750395b0e214f7830046d717",26,26,0,26,26,0,1,2
"26186","b50ff77ea9d80c2bb632d2976c2d79b0",27,27,0,27,27,0,1,2
"26187","b51160debe266a7ddf1cb91d9ddc53e2",175,99,64,19.140625,175,0,3,3
"26188","b51353fcf07cb61280eda45e33679871",138,82,42,23,105,33,3,3
"26189","b5138452a2f1930a27869c43382dafa0",33,33,0,33,33,0,1,2
"26190","b514b6958017c49ca75887d5f067268f",119,72,72,11.5694444444444,73,46,3,3
"26191","b519a0b4878c6d34b7fce030118e203c",17,14,72,1.65277777777778,17,0,2,1
"26192","b51a716cc62f32950fb483f5255e0ebd",125,78,83,10.5421686746988,125,0,3,3
"26193","b51b71734acc5362560944bd6b732842",2,2,0,2,2,0,1,2
"26194","b51bfd8ecd7bef7f41c82a00e18edaff",12,12,0,12,12,0,1,2
"26195","b51dae770d6bf8df7f522a74dd2e5dc3",179,94,55,22.7818181818182,179,0,3,3
"26196","b51f9747e6feed3139a4e17e2c295c41",170,98,57,20.8771929824561,170,0,3,3
"26197","b521a1a67586f377339a22ef39eeb883",151,76,64,16.515625,151,0,3,3
"26198","b522707c083b1cd74164d9da37a69dc3",127,56,84,10.5833333333333,127,0,3,3
"26199","b522a473cdce452d3ff8b7250d846f01",12,10,51,1.64705882352941,6,6,2,1
"26200","b52490c55749c165da46ff3fa683620b",36,36,0,36,36,0,1,2
"26201","b524be31943b050bd9566f7505b4b995",13,13,0,13,13,0,1,2
"26202","b5254df546ab87ce669f35d92bfdace0",25,18,57,3.07017543859649,25,0,2,1
"26203","b5288a591289a538a30cada5008b40a4",45,24,71,4.43661971830986,25,20,2,1
"26204","b528c35a01aaadf240db313f0b47313d",133,84,32,29.09375,133,0,3,3
"26205","b52a0f0542268926590ce7d59f1a6a6f",67,58,36,13.0277777777778,67,0,2,3
"26206","b52bb916736313397c050b44cf1e7806",18,18,0,18,18,0,1,2
"26207","b52bda5b2644bf3f6dfb4cd361fbd672",62,53,77,5.63636363636364,62,0,2,3
"26208","b52ccbe472c14784a3e2e20331d5d142",36,36,0,36,0,36,1,2
"26209","b52ff0b08047f8143a4b05cbdff37d3b",9,9,0,9,9,0,1,2
"26210","b531d4a818523382acdbe33f3a8dd1cf",32,24,23,9.73913043478261,32,0,2,1
"26211","b5324557c7cd2fb45c233e981ad5c680",221,104,70,22.1,184,37,3,3
"26212","b53259fb77dc50a666015542f41a20f3",29,29,0,29,29,0,1,2
"26213","b536c8af409fadd39f1354a1ed3d767f",26,22,34,5.35294117647059,26,0,2,1
"26214","b53881de711640cc1d04ab03ff714a67",23,23,0,23,23,0,1,2
"26215","b5396abedcce0b24d0c639c24e4acb67",1,1,0,1,1,0,1,2
"26216","b53b627d554ec7cc8aff3274e03dedf5",31,27,33,6.57575757575758,31,0,2,1
"26217","b53dcab5608a36022c33ca13882daedf",34,29,30,7.93333333333333,15,19,2,1
"26218","b5408a8053a0a4224c1677e49392abcb",28,28,0,28,28,0,1,2
"26219","b540e711345aebfed38851dedea6701d",39,39,0,39,39,0,1,2
"26220","b54236bcd72f89ecffcd753793bc0244",71,51,36,13.8055555555556,38,33,2,1
"26221","b5428b107ea27c948c4071f5546a5900",170,97,49,24.2857142857143,170,0,3,3
"26222","b543c8f43b475d332cc276da31d56fab",33,33,0,33,33,0,1,2
"26223","b544eefc0bb70e08b295ad6f62ad7cb1",15,15,0,15,15,0,1,2
"26224","b5457ba95cf4a55a73e03130561a251b",216,88,69,21.9130434782609,216,0,3,3
"26225","b54856f8ca67a690af7405e08f97539b",16,16,0,16,16,0,1,2
"26226","b54a0fd9c313924a087f2c0cb65d581f",41,31,37,7.75675675675676,17,24,2,1
"26227","b54a1b7c0aefee1053f1507883041e0d",32,32,0,32,32,0,1,2
"26228","b54ad955acb9576efdc92874713c9e41",20,20,0,20,20,0,1,2
"26229","b54c913ee416b32b7b3248b451c5070b",78,56,58,9.41379310344828,78,0,2,3
"26230","b54f2ea90c6d6f67fe0d42c952f92822",40,36,53,5.28301886792453,40,0,2,1
"26231","b55131e10f3b9acf74e06abf3e3ca61f",175,70,82,14.9390243902439,160,15,3,3
"26232","b552949c17144bb9fb914a5c3e7de281",47,16,81,4.06172839506173,47,0,2,1
"26233","b552f40129ee48d8a3fe665aa2ad3202",29,22,32,6.34375,29,0,2,1
"26234","b556ad89b0ef0634ea19e9d7e099d2de",80,54,50,11.2,80,0,2,3
"26235","b5577eb51385f7eb50f1da3a8c4acf24",61,48,26,16.4230769230769,61,0,2,1
"26236","b5585a57fc9c5ce9164ad69d49377ca9",18,18,0,18,18,0,1,2
"26237","b559733dc39cf82cab05d1ffd0104b80",167,92,69,16.9420289855072,167,0,3,3
"26238","b55a62072547338ef8a534bc4961037f",101,83,46,15.3695652173913,101,0,3,3
"26239","b55eb532be284b4a437d10affa61dd5b",80,70,18,31.1111111111111,80,0,1,3
"26240","b55f430c06e9b35bf9c5f22fe26b635d",6,5,55,0.763636363636364,6,0,2,1
"26241","b55f6ddc1501cd26030035baa4830f80",49,32,26,13.1923076923077,23,26,2,1
"26242","b565638709b5c3e35a54aec26fdddea4",20,20,0,20,20,0,1,2
"26243","b566ab54a92f6b0c6ea1c1c36dfe4a38",16,16,0,16,0,16,1,2
"26244","b567faa97c681d8568879707916da115",14,14,0,14,14,0,1,2
"26245","b56926915415dad07744faa3856878da",69,66,74,6.52702702702703,69,0,2,3
"26246","b56a73d8f38bcbae7d618b9542eba056",39,39,0,39,39,0,1,2
"26247","b56a7b607fab9fa7adfed0a10bbea6b0",1,1,0,1,1,0,1,2
"26248","b56f175664c22787111714643e5886b6",69,59,46,10.5,69,0,2,3
"26249","b56f39f725de4ff72a42133cfd6eb1a8",21,21,0,21,21,0,1,2
"26250","b570e6074b481da497a7f9785a7fa577",15,12,21,5,15,0,1,1
"26251","b57124fe8add818fb5a9a8264d7aa67a",47,36,7,47,0,47,1,2
"26252","b57241afc9c712e3a8fc0cd0836aed02",23,23,0,23,23,0,1,2
"26253","b572c2e688a9d6e85886bfd76f4c6f43",14,14,55,1.78181818181818,14,0,2,1
"26254","b573ac2989fdbe199bb84178fd8b8bc4",47,47,0,47,0,47,1,2
"26255","b575e5ef366e6b74df7d0d5d04df90ab",35,35,0,35,35,0,1,2
"26256","b5782b010ded84cffd76cc8c387ed1be",71,53,65,7.64615384615385,33,38,2,1
"26257","b5791d1596ea3fbd3dace570644d1751",22,22,0,22,22,0,1,2
"26258","b579851d5ce0c243f21d96efd64c6937",10,9,27,2.59259259259259,10,0,2,1
"26259","b57bc9d03c25865348dfaa7b6fad7bea",21,21,0,21,21,0,1,2
"26260","b57d1ef8628251e6260f685a01497cae",153,112,51,21,140,13,3,3
"26261","b57d4495cf4bb7a6ecf81a6d7fea5edf",18,18,0,18,18,0,1,2
"26262","b583e8c6d0977f7c09f59ee489563ce2",133,100,62,15.0161290322581,133,0,3,3
"26263","b588a96cb74deaa52f8355b31be155bb",139,100,72,13.5138888888889,113,26,3,3
"26264","b588b2220a57a3b0f13131fd07fb0443",21,21,0,21,21,0,1,2
"26265","b58c1328dac99825e7478378e685c556",71,60,30,16.5666666666667,71,0,2,1
"26266","b58c95de30cdb329c61bfcbfa31e2923",32,32,0,32,32,0,1,2
"26267","b58d62d17c9b8717554502e46f7e2881",69,61,18,26.8333333333333,69,0,1,2
"26268","b59058a475947d59cd0417ab6c8b283c",65,52,64,7.109375,26,39,2,1
"26269","b5929b42342a1efc5bcddeae9b278df6",44,33,64,4.8125,44,0,2,1
"26270","b59594364e726fa5bee37dbb910aaf66",36,36,0,36,36,0,1,2
"26271","b5971d9a27f3aeb64fb6111080c243a9",219,106,77,19.9090909090909,185,34,3,3
"26272","b5986eda0ae3b1e95427148e8c439444",13,13,0,13,13,0,1,2
"26273","b59f4419b2244ad70182ade061c4a7a0",86,70,71,8.47887323943662,86,0,2,3
"26274","b5a036ef0588e9a6996d3b97a8a542b1",45,45,0,45,45,0,1,2
"26275","b5a07991219d2ca47936a3cbcecaa9b4",147,93,47,21.8936170212766,126,21,3,3
"26276","b5a386cae5a28bae2bc97ab2784f801c",61,46,70,6.1,61,0,2,1
"26277","b5a5477f7f1738ad922de3f919033235",62,41,29,14.9655172413793,30,32,2,1
"26278","b5a5d7807b340dae34e1f79e301472ea",28,28,0,28,28,0,1,2
"26279","b5a7333d9ce9a9a7d0f529049f01fcae",84,71,34,17.2941176470588,84,0,2,3
"26280","b5a92c4956f18af29543b1edb5db166f",42,42,0,42,42,0,1,2
"26281","b5a9a38ed8d8e6fceaf9be6495cc0d19",17,17,0,17,0,17,1,2
"26282","b5ad61e5b2c3558a8da4f9386561d189",55,55,0,55,0,55,1,2
"26283","b5ad6add73070761d074842a701433e1",46,46,0,46,46,0,1,2
"26284","b5ae487684ae3d828a5a8e1900f2d3aa",175,104,50,24.5,175,0,3,3
"26285","b5aefe4f005a6fa941699a59b53a03a8",61,49,73,5.84931506849315,61,0,2,3
"26286","b5af070f368475030aadd55e4b7eaa15",6,6,0,6,6,0,1,2
"26287","b5b361a14abc21c2e6b576ff91bf26d7",35,35,0,35,35,0,1,2
"26288","b5b6547a337c65fec28dfcd299e903bb",139,83,60,16.2166666666667,90,49,3,3
"26289","b5b6fdcd5ce2bc87be0e0898357843f9",98,73,35,19.6,98,0,3,3
"26290","b5b81cb0491c4d86f761c84a136c45f0",227,82,63,25.2222222222222,198,29,3,3
"26291","b5b8b755be6d1de7e24988c21f7a217e",95,72,57,11.6666666666667,95,0,2,3
"26292","b5b94a7b3409bea8ca7572b1c5f34bbb",45,45,0,45,45,0,1,2
"26293","b5bc87417a8f50a2d6e0168c4004e30b",18,17,4,31.5,18,0,1,2
"26294","b5bcbe24a4607ed2de8a11c4ec44cb1a",83,52,76,7.64473684210526,58,25,2,1
"26295","b5bd068300f41f978bdb25daca55a0df",9,9,0,9,9,0,1,2
"26296","b5bdb54e4b53076dc8300e888744075e",54,54,0,54,54,0,1,2
"26297","b5be7f2d26e6df7fd1db16a6b6034a0e",41,38,35,8.2,41,0,2,1
"26298","b5c1f71ae50f9dc98fe3d6e9e50f65ec",115,42,74,10.8783783783784,115,0,2,3
"26299","b5c6149c49164068796e44e4f994ce99",19,19,0,19,19,0,1,2
"26300","b5c900c88a8c40082056ad81287552a4",38,38,0,38,38,0,1,2
"26301","b5c912225045eba0e3f7e5797850cfc1",155,96,82,13.2317073170732,135,20,3,3
"26302","b5cbf988427a6ffc4a8f78ba59dfbcd2",53,48,21,17.6666666666667,53,0,2,1
"26303","b5ceb3dbff789dcb72f115a016de8313",31,31,0,31,31,0,1,2
"26304","b5d44cfa567965e820265f7492a861e3",45,45,0,45,45,0,1,2
"26305","b5d7063a0e120f8ad8ab38655722e39d",41,41,0,41,41,0,1,2
"26306","b5d8bd1eeaf5f7e8efe335da23c74978",30,30,0,30,30,0,1,2
"26307","b5d918dc056f512b0cade1b4018c3dd1",42,42,0,42,42,0,1,2
"26308","b5dfc6f8c5c09a789af522e5003dd566",5,5,0,5,5,0,1,2
"26309","b5e5266a5c5fa4b66af4ef33c8440149",63,55,34,12.9705882352941,63,0,2,3
"26310","b5e5d8aa3ade6a28003dc3445acf39d2",129,74,66,13.6818181818182,129,0,3,3
"26311","b5e6724205cfa8fd300842e444abe14a",28,28,0,28,28,0,1,2
"26312","b5e7a79332db976606ed7068314f5293",36,36,0,36,0,36,1,2
"26313","b5e921f9831c8a6723fd5a095e7bcecb",50,37,33,10.6060606060606,50,0,2,1
"26314","b5eb66bc7e79f092dff6787f83c01a92",6,6,0,6,6,0,1,2
"26315","b5ebeb1614c17f2f0ad9fc08c5f0a946",142,103,58,17.1379310344828,118,24,3,3
"26316","b5ece44f25a119c2daf713884c48cf01",11,11,0,11,11,0,1,2
"26317","b5f0832ceaea7b3385cb96c0af0254ae",47,39,26,12.6538461538462,47,0,2,1
"26318","b5f272179f540564c543a1a244aff259",21,18,57,2.57894736842105,21,0,2,1
"26319","b5f334b6d4ee120fc792600cae1225de",52,45,31,11.741935483871,19,33,2,1
"26320","b5f529f361cb9671604cc2cbf468cdbe",51,39,63,5.66666666666667,51,0,2,1
"26321","b5fc82366c790a73b52423f5c1fe0a87",42,42,0,42,42,0,1,2
"26322","b5fcc8319f407bfbc09fa102df6af86f",30,30,0,30,30,0,1,2
"26323","b5fdeddec2a7fa6f5c7e4533db8fe831",46,39,56,5.75,46,0,2,1
"26324","b60102094c42cff2aafd9813d665f569",205,65,77,18.6363636363636,205,0,3,3
"26325","b6022e645daa69d5db28a244f0938e41",58,38,33,12.3030303030303,45,13,2,1
"26326","b603e7a4fd0578ad8e85412b01485ee7",1,1,0,1,1,0,1,2
"26327","b605a49a9ab5bb608528f49fbcee8d92",71,60,35,14.2,71,0,2,3
"26328","b60a92f1eaec4bf95f76efcfa6427381",80,50,61,9.18032786885246,53,27,2,1
"26329","b60d1479bf3476818401530bc70989e2",23,23,0,23,23,0,1,2
"26330","b60fb66a4915740e13c14d134be28788",208,110,63,23.1111111111111,208,0,3,3
"26331","b610b44fb4629221527fc03194d3615f",13,13,0,13,13,0,1,2
"26332","b6116e106b9d276b787a99f8835ff8ed",25,25,0,25,25,0,1,2
"26333","b613b22c22d122cf23faa9228e6b10c4",22,22,0,22,22,0,1,2
"26334","b614df08a96de5d84102b51ceb29bbea",127,75,55,16.1636363636364,127,0,3,3
"26335","b617e92311e32ff26b0b6ac6af5b745a",56,45,16,24.5,27,29,1,1
"26336","b61ddebfd05764af5b5d6288ec8bd8f4",134,90,59,15.8983050847458,85,49,3,3
"26337","b62604d577f2ea9d1892bb72c78349a4",43,36,6,50.1666666666667,28,15,1,2
"26338","b626d0583e05a3e81bc6e1f0ecdcb73d",74,42,50,10.36,74,0,2,3
"26339","b62765a4d2a7eb0d990e1521b53679da",16,16,0,16,0,16,1,2
"26340","b62922aaf3eb695947421c504a2cd68f",70,50,42,11.6666666666667,22,48,2,1
"26341","b629f6d594a941f5c15873a11f88519e",72,52,48,10.5,46,26,2,1
"26342","b62bc6e473c609177ab041a13055cda3",15,15,0,15,15,0,1,2
"26343","b62c03b7f85497869352b14ba2781331",27,27,0,27,27,0,1,2
"26344","b62d6e0adc013768947b251889c105a6",99,78,28,24.75,99,0,3,3
"26345","b630d98dd876053d42b77da1b670b7ad",226,116,70,22.6,196,30,3,3
"26346","b63785d0b2e688ad7066489000951acd",17,17,0,17,0,17,1,2
"26347","b6389696278af58683433da8d63808e5",27,27,0,27,27,0,1,2
"26348","b63aafabed9d97c472cc074c3fc4b59c",79,61,47,11.7659574468085,37,42,2,1
"26349","b63b0c015b1027fa435381787974bf76",201,93,81,17.3703703703704,169,32,3,3
"26350","b63b1ac4c83a3ff1d722e80d53b2d5b1",4,4,0,4,4,0,1,2
"26351","b63b82803b00807a0add7ec6f01b745b",52,52,0,52,52,0,1,2
"26352","b63ba2880607b5adba0ec0bfbb5ab1d7",104,76,13,56,104,0,1,2
"26353","b63beecb32af114a456cb87719278482",22,22,0,22,0,22,1,2
"26354","b63c1797d0fa7ddf0f042138d5c9a9c7",116,73,66,12.3030303030303,90,26,3,1
"26355","b63c9ac9099caca0fe162b5be344dc15",79,62,28,19.75,79,0,2,1
"26356","b63ca51d2d4aea18283112f86febcc48",54,46,46,8.21739130434783,54,0,2,1
"26357","b63cafe8afa2ed14ac313f514cd6f13f",48,48,0,48,48,0,1,2
"26358","b63dfa2e93c8ad14fba7c906841a6ac2",99,55,68,10.1911764705882,78,21,2,1
"26359","b63f7fa343340fe29ae6bf99a0dccca3",14,10,59,1.66101694915254,14,0,2,1
"26360","b63fe103f8940c3bd59d8f8914fe1ac9",54,54,0,54,54,0,1,2
"26361","b640396903fef601b83e1e1cbecc1bcb",32,32,0,32,32,0,1,2
"26362","b641cf41145bcd0807c2d92e90184ef3",116,67,62,13.0967741935484,77,39,3,3
"26363","b64388dc18ff3499181cf5cfbccf7eae",194,108,70,19.4,162,32,3,3
"26364","b64575afa0f035ace764aeb5577b74ee",51,35,31,11.5161290322581,51,0,2,1
"26365","b64653260b7fe1ec7c880232ba44bbc1",73,65,30,17.0333333333333,73,0,2,1
"26366","b6472fef6ae972b2171e5d82e16cb65f",103,64,51,14.1372549019608,80,23,2,1
"26367","b64c59e42aeda0f3b1149db1f59f8031",132,54,70,13.2,92,40,3,3
"26368","b64c8e41634a2436fa98bc319ef73918",77,59,56,9.625,77,0,2,3
"26369","b654fbcb3e989a8ef3bb236bdc003a5a",8,8,0,8,8,0,1,2
"26370","b656a9fefa54a81b8e345864bcb41392",86,68,77,7.81818181818182,86,0,2,3
"26371","b657dc44cd1d6a263b31b79554748c9d",6,6,0,6,6,0,1,2
"26372","b65a36dd566aaf213dcfd1fea7dce8a5",136,85,75,12.6933333333333,136,0,3,3
"26373","b65c09d55fb0424d9b4da73effb76bf9",27,27,0,27,27,0,1,2
"26374","b65cfb4ef6f7c66a88dc17b94e4d3c0c",8,8,0,8,8,0,1,2
"26375","b65e167042bfb22300e8155ffb1f1971",53,53,0,53,53,0,1,2
"26376","b65f63c36335f6bcea612e948319b3c5",84,67,53,11.0943396226415,84,0,2,3
"26377","b65f97e2ebe5c02a150b4faba24aeec3",8,7,7,8,8,0,1,2
"26378","b6603920aade5a41a18ae1d9e0214565",75,65,28,18.75,75,0,2,1
"26379","b66234ebd45a6e6899626745f7211591",26,26,0,26,26,0,1,2
"26380","b665220ef6508fac123c54bfdbfdfa6d",62,51,82,5.29268292682927,62,0,2,3
"26381","b665c92db5dd070d58ce492cd2bba1bf",7,7,0,7,7,0,1,2
"26382","b665f85099ef7ac3cfde745a5623b630",26,26,0,26,26,0,1,2
"26383","b66ddba14ed8c19cc10c896a56a6aea1",134,118,71,13.2112676056338,105,29,3,3
"26384","b6705122eef573056023c1d442b2ba49",187,90,83,15.7710843373494,187,0,3,3
"26385","b67536ad9eeb64a6e6a1a55b362f367e",99,78,58,11.948275862069,99,0,3,3
"26386","b6767c3d24eb03867d60a1cd349c1c0f",88,49,75,8.21333333333333,88,0,2,3
"26387","b677915bce76eb27a3d8212b584ff506",26,26,0,26,26,0,1,2
"26388","b67a4095ce70dc7e804596dd7ad4f74e",189,58,35,37.8,189,0,3,3
"26389","b67f9bd3098983f96e27e21943cb1141",5,5,0,5,5,0,1,2
"26390","b685f0192c9adfe99f88a147e2062b7e",44,27,56,5.5,44,0,2,1
"26391","b68790bd90ba1bf04346e30284124c0a",129,64,48,18.8125,105,24,3,1
"26392","b687aa0bcc9f9bd2149fd0a2ddb11805",7,6,3,16.3333333333333,7,0,1,2
"26393","b68998d9260f458d6e5322a2ef6009f2",29,25,39,5.20512820512821,20,9,2,1
"26394","b689ceab848e0f382ca33b3a7e49d9c5",142,95,64,15.53125,142,0,3,3
"26395","b689f15f7b97f960f0bdb5051af5040f",42,42,0,42,42,0,1,2
"26396","b68b565fe1338e696affb4cc8dbe40ed",41,41,0,41,41,0,1,2
"26397","b68cbf579d25e5af73c6873e0ec835e2",11,11,0,11,11,0,1,2
"26398","b68e10a7e288cbd7caf8a294e4810473",23,23,0,23,23,0,1,2
"26399","b68e5a6123fe2fe378f2e3b432e0b377",169,97,71,16.6619718309859,116,53,3,3
"26400","b69036616cb4a3295bd96f941d31b167",54,42,84,4.5,54,0,2,1
"26401","b696a741777b8b085b4568de2dfff0c9",166,107,70,16.6,132,34,3,3
"26402","b6973224797385173becf71e5e835137",72,64,41,12.2926829268293,49,23,2,1
"26403","b699738046d2106f29d77a23d2c5f168",124,76,59,14.7118644067797,80,44,3,3
"26404","b69a22fdb4d80f071d37f8f3489efa87",42,42,0,42,0,42,1,2
"26405","b69b6de1a5cc96db907778767274aacb",107,58,73,10.2602739726027,73,34,2,1
"26406","b69d8084563bff799233c272d938faf3",19,19,0,19,19,0,1,2
"26407","b69f2c6b799ff77ccd9a0a324667498d",7,7,0,7,0,7,1,2
"26408","b6a00891942cf4927f07181e4e74dabe",30,30,0,30,30,0,1,2
"26409","b6a1b9157287ebcab71cc6f0072e2485",36,36,0,36,36,0,1,2
"26410","b6a2129e6c99cebf42d426340a74bd4a",25,25,0,25,25,0,1,2
"26411","b6a3bae1bcc7667da76fdd74032a85f5",28,28,0,28,28,0,1,2
"26412","b6a60fafede7f81bba158024e64f9e39",53,53,0,53,53,0,1,2
"26413","b6ae77eca015abae5549c521e9039de2",6,6,0,6,0,6,1,2
"26414","b6aeb2acc949cd5ff2f726bb177c1dbd",53,53,0,53,0,53,1,2
"26415","b6af9e247c71cb15166f26db1436c325",24,24,0,24,24,0,1,2
"26416","b6b041172b5ff987df85dec89ea74788",24,24,0,24,24,0,1,2
"26417","b6b19038068d06c5d51ec64285f7a7c7",77,49,58,9.29310344827586,77,0,2,3
"26418","b6b21822bc45957afe28b2101c198db2",38,38,0,38,38,0,1,2
"26419","b6b52f5b5fc7263b899646ad75ecdc63",117,85,36,22.75,117,0,3,3
"26420","b6b5897954591a50a9cead4468a793a1",56,48,43,9.11627906976744,21,35,2,1
"26421","b6b7151941189624def2459e23c45b57",32,32,0,32,32,0,1,2
"26422","b6b7b94224b342191ddf563828aea1fe",64,35,67,6.6865671641791,64,0,2,1
"26423","b6bb73d44776b5b257575c9304c6174a",31,31,0,31,31,0,1,2
"26424","b6bed4cda6c98377d04bce5ced7ef916",31,31,29,7.48275862068965,8,23,2,1
"26425","b6bfc4c141cd8d9c9789d2eb4b79f922",22,22,0,22,22,0,1,2
"26426","b6c02dc95a5265a08cf81a9f5a2dc522",35,35,0,35,35,0,1,2
"26427","b6c0d6a4df71e9cac4394c453a124bcd",107,65,70,10.7,57,50,2,3
"26428","b6c39b97285f4f917d38bbc0cb980d62",103,77,74,9.74324324324324,103,0,3,3
"26429","b6c477cfa9383941ffbb5ee8da54ea8f",52,43,32,11.375,52,0,2,1
"26430","b6c6b1f2b5068d163dbff4c9be49c025",17,10,86,1.38372093023256,11,6,2,1
"26431","b6c716def10917e478e415a370239c17",109,57,53,14.3962264150943,109,0,2,3
"26432","b6cc0869d9c00d4f723940b08c9677e8",72,63,31,16.258064516129,72,0,2,1
"26433","b6cd52c1eb64a5e5353c77f77298144f",93,58,71,9.16901408450704,56,37,2,3
"26434","b6d3e1cdd8dd8a323fc0b91dfdda9ac1",21,20,13,11.3076923076923,21,0,1,1
"26435","b6d410f0764c13a15c6bafd3f6c270ad",22,13,49,3.14285714285714,22,0,2,1
"26436","b6d4fd899d6eb8c7e3bd46bc19bb91a8",25,25,0,25,0,25,1,2
"26437","b6d5ca7fd85710358d347f5b733e3e5c",4,4,0,4,4,0,1,2
"26438","b6dae9e5cf205df6c27a67741f6d4b05",30,30,0,30,30,0,1,2
"26439","b6dba598c8bc451e38ecfe36b1115198",38,38,0,38,38,0,1,2
"26440","b6dcb595e502816fcea7a754fa379736",8,8,0,8,8,0,1,2
"26441","b6dcc767c094d420a45aea48607b70a2",124,70,60,14.4666666666667,124,0,3,3
"26442","b6df581b864f8a854a8d4b5e1cf525fa",36,30,43,5.86046511627907,36,0,2,1
"26443","b6e089591dc961cb6696b368f1322041",52,33,56,6.5,33,19,2,1
"26444","b6e0c952fbb94d3665dbc3417f94a1fd",53,43,22,16.8636363636364,53,0,2,1
"26445","b6e1159537f0df2b7a5ef7330740c569",108,50,49,15.4285714285714,108,0,2,3
"26446","b6e17610efb7edc9dacc715c708c4c6f",11,11,0,11,11,0,1,2
"26447","b6e404457f8df9c534a3a33ae5cff91e",12,12,0,12,0,12,1,2
"26448","b6e7cc364d8e30f61aaf1232ca1f232b",20,20,0,20,0,20,1,2
"26449","b6e9d3b86d5b7e828de8f84eb5715868",33,33,0,33,33,0,1,2
"26450","b6ef0037345628de4488a4d4808c766c",94,51,73,9.01369863013699,94,0,2,3
"26451","b6f43c53cc87afb86fc2250860550afc",41,35,14,20.5,0,41,1,1
"26452","b6f4a5fdbbd246d69d1ae96b68325ac7",58,42,14,29,58,0,1,1
"26453","b6f941920c96749c1af766a975085728",1,1,0,1,1,0,1,2
"26454","b6fc100e605def81d8b81f697c39125b",60,23,89,4.71910112359551,50,10,2,1
"26455","b6fef1d952a0fb817ea3e83ad3935c1c",175,101,41,29.8780487804878,175,0,3,3
"26456","b7010ebc22acb9b053efd6b993e38b9f",32,32,0,32,32,0,1,2
"26457","b70b40aa345933cb8baaf520e9a14b9e",111,81,26,29.8846153846154,111,0,3,3
"26458","b70fc9d5c69f4a67400a26a3f7c352c8",4,4,0,4,4,0,1,2
"26459","b7132e3c688d7c72d080d4a0b3ea435d",55,55,0,55,55,0,1,2
"26460","b713608f2ced6bfb18510ac7449f5d4d",34,30,72,3.30555555555556,34,0,2,1
"26461","b713f340ef794cb22bbfa37e7c06d71f",42,36,21,14,0,42,2,1
"26462","b714842e8dd2f9a4451be9904d5627f5",24,24,0,24,24,0,1,2
"26463","b7162eb53f8892eb3557622411e1e3e7",15,15,0,15,0,15,1,2
"26464","b717880cfcaf9e350f68f9ad48437cea",24,24,0,24,24,0,1,2
"26465","b717e137fcfe6c4e6c6ebbe2c07d239f",114,98,82,9.73170731707317,114,0,3,3
"26466","b717fc4d1a85f17e45e647596c547d23",21,21,0,21,21,0,1,2
"26467","b71877445a4867975fb0432f5dd846e4",42,42,0,42,0,42,1,2
"26468","b71910641f2ac33248ff56ea4c867020",212,120,71,20.9014084507042,181,31,3,3
"26469","b719e1528f146c012253139f08afc059",33,33,0,33,0,33,1,2
"26470","b71a5efbee6111b0dd7def3ddf51425b",164,117,69,16.6376811594203,117,47,3,3
"26471","b71a9e050d38f9e77c76e347583fa90a",65,36,61,7.45901639344262,43,22,2,1
"26472","b71b2562df7c993976a05349f6b1a650",109,83,31,24.6129032258065,58,51,3,3
"26473","b71b4976e0b36e844f617f837754bd96",35,28,13,18.8461538461538,35,0,1,1
"26474","b71e44bb2d69677b2d32e9e7f14a49c3",84,61,36,16.3333333333333,84,0,2,3
"26475","b71ee14afe88b5d8bcf9233144eb48c4",159,105,48,23.1875,159,0,3,3
"26476","b7239ba13bdd39d383a8cba12a595ed9",41,41,0,41,41,0,1,2
"26477","b724aa93126570d58e69cf969b77a2a7",12,7,40,2.1,12,0,2,1
"26478","b72526e19cdd23bb317491594eded780",63,45,47,9.38297872340426,63,0,2,1
"26479","b726f0a53d64000be16ada417e5070b7",38,38,0,38,38,0,1,2
"26480","b72901270cbb6c55ef692f590cb5c5ad",24,24,0,24,0,24,1,2
"26481","b72969dffb4d4435cb4e079e5ade1558",36,36,0,36,36,0,1,2
"26482","b729b2120b99bd58df49cd7d6f9ff39e",131,102,76,12.0657894736842,113,18,3,3
"26483","b72a9fa99aba52f32fb1afb0ae366727",119,98,35,23.8,119,0,3,3
"26484","b72acbfc2f4bb8e3b28830076ca2c7f1",23,23,0,23,23,0,1,2
"26485","b72ce8277a5dd0cd624a9eaf976abdf5",26,26,0,26,26,0,1,2
"26486","b72cf3ba5cbcf04e390f9c027e787ec0",12,12,0,12,12,0,1,2
"26487","b72d22359a5bdc20778a281d8bd091d2",60,49,40,10.5,34,26,2,1
"26488","b72de20d174e9745efee443dfbf2b7fc",148,93,31,33.4193548387097,94,54,3,3
"26489","b72e25613bf12198f7c83cdb9214fe1f",180,96,61,20.655737704918,180,0,3,3
"26490","b72ef42755fa63e13544d55f724f958b",4,4,0,4,4,0,1,2
"26491","b72ff4d5c896395c56fc6edf269aa5ec",2,2,0,2,2,0,1,2
"26492","b730fd75d2dc56a3c7cf413a4e920b31",8,8,0,8,8,0,1,2
"26493","b73165dc50c72c67fdf4a5e344af132b",139,89,65,14.9692307692308,106,33,3,3
"26494","b731eaa3a94a208548b34c384e1bee0c",85,55,34,17.5,44,41,2,1
"26495","b73342bd2c79a1fb0504f1acadee61f1",48,48,0,48,48,0,1,2
"26496","b7340be919f3f984cdec5fc94c8361eb",177,93,82,15.109756097561,177,0,3,3
"26497","b735af4d6c9b3161beeb2f712ca83700",89,56,70,8.9,89,0,2,3
"26498","b737bbc4cc7a2343843dcbefc817af27",12,12,0,12,12,0,1,2
"26499","b73871c922ea88667b3cf243d126cfae",17,17,0,17,17,0,1,2
"26500","b73ce4b193172675acc5eaa6d0fc4adf",69,47,44,10.9772727272727,69,0,2,3
"26501","b73d2f5b674b6236d76d49d4306b72ad",127,61,80,11.1125,103,24,3,1
"26502","b73eb276c5b625be7bbb7dac69221eff",34,27,68,3.5,23,11,2,1
"26503","b73f6621ae9935d4aa9be387a3fe6e2a",22,22,0,22,22,0,1,2
"26504","b73fb8ac71f8d079de9a5ea30e1b0953",42,39,14,21,42,0,1,1
"26505","b740d32156f2a0bee77777e62ec287fb",33,27,7,33,33,0,1,2
"26506","b740e6613cd5c8b99e4f94cf55763f90",45,40,55,5.72727272727273,17,28,2,1
"26507","b7421c186c6baa5b6dc1f1e7e7a64a06",35,35,0,35,35,0,1,2
"26508","b7462331bef5e5fba00c7d483205623e",136,96,72,13.2222222222222,117,19,3,3
"26509","b74eac2e77d77f0a02b6f751a7593847",22,22,0,22,22,0,1,2
"26510","b74fa2a1383bcec9e3678980fd5f56e6",14,14,0,14,0,14,1,2
"26511","b750bcee305884d4a8deb76bfd731e84",22,22,0,22,22,0,1,2
"26512","b752be5eec581102004a0ea19ed38427",37,37,0,37,37,0,1,2
"26513","b7552635324448ab94d49b7d45a75b50",11,11,0,11,11,0,1,2
"26514","b755f68ead20261f126d5b4cf6a28a7a",50,44,35,10,50,0,2,1
"26515","b758aa2fbfac7ce56672e5328dfc250b",67,57,55,8.52727272727273,67,0,2,3
"26516","b7592e52faac02307c548a3f11f9ffa4",202,138,77,18.3636363636364,149,53,3,3
"26517","b75b54c30076ad1608f4a736789d9467",17,17,0,17,17,0,1,2
"26518","b75dc929562c3241997596425e880762",93,68,63,10.3333333333333,93,0,2,3
"26519","b75faf1bec1a42963f57443936ea8c49",55,40,37,10.4054054054054,55,0,2,1
"26520","b760b7ee5fb44815ec567131a3bb476a",29,29,0,29,0,29,1,2
"26521","b761d4c0033fe7ae65cda42112c456cd",126,82,67,13.1641791044776,126,0,3,3
"26522","b76471cee440a5808a15842472d14de1",55,55,0,55,55,0,1,2
"26523","b765b5fad953410bc7a1046a20e26467",148,105,77,13.4545454545455,148,0,3,3
"26524","b7684eb690b77134d5d1b6aa3777d75a",47,34,79,4.16455696202532,47,0,2,1
"26525","b76d29ce1684416ba2af3bc4c26abbd5",120,60,54,15.5555555555556,105,15,3,1
"26526","b77432af2a9fbd4f91f3096b22e70a76",29,29,0,29,29,0,1,2
"26527","b7744cfd830facbcfac8e70f3a10fa26",10,10,0,10,10,0,1,2
"26528","b7752f08195f888644e2eb8104370825",69,59,39,12.3846153846154,69,0,2,3
"26529","b777b49ea683edea0151eee5e80546c2",23,23,0,23,23,0,1,2
"26530","b77ab1aabe4fa1a3d7e22df411edad99",66,41,61,7.57377049180328,42,24,2,1
"26531","b77ba08f2932d0d873be391301ec1a41",20,13,41,3.41463414634146,20,0,2,1
"26532","b77c113dec2439247a2c64b2f9e95a5f",20,20,0,20,20,0,1,2
"26533","b77c96680709c9e7281889671f246843",117,84,28,29.25,117,0,3,3
"26534","b77cd0e7243d0e07ef930c744e37b32b",103,45,76,9.48684210526316,72,31,2,1
"26535","b77e25ac459379aa6de2de646fccd504",14,13,6,16.3333333333333,14,0,1,2
"26536","b7806d07a9ef0fac4548140ff2347737",13,13,0,13,13,0,1,2
"26537","b784cf398aea1b11bad7408e3392c579",10,10,0,10,10,0,1,2
"26538","b7852f1b48ffbe0f6bb205bbc8ad7250",181,143,40,31.675,181,0,3,3
"26539","b7856cdff14147be8c609148e1f8b410",30,30,0,30,30,0,1,2
"26540","b78a73d0807bfc6be058d57b77fb862f",103,73,71,10.1549295774648,103,0,3,3
"26541","b78b04ce9e40b021a45f9af7074f523c",34,34,0,34,34,0,1,2
"26542","b78d49cff36d8180c5d1a57a0b170d3a",7,7,0,7,7,0,1,2
"26543","b790729b178606ba45d242fa5c240581",66,55,33,14,34,32,2,1
"26544","b7922fd3b62a956cf063f3444fdd0968",108,55,62,12.1935483870968,108,0,2,3
"26545","b79370ba86a1c8facc39fa22e7e0d60e",25,25,0,25,25,0,1,2
"26546","b794c4249b3ec11513f4539658f13b61",29,29,0,29,29,0,1,2
"26547","b7950a0813818c7b411b0600c74fbff7",135,81,75,12.6,135,0,3,3
"26548","b7977f18e31153bedf95475e132b8c4c",60,46,43,9.76744186046512,60,0,2,1
"26549","b797c3172d94c74548effdba5bc7a7a1",23,23,0,23,23,0,1,2
"26550","b798586e9d8c7fad92b83d9d7fb44198",10,10,0,10,0,10,1,2
"26551","b7993d1aa09729e4019e97d18a7e3a17",34,29,28,8.5,34,0,2,1
"26552","b799bcee4fde4e7bfc8c212e93321052",147,82,63,16.3333333333333,147,0,3,3
"26553","b79a4afd2f6acf96d6affc901c612b67",26,26,0,26,26,0,1,2
"26554","b79db8d8812abf80db7d603b4debd201",8,8,0,8,8,0,1,2
"26555","b7a042bd472c44e879d72964476ca65a",96,83,36,18.6666666666667,44,52,2,3
"26556","b7a3f2b5efd0994d6b5551343779e118",26,24,50,3.64,26,0,2,1
"26557","b7a3ffda19de7ed79b6aeb9350932d18",43,43,0,43,0,43,1,2
"26558","b7a4ad110a9b9a7ea2a69087385261ab",29,29,0,29,29,0,1,2
"26559","b7aa9caa5da75b75bf1139dc27d75350",124,84,71,12.2253521126761,124,0,3,3
"26560","b7aadc1bee17a87d3297b0b0e5b41328",34,34,0,34,34,0,1,2
"26561","b7acd2c787343c7f08419c9f7d275118",17,17,0,17,17,0,1,2
"26562","b7aea19a31440bd09b261bd8a1a72e56",98,92,25,27.44,98,0,3,3
"26563","b7b143bca6536fafc4b8bcad0f538104",128,71,60,14.9333333333333,85,43,3,3
"26564","b7b452ff61d85590eb9b9455e97562ce",88,56,65,9.47692307692308,88,0,2,3
"26565","b7b502003d00ce0172d027ab60213a96",44,32,56,5.5,44,0,2,1
"26566","b7b6b7e2ea5674a331d32326c4e036d5",36,36,0,36,36,0,1,2
"26567","b7b7659581410426e03b701e04e396ef",17,17,0,17,17,0,1,2
"26568","b7b817e25680e41aa72bffad253859a7",33,33,0,33,0,33,1,2
"26569","b7b8968147800fd7ac9d1358daf00128",25,25,0,25,25,0,1,2
"26570","b7b93d0930a3a82e7f65c0706be82971",12,12,0,12,12,0,1,2
"26571","b7ba0d4983715bb4c54c0e37d4f1daa1",92,68,35,18.4,92,0,2,3
"26572","b7c048a5dd53e1c232f979df95e62e60",16,16,0,16,16,0,1,2
"26573","b7c089dd137975e730e73b247b892466",4,2,39,0.717948717948718,2,2,2,1
"26574","b7c0dd95183ea545d0dce5065a324189",50,34,39,8.97435897435897,50,0,2,1
"26575","b7c2a33f375fdb36b952f62617e4264f",42,42,0,42,42,0,1,2
"26576","b7c43000231bc924008f3593ea9909f8",14,14,0,14,14,0,1,2
"26577","b7c50d43a163dedacd76dc5ee30140d1",10,10,0,10,0,10,1,2
"26578","b7c6f57521f647e1ed9f209f2dabcbe4",133,67,49,19,101,32,3,3
"26579","b7c7f7916d38996376c62caca1530aa5",6,6,0,6,6,0,1,2
"26580","b7c81b6a5cd2c9300d0c608a9974a555",31,31,0,31,31,0,1,2
"26581","b7c8236950d5ba3050b7d0ba30adde42",210,96,58,25.3448275862069,155,55,3,3
"26582","b7c837df15ce2839325286c4fea7a273",87,66,64,9.515625,87,0,2,3
"26583","b7c8e602fde34bfbed8b6215c1a9769b",86,64,82,7.34146341463415,86,0,2,3
"26584","b7c9a33dba05997aa366254b420b97f8",26,26,0,26,26,0,1,2
"26585","b7ca356f10c2c66fad712caf737b9f9d",24,13,28,6,24,0,2,1
"26586","b7cb0c44517c250c6840c70e20c4e919",28,28,0,28,28,0,1,2
"26587","b7cd349dc6111177997228ca5495cc0e",25,19,25,7,12,13,2,1
"26588","b7cd50ff6b391a1244f7e9c28969f2b0",52,38,47,7.74468085106383,23,29,2,1
"26589","b7cda39d5142988b9fe2ddda65e698d6",45,45,0,45,45,0,1,2
"26590","b7d20e6a237bdc1c0dd10b811f4142fa",140,74,75,13.0666666666667,140,0,3,3
"26591","b7d227b6df68889127935e82aceb1653",164,46,82,14,111,53,3,3
"26592","b7d445353da21ea27875ab4ccd020c46",227,116,71,22.3802816901408,190,37,3,3
"26593","b7d54783e8d570583963bc483659447b",29,29,0,29,29,0,1,2
"26594","b7d598055b6007fa5e01c55639428f87",39,39,0,39,39,0,1,2
"26595","b7d716e153cb1ee21130520a79b17959",50,50,0,50,50,0,1,2
"26596","b7dc79242be46cf305cbcc7c9caa48a0",134,58,61,15.3770491803279,134,0,3,3
"26597","b7dec253b8e4bc1befae4faa22a213ee",39,39,0,39,39,0,1,2
"26598","b7df0cd9d9dc06f5850a920d74025a74",136,93,71,13.4084507042254,136,0,3,3
"26599","b7df972a78ffe27983bbe8bcb7a52eb9",99,66,17,40.7647058823529,53,46,1,3
"26600","b7dfa320974e648871c11e399ddbce2f",42,28,47,6.25531914893617,39,3,2,1
"26601","b7e08606f11d9f0271fbf62196f69199",135,94,48,19.6875,135,0,3,3
"26602","b7e15ea8827df172ed264f7adbdf898e",39,34,59,4.6271186440678,39,0,2,1
"26603","b7e319f3078df06c741c072f003dfc7d",145,95,52,19.5192307692308,99,46,3,3
"26604","b7e416e2f6adc64dd82364c945a5a179",22,20,82,1.8780487804878,7,15,2,1
"26605","b7e6234a02acd7c5759e95df08ee95d2",39,31,7,39,39,0,1,2
"26606","b7e6e4f1013ab13cc1768614565f7bcf",56,45,47,8.34042553191489,55,1,2,1
"26607","b7e923cb1c5347cf90dc1d56879d22f1",93,66,51,12.7647058823529,56,37,2,3
"26608","b7ea40db986a9af0f2d28a577eed459a",115,77,35,23,115,0,3,3
"26609","b7ed31c71de4bf0ef3bc1503cfdba39a",21,14,63,2.33333333333333,21,0,2,1
"26610","b7ee8540e356d2f3702cb4d1b447039e",18,18,0,18,18,0,1,2
"26611","b7f1849d56d77c1f3fca199cf036b10b",15,15,0,15,15,0,1,2
"26612","b7f1cf02a48a8f29f5974d0b4693357c",37,37,0,37,0,37,1,2
"26613","b7f2bef7be040ccc80e369b65c385f55",53,34,77,4.81818181818182,53,0,2,1
"26614","b7f48c6d6ad1fdebc8e4e40089e7dd3a",133,78,42,22.1666666666667,88,45,3,3
"26615","b7f4ab525cdfed0cf4cb2db766ae1840",28,28,0,28,0,28,1,2
"26616","b7f663240c98056ed1adf69a0a584efe",191,104,80,16.7125,142,49,3,3
"26617","b7f719da2dc61baf862ff8a7a9d9794c",47,47,0,47,0,47,1,2
"26618","b7fa1a45be871c99aa529f24c56bbb86",117,51,31,26.4193548387097,98,19,3,1
"26619","b7fabdfc37d5289488ac77af0c91b887",31,30,5,43.4,31,0,1,2
"26620","b7fc223f527f9acf4ebfe7e6ae0ebd08",84,67,16,36.75,84,0,1,2
"26621","b7fc4811b5efdaf6e40990106fc3e2ae",63,55,32,13.78125,32,31,2,1
"26622","b7ffba0b4b6a38badaf1132ffed30de0",121,72,38,22.2894736842105,121,0,3,3
"26623","b805bb6474eb830327304bc5bc8705ef",237,113,89,18.6404494382022,203,34,3,3
"26624","b807705ab857c457200e89672db1ac6c",5,2,63,0.555555555555556,5,0,2,1
"26625","b80795bce84ecb5f53b0ac0472de134e",175,69,76,16.1184210526316,154,21,3,3
"26626","b80aa01aefe7970b11212bf5b217ecbb",32,27,42,5.33333333333333,32,0,2,1
"26627","b80aab8f57516d930e30ea184d2503e1",83,52,42,13.8333333333333,83,0,2,3
"26628","b80fdc867ccef4994ae31c190a2b7284",80,66,11,50.9090909090909,80,0,1,2
"26629","b812c7b593411e91a215ce3ea2a2e471",55,50,74,5.2027027027027,55,0,2,1
"26630","b8155d7628f1aaf6b50d856113811489",182,123,71,17.943661971831,182,0,3,3
"26631","b816ab68c461bb40f41211ccddf42e7d",215,85,70,21.5,215,0,3,3
"26632","b816c5ed3c466163222cf75e65a21d45",64,53,57,7.85964912280702,64,0,2,1
"26633","b818ccda4379b5ddee81fe89ba651e89",37,30,61,4.24590163934426,37,0,2,1
"26634","b81925b8d27cfe8c172ed0ac22120209",25,25,0,25,25,0,1,2
"26635","b8192de0a22512a3fe972291e2229aec",36,36,0,36,36,0,1,2
"26636","b81a8687e4a42d7056db114d640c8cc3",60,34,58,7.24137931034483,60,0,2,1
"26637","b81a9dc21efb7ab90ebf5f2df0e1b1d0",138,106,48,20.125,138,0,3,3
"26638","b81f8381929ec837ebca59ede41b5f69",81,61,26,21.8076923076923,81,0,2,3
"26639","b8222d2bdb4e84592db99ff1cbc1bc26",59,47,41,10.0731707317073,59,0,2,1
"26640","b825305f39dbe5eb179fb112f9652f5c",81,47,58,9.77586206896552,81,0,2,3
"26641","b8254dc730e8278dec2a26ef7d7c4bfa",194,121,84,16.1666666666667,194,0,3,3
"26642","b827c3ddc869f99c4416a4642865450e",196,98,65,21.1076923076923,158,38,3,3
"26643","b82811545728110e16c0bb448ba5fc2d",155,95,69,15.7246376811594,113,42,3,3
"26644","b8293accb1e57be3bfc3111c776f8c3c",52,39,35,10.4,52,0,2,1
"26645","b82a8bf464bd364eb0b0daf7abf5d0bc",57,48,60,6.65,57,0,2,1
"26646","b82bdaddbe170872f214dadc933a5a58",58,50,50,8.12,58,0,2,1
"26647","b82edad490942345d54b481cadeb7a20",21,21,0,21,0,21,1,2
"26648","b82fae830d9666458a1ba70ea0a93fc4",86,54,78,7.71794871794872,86,0,2,3
"26649","b82ff864da85297f8645daf9eeb27ff0",50,50,0,50,50,0,1,2
"26650","b831c040d9af782d1ea0c16493f9670e",31,31,0,31,31,0,1,2
"26651","b835853b1e3e4c3dd88af68f4aa21d4e",25,25,0,25,0,25,1,2
"26652","b83633750b81e1bd08f1ce3f420dbefb",19,17,42,3.16666666666667,19,0,2,1
"26653","b837c1564899f33587b0c690daadca0f",27,27,0,27,27,0,1,2
"26654","b838443dcf671f0d27bf5cc5d525cf59",38,28,25,10.64,38,0,2,1
"26655","b838823e06fc81a41e0b5654fc0d4393",50,50,0,50,50,0,1,2
"26656","b839b06c3770ccaacc3be10910dd9229",29,29,0,29,29,0,1,2
"26657","b83a23c98f051538ca0a620d4f142311",20,20,0,20,20,0,1,2
"26658","b83aa7b58b586f79b88aed6001d261e5",26,26,0,26,0,26,1,2
"26659","b83aef644d60b98b6566c24c80968db9",173,113,76,15.9342105263158,173,0,3,3
"26660","b83b723f03be6d4def115ce0efc55b77",20,20,0,20,0,20,1,2
"26661","b83be7b9679dba6e9df1b5d1b8de9535",35,35,0,35,0,35,1,2
"26662","b83c4a323b620e411825c6b345267054",13,9,21,4.33333333333333,0,13,1,1
"26663","b83cbd06326491c4c77fcc047cd34b39",102,87,36,19.8333333333333,102,0,3,3
"26664","b83e276c7f1341d4b7fbf0a34706a5df",18,18,0,18,0,18,1,2
"26665","b8409cf1ee53db1ca7cb557ea9e96753",95,78,57,11.6666666666667,95,0,2,3
"26666","b841902ae0c34f24f9e160cba87d1cae",161,109,48,23.4791666666667,161,0,3,3
"26667","b8461283ebfcacf957f692c4f80c1d52",15,15,0,15,15,0,1,2
"26668","b84734b18b382da9756b77a58f012c7f",126,67,70,12.6,126,0,3,3
"26669","b8474d04e811dfde0745691106144229",184,100,84,15.3333333333333,184,0,3,3
"26670","b847c0971b71d7427f48b4e030aff0b5",6,6,0,6,6,0,1,2
"26671","b847c3f6116eb95d54aa27cffee42e9e",87,56,59,10.3220338983051,52,35,2,1
"26672","b848e66731378bb99cdd32a77ced26bd",45,30,71,4.43661971830986,37,8,2,1
"26673","b849f288c40e1a89edb8906dced317cf",44,38,22,14,44,0,2,1
"26674","b84aa5c7c612837f530f1d1ed3c16282",96,60,53,12.6792452830189,96,0,2,3
"26675","b84b39778b2f04a3e8e8f047f0ffce42",35,25,78,3.14102564102564,28,7,2,1
"26676","b84c60bd9c7f14afd3871924097097e7",7,7,0,7,7,0,1,2
"26677","b84dc4aaae39aa39475feb90703dbc57",41,34,31,9.25806451612903,41,0,2,1
"26678","b84f959f2274cd2052b84e4adca8285f",74,61,27,19.1851851851852,36,38,2,1
"26679","b850fcc2d3dd99a60549bd649a501a2f",37,37,0,37,37,0,1,2
"26680","b85292bbf6106e98058619113b7a11b7",127,95,55,16.1636363636364,127,0,3,3
"26681","b852934089e5edfeb13fb8f63be051d0",180,111,80,15.75,180,0,3,3
"26682","b8531b87b27718929da64a6e05124bdd",61,46,18,23.7222222222222,61,0,1,1
"26683","b8543750d39b094f4c1fc49454ae4d46",24,24,0,24,24,0,1,2
"26684","b856784ebadafb33d6cf8cc69c1fb669",19,19,0,19,0,19,1,2
"26685","b8594db486441d3fc93e23c10ba8c1f2",6,6,0,6,6,0,1,2
"26686","b859a167cb32e897879544497a942cb9",130,96,27,33.7037037037037,130,0,3,3
"26687","b85a0352489a2ceb50b57130e7cd0788",33,26,26,8.88461538461539,13,20,2,1
"26688","b85a6c9a40983ca9528d31f93c6a5934",118,60,63,13.1111111111111,118,0,3,3
"26689","b85b3411d0538591b3a97a365aae2ed3",142,60,77,12.9090909090909,142,0,3,3
"26690","b85c9ac61ffed786b936ad64f8f2306e",204,105,77,18.5454545454545,175,29,3,3
"26691","b85fc7c15de3d43471adbd7f31185042",77,53,37,14.5675675675676,41,36,2,1
"26692","b860319adb25328b6b030aac70b72e1a",2,2,0,2,2,0,1,2
"26693","b86560c5aa134320a0268ab8589f84cc",49,46,29,11.8275862068965,49,0,2,1
"26694","b8664a4ecdcba0e2d1707eb674e62814",30,30,0,30,30,0,1,2
"26695","b86857ef7e72daf1b980c1c241fcc132",91,72,30,21.2333333333333,47,44,2,3
"26696","b86a0a44bcf331dcc67e046538bc2e32",162,54,81,14,154,8,3,3
"26697","b86af8edf32a9fa514c9850218c27c1c",133,109,35,26.6,133,0,3,3
"26698","b86e4a393890d03653a0169784688050",64,48,62,7.2258064516129,46,18,2,1
"26699","b8740d5385cdfaf55d0764424b650cd8",69,49,60,8.05,69,0,2,3
"26700","b877a4b7ac521b9aa35fd03a7a71c519",88,66,35,17.6,88,0,2,3
"26701","b87c8d5d1f8a8a6fe69fa9e630bf8882",25,22,43,4.06976744186047,25,0,2,1
"26702","b87d64f222448abad51a4b77b898030b",81,60,28,20.25,81,0,2,3
"26703","b87dd5d877bd8fa7b2c694c891699042",36,35,27,9.33333333333333,36,0,2,1
"26704","b8800febca8ef838fd6503beb3b5be06",218,91,84,18.1666666666667,198,20,3,3
"26705","b885aaf0a180e90f7af63b4f6f873b50",44,25,73,4.21917808219178,44,0,2,1
"26706","b885fe223e8cb5e227814cc551bd6dc5",42,24,63,4.66666666666667,42,0,2,1
"26707","b8876b43574fa9486493e1c624ffcda0",202,71,86,16.4418604651163,202,0,3,3
"26708","b887af87047af03d7628fe25c3f4d163",8,8,0,8,8,0,1,2
"26709","b88c23ba83e7c6ee66ec2a8797ab3432",90,61,77,8.18181818181818,90,0,2,3
"26710","b88d97720375b8bbac2c104db159d652",111,70,70,11.1,111,0,3,3
"26711","b88e1d787f20414ff2e843e0487308ee",28,28,0,28,28,0,1,2
"26712","b890556895a529de9e6376ca7169ff1e",115,57,56,14.375,115,0,3,3
"26713","b890e780de456cd0088d85938561162f",97,67,35,19.4,70,27,2,1
"26714","b8910c2f04052a3a30587d46a4ab9728",30,30,0,30,30,0,1,2
"26715","b8920975fd5062e805506b14d7cfc30e",38,38,0,38,38,0,1,2
"26716","b89265b3eab1a7087d7eeaebb2fa8f8e",1,1,0,1,1,0,1,2
"26717","b892b949ac7dddd6b7e2781bcb9eed4b",10,10,0,10,0,10,1,2
"26718","b892c6d5f1eab746c3fa20c3b7f0c804",14,14,0,14,14,0,1,2
"26719","b89586544ae0a623612ba6c22e9f7b92",16,16,0,16,16,0,1,2
"26720","b8973d376fb9cf3fae1fde3c27588e34",142,63,74,13.4324324324324,142,0,3,3
"26721","b89ad5a38771788656968022d0db517a",57,45,22,18.1363636363636,57,0,2,1
"26722","b89dc5f1da4634e2c272fd84c497d040",183,132,67,19.1194029850746,158,25,3,3
"26723","b89e26fe6f2759288e949efb220a4207",37,29,51,5.07843137254902,37,0,2,1
"26724","b89f5be42286287fdeca2a707e5d450a",36,20,42,6,36,0,2,1
"26725","b8a103b351670d136e1866c0827cbfd1",124,80,28,31,124,0,3,3
"26726","b8a43fc22577078e77d023aeb3dbb269",26,24,31,5.87096774193548,26,0,2,1
"26727","b8a5cc1335ee9c02c9047b4ab24bf035",38,38,0,38,38,0,1,2
"26728","b8a7aaf39efeb4e3c8c0f9edf0072dda",126,91,31,28.4516129032258,126,0,3,3
"26729","b8a7fe0408c37cbb98f2084ec2c9797d",29,29,0,29,29,0,1,2
"26730","b8a8eb36c85b6101e4d9ceda167671a9",10,10,0,10,10,0,1,2
"26731","b8a9f7e01389b4836ec79176e052efab",85,66,81,7.34567901234568,61,24,2,1
"26732","b8ae6777984894af038ba679955c38e5",72,49,51,9.88235294117647,72,0,2,3
"26733","b8af1e76384c88dd8151cdd8fcc58a1e",43,43,0,43,43,0,1,2
"26734","b8b08da8c68964de28aed2c636845ace",102,57,76,9.39473684210526,102,0,2,3
"26735","b8b6af29f7283da5034762aec8a1392c",36,36,0,36,0,36,1,2
"26736","b8b769ae741f0581a575d04de4397fa3",49,38,59,5.8135593220339,49,0,2,1
"26737","b8b8bb64bb91361746b72680edba30f4",153,86,54,19.8333333333333,153,0,3,3
"26738","b8b8ee5d22a5c439204fdbb2162d383f",65,54,20,22.75,65,0,1,1
"26739","b8bc8ea19f20d0de000cefd3836252fe",9,9,0,9,9,0,1,2
"26740","b8bd63a5e84dc2e2c986627d31c02e7a",29,29,0,29,29,0,1,2
"26741","b8bda3adcd327b13f75d290b82377ba6",14,14,0,14,14,0,1,2
"26742","b8bde20053555913e0128abb302e4fa0",51,51,0,51,51,0,1,2
"26743","b8bde44710dd3f4fc54325a0ef6ab215",17,17,0,17,17,0,1,2
"26744","b8be782efb18f96f38b8a6e027026281",26,26,0,26,26,0,1,2
"26745","b8bf41c19c14f2df7d919ae2c816b873",176,84,53,23.2452830188679,150,26,3,3
"26746","b8c02552e01a2c4949f035671c6ce43d",29,29,0,29,29,0,1,2
"26747","b8c12cd9ccff773b9e1eb5e62b6878c6",61,50,54,7.90740740740741,61,0,2,1
"26748","b8c20e48a7a69bcebc2779c0675ef09d",52,49,56,6.5,52,0,2,1
"26749","b8c28a3665b8216a43bf6ae23e7a0919",67,58,39,12.025641025641,67,0,2,3
"26750","b8c2c4fb2a55accaadfcf94fdf706a08",50,50,0,50,50,0,1,2
"26751","b8c995963085f2fa91d87114298608a4",26,26,0,26,26,0,1,2
"26752","b8cd72236319dfe46e2c5852bce48b1d",25,25,0,25,25,0,1,2
"26753","b8cdaa1cefb3c69093295e22bef6928e",83,70,26,22.3461538461538,83,0,2,3
"26754","b8ceca506513579e56dcdd89f44c8e3a",144,84,73,13.8082191780822,144,0,3,3
"26755","b8cff534f98915e2801a1d059446fb73",32,32,0,32,0,32,1,2
"26756","b8d487de9fd847cc47ee877be6336cf1",23,13,64,2.515625,16,7,2,1
"26757","b8d4caa751ed3e5b84e3df189c9051e3",81,54,31,18.2903225806452,36,45,2,1
"26758","b8d9d602e93aea8fd83855bcbd2c10ef",39,39,0,39,39,0,1,2
"26759","b8dc01f61fa4004cdba5dce19b1a5f50",225,107,90,17.5,174,51,3,3
"26760","b8deb5f81b49d23358797495ac2e3963",67,54,14,33.5,67,0,1,2
"26761","b8dfdca4edc40c2c8d3ae74709da0ed6",67,55,37,12.6756756756757,67,0,2,3
"26762","b8e0c9c10bc6fee52d88d4348ab1c95e",37,37,0,37,37,0,1,2
"26763","b8e10c5e393360f665f4a23dcb0d20c2",66,57,23,20.0869565217391,66,0,2,1
"26764","b8e147f2995516a1a558c043e0cc01b4",31,26,49,4.42857142857143,0,31,2,1
"26765","b8e7e42686816eac965425a331fac2ab",15,15,0,15,15,0,1,2
"26766","b8e80c1b64e4f4630326ab34ed3bf792",48,48,0,48,48,0,1,2
"26767","b8e88e35a44dda8bf115da0da4136747",68,57,20,23.8,68,0,1,1
"26768","b8e8934f807c1148493e24cb4a10af1d",62,50,40,10.85,30,32,2,1
"26769","b8eb6054ffe919fe1f036d4ad0e785f8",66,49,59,7.83050847457627,66,0,2,3
"26770","b8ecc7f8ba0668da07a3552aa8568099",111,85,76,10.2236842105263,57,54,3,3
"26771","b8ef2391062fe7b53036be7e591341e5",19,19,0,19,19,0,1,2
"26772","b8f06f7e7f2f74ccd8886d9f58ec5359",66,40,28,16.5,66,0,2,1
"26773","b8f42c9c9cd347ddc58b7181e3cad29b",101,66,60,11.7833333333333,101,0,2,3
"26774","b8f472fad307b6c6ba21b3e915b822e0",18,18,0,18,18,0,1,2
"26775","b8f5478d1ff1b1d50a8e11d9c5f68743",19,19,0,19,19,0,1,2
"26776","b8f6a9c19fc5d96e88af2c0ef2c5fb9a",86,59,77,7.81818181818182,71,15,2,1
"26777","b8f6bf63c4a11058c982d69fa7d5d423",143,128,38,26.3421052631579,124,19,3,3
"26778","b8f7c6edfb6e4c86170e724a99a00349",21,21,0,21,0,21,1,2
"26779","b8f9aa1954650cbe261ab3bac07dea0a",53,53,0,53,53,0,1,2
"26780","b8fbd58606b58762a31cd6ca12ea336c",44,44,0,44,44,0,1,2
"26781","b8fd7facebc169ec2af3929657611367",38,38,0,38,38,0,1,2
"26782","b90073ac3a9ac09bc01ae702eb162b1c",29,21,63,3.22222222222222,11,18,2,1
"26783","b9029c45d4ca554303f6a2ce951e5c81",137,59,84,11.4166666666667,137,0,3,3
"26784","b905550ff12048bee8aa33bbba695ff1",35,30,28,8.75,0,35,2,1
"26785","b906d3be671e434e9675f5c4ae7213b6",45,45,0,45,45,0,1,2
"26786","b90b367864954a1d23b71570cc6600a7",40,40,0,40,0,40,1,2
"26787","b9129cdc11eb896d3e4ae265666c128c",185,102,60,21.5833333333333,150,35,3,3
"26788","b916573e7947adc3d7b0a5d3f735fd43",20,20,0,20,20,0,1,2
"26789","b916dd5aaae8008276d2eb51a56cc691",28,21,37,5.2972972972973,28,0,2,1
"26790","b916e9c667ef720c66f864b33ef28e63",22,22,0,22,0,22,1,2
"26791","b917b4fe877daaf15ef99048615b07cd",96,75,43,15.6279069767442,96,0,2,3
"26792","b91a4074b128bff9b1b2f3496197b832",17,17,0,17,17,0,1,2
"26793","b91aadc9975beb62d383a2826657f2c2",110,73,69,11.1594202898551,110,0,3,3
"26794","b91ae62995b3fef233b7c174f7d5faba",9,9,0,9,9,0,1,2
"26795","b91c473e531e93ffb71290337ca722a6",116,84,43,18.8837209302326,91,25,3,3
"26796","b91d945ac294860cd31a114a9ee4b8e8",78,50,67,8.14925373134328,78,0,2,3
"26797","b91d99b4ac81dad956b489329f9477f1",233,111,78,20.9102564102564,193,40,3,3
"26798","b9205f0fc4d882bfa351a93785e89769",26,20,76,2.39473684210526,26,0,2,1
"26799","b92106d8e5da9112ea2e8309a285bad9",10,10,0,10,10,0,1,2
"26800","b92131a555707aa2ec0a9248ff91fc5a",23,23,0,23,23,0,1,2
"26801","b921bae3de7425b1e855c899073f7d36",31,31,0,31,31,0,1,2
"26802","b922b239a2793a6c5e8832bbe27fb83a",19,19,0,19,19,0,1,2
"26803","b926a3ef3a2c1c8c6ada7fd6a7527cc7",32,32,0,32,32,0,1,2
"26804","b92b514345e53b79d36809daa2f1bd92",42,42,0,42,42,0,1,2
"26805","b92c551e62b6640265cb6864510ed6f7",23,20,7,23,23,0,1,2
"26806","b92dc8d8ed5624bd86c643162b4052a8",31,31,0,31,0,31,1,2
"26807","b933b2e26983525a68671586c2141f8c",40,40,0,40,40,0,1,2
"26808","b938c442ecee004dcfb8dffa7894b6b3",143,113,79,12.6708860759494,143,0,3,3
"26809","b93ad2dfce3ccb6658d238a646100a1d",35,31,28,8.75,35,0,2,1
"26810","b93c00fb779072437006e325d5eefb12",71,50,40,12.425,23,48,2,1
"26811","b93e06dc3fd65ce2f26b48dfd45b8dd3",35,35,0,35,35,0,1,2
"26812","b93e601143b64901ee0700050d08cab5",39,39,0,39,0,39,1,2
"26813","b9411518701c49862254101d9d37ec61",35,35,0,35,0,35,1,2
"26814","b9414297ce9d91c7fc0596fa3ee84f42",37,30,14,18.5,37,0,1,1
"26815","b94156c54673d78741115fbc2c3dcd80",105,76,81,9.07407407407407,105,0,3,3
"26816","b941c9ed1cfad97fd0ed4706f34e9d18",61,43,63,6.77777777777778,51,10,2,1
"26817","b943e2f66499962beefba4acdc15b408",82,66,28,20.5,82,0,2,3
"26818","b9445746f663b1e91e89ba34b401c0e2",191,133,61,21.9180327868852,191,0,3,3
"26819","b9471702e824d317feea7550fdda1b1c",53,41,42,8.83333333333333,0,53,2,1
"26820","b94869d94891311fdc4e159258ef0061",60,56,23,18.2608695652174,60,0,2,1
"26821","b9486bffa4c4dad899db01b464a00829",35,35,0,35,35,0,1,2
"26822","b949d7ff8b619e9ff2e2dae81dea5701",28,28,0,28,28,0,1,2
"26823","b94a1857411d9084f7f8292d19278b12",93,72,49,13.2857142857143,93,0,2,3
"26824","b94d28f64094f2554c5ecf15d6557dff",113,47,86,9.19767441860465,76,37,2,3
"26825","b94ef51d890e483455bf64faaf029345",26,18,26,7,26,0,2,1
"26826","b955d337a6bab9696b7dc599e3b1a796",28,28,0,28,28,0,1,2
"26827","b958dee6fb9a99d2f3d91ed557a300d6",95,64,74,8.98648648648649,61,34,2,3
"26828","b95d77a36696efdef1afb7f0d5f3d9af",103,59,80,9.0125,63,40,2,3
"26829","b962ae0eacd0210973c3dbbb8c4fcf5e",29,29,0,29,0,29,1,2
"26830","b963528a970af951cb05e2b7182f58cd",79,57,62,8.91935483870968,48,31,2,1
"26831","b9651ed4456daf51fd163d110ac13088",36,36,0,36,36,0,1,2
"26832","b9690dc77d7a7a8fbd4bdaed2f090da4",14,14,0,14,14,0,1,2
"26833","b96968163799056709898ca04d153198",66,49,80,5.775,61,5,2,3
"26834","b96b6be9e5c23b01d43e0fa24fadc10c",226,128,89,17.7752808988764,186,40,3,3
"26835","b96ee80fb987d56ccc93c7d973bd9f42",139,81,63,15.4444444444444,139,0,3,3
"26836","b96f12e6ea783ea4b2039bb3bdeafb1d",17,17,0,17,17,0,1,2
"26837","b9740ec44b12c78bed20691d2957bcdb",64,50,57,7.85964912280702,64,0,2,1
"26838","b9756ba96b8d05e7fb0bd6b079991faa",27,27,0,27,27,0,1,2
"26839","b979dd32b12eedb6eafb17411f0f0b4b",105,81,86,8.54651162790698,94,11,3,1
"26840","b97b520007afa7a5367a3d1c073e89fa",112,76,47,16.6808510638298,112,0,3,3
"26841","b97be59b2726dfc5295c9841c8e820cd",14,14,0,14,14,0,1,2
"26842","b97d334c9b4fa0bb1a26f49c2fb59fc6",12,12,0,12,12,0,1,2
"26843","b97ed268ef1ac541845bf8ab4e5fb3a7",138,85,60,16.1,138,0,3,3
"26844","b97fef37bde97d9bb44e3871484fe23e",15,15,0,15,0,15,1,2
"26845","b980b6ef33f63dc886c5981a355020ec",37,31,32,8.09375,17,20,2,1
"26846","b9880e434a3ac685b5d49e6b30104a98",52,31,74,4.91891891891892,52,0,2,1
"26847","b988a9d6a988ff569f69982a00d4d823",17,17,0,17,17,0,1,2
"26848","b98954819092ab22fda55510c310dd17",19,19,0,19,19,0,1,2
"26849","b9896ffc52c1a056d4fa9a5886b206b6",99,72,82,8.45121951219512,99,0,3,3
"26850","b98bd52d237fafb7f9a1e507901722d4",73,49,65,7.86153846153846,44,29,2,1
"26851","b98c3395997485bda81a1241972b4d2b",28,28,0,28,0,28,1,2
"26852","b98cafcb1e6aecfb737d7c9396916b65",222,102,77,20.1818181818182,186,36,3,3
"26853","b98d3089388d2ced4af99b4e5d76475f",86,52,44,13.6818181818182,86,0,2,3
"26854","b98fe7e2fc8dc957297d7c593b822e69",6,6,0,6,6,0,1,2
"26855","b99185ae2a2c0aa1172873df867492e5",127,72,81,10.9753086419753,113,14,3,1
"26856","b994b1fd3eabdb32aad5503b6eb2422c",14,14,0,14,14,0,1,2
"26857","b995190ec43d24c59f084189710c5087",44,39,58,5.31034482758621,18,26,2,1
"26858","b998883d3af180852ac075fd66117e4f",27,27,0,27,27,0,1,2
"26859","b99a6e0014ec1f498073baf76211fb8d",26,26,0,26,26,0,1,2
"26860","b99bb7dbbe8ee1a6c99b324ce4092000",46,38,40,8.05,46,0,2,1
"26861","b99c6cd231ef2d4ecb192d6be689521b",13,11,28,3.25,13,0,2,1
"26862","b99f5e3785b3ad46a0d504932c90b953",117,85,46,17.804347826087,70,47,3,3
"26863","b9a256c4d84306899f9157d05f93bcb3",50,27,62,5.64516129032258,50,0,2,1
"26864","b9a67a414a17327837cf645367d5abdb",31,31,0,31,31,0,1,2
"26865","b9a7f04738c6edeb771ec6d2ee64c917",104,59,70,10.4,104,0,2,3
"26866","b9a91a95be08403aad98b1a745c25ebf",28,28,0,28,28,0,1,2
"26867","b9a9b70575d50b9732154b4c7994081e",105,71,68,10.8088235294118,79,26,3,1
"26868","b9ad1ea362d844e928df3e57ec09b9c2",196,89,78,17.5897435897436,196,0,3,3
"26869","b9ae48a119ce9f5ddd38347a93fccaf1",57,41,29,13.7586206896552,42,15,2,1
"26870","b9af1d48a0bf5b450b993fd1d904a11a",80,70,34,16.4705882352941,80,0,2,3
"26871","b9afe0e360cd7af6ca82dc42f9e7629e",30,30,0,30,30,0,1,2
"26872","b9b069659a609b1a3cc3a74723883dfb",21,21,0,21,21,0,1,2
"26873","b9b6c5fe6d926f8bc0cc4e7305f409e8",42,21,59,4.98305084745763,26,16,2,1
"26874","b9bb3a71f9468cf439e7b4c2103cd42e",22,22,0,22,22,0,1,2
"26875","b9c060b97545cc091491b4fa785dfd84",152,86,50,21.28,103,49,3,3
"26876","b9c0c35c15001b3f15a9fc6a2143e53e",3,3,0,3,3,0,1,2
"26877","b9c5b260a0d644b52befd13f9ae768a1",164,108,71,16.169014084507,136,28,3,3
"26878","b9c5f319aa1eb8879be694b349b4b5a1",94,68,38,17.3157894736842,72,22,2,1
"26879","b9c794dd6fe3e001465f3bf41e0e7572",16,16,0,16,16,0,1,2
"26880","b9c8d94c8887c9a3c4b8cc304d190608",215,129,77,19.5454545454545,215,0,3,3
"26881","b9ca37132f50159733d26eaffb36f026",58,38,63,6.44444444444444,58,0,2,1
"26882","b9ca8d923f4db35141ef0c0d0a4ceff2",62,50,76,5.71052631578947,62,0,2,3
"26883","b9ccfe1360b38d413a603ed9fadfdf2c",3,3,0,3,3,0,1,2
"26884","b9cd8e95f35a57e99436cee8f81e465e",54,54,0,54,54,0,1,2
"26885","b9d09dc78ef12d3ee5bfa28cdffffd45",42,25,36,8.16666666666667,42,0,2,1
"26886","b9d225354e5c5730e5eaaffd75b5c321",1,1,0,1,1,0,1,2
"26887","b9d6241f78dced80158b43861bc34df3",14,14,0,14,14,0,1,2
"26888","b9d80efd84a390bba3b5d0b14c24a7ae",37,37,0,37,37,0,1,2
"26889","b9db6c2c6ad246261c41eba4032bbe43",163,107,49,23.2857142857143,117,46,3,3
"26890","b9dffdf1b3553ac1726ba90e2d46f730",25,24,63,2.77777777777778,25,0,2,1
"26891","b9e4bd85d18819264ec944a6a747e3fa",30,30,0,30,30,0,1,2
"26892","b9e4f5a642836c5273e3d2509020b017",53,53,0,53,53,0,1,2
"26893","b9e8da90a3ebb06b9d2856a4481f2e1e",140,95,43,22.7906976744186,140,0,3,3
"26894","b9f087d16706916ec032ef1b99e33c81",146,102,84,12.1666666666667,146,0,3,3
"26895","b9f1c4647798ded113cab62c4813abaf",11,11,0,11,11,0,1,2
"26896","b9f47272d7a545563db33c882575c44d",47,42,39,8.43589743589744,47,0,2,1
"26897","b9f56c411bfe960bb4dbf6e15604b5ea",3,3,0,3,3,0,1,2
"26898","b9f63f7ead53e70ab995d57552eb360e",228,128,73,21.8630136986301,191,37,3,3
"26899","b9f828cf8bf03e1baf0242fc43035cf2",29,25,40,5.075,29,0,2,1
"26900","b9f85428d57c5050d07bbf8e4657daad",13,13,0,13,13,0,1,2
"26901","b9fb889552b10712944094cbc18fbf13",120,76,47,17.8723404255319,120,0,3,3
"26902","ba00722892ef483cdc1d3698fe442a06",37,37,0,37,37,0,1,2
"26903","ba00b551deaaf0fa2d7c9ffcfbcfa16f",20,20,0,20,20,0,1,2
"26904","ba03d06e98c4224cfc4d1c205a386547",166,98,72,16.1388888888889,129,37,3,3
"26905","ba0604513c0ef6a9ecb87c8d7158b1d5",4,4,0,4,4,0,1,2
"26906","ba0681e85111189a65499365f151bc12",64,21,75,5.97333333333333,52,12,2,1
"26907","ba0c4c7b991137edfea8e00737acc07e",49,49,0,49,49,0,1,2
"26908","ba0e7a9aeafaff9a96b4a2a6f33be4e5",7,7,0,7,7,0,1,2
"26909","ba0fdf2c1f3dce63e965b642ea14e7e9",20,20,0,20,20,0,1,2
"26910","ba12d3930db1462d40e5f25f3a1e29ab",66,45,87,5.31034482758621,49,17,2,1
"26911","ba17460f4e9be3f20ea0d00d44c77204",130,92,59,15.4237288135593,130,0,3,3
"26912","ba1909296a4c13270bedbb673f21247b",59,35,38,10.8684210526316,59,0,2,1
"26913","ba1cf3b6eb2c85aabf839c1c27f8f761",128,85,63,14.2222222222222,128,0,3,3
"26914","ba1d4bb5df76327b6d040e5815b773f9",94,54,50,13.16,94,0,2,3
"26915","ba1f50f795638c39a555910e07f9e4ec",72,63,62,8.12903225806452,72,0,2,3
"26916","ba21ad4bb5940a25ae1d51469a4f5878",189,113,80,16.5375,189,0,3,3
"26917","ba226d33be6f374cdb78cce1edc89717",47,43,50,6.58,47,0,2,1
"26918","ba26efc9adcd6f437fa596d574256db5",5,3,2,17.5,3,2,1,2
"26919","ba2717370a39f190078074593f0efe61",61,58,48,8.89583333333333,61,0,2,3
"26920","ba2749d78bf4b6c8c727c9cb46151695",37,27,35,7.4,11,26,2,1
"26921","ba28ebcbfaca8b401bdfba885bbad1ab",24,24,0,24,24,0,1,2
"26922","ba2c95892b48bd441b65e9cda7679c5a",66,27,61,7.57377049180328,66,0,2,1
"26923","ba2e01594bfb5338c8548067fa422a61",233,87,77,21.1818181818182,184,49,3,3
"26924","ba2e67c3c417ec13cd66899f138ca69e",54,39,28,13.5,54,0,2,1
"26925","ba306f5308a33028cf61187dd248f985",183,85,89,14.3932584269663,183,0,3,3
"26926","ba30e56bf6ea763576ae86f8863ce568",29,28,5,40.6,29,0,1,2
"26927","ba31cfea81ac52ef8ac16c3a98479570",65,47,26,17.5,65,0,2,1
"26928","ba3447eb17d0d7cae1d399533196ecb3",53,53,0,53,53,0,1,2
"26929","ba3542232d665f4caa6f5f6ff6c5e465",130,90,41,22.1951219512195,130,0,3,3
"26930","ba3604114e49fbc9c38f6f5503361c61",36,36,0,36,36,0,1,2
"26931","ba3dc4b30f2acc49bae3eb149e80fdf9",49,43,30,11.4333333333333,29,20,2,1
"26932","ba3e3bec8a6395b64768446c6443bec4",33,33,0,33,33,0,1,2
"26933","ba3f45e96b311bcb95e8be95e1c48eaf",135,83,80,11.8125,135,0,3,3
"26934","ba406a230740c166ee5520add1e9dab9",30,30,0,30,30,0,1,2
"26935","ba4121bbc3338b5b0870f52ea1eef2e4",63,46,62,7.11290322580645,63,0,2,3
"26936","ba41a63f85232f8804cc03d824fef351",9,9,0,9,9,0,1,2
"26937","ba41e8fc9036fc2ceb95e33325b265fa",21,21,0,21,21,0,1,2
"26938","ba42c1f46c68fb2bb8bb2de603a93115",61,50,68,6.27941176470588,61,0,2,3
"26939","ba44879d1375d18eef1c9ac5ef9d7c74",75,45,33,15.9090909090909,48,27,2,1
"26940","ba46494f36177d8cb52ad51df6406f27",12,12,0,12,12,0,1,2
"26941","ba46882e4c2d465b1d848fa8f61197e3",13,13,0,13,0,13,1,2
"26942","ba471c926dc405991eed851cf4237bc3",22,22,0,22,22,0,1,2
"26943","ba48e65dfe7cef7024bda7249825a105",9,6,57,1.10526315789474,5,4,2,1
"26944","ba49ff57d79b6ecca58e41065b63586c",19,19,0,19,19,0,1,2
"26945","ba4b839ad4fbcfe1fddabdd0dcd24792",29,29,0,29,29,0,1,2
"26946","ba4e0c49b7bf9c0cab9a0447df523c34",14,14,0,14,0,14,1,2
"26947","ba51c6ef0319ff055e36465e2494e69f",100,77,60,11.6666666666667,100,0,3,3
"26948","ba52288604d69c6e6bb11da6218df4ca",31,31,0,31,31,0,1,2
"26949","ba54154fc7a956af69cc1f7eaf5e4535",111,96,38,20.4473684210526,111,0,3,3
"26950","ba541ce6b7a3d81d91d39fbb39a044e6",29,29,0,29,29,0,1,2
"26951","ba5462abee9630694e1712f8ffbda759",6,6,0,6,6,0,1,2
"26952","ba560a200259692b987746d7cc0f45c1",13,13,0,13,13,0,1,2
"26953","ba57833056fc9812aab43e541548db67",233,86,78,20.9102564102564,205,28,3,3
"26954","ba5c12f3bc08253fc5c9c9794f560fb0",9,7,40,1.575,3,6,2,1
"26955","ba5d92dfe1ee6bfbb996e153343081d4",28,28,0,28,28,0,1,2
"26956","ba5dbc15dd2f0cea9ee7d1cd6f967587",83,57,28,20.75,83,0,2,3
"26957","ba6416224869f1546470af5f7920c680",17,17,0,17,17,0,1,2
"26958","ba647b4558653d1dff84d5ee7f9331d6",48,48,0,48,48,0,1,2
"26959","ba649972d61bc51511475e0cbc6260d2",113,52,62,12.758064516129,113,0,2,3
"26960","ba662de47ba22528c1f61abb8bc44ad2",70,40,56,8.75,70,0,2,1
"26961","ba680a8811724c6c2a41834c054b1853",135,74,74,12.7702702702703,135,0,3,3
"26962","ba68daca6ff3c5021852e5813928ebdd",122,94,35,24.4,122,0,3,3
"26963","ba69a49ecf05e4895b5f2d1339d14530",39,34,41,6.65853658536585,39,0,2,1
"26964","ba6a0aacaee4e526a5e6f153ad6e0e6e",116,53,59,13.7627118644068,103,13,3,1
"26965","ba6a62b8b8730eb1844e6c613de00e79",32,32,0,32,32,0,1,2
"26966","ba6b2c4b93a60afa166ce329d0206022",7,7,0,7,7,0,1,2
"26967","ba6b5ef7f086eb03acf4dc40511f64da",27,27,0,27,0,27,1,2
"26968","ba6d1df0d785bfa5a436daa3f96bce47",104,79,23,31.6521739130435,104,0,3,3
"26969","ba6e36eef80c7406f8da8f57de5b6c83",109,77,56,13.625,109,0,3,3
"26970","ba718e62c7d9e63a21ff4d634844b093",111,79,30,25.9,64,47,3,3
"26971","ba75d9ca064d86069240124fa1d6bc63",41,41,0,41,41,0,1,2
"26972","ba77a9673c9bb5520f8e8cc0b0ffe1f6",12,12,0,12,12,0,1,2
"26973","ba7e85fe1bcb6b7fcdba28271041736e",104,78,42,17.3333333333333,70,34,3,3
"26974","ba7e948bba6143ba089f226117965123",144,85,70,14.4,144,0,3,3
"26975","ba822f39665e3265fd211d10b45760a2",105,82,28,26.25,105,0,3,3
"26976","ba836230591fcea6a2f6019a976f66dd",7,7,0,7,7,0,1,2
"26977","ba8593af4fe7c44677dd90b3d6ec86ef",45,39,27,11.6666666666667,45,0,2,1
"26978","ba85ae76f8bc22af961f5c953bb44be4",60,42,28,15,60,0,2,1
"26979","ba87778a1a8ef73f364b7151925c1aff",32,32,0,32,32,0,1,2
"26980","ba88b3aaa03a589bc7a65c3b7f09ea4c",209,114,57,25.6666666666667,164,45,3,3
"26981","ba899274d0df68cc65ea1dac42925e1e",45,43,17,18.5294117647059,25,20,1,1
"26982","ba8dac589f57c1c9a8d581d90d811f5d",7,7,0,7,7,0,1,2
"26983","ba8e33c907bc09dae0c9a12987a2c2d3",115,73,53,15.188679245283,115,0,3,3
"26984","ba8fc37a2756f0e5c634fbd1b2d3a37a",40,40,0,40,40,0,1,2
"26985","ba93cb1a1714b7f412e171e91bfd9c07",31,29,11,19.7272727272727,21,10,1,1
"26986","ba962abd7a22d4075e367567e4f8b553",29,29,0,29,29,0,1,2
"26987","ba9668084b63dfcc96f0b5760d897d25",63,49,77,5.72727272727273,33,30,2,1
"26988","ba9749930e27909c3ed57c134656c751",19,19,0,19,19,0,1,2
"26989","ba9776870d0c00a988eba54c642204fc",33,33,0,33,33,0,1,2
"26990","ba97b8b1f36495f93cef30556c62b904",241,95,81,20.8271604938272,190,51,3,3
"26991","ba9959c12d470b2e89b80db7bbc88335",41,17,64,4.484375,25,16,2,1
"26992","ba99be5ccf901c2279e7578eefebb809",92,68,25,25.76,92,0,2,3
"26993","ba99f427b03f3620cb9f9a989a4d2730",162,94,57,19.8947368421053,162,0,3,3
"26994","ba9c303a29ff7a7f0dd786050dd892c0",103,79,49,14.7142857142857,103,0,3,3
"26995","baa06ad2be934dbb8fd71613c09f1cf6",18,15,50,2.52,18,0,2,1
"26996","baa15eccafae695f979dde6e87b76c42",134,48,65,14.4307692307692,134,0,3,3
"26997","baa86fd2b3ceffc0f10e44e324a5c42a",118,83,53,15.5849056603774,82,36,3,3
"26998","baa9447b185f0fb100bdf9eab7d8abd8",21,21,0,21,0,21,1,2
"26999","baa96bf8fcbf70d8807b46085d58969b",54,43,68,5.55882352941177,54,0,2,1
"27000","baaf26cc71645a5f34aec412589fa39c",29,29,0,29,0,29,1,2
"27001","bab280f44ffe7f10e4432ef2934e4e2b",40,40,0,40,40,0,1,2
"27002","bab2ee9a8a23d602e8b722d1616651c5",52,52,0,52,52,0,1,2
"27003","bab39e98f39a7bfe18af52c19e69195a",30,30,0,30,30,0,1,2
"27004","bab70aada0a3d6f30aca4399c4b19d5b",40,40,0,40,40,0,1,2
"27005","bab895c0d98244463bebc3c5f9e7419d",35,35,0,35,35,0,1,2
"27006","babd705bb59c7d2b96f9b89c3ce7ba1c",45,45,0,45,0,45,1,2
"27007","babee50e7106e596b5bb6b307a02aedb",43,34,47,6.40425531914894,21,22,2,1
"27008","bac13af8274bc9aa17f712b566368623",41,41,0,41,41,0,1,2
"27009","bac165b317bc3cb770274175b3749379",23,23,0,23,23,0,1,2
"27010","bac20f549de0f8080e2b0983ae654797",19,19,0,19,19,0,1,2
"27011","bac62a8eb612daa391319845f14c2b5f",40,37,11,25.4545454545455,13,27,1,2
"27012","bac81b5ef8ec9db4b657f29bc59c80c9",20,20,0,20,20,0,1,2
"27013","baca916de8e4b5647acb6eb44017999b",12,12,0,12,12,0,1,2
"27014","bacf830a07df232c2a84dfff2b1b691d",20,20,0,20,20,0,1,2
"27015","bad268ec4b0d139ed1ba9cf97841d45c",30,30,0,30,30,0,1,2
"27016","bad2cae2dcf75dfc909b9b0851d0bcc5",57,47,18,22.1666666666667,26,31,1,1
"27017","bad4c5d90b8e5f65a9b47ec787ccf0bd",110,79,27,28.5185185185185,66,44,3,3
"27018","bad5132239275996d3506be40dbd338a",204,111,63,22.6666666666667,204,0,3,3
"27019","bad5997d45eec1c7b037b3053702f8d4",129,53,89,10.1460674157303,111,18,3,1
"27020","bad72e13a9308235a326a93633727120",88,46,62,9.93548387096774,56,32,2,1
"27021","bad962405bc5e2536a6ad8acafe5f3ca",35,35,0,35,35,0,1,2
"27022","bada806ae74e9b301c8f89a0f0bc8a13",48,48,0,48,48,0,1,2
"27023","badacd3d74197878f2221374bb429e26",87,61,88,6.92045454545455,87,0,2,3
"27024","badad3825f0d76e6f68a509003b33d92",21,21,0,21,0,21,1,2
"27025","bae51b1a5eb1c4f7324d37c0cb3a5039",13,13,0,13,0,13,1,2
"27026","bae7464d106dbf3313411695ba830819",249,120,85,20.5058823529412,200,49,3,3
"27027","baea94d29460d16c8a4f821f67fd4f6d",80,62,12,46.6666666666667,80,0,1,2
"27028","baefb44403be65b318c6a81318918144",12,12,0,12,12,0,1,2
"27029","baefe5625270926d9548ba5ebf67248d",34,34,0,34,34,0,1,2
"27030","baf23e0c3470a22fbcff722e91cafef1",11,8,22,3.5,11,0,1,1
"27031","baf5339b70627cc46377f319796fc4be",35,35,0,35,0,35,1,2
"27032","baf70899b23d071059e8dcf4a17fc481",36,28,11,22.9090909090909,36,0,1,2
"27033","baf825572ee41392d428f21ec5f41b24",16,16,0,16,16,0,1,2
"27034","bafb669a18560f3c40e72cd92affb54d",17,17,0,17,17,0,1,2
"27035","bafe5f1d0c63769e97fd582a768cb6c2",54,54,0,54,54,0,1,2
"27036","bafe84f2f3084ad9dc6f9c7dc09ccec3",89,59,26,23.9615384615385,89,0,2,3
"27037","bb012d350c73bee6aa6a4f4b110cbe9a",19,19,0,19,19,0,1,2
"27038","bb01cc6c9590dc6fa12295f50c5cf9c6",43,30,21,14.3333333333333,0,43,2,1
"27039","bb029fe7fd0472c59855015b58c97d51",144,82,51,19.7647058823529,144,0,3,3
"27040","bb060014a94164b1a2749879f82e397b",44,44,0,44,44,0,1,2
"27041","bb08113af3827cbeb81581b60a3bb67e",34,34,0,34,0,34,1,2
"27042","bb08f5715c078eb680fbfed4de65ba28",60,47,33,12.7272727272727,60,0,2,1
"27043","bb0915a9f2ac14d0b5ea767c144d8e93",20,20,0,20,20,0,1,2
"27044","bb0a89d02fc8f5262d78bf8c552fd444",124,88,63,13.7777777777778,124,0,3,3
"27045","bb0bcadb09c9b91882107e4ade427917",28,28,0,28,28,0,1,2
"27046","bb0d1d91f82773e56708555e0538fb0d",191,84,86,15.546511627907,143,48,3,3
"27047","bb0d94b75d7b815163171eecc96ef04f",23,23,0,23,23,0,1,2
"27048","bb108b47babb72844df08e2bc4f73b82",12,12,0,12,12,0,1,2
"27049","bb10d9e0b46e6e9bec6bcc023f7a9c41",20,20,0,20,20,0,1,2
"27050","bb12b9448413c378a6e37feebd7f8489",43,43,0,43,43,0,1,2
"27051","bb12f7dccf4053fecbf33bfb37cbb167",164,98,68,16.8823529411765,164,0,3,3
"27052","bb1d6d2dd052029d221878e1b7f0d0db",43,43,0,43,43,0,1,2
"27053","bb1e1e8a70308d36ea70fd1c20aa5925",14,14,0,14,14,0,1,2
"27054","bb216a9c70d87ae525311648867651f6",37,37,0,37,37,0,1,2
"27055","bb21c2eb8fe55bf32fca91b84c040fbc",48,41,61,5.50819672131148,48,0,2,1
"27056","bb22aa4cc7ce22c78bf4f2373b43a1f8",71,52,48,10.3541666666667,44,27,2,1
"27057","bb249dab3c986f99632c6fdf64cbc502",48,48,0,48,48,0,1,2
"27058","bb25edefc7b1c82c9dc7b51c7c6bbc2f",30,25,34,6.17647058823529,30,0,2,1
"27059","bb2a9932430926b8a8f3012edd4ba151",41,32,35,8.2,41,0,2,1
"27060","bb2d1ee9eb0ff26bf855c140c6d86306",8,8,0,8,8,0,1,2
"27061","bb31a4fa18dab2848a3fd4f205073d1d",44,44,0,44,44,0,1,2
"27062","bb33fde3b6c0ac951a3742a8011fffe0",55,43,17,22.6470588235294,55,0,1,1
"27063","bb35a6e70b4f4c282d5a095e5edefc9d",34,34,0,34,34,0,1,2
"27064","bb35c24e590f31f2640feada0be843c2",93,52,56,11.625,93,0,2,3
"27065","bb373ce5d815ea882b806af066e97839",33,33,0,33,33,0,1,2
"27066","bb37d283c1c0d756c85bcba1e41ad0ff",106,81,37,20.0540540540541,106,0,3,3
"27067","bb385ab3d764e8b8f313e5745cbad04d",54,51,64,5.90625,28,26,2,1
"27068","bb3aa53404adfb39405b47e0a3f081a9",47,39,35,9.4,47,0,2,1
"27069","bb3d39258b2508ed2cec154979805d18",58,50,15,27.0666666666667,58,0,1,1
"27070","bb3fde01892051c6651003c76d88de51",40,39,8,35,40,0,1,2
"27071","bb3fee6f4df1a72ccb47aa1482f26d5a",17,17,0,17,17,0,1,2
"27072","bb42bd881ae0ca284426854676bec51a",30,30,0,30,30,0,1,2
"27073","bb4370f1fcdfcd98acd6ef97fee7ee00",49,49,0,49,49,0,1,2
"27074","bb458d930e4a3f73aeb00993202fad1e",10,10,0,10,10,0,1,2
"27075","bb47d921603c430b8d0d5d91620744fa",15,15,0,15,15,0,1,2
"27076","bb4d94666bbabe13d3f63ca37c250cd5",50,45,51,6.86274509803922,50,0,2,1
"27077","bb4da5329e3209b3e5d8eeac202a66c3",73,40,76,6.72368421052632,73,0,2,1
"27078","bb4ddc8782b1e45b4a20af0c9e67563b",184,105,47,27.4042553191489,184,0,3,3
"27079","bb4f232f6a572cd568a15e242b8b4057",83,58,33,17.6060606060606,83,0,2,1
"27080","bb4f6c02fb6cf60ce5435be53b7860eb",44,44,0,44,44,0,1,2
"27081","bb50323f6e9b8da15a8a33e50267af52",53,44,26,14.2692307692308,53,0,2,1
"27082","bb524a394d3a719408454b4d2742494b",28,28,0,28,28,0,1,2
"27083","bb53c65bdfd01d9e87ff0ae65d74b12b",21,21,0,21,21,0,1,2
"27084","bb5547bb4fd478e29b49f4962f53deb2",45,45,0,45,0,45,1,2
"27085","bb58e97aa91535c21d1cc22879188f5e",79,58,41,13.4878048780488,79,0,2,3
"27086","bb5a0d9f5fbbbb95002643578c7bd2e0",25,25,0,25,25,0,1,2
"27087","bb5ad6f5f2b3f57d00e3437e75316066",31,31,0,31,31,0,1,2
"27088","bb5b228622da0b74892adcbaf5c1e110",150,70,63,16.6666666666667,133,17,3,3
"27089","bb5be2cf476aaa1bb8addff8fd46b925",25,25,0,25,25,0,1,2
"27090","bb5cfafc16d2d2105535d0aa4f29792d",34,34,0,34,34,0,1,2
"27091","bb5d3731f6e96015e265289f3fe73780",51,50,10,35.7,22,29,1,2
"27092","bb5ef9ac5b1d0a20cf36702933aeecd3",23,23,0,23,23,0,1,2
"27093","bb6511e6e2a3a6f8223d8e04423fbcf3",41,41,0,41,0,41,1,2
"27094","bb67614db606918504ee8b837187e948",2,2,0,2,2,0,1,2
"27095","bb686aece648069cf5202965e11b8b56",121,61,88,9.625,87,34,3,1
"27096","bb6a980fbd06eef2b16c0a0f8736d2b6",36,36,0,36,36,0,1,2
"27097","bb6d5baccf2ae846577b9a61703b74dd",147,98,69,14.9130434782609,147,0,3,3
"27098","bb6de90ce99e733b06ce92326c12ad93",97,32,82,8.28048780487805,79,18,2,1
"27099","bb6eb0180b6066af58935b51c1faeebc",41,35,7,41,0,41,1,2
"27100","bb716b916eb2a260a809157b32147f78",60,41,60,7,9,51,2,1
"27101","bb71ba43160b2514168983aadc8849c0",44,28,39,7.8974358974359,24,20,2,1
"27102","bb73a77b38c64a5f3b9b438f8122bd2d",49,41,7,49,49,0,1,2
"27103","bb741c4756d00639242e3efb3d917c07",72,49,67,7.52238805970149,72,0,2,3
"27104","bb7726c10fc1272dcd5dd85df846c0b3",27,27,0,27,27,0,1,2
"27105","bb78ab3b325425bed96b5e9096f02f9b",27,27,0,27,0,27,1,2
"27106","bb792fe33e820c5c66501bbe45fec1f0",64,46,26,17.2307692307692,30,34,2,1
"27107","bb7cc91d50c3d93716df196bb2ac92b7",23,23,0,23,23,0,1,2
"27108","bb7e8e5791d063d723dc05c87b2fef2f",53,37,65,5.70769230769231,34,19,2,1
"27109","bb7e9e33e08fbeb9fc80e7c702c6046a",37,22,33,7.84848484848485,37,0,2,1
"27110","bb7fe8bfaf88f6f3153a93e8b0febf86",51,45,28,12.75,51,0,2,1
"27111","bb8104b634ede9b46bf4b53789ef50b1",136,21,85,11.2,113,23,2,1
"27112","bb839cb865d6afc76bbba644253e3825",8,6,50,1.12,8,0,2,1
"27113","bb860f916c613efacd314ea95510845e",106,75,59,12.5762711864407,106,0,3,3
"27114","bb87ea708b421c6059604c6797e780d5",11,8,71,1.08450704225352,11,0,2,1
"27115","bb8a6a5e60e2654e5fef6b244a391d8c",44,44,0,44,44,0,1,2
"27116","bb8b46c673b6bdc5090e0754b4043c47",152,82,74,14.3783783783784,152,0,3,3
"27117","bb8cf95186113f73299c0ec87a01b634",163,99,69,16.536231884058,163,0,3,3
"27118","bb8d1b04c488691a8e5025ee14c8e80f",111,79,84,9.25,111,0,3,3
"27119","bb8f65c45387202d1975568fe89cd04b",23,23,0,23,0,23,1,2
"27120","bb91d1e4c5d99f7a923af9591221d417",15,13,38,2.76315789473684,15,0,2,1
"27121","bb9218c6047cd7b0dc15f0dbf4d961de",14,14,0,14,14,0,1,2
"27122","bb992a9552c92e63e4a50176d18d7d2c",96,72,29,23.1724137931034,96,0,3,3
"27123","bb99f1d7ed62cde20c533ba1c8f716ce",25,25,0,25,25,0,1,2
"27124","bb9cb2f46b61930760f76eb6f6642615",32,32,0,32,32,0,1,2
"27125","bb9eed830c999061e337edf89d1c6696",45,37,56,5.625,45,0,2,1
"27126","bba0bc5b4f37f363e67934e1a7352b2e",8,5,28,2,8,0,2,1
"27127","bba13fcc08267242c693422cbdca929d",97,86,59,11.5084745762712,97,0,3,3
"27128","bba1b83c7cbb83051a0bd00cc5f0f455",16,16,0,16,0,16,1,2
"27129","bba48b208c060d2de93fdcf37db6a494",43,43,0,43,43,0,1,2
"27130","bba4d93a41d97bb5e15c16f74b1dad96",3,3,0,3,3,0,1,2
"27131","bba648a36f0f2b21f34cbe3e3abc7415",126,88,68,12.9705882352941,75,51,3,3
"27132","bba70bb07f5a7235bdc740ade7a6b49e",33,33,0,33,33,0,1,2
"27133","bba7838127b9634f24d859ae832af1fb",5,5,0,5,0,5,1,2
"27134","bba8a03695b98dac3a13fe931ddd59e4",174,78,72,16.9166666666667,174,0,3,3
"27135","bba99245e2afb0a0038ead9b222ecd49",25,25,0,25,25,0,1,2
"27136","bbb19603ed7fee3310440b556d4e9385",34,34,0,34,0,34,1,2
"27137","bbb5805e0a6c2a1a1d2af4a76ffba4dd",1,1,0,1,1,0,1,2
"27138","bbbacd1900bf6d0cd235d4358451714c",218,84,88,17.3409090909091,168,50,3,3
"27139","bbc0cbba2dffc5ff4311e66fbc0d939c",64,56,44,10.1818181818182,64,0,2,3
"27140","bbc59d2ce8982eeade45fc7d89af3d23",7,7,0,7,7,0,1,2
"27141","bbc7198047666d22b7d415453b3312ae",49,37,14,24.5,49,0,1,1
"27142","bbc79d39cdd045c6e929e53a660c9d8e",165,75,75,15.4,155,10,3,3
"27143","bbcc0a93cd271b3e2d25be47163e2ae9",88,65,39,15.7948717948718,43,45,2,1
"27144","bbcd8092a9f27a1454d580150afe9a56",10,10,0,10,10,0,1,2
"27145","bbce9905855b50e66d948ae7bd56c4d9",148,89,53,19.5471698113208,148,0,3,3
"27146","bbd1b3a7f7e9dc1a3503e23b5696c6b7",24,24,0,24,24,0,1,2
"27147","bbd37b2585a5ff2efba878d90c4a61a8",77,51,84,6.41666666666667,77,0,2,3
"27148","bbd5ffa3677f9a4e44db8bd3a421ea31",20,20,0,20,20,0,1,2
"27149","bbd6d3215cd82534c1720c5bd4222598",2,1,1,14,2,0,1,2
"27150","bbd9289e9355a0f4dd82abd9ce6e2f7f",44,39,29,10.6206896551724,44,0,2,1
"27151","bbda851349acbf86d63e355edf5955f3",27,22,51,3.70588235294118,27,0,2,1
"27152","bbdb5969e98eb7025e5e4a7a0f7f35aa",33,31,23,10.0434782608696,33,0,2,1
"27153","bbdb59e169691bda62d5fa714186b9a2",40,31,13,21.5384615384615,40,0,1,1
"27154","bbdb90c4b662d450a5cd31ccc6489c1a",122,95,58,14.7241379310345,122,0,3,3
"27155","bbdc2022863af5202411def8675e191b",79,57,42,13.1666666666667,79,0,2,3
"27156","bbddc806498543308ef4c69dfab3b317",38,29,56,4.75,38,0,2,1
"27157","bbe1c94279efdfd9b655344a9bd8f18a",37,28,55,4.70909090909091,37,0,2,1
"27158","bbe1f982bb9999ca141b112d3419d9a2",1,1,0,1,1,0,1,2
"27159","bbe51c892463e39824e7f3e2ef3cffb9",40,40,0,40,40,0,1,2
"27160","bbe5f3a809c11819fb2f12b493c5eee5",16,16,0,16,16,0,1,2
"27161","bbe83ed7d00c67d47fcb5d4ccb077965",182,76,74,17.2162162162162,128,54,3,3
"27162","bbe88cf359f045e94a88c9c088dfc880",151,111,56,18.875,151,0,3,3
"27163","bbe89f11859ba91c21b133fb06901159",14,14,0,14,14,0,1,2
"27164","bbe9cd53a5b23dda46f8891fc58174a8",63,45,37,11.9189189189189,63,0,2,1
"27165","bbed9d87a0d0bc35bef8b9b6bdb375fb",52,37,53,6.86792452830189,52,0,2,1
"27166","bbf4f21df020ed83f269cb44fb3b34ff",25,25,0,25,25,0,1,2
"27167","bbf520a4d2ca801b8a130d93a7e5f03c",217,135,63,24.1111111111111,217,0,3,3
"27168","bbf5f691774677bf0c9fff13ac6ce8c8",47,25,60,5.48333333333333,30,17,2,1
"27169","bbf7690fdc2381787ff98527dfbae805",7,4,67,0.73134328358209,7,0,2,1
"27170","bbfa28e6a462597c43c27493e8bc8ecb",98,46,86,7.97674418604651,98,0,2,3
"27171","bbfb0cddf2b6acdfbd4da407561e5fcf",126,80,75,11.76,126,0,3,3
"27172","bbfb79c3f1888be6392990be17a4a9aa",195,114,82,16.6463414634146,175,20,3,3
"27173","bbfb99fd9dd67adf396675b9b32326a7",23,23,0,23,0,23,1,2
"27174","bbfbc5fa4b125aefe5a5a633b73ba436",19,19,0,19,19,0,1,2
"27175","bbfd53790429a98d538a10a7178591e9",53,46,13,28.5384615384615,53,0,1,1
"27176","bbfe058613fc7e42a165f80ff012f88e",87,65,47,12.9574468085106,87,0,2,3
"27177","bbfe1a18ddba8357f1eb08ead34050b4",5,5,0,5,5,0,1,2
"27178","bbfec7499e6f5977d28bd6d4ea4c9063",135,99,36,26.25,91,44,3,3
"27179","bbfed32587ebeeb3c5e93405f7e65fed",12,12,0,12,12,0,1,2
"27180","bc008b24c17819ecb606d4e4cce7ed19",204,146,63,22.6666666666667,204,0,3,3
"27181","bc0149e943c4b430f7ea18a75a7528a8",42,42,0,42,42,0,1,2
"27182","bc04e93f06da8c96d9a6d881c91d4822",228,108,79,20.2025316455696,202,26,3,3
"27183","bc056a9777f66ef2076c25ec39b90d5f",16,16,0,16,16,0,1,2
"27184","bc0ab9a81354ef7a004d27ad64d247d2",116,68,51,15.921568627451,116,0,3,3
"27185","bc0ba14928b6bf739a2426a83fbcd720",11,11,0,11,11,0,1,2
"27186","bc0d1b7836e0310fffb02b97b214d0d3",25,25,0,25,25,0,1,2
"27187","bc0da2ce99998cde443664499d8ddd85",19,19,0,19,19,0,1,2
"27188","bc0ed86dcf951be7fb378eb2458d3cff",53,53,0,53,53,0,1,2
"27189","bc10690c744944cc624fd7dee530ef8e",117,95,40,20.475,64,53,3,3
"27190","bc13215345416a9425e44d9d433fb54d",31,31,0,31,0,31,1,2
"27191","bc134c60cce4b0520e4aad9c53e23a56",158,88,74,14.9459459459459,158,0,3,3
"27192","bc137bb75951e7de92d6b54061800e99",90,53,69,9.1304347826087,71,19,2,1
"27193","bc152fce3b74ab10d188a56d46bdb853",36,36,0,36,36,0,1,2
"27194","bc16785b9a490c14278a526b0e82b4c6",12,12,0,12,12,0,1,2
"27195","bc16f2ff7ee81ec75c342bec03eae080",159,99,44,25.2954545454545,159,0,3,3
"27196","bc17b0f3031b0b5a439e56b8fed08f52",27,27,0,27,0,27,1,2
"27197","bc186fd38bf63fa2ccb5794bc51f8b57",3,1,63,0.333333333333333,1,2,2,1
"27198","bc1bd8d23e492bb05d6ba6feb9dcf91e",36,20,82,3.07317073170732,27,9,2,1
"27199","bc1dab5cd5248edef5ba7d44679d59c9",6,5,6,7,6,0,1,2
"27200","bc1e23cac8cf3f583e4e142ccc7461b4",20,19,3,46.6666666666667,20,0,1,2
"27201","bc1e5e0461f577a9ef693915cd9c6321",35,35,0,35,0,35,1,2
"27202","bc2305515e13dbbf9cb52131f27e84bb",63,51,17,25.9411764705882,26,37,1,1
"27203","bc25f0066dec282eab65b9e19e8eb0b2",29,29,0,29,29,0,1,2
"27204","bc2d241df747716bef1db889958c99e7",35,35,0,35,35,0,1,2
"27205","bc2e38c5bcd94f019241b0f7628d7c40",28,28,0,28,28,0,1,2
"27206","bc3091614d6508e9c7e398cdd1b41e55",72,48,59,8.54237288135593,72,0,2,3
"27207","bc32483aa12bd97d43954fb441261edd",31,31,0,31,31,0,1,2
"27208","bc32968c6d62c1cbd3ee4499d8f59419",22,22,0,22,22,0,1,2
"27209","bc3491ccef6641e583ac23b887f47c7e",130,101,78,11.6666666666667,130,0,3,3
"27210","bc364a3418d4095305b97a4555fefca8",58,50,73,5.56164383561644,28,30,2,1
"27211","bc3be08013400ea43ae80eabca99e044",77,68,42,12.8333333333333,25,52,2,1
"27212","bc3e9b69dcaf57a01b0aaed9a69c4cf4",65,53,33,13.7878787878788,34,31,2,1
"27213","bc4127174b9be42970d3edaca59a23e4",131,89,78,11.7564102564103,131,0,3,3
"27214","bc416550c272498aa36f470ab6e3af6a",97,58,21,32.3333333333333,97,0,1,2
"27215","bc43bfeb97f5a448a908eb5a26fc2fbb",26,26,0,26,26,0,1,2
"27216","bc450410e8c2a6d7994d5f5e77602453",43,43,0,43,43,0,1,2
"27217","bc4946fa674f487b2f5b441d8e6af431",89,56,32,19.46875,48,41,2,1
"27218","bc4a016596795bcf392637d0eaa91cf1",57,41,54,7.38888888888889,57,0,2,1
"27219","bc4abd88379af084c0cc8eaf300015f4",37,37,0,37,37,0,1,2
"27220","bc4dc8ecbe4a7934cd588087a54ee7af",34,34,0,34,34,0,1,2
"27221","bc4ed0e8f03eb96f28eca129b4fe0705",164,105,90,12.7555555555556,164,0,3,3
"27222","bc519eb94da3d4b7573a6774287fbdcb",12,12,0,12,12,0,1,2
"27223","bc51b4cc43f6fda12226bcc74a737405",79,49,67,8.25373134328358,79,0,2,3
"27224","bc532e3c13ac2fd4ecee324f1a8017d0",32,32,0,32,32,0,1,2
"27225","bc5705d6deedf4a85c6631ae85cfa324",27,27,0,27,27,0,1,2
"27226","bc5803d11f6b76e5c159f89be188d460",5,5,0,5,5,0,1,2
"27227","bc5897485c047e993576c86be6e73e46",9,9,0,9,9,0,1,2
"27228","bc599757da3ff54a6ab6a86256e4ce97",214,118,82,18.2682926829268,214,0,3,3
"27229","bc5df3aae87f618ec536b8ab73abd147",112,76,89,8.80898876404494,90,22,3,1
"27230","bc5df5dd43d7d2cee3911065e76db278",62,43,82,5.29268292682927,55,7,2,1
"27231","bc5f2264a73cab5a996143eacd9f33e9",35,35,0,35,35,0,1,2
"27232","bc60af3c45a1d85aaecbfef3af31899a",59,43,55,7.50909090909091,59,0,2,1
"27233","bc6229f743c5bbac2f4f8119a246b556",30,29,38,5.52631578947368,30,0,2,1
"27234","bc63bf9b9ad531d9385526a3cce6ed8b",45,40,41,7.68292682926829,45,0,2,1
"27235","bc6bd7e6c30fe90879fb86d71271cb11",54,53,51,7.41176470588235,40,14,2,1
"27236","bc6e7e9cfb6fa31353c0521c7e782bba",1,1,0,1,1,0,1,2
"27237","bc728b720e77db20e72b10108e38825c",21,21,0,21,21,0,1,2
"27238","bc72fa22748a63014aff15a7f5ce6c5a",14,14,0,14,14,0,1,2
"27239","bc747622b9a96d0901fd33cf091ea222",159,84,56,19.875,140,19,3,3
"27240","bc749a0d2c7ee67a8731904ec4fe60c9",13,13,0,13,0,13,1,2
"27241","bc754f3c5bc3bb1b781f8359be01dab1",53,41,15,24.7333333333333,26,27,1,1
"27242","bc76537ca03cec9e65f89a1ee8b68ffc",34,34,0,34,34,0,1,2
"27243","bc79640c152fb12d4fa5420dc4597fbd",35,35,0,35,35,0,1,2
"27244","bc7aa82170261b43d1a163ca539f1716",66,53,32,14.4375,66,0,2,1
"27245","bc7b599ff180aa9e5732e1912286d494",74,55,34,15.2352941176471,74,0,2,1
"27246","bc7b5ea99b07fd798ad74b53cba0a0ba",15,15,0,15,15,0,1,2
"27247","bc7ba972023a1b9726ab13a19ec60f8f",90,73,31,20.3225806451613,49,41,2,3
"27248","bc81d17dbea9030e2bced73dc29708c4",23,23,0,23,23,0,1,2
"27249","bc825a0818a1a641bfca75e9a95089f0",128,82,71,12.6197183098592,128,0,3,3
"27250","bc830f83610a9101dd5fcc628469bff3",6,2,54,0.777777777777778,6,0,2,1
"27251","bc85f142f183fc974bef24a9dbf1184c",74,41,69,7.50724637681159,62,12,2,1
"27252","bc89d435d96d9b317378c121909eeee2",130,109,46,19.7826086956522,130,0,3,3
"27253","bc906f8159f9449d5fd46ada4939053f",56,51,16,24.5,56,0,1,1
"27254","bc92367084bd196c1d490bc68c4fd7ea",22,22,0,22,22,0,1,2
"27255","bc92e15cb414043a13a98304c1d45b7a",34,34,0,34,0,34,1,2
"27256","bc942a6dbb75048e0c1d314a597ab2b9",85,52,84,7.08333333333333,85,0,2,3
"27257","bc945c8208c27f381720dc28638e364f",35,35,0,35,35,0,1,2
"27258","bc95c3741fba9cce0926c56f214c523e",74,51,55,9.41818181818182,26,48,2,1
"27259","bc9724d1b430da1df2bf0fe673bdaa42",9,9,0,9,9,0,1,2
"27260","bc9868474d3366fd21e505c038e2d68d",43,29,28,10.75,43,0,2,1
"27261","bc9b1835e0b68f874f06b70ec09236e7",127,76,55,16.1636363636364,85,42,3,3
"27262","bc9b7604a2f62d69a9fcfe6107c68d67",119,88,68,12.25,119,0,3,3
"27263","bc9be8aa94a1d8e9d82b13944c0a52d1",62,47,26,16.6923076923077,62,0,2,1
"27264","bc9ca609fa5ab37aac7c8dd9b1da7831",118,78,70,11.8,118,0,3,3
"27265","bc9e6dd811d2bbfb486ffeca1a19852f",71,48,30,16.5666666666667,71,0,2,1
"27266","bca11c96680c28ddd9972e662e5152a3",107,71,57,13.140350877193,107,0,3,3
"27267","bca2eac5565ad3d0fcc6ca0ce7862c24",9,9,0,9,9,0,1,2
"27268","bca3329741631f8525a17d8e59b99e2b",167,106,65,17.9846153846154,133,34,3,3
"27269","bca3f12bdc431a2e0487456b047cd45f",120,65,57,14.7368421052632,120,0,3,3
"27270","bca468d06f8ef4d85ea7178b324aa128",12,12,0,12,12,0,1,2
"27271","bca5ac9f88d32f5f1cda15e4dac28795",80,48,60,9.33333333333333,80,0,2,3
"27272","bca91655aeae9d5ca49e48dcc170391a",46,46,0,46,46,0,1,2
"27273","bcab05228959d876d7324b24a9b46af0",24,24,0,24,0,24,1,2
"27274","bcafa8db4367be86db786b776a5fd531",76,29,64,8.3125,29,47,2,1
"27275","bcb3fa723c4ebf5feb49cbe6823ed73f",115,73,69,11.6666666666667,108,7,3,1
"27276","bcb6271bc92c0ed025f8363a1a3ac147",130,91,30,30.3333333333333,130,0,3,3
"27277","bcb9d0acd9a66b300ad5773182e6ce98",41,36,55,5.21818181818182,41,0,2,1
"27278","bcbb8c41c87442a45d5a493310d4bcde",16,11,38,2.94736842105263,16,0,2,1
"27279","bcbbaea91d840989e60aa4852149269d",61,45,41,10.4146341463415,61,0,2,1
"27280","bcbbb76755c2656c82a014b0f3cd8101",36,36,0,36,36,0,1,2
"27281","bcbbd1ca43a563c7aaec92677761c8f8",47,39,28,11.75,47,0,2,1
"27282","bcbd01b35ae89c303d683871ba2cf8fa",31,25,54,4.01851851851852,31,0,2,1
"27283","bcbe8897594d26546dcc9e6fb2d78f3b",162,104,76,14.9210526315789,162,0,3,3
"27284","bcc02fd736a9e285645cb7bf813cb36f",43,30,46,6.54347826086957,22,21,2,1
"27285","bcc111448c3bdbb594e4b578b292ed67",42,42,0,42,42,0,1,2
"27286","bcc3b53b0dc540eb4494d6507f44edd9",27,27,0,27,0,27,1,2
"27287","bcc3bb9a20236ede7c622c00ef5522dd",41,25,71,4.04225352112676,32,9,2,1
"27288","bcc9646976efa75ec444d025482ce413",29,29,0,29,29,0,1,2
"27289","bccb0499dc76e3c4d1a26effb43f3108",153,79,70,15.3,153,0,3,3
"27290","bccd7eb6f491724a1c05f3444347247f",20,2,22,6.36363636363636,20,0,1,1
"27291","bcce2397cccb14e1d7675e85ad63d822",20,20,0,20,20,0,1,2
"27292","bcce4edfabd79592e895b458c65bc95f",27,27,0,27,27,0,1,2
"27293","bccff91f36bf487dcb63ba71a491c9d7",180,102,69,18.2608695652174,180,0,3,3
"27294","bcd25c610dbceb4d9bc3c30217fd97e2",18,18,0,18,18,0,1,2
"27295","bcd6617ea3d7446c1c1f5f7d8f484157",81,47,28,20.25,81,0,2,1
"27296","bcd68c2be6c486cdc8cd80fa5bb59a4b",1,1,0,1,1,0,1,2
"27297","bcd85682905d0a083e53189c1403c827",58,46,37,10.972972972973,58,0,2,1
"27298","bcd9c0326361c99e7d7550175ecfd6de",46,34,59,5.45762711864407,39,7,2,1
"27299","bcdb2e5d2c84f92cd7395e6a4f1ec202",36,36,0,36,36,0,1,2
"27300","bcdd330f94ac0322ee8c347f6eec4ab1",22,22,0,22,22,0,1,2
"27301","bcde1b6d63cd02ca629e1432d710c28f",148,84,87,11.9080459770115,120,28,3,3
"27302","bcdf085609d19942e009b3032f0be717",42,40,17,17.2941176470588,42,0,1,1
"27303","bcdfb3a7bd53e8a0d758a5c2a48fdfab",36,35,14,18,0,36,1,1
"27304","bce0075fba00a745cd3df08bbe329899",36,36,0,36,36,0,1,2
"27305","bce0965a56e91545ec932405fc4b4292",25,25,0,25,25,0,1,2
"27306","bce0aa58b995d5c3ef225e6eee596d89",42,38,24,12.25,42,0,2,1
"27307","bce2e08a8d001b1ee131358005ff3129",16,16,0,16,16,0,1,2
"27308","bce31ff3f5933761a80ad7c2993ccbdf",55,46,54,7.12962962962963,55,0,2,1
"27309","bce4f947d88908ffadf49b4d7926ad3f",92,66,63,10.2222222222222,92,0,2,3
"27310","bce5e2f86b1bb913d3113b604b442b1f",16,16,0,16,16,0,1,2
"27311","bce7796a3d60419e214520726e2cfd9d",74,54,33,15.6969696969697,74,0,2,1
"27312","bce9cfc04da08c12a6d895530b447f56",1,1,0,1,1,0,1,2
"27313","bceb4e78dba6754c05e57af9499fc654",56,56,0,56,56,0,1,2
"27314","bceb8ac7938a881377802154d62dce8f",107,71,89,8.41573033707865,57,50,3,3
"27315","bceec7c264a171d8955fd2725f45cc42",89,71,77,8.09090909090909,89,0,2,3
"27316","bcef15e0cc5771bcc34dbd86e6464140",40,36,76,3.68421052631579,35,5,2,1
"27317","bcefc5b264e90324e760c70ecb0a6d70",86,69,65,9.26153846153846,86,0,2,3
"27318","bcf00203ef273aaecac1e8b381b3c1b9",48,44,26,12.9230769230769,48,0,2,1
"27319","bcf06517fc3f0bd2063b9bd236fdcb4b",4,4,0,4,4,0,1,2
"27320","bcf1ee5225cad60af433eb35b7f52c55",45,32,86,3.66279069767442,45,0,2,1
"27321","bcf2c59fe7e912867888583acb3a8ade",164,111,50,22.96,164,0,3,3
"27322","bcf40c4b9fd7a1b8d1c2c841c7fe99fe",18,18,0,18,18,0,1,2
"27323","bcf45cf4314c168f53f3319ee2fbc04d",107,55,59,12.6949152542373,81,26,2,1
"27324","bcf787f70912df8a0254ab1f04fe4c0f",19,16,27,4.92592592592593,19,0,2,1
"27325","bcf9ba57ce7b63c7468cb654dd3301d7",149,86,70,14.9,120,29,3,3
"27326","bcfd092783511c8d92379df41f947e92",22,19,39,3.94871794871795,22,0,2,1
"27327","bcfffcf61a2955df6c64eb03c1708490",19,19,0,19,19,0,1,2
"27328","bd00812f47d85bd00b4c55f6ba74c4f4",81,59,32,17.71875,37,44,2,1
"27329","bd0086608e6d8aeb528b97cf101c0223",42,42,0,42,42,0,1,2
"27330","bd0173418892a818eb66a0a63d5c1378",18,18,0,18,18,0,1,2
"27331","bd048a17f41d75d94358e8a9a9763076",7,5,34,1.44117647058824,7,0,2,1
"27332","bd04ec3b51a10f4cd360f494670293d6",115,94,82,9.81707317073171,115,0,3,3
"27333","bd0553987d30ea9c15cbf0b178fb8128",118,90,59,14,67,51,3,3
"27334","bd0858e02bacf8715db8dc0eaaa742e1",11,11,0,11,11,0,1,2
"27335","bd09029234d5649a39b127949e70a5dd",66,49,66,7,54,12,2,1
"27336","bd0957255c584f36f1127e548ddb4483",102,56,62,11.5161290322581,102,0,2,3
"27337","bd0f913bcb50a1dbcf794ec8642ab235",216,111,43,35.1627906976744,216,0,3,3
"27338","bd10c22a5b30930c0e2c83888230d6f9",4,4,0,4,4,0,1,2
"27339","bd1126618e8ef52b01cce2d33df3388b",105,54,81,9.07407407407407,105,0,2,3
"27340","bd14c490ae5e3f6c4250b3853295fac2",20,20,0,20,20,0,1,2
"27341","bd16830a878718767b9884ba505af24b",125,93,61,14.344262295082,125,0,3,3
"27342","bd16835eac6690200d8389144313481b",66,52,22,21,66,0,2,1
"27343","bd16cd97dcb267cfe1ba4eef4c8f7f53",36,31,22,11.4545454545455,36,0,2,1
"27344","bd16f0a893eaddf29b3a919c83b56421",15,12,4,26.25,3,12,1,2
"27345","bd1b09bcd5f47979c12348e82a17dc63",18,18,0,18,18,0,1,2
"27346","bd1b70aca10b57c7936623952c799195",125,75,86,10.1744186046512,125,0,3,3
"27347","bd20ee902f8029effcec209cf687155b",75,59,64,8.203125,38,37,2,1
"27348","bd223915f9864b6a52fc30bac66af158",191,119,81,16.5061728395062,191,0,3,3
"27349","bd22f737c406cff7c55085c9b9407982",32,32,0,32,32,0,1,2
"27350","bd23bccb63cb4b4e949174da646656c1",26,26,0,26,26,0,1,2
"27351","bd24cb55024b3f014596b16232a37c65",151,125,83,12.7349397590361,151,0,3,3
"27352","bd2bebbb68cd54580fd7faedaf1b0185",46,38,36,8.94444444444444,46,0,2,1
"27353","bd2f9faaf6435bc906d949db9f236621",216,139,82,18.4390243902439,165,51,3,3
"27354","bd331071c0d95ffa4d0f36678582827c",23,23,0,23,0,23,1,2
"27355","bd331e950158d90bbb7750cf0ba62282",17,17,0,17,17,0,1,2
"27356","bd33ea44962c70456b235ef2823c2367",1,1,0,1,1,0,1,2
"27357","bd3459b176ca2e4ce6aaa5cab0451938",22,22,0,22,22,0,1,2
"27358","bd3469cebb5dc1227671d2fb092246bb",92,57,46,14,59,33,2,3
"27359","bd3499ab81957cf5f1fc2a4f9e316dd8",161,81,86,13.1046511627907,122,39,3,3
"27360","bd372397e8e1fcdde99c7e64512b175a",108,71,25,30.24,108,0,3,3
"27361","bd3d2bd78a82d746328008a1ff4e9632",109,64,64,11.921875,109,0,3,3
"27362","bd3f3b646972ab5e73144638ae53a6d0",74,58,79,6.55696202531646,74,0,2,3
"27363","bd3fac1de7de41b26908e24f5c41d6df",69,51,66,7.31818181818182,53,16,2,1
"27364","bd483a80463db124483716dde3524761",146,103,83,12.3132530120482,146,0,3,3
"27365","bd48eb3f8385906e4e7c1cc2f3e60c97",75,54,21,25,75,0,1,2
"27366","bd4a13ed04d21148e348e6ac5777f3a2",139,88,42,23.1666666666667,139,0,3,3
"27367","bd4a25f52aa1cd091d44e0b17560a4d4",127,102,20,44.45,127,0,3,3
"27368","bd4d2c83fb6c5ca318b54f648f8e3cae",15,15,0,15,15,0,1,2
"27369","bd4d7e1c95f33341aed30a12637adeb4",187,141,54,24.2407407407407,187,0,3,3
"27370","bd4e9e7469d08f3273fd9acb698a0936",125,66,55,15.9090909090909,125,0,3,3
"27371","bd4ebb0ba7b26c90c5379c2328f65dd5",52,52,0,52,52,0,1,2
"27372","bd4f33f753ced90486de11cee27ffd1f",17,17,0,17,17,0,1,2
"27373","bd50ee2c0e76850d08e40b4a7405f70a",30,30,0,30,30,0,1,2
"27374","bd5177c659c90897575200abf2c19b22",15,15,0,15,15,0,1,2
"27375","bd521daaec4f52ff4e11a3ab2603aca8",40,40,0,40,40,0,1,2
"27376","bd5239d64513e861e2be068c6134f3ea",77,43,48,11.2291666666667,56,21,2,1
"27377","bd52e1ecd171eb3b0cea1018b39f2825",21,21,0,21,0,21,1,2
"27378","bd5612d1a178539f970a5850110d9bf4",126,92,74,11.9189189189189,126,0,3,3
"27379","bd56cce34d13bb0424b12d25ab09030e",102,80,51,14,102,0,3,3
"27380","bd56faaadd4663c31cfe18314f668a80",7,4,36,1.36111111111111,7,0,2,1
"27381","bd570c03860946999118a18e7a733196",37,37,0,37,37,0,1,2
"27382","bd57de839f220658f53deaa2d2923105",177,99,76,16.3026315789474,177,0,3,3
"27383","bd59cf52563f6c479772f4a7e7e0f81d",19,19,0,19,19,0,1,2
"27384","bd5c0c2cf83212431af572608a8ee2ad",101,52,79,8.94936708860759,51,50,2,3
"27385","bd5c88156898709329b3958f849e3be6",32,32,0,32,32,0,1,2
"27386","bd5d2f29abc99db7f4a8d1ffa4a85159",80,49,69,8.11594202898551,79,1,2,3
"27387","bd630f0e4a2d34ef7c062991b0280d77",29,29,0,29,29,0,1,2
"27388","bd6360da119f3b823c65647043865304",17,12,35,3.4,17,0,2,1
"27389","bd6a0c44f4b5d31099718d1d6679f8ac",40,31,14,20,0,40,1,1
"27390","bd6a7e504d7b836955e2243af1f21ae3",86,65,65,9.26153846153846,86,0,2,3
"27391","bd6b9b455183630fa7fbaab547444bd7",61,42,77,5.54545454545455,61,0,2,1
"27392","bd70638cf235c8499a66909469f65618",118,87,70,11.8,118,0,3,3
"27393","bd70c8a1eb2586bd5729f09f6edcb9a7",73,25,72,7.09722222222222,73,0,2,1
"27394","bd736516d1c5c3cbf9cd74775c5cf1bc",38,38,0,38,38,0,1,2
"27395","bd74ec408d4e04da1301b68560edf4ef",176,113,58,21.2413793103448,148,28,3,3
"27396","bd75552b228c76527178295f1551847a",13,13,0,13,13,0,1,2
"27397","bd77c6e9763d52db0c9e79e1b4004678",16,16,0,16,16,0,1,2
"27398","bd77f383c6e87eb07f152073ef7587b4",59,39,62,6.66129032258065,59,0,2,1
"27399","bd799145aa6d2303b4ba7a7a85bf884c",11,11,0,11,11,0,1,2
"27400","bd79afd0b751896d1ea8e7204b2dd106",160,96,61,18.3606557377049,160,0,3,3
"27401","bd7e9cda169ecb7c04a6873a9c1a8ca4",36,36,0,36,36,0,1,2
"27402","bd8012d778a2f6722d54fd1a429faad9",35,34,20,12.25,35,0,1,1
"27403","bd81d987c92e44b41f6c33927dcb3b62",18,18,0,18,18,0,1,2
"27404","bd82880dedda4009b4932a8c4e108a1c",101,65,77,9.18181818181818,62,39,2,3
"27405","bd830a9ff4ad6dfe91e203b0415417f3",80,68,23,24.3478260869565,80,0,2,2
"27406","bd887be79b49b006b85963b8371cc94e",43,43,0,43,43,0,1,2
"27407","bd888a0447a96740773efc892a4632b0",27,27,0,27,27,0,1,2
"27408","bd88b64b0547f30013709f36c41a3fc6",24,24,0,24,24,0,1,2
"27409","bd8a3d32200b46a12870cebe0c88cd4d",83,68,40,14.525,83,0,2,3
"27410","bd8bbd758673a347cc6e8823cb64872e",126,72,59,14.9491525423729,101,25,3,1
"27411","bd90dd3e84ea6b741ae8650dea3e4cea",84,41,58,10.1379310344828,84,0,2,3
"27412","bd9156dc3956b3d14622ce0e6a0f40d4",117,97,57,14.3684210526316,117,0,3,3
"27413","bd92b22cb36d39f2983b64dd40c4c424",88,74,32,19.25,64,24,2,1
"27414","bd94dd4ace36b923b9cda1b3459b2157",121,93,82,10.3292682926829,82,39,3,3
"27415","bd968ce9328fb2d5499df65c5b03b047",15,15,0,15,15,0,1,2
"27416","bd9723327bf61fa6c9e1d9a83064d0ee",104,55,50,14.56,104,0,2,3
"27417","bd9a8241d13665b46a826e1297d6be6a",32,32,0,32,32,0,1,2
"27418","bd9a971ac990a4d145b9bc2067325ef9",43,43,0,43,43,0,1,2
"27419","bd9bf66d1154e204f727b7874d4f7b39",12,6,59,1.42372881355932,12,0,2,1
"27420","bda07bdedf16dae59b28034104ded824",34,28,22,10.8181818181818,34,0,2,1
"27421","bda31005362312f885bde6d6551dfc34",11,11,0,11,11,0,1,2
"27422","bda3851e49db8ee5d2314f4a425f872d",103,78,59,12.2203389830508,103,0,3,3
"27423","bda5cc5cb961b0ecfe97b9dfa035d8be",30,30,0,30,30,0,1,2
"27424","bda89ecfee94fd9fa64f50eee138a055",18,18,0,18,18,0,1,2
"27425","bda9774a52f517c49c3e2bdb72f30aeb",118,71,86,9.6046511627907,118,0,3,3
"27426","bdaa2d2716d19002fcdfe480740da803",93,71,39,16.6923076923077,51,42,2,3
"27427","bdabf4d7d69889a620514831086a6c6e",34,34,0,34,34,0,1,2
"27428","bdac597aab0e968effc72240b4baa73f",79,59,73,7.57534246575342,26,53,2,3
"27429","bdadc9cdd591ed355656cfb131037147",14,14,0,14,14,0,1,2
"27430","bdaf730d5de903a988eb2920d3db1856",68,58,20,23.8,68,0,1,1
"27431","bdb0071e2c45ee1948935f14558a7d34",99,65,62,11.1774193548387,99,0,2,3
"27432","bdb0569596961163cebae4a9e6a43cf7",93,69,49,13.2857142857143,93,0,2,3
"27433","bdb243c1c8d553ef152ffaf8c7ecceb5",40,37,63,4.44444444444444,0,40,2,1
"27434","bdb552cf6facf9ba9bd778ba77610601",56,51,27,14.5185185185185,56,0,2,1
"27435","bdb93918a66fdf8a08cfe5009f7114ad",21,21,0,21,21,0,1,2
"27436","bdbb0f402ea7661c3aaf2ed4f8ea9d95",67,53,14,33.5,67,0,1,2
"27437","bdbbbee0a7af938d8c4ba978b00d98dd",85,62,27,22.037037037037,85,0,2,3
"27438","bdc402043af6cf99079a536335a7bff1",106,71,63,11.7777777777778,106,0,3,3
"27439","bdc4766703df395f6caaa7adfc393ce4",46,34,16,20.125,46,0,1,1
"27440","bdc47a3212a1a3ba50f6f7c5a1f756b0",13,13,0,13,13,0,1,2
"27441","bdc873afa181f014b53b56ee255a15e5",20,20,0,20,20,0,1,2
"27442","bdc8e6fe3a1b1a0ca80ee72e7f2e8412",47,47,0,47,47,0,1,2
"27443","bdc9444f309c03851aa3963d4bbeaa47",13,13,0,13,13,0,1,2
"27444","bdcac29230b863c2a562db668b3cd7be",86,73,70,8.6,86,0,2,3
"27445","bdcb97c547197b259d79ccb2c87831ae",75,43,29,18.1034482758621,25,50,2,1
"27446","bdd077623a81d2e25078aa7ed9b2acf5",29,29,0,29,29,0,1,2
"27447","bdd1c8eef73e640f278a46e60c497897",10,10,0,10,10,0,1,2
"27448","bdd3028a1f0ed4da8957ab1adb6d71e9",116,44,70,11.6,116,0,2,3
"27449","bdd308fdc6e8fccfc77ecdb99107b6e2",74,59,38,13.6315789473684,74,0,2,3
"27450","bdd4d0479db36f1616a526b19aea4c5e",144,122,39,25.8461538461538,144,0,3,3
"27451","bdd7b4f7b76e7d9436d32226eea436cc",39,39,0,39,39,0,1,2
"27452","bdd7def31a936eacb23606ae4bd8e80e",13,11,16,5.6875,13,0,1,1
"27453","bdd9b960e894de75c4b1752257e08e39",158,94,61,18.1311475409836,126,32,3,3
"27454","bddad8eeb2de27efa163666b3c318aa8",22,22,0,22,22,0,1,2
"27455","bddbdabaed98226037217bfbce69daeb",144,84,77,13.0909090909091,144,0,3,3
"27456","bddd63b1bfa1bc0ed610335180c79710",44,44,0,44,44,0,1,2
"27457","bddef84699908f592b11e6d4969b09a4",27,27,0,27,27,0,1,2
"27458","bde081d2dbfee25882a3aba0718ad751",129,86,21,43,129,0,3,3
"27459","bde0a1a1d46d1bf31b071428a89e0638",21,21,0,21,21,0,1,2
"27460","bde233423d9e77f7108003cd3cd56b1d",104,54,70,10.4,104,0,2,3
"27461","bde2a384dff61544bb09d8b467991975",85,66,82,7.25609756097561,59,26,2,1
"27462","bde36e0ca0b3b241891288479c5e0ce2",128,81,68,13.1764705882353,89,39,3,3
"27463","bde447fd576790604faf72adf81afed2",6,6,0,6,6,0,1,2
"27464","bde61efa5932eb81336c3192c8d0d13b",53,53,0,53,53,0,1,2
"27465","bde678b12f132cbb3f0bc77487e9d1c4",103,79,37,19.4864864864865,103,0,3,3
"27466","bde86cd6bcaccbfc3ad65b70e924a63a",89,72,41,15.1951219512195,49,40,2,3
"27467","bdeedeabc06b755e3f24c577a4b984bb",23,23,0,23,23,0,1,2
"27468","bdf2b62a5464724391b0445c0c83b63a",29,29,0,29,29,0,1,2
"27469","bdf344d24a0cfd190288052ee819153e",84,63,77,7.63636363636364,84,0,2,3
"27470","bdf4df4c1b5ec82803244c7075405738",1,1,0,1,1,0,1,2
"27471","bdf5c9c846f83406781b340c57ac236a",136,98,69,13.7971014492754,136,0,3,3
"27472","bdf754ccb2fb2bf25f86066411f800e5",13,13,0,13,13,0,1,2
"27473","bdf8116bd9dbfd7fa9568f446e5b07be",28,28,0,28,28,0,1,2
"27474","bdf872fa181d5f67b130f40d9f3b48d4",24,24,0,24,24,0,1,2
"27475","bdf9c7488dc7d455f10d34a2b63e3883",107,78,37,20.2432432432432,107,0,3,3
"27476","bdfaba633194183ba7522179480f0d8a",16,11,32,3.5,16,0,2,1
"27477","bdfac9944a6d64cb02c6678315f7d037",34,34,0,34,0,34,1,2
"27478","bdfddc677b8d24bb1ba42013f530852e",47,39,14,23.5,47,0,1,1
"27479","bdff39e6eba8407f2694628fddc72d8b",34,34,0,34,34,0,1,2
"27480","be027796f6f1cb4d8f665485c674ee81",83,50,58,10.0172413793103,61,22,2,1
"27481","be04a8f42f534880f685bf455efe25d7",37,37,0,37,37,0,1,2
"27482","be05466b05b8664da7fd7d93781494ed",63,48,46,9.58695652173913,30,33,2,1
"27483","be059e5b4f432e59350ad4242b48beb6",72,57,21,24,72,0,1,2
"27484","be05f4d64d5ef982b2b6947809489ef4",31,31,0,31,31,0,1,2
"27485","be070a8623328614dfc608d91a46cb6d",199,116,51,27.3137254901961,199,0,3,3
"27486","be08b9fc11eca20e14172dd8b99c2b32",30,30,0,30,30,0,1,2
"27487","be092aded7ff7a5d89317f20c2accb9d",128,80,63,14.2222222222222,128,0,3,3
"27488","be09d7ee4a33f1bc587e98e27a3a0f37",29,21,39,5.20512820512821,29,0,2,1
"27489","be0a11ee5a40529345006e8d1d16ec53",55,32,49,7.85714285714286,25,30,2,1
"27490","be0b5324a22905259801a986242fc9f1",30,28,8,26.25,15,15,1,2
"27491","be0c45689b452b75015d919dfa229ef1",45,41,35,9,45,0,2,1
"27492","be0ec61982ebf78c516f07117d287dd1",26,25,5,36.4,1,25,1,2
"27493","be0f9446dd2eeb0d9e5c6f5e2c98342c",175,116,70,17.5,175,0,3,3
"27494","be13f220de641a20c13bdf66fa0f58aa",39,39,0,39,39,0,1,2
"27495","be18262acdb129f3a7e952416251f402",28,24,21,9.33333333333333,0,28,2,1
"27496","be1990f1bf6cb88d08ad612cbd144202",18,13,63,2,0,18,2,1
"27497","be1b722fbc54e747ea37cc53a47e3773",142,82,55,18.0727272727273,142,0,3,3
"27498","be1ca2c84c86ac73956231dd3b2d8fb6",50,47,8,43.75,31,19,1,2
"27499","be1e3336a6118477470463e75671045d",22,22,0,22,22,0,1,2
"27500","be246c1088515145d9282db31807fc42",25,25,0,25,0,25,1,2
"27501","be25be7978aba433a5e07ee18d1aca49",48,48,0,48,48,0,1,2
"27502","be285bfb4f7f56bb8e975e42be747290",115,81,64,12.578125,115,0,3,3
"27503","be290d825281b1d603fbc151c71cd69d",44,44,39,7.8974358974359,44,0,2,1
"27504","be298dcb3ee2ce77915b1f2e8eec2e63",240,93,71,23.6619718309859,210,30,3,3
"27505","be2b56a62ff261136087c2312366a79a",48,35,68,4.94117647058824,48,0,2,1
"27506","be2ee30aed33ab9957d301c7d7d2050d",99,85,50,13.86,73,26,3,1
"27507","be3221621998a35ca23e36d43ed69d23",18,18,0,18,18,0,1,2
"27508","be33822c6a6dee5a494e519efc6ec938",29,24,51,3.98039215686275,29,0,2,1
"27509","be370453b737d017e6194888d1922cbe",132,100,44,21,132,0,3,3
"27510","be37f812b11a98c9336a257ee6b60e01",178,62,63,19.7777777777778,178,0,3,3
"27511","be3a2a7b4cdbd20185afed52eca27590",33,29,26,8.88461538461539,33,0,2,1
"27512","be3a59384c88b2e02d90ab23d1de76f2",11,11,0,11,11,0,1,2
"27513","be3d9d37ee50d47cf0df06e13dcd66e8",183,108,75,17.08,183,0,3,3
"27514","be3fec7d5bffa3ff8ae11bc339431ef5",26,26,0,26,26,0,1,2
"27515","be406a342dc699f314bfe05a3e5b4197",36,36,0,36,0,36,1,2
"27516","be41de6c99384976c505501cd7fc1522",55,38,46,8.3695652173913,42,13,2,1
"27517","be428fe52863aef5fc28e3deedb6c27f",27,27,0,27,27,0,1,2
"27518","be43aac47c274636e8c559082f0d5f55",7,7,0,7,0,7,1,2
"27519","be446e605417b0e9d1e3f08425d618ba",41,41,0,41,41,0,1,2
"27520","be4524547628697ed689ffd2bf7fc9a3",124,55,82,10.5853658536585,84,40,3,3
"27521","be46b36218fbb1ec954bdf44eefa8b2f",184,101,44,29.2727272727273,184,0,3,3
"27522","be46b4be9c5a07068e59b5893dc50b4d",130,48,70,13,130,0,3,3
"27523","be49a6c8fe3ffab9b399798c20bdea81",85,72,44,13.5227272727273,85,0,2,3
"27524","be4a3cdd6ab4e1131765b10c584e7489",145,77,75,13.5333333333333,129,16,3,3
"27525","be4b2c61d8f9655a42229f7db3e3e198",67,50,73,6.42465753424657,46,21,2,1
"27526","be4bab1a6b38b650035bf207a8576065",24,24,0,24,24,0,1,2
"27527","be4c796ced63d3d4191154c559912b11",122,79,72,11.8611111111111,122,0,3,3
"27528","be4d06a6c3fd8e8e75a4de6db49c943e",66,51,11,42,34,32,1,2
"27529","be4e2d6eb65e8dde03cc16500f59d7d3",16,16,0,16,16,0,1,2
"27530","be4ef2d8d57ae87f7741964e44fe61ae",27,27,0,27,27,0,1,2
"27531","be5085db0edb3c2f49f5ef7db8d189e3",30,30,0,30,0,30,1,2
"27532","be53401c1ead5843abc15e06536df939",32,32,0,32,0,32,1,2
"27533","be534dc58c8baf144c4645354f0c4adb",49,49,0,49,49,0,1,2
"27534","be54501c3656fe1111d61ddaa4cb6ba3",92,58,62,10.3870967741935,37,55,2,3
"27535","be5486e71f1e93c7bfe64248dc4988dd",92,61,82,7.85365853658537,80,12,2,1
"27536","be55a1f8c882d9702829f6dd328c47f4",95,84,61,10.9016393442623,70,25,3,1
"27537","be568e18cf1cdc54775f9731a9146da8",37,32,7,37,0,37,1,2
"27538","be5ca6c2f3e060406da3e89f8fec0369",10,10,0,10,10,0,1,2
"27539","be5dc3c38e9fa2ed83bc9469bd92e0e6",108,98,47,16.0851063829787,108,0,3,3
"27540","be60249730d5cc546237fa5819a17d24",56,49,36,10.8888888888889,56,0,2,1
"27541","be6b7d763eeddc75e96195abb928e432",75,30,21,25,75,0,1,2
"27542","be6dbd368fea942f0cfaf451f3f51226",105,80,68,10.8088235294118,74,31,3,1
"27543","be6f53a8991c5916f5b35e792496c2ba",23,19,58,2.77586206896552,23,0,2,1
"27544","be70135b269116d78337beada8372356",28,28,43,4.55813953488372,1,27,2,1
"27545","be728cc78f478bcb84933e71e5a76bdb",171,101,63,19,171,0,3,3
"27546","be745ebc98c3aa18b444d7f95473d624",47,47,0,47,47,0,1,2
"27547","be76dd565f2984b04f564dc2d6e3f26d",31,20,35,6.2,31,0,2,1
"27548","be78e8405c4b42e14f34bb87c3769e02",45,45,0,45,45,0,1,2
"27549","be79756fdb3a0b11ab02ecc2e331b68c",108,77,57,13.2631578947368,73,35,3,3
"27550","be7d923ef224ef3dd43b55cb08cea665",74,50,31,16.7096774193548,74,0,2,1
"27551","be813433df0c1a5303ccb6b5e0d21b11",52,52,0,52,52,0,1,2
"27552","be81eb94f4a9cdd2785fc1a6472aeee5",25,18,37,4.72972972972973,15,10,2,1
"27553","be871568347cfbd2aa0b9efe5c2e9a37",44,33,39,7.8974358974359,24,20,2,1
"27554","be889e10761989ccecaec96690911b35",38,38,0,38,38,0,1,2
"27555","be89426b146216ebd11502d6f8af19e8",25,25,0,25,25,0,1,2
"27556","be89dd412e5d963b135c2bb44037290c",29,29,0,29,0,29,1,2
"27557","be8ac80d46d0e0eac710d800574e6b40",39,36,7,39,39,0,1,2
"27558","be936f5d392ba14866ce5bbb5b426d85",65,53,53,8.58490566037736,65,0,2,1
"27559","be93dcdd911cdf1823300b03a8a80f50",36,36,0,36,36,0,1,2
"27560","be944d5ac03b738e392ffb59e8d1e0a7",105,61,65,11.3076923076923,69,36,2,1
"27561","be9620a02d6f7d91d584613530e2d1df",79,52,66,8.37878787878788,79,0,2,3
"27562","be97df446401b14e926b765deeff0cbd",2,1,12,1.16666666666667,2,0,1,1
"27563","be9b422ef29d0f821ed34507e3b7cafc",26,26,16,11.375,9,17,1,1
"27564","bea26dcced0f62a31220dec564bff095",21,21,0,21,0,21,1,2
"27565","bea3c76b232786649e6abb8b0219d688",70,58,66,7.42424242424242,70,0,2,3
"27566","bea62202be377ed8fe371aee16c3ad01",22,22,0,22,22,0,1,2
"27567","bea77d12a6cf979aaba3f9180ce552c4",20,20,0,20,20,0,1,2
"27568","beabaf603d47935ec1ccd35b3ad26bb8",38,38,0,38,0,38,1,2
"27569","bead401a3943454ca15b027dcc6ac70b",24,24,0,24,24,0,1,2
"27570","bead4b30e809ba8846263df1f1b55e78",51,51,0,51,51,0,1,2
"27571","beae32966b423f856acbdb410e8b2d31",39,39,0,39,0,39,1,2
"27572","beae55f7b8e52873b6973fe4aaa005b6",41,39,8,35.875,41,0,1,2
"27573","beb2e6ae7c4bdaae90bee78e67072d00",35,31,63,3.88888888888889,35,0,2,1
"27574","beb6d1b9f4eb5acd8999a350ff91752f",78,66,28,19.5,78,0,2,1
"27575","beb7b117759f8ff5ed71b56595bdcfe5",16,16,0,16,16,0,1,2
"27576","bebaf05d4523c16635fb2b5f9a4f45b4",29,29,0,29,29,0,1,2
"27577","bebde14f4fdb17f8f2fc22b0fa1d963a",39,39,0,39,0,39,1,2
"27578","bebe81a42c20cc92c96977cee8a39e68",20,16,19,7.36842105263158,12,8,1,1
"27579","bec0b7628359e6f1efbd9b067a9ec98b",17,17,0,17,0,17,1,2
"27580","bec13abc45dbbdbe4b8dbe0e7ec46a3d",22,22,0,22,22,0,1,2
"27581","bec1aaf70b57610a8402df11aff943b9",160,84,83,13.4939759036145,160,0,3,3
"27582","bec54c87165df0bc867a9303c119c99b",18,18,0,18,18,0,1,2
"27583","bec63a4de8d80759d42bd5961614ef6d",23,23,0,23,23,0,1,2
"27584","bec68447a02aa6ba6a710be1d8266585",34,34,0,34,34,0,1,2
"27585","bec7e6cde26bd08bd74d13f65eae031e",141,76,59,16.728813559322,141,0,3,3
"27586","bec8c63a1d34b812269899ea0f9aece6",29,29,0,29,0,29,1,2
"27587","beca1945132c8dbe4c9cfea7ed821531",41,36,53,5.41509433962264,41,0,2,1
"27588","becf2dd133af3d98c6a639865c9542b8",205,118,77,18.6363636363636,165,40,3,3
"27589","becf514d25f78f19309c1820b4e585a4",126,73,82,10.7560975609756,126,0,3,3
"27590","bed25bc07961cda70e9e40ec794a3758",44,40,42,7.33333333333333,0,44,2,1
"27591","bed514eec534a5ce502a25e75c5137e5",34,29,34,7,34,0,2,1
"27592","bed7762b129c1ba11db4fc9a343fc24e",88,63,56,11,88,0,2,3
"27593","bedaef406908e45d9a8d9ac76fd42346",54,44,45,8.4,29,25,2,1
"27594","bedbb9dabceaf548958431d05a4e2559",71,56,49,10.1428571428571,71,0,2,3
"27595","bedf5c640dae2c3423e6978367195a9f",107,57,67,11.1791044776119,107,0,2,3
"27596","bee3b185e68102c6586021947a8e59ee",27,27,0,27,27,0,1,2
"27597","bee66d809af701ba512322a6e813684f",104,74,42,17.3333333333333,104,0,3,3
"27598","bee744ced244adfeddeef9a9d8814c56",151,101,57,18.5438596491228,151,0,3,3
"27599","bee7b6769c1d83de6f2720f60384fffc",159,95,86,12.9418604651163,159,0,3,3
"27600","beeaccdfee9e38b739347773713b777b",53,37,33,11.2424242424242,22,31,2,1
"27601","beec8eb57905749a424aa420c61fb16d",65,45,27,16.8518518518519,65,0,2,1
"27602","beeed1f0289f163ba140429541b4ba23",57,42,39,10.2307692307692,38,19,2,1
"27603","beeffb4785b97f88f5bc5f921fde2e14",143,98,56,17.875,143,0,3,3
"27604","bef1da30fe39b555dc81cf043bebb732",210,125,70,21,210,0,3,3
"27605","bef49990e406c0a25a5071118488c244",155,84,63,17.2222222222222,155,0,3,3
"27606","bef87e7c0623b114d3e01838a99734b7",127,77,28,31.75,127,0,3,3
"27607","befb07efd9f0d6311a7d0f45cebd984a",43,43,0,43,43,0,1,2
"27608","befb26f97d19b77a50038690c21dad1f",128,95,58,15.448275862069,128,0,3,3
"27609","befe208fa439f4641d129ce97c80974a",23,23,0,23,23,0,1,2
"27610","befe78cd1cec350c298bd15ff7894b0d",25,20,51,3.43137254901961,25,0,2,1
"27611","beff0dc5ca8e89ec603ea73bb91d64a6",242,118,66,25.6666666666667,209,33,3,3
"27612","bf0014c2a1d061c32de55cb19830cc33",148,87,51,20.3137254901961,148,0,3,3
"27613","bf0243cd1d605c8c94471110f4bc780d",11,11,0,11,11,0,1,2
"27614","bf02c6c8ff56d63ae4c5982d17801e07",14,14,0,14,14,0,1,2
"27615","bf03b5cfb73543d0f05d2a6ca66d639e",85,69,44,13.5227272727273,42,43,2,1
"27616","bf0a2d4683b84525dfb2dcb49f56d31a",19,19,0,19,19,0,1,2
"27617","bf116e0a1468e0345493cb2d0b5a50bb",184,87,84,15.3333333333333,184,0,3,3
"27618","bf132944d1d59014d89078c235bb9171",94,71,75,8.77333333333333,84,10,2,1
"27619","bf1329542e350fcc59ee2f4ba272683c",94,54,52,12.6538461538462,94,0,2,3
"27620","bf1349ce049918103052780d1cbf833e",24,21,82,2.04878048780488,14,10,2,1
"27621","bf153e5612925836b4fb134fed18de5f",40,40,0,40,40,0,1,2
"27622","bf1a781ae5342755a6bba52a4d3bb22b",94,71,64,10.28125,94,0,2,3
"27623","bf1cf6521b0d68537d5a514cd3f394c5",24,24,0,24,24,0,1,2
"27624","bf1da8c516327d44b87ea91c7a2afb27",6,6,0,6,6,0,1,2
"27625","bf20e853bd481c41b3804f8f1942a437",56,44,56,7,56,0,2,1
"27626","bf2211a680a9c2cd5709d37bef8e8b8e",158,84,57,19.4035087719298,158,0,3,3
"27627","bf2281a3fdfae87382bb94440f28c042",71,60,74,6.71621621621622,71,0,2,3
"27628","bf25b7344baa04a50fe7d67b338099c5",239,108,70,23.9,189,50,3,3
"27629","bf25ef9eebf4bdde56d6e9f222496f02",24,24,0,24,24,0,1,2
"27630","bf273cb5168bdc6787371663263f4a91",107,57,59,12.6949152542373,107,0,2,3
"27631","bf29cab0313f333290a7fa4c33b3c35a",115,75,28,28.75,115,0,3,3
"27632","bf3128040d5d156805b7e2f4af4970ae",66,46,36,12.8333333333333,36,30,2,1
"27633","bf3132ecad2f04a33ffcde737b540201",14,14,0,14,14,0,1,2
"27634","bf32706f5ead1565cd3affa62d99e9f0",20,20,0,20,20,0,1,2
"27635","bf32f78d7d09ae5d13fedeec9e10e6eb",90,74,49,12.8571428571429,90,0,2,3
"27636","bf32fdbf0556b8c40e9fbf2aedefd281",78,64,34,16.0588235294118,78,0,2,3
"27637","bf337a8bb45cacdb4ca839d13eefd995",190,89,77,17.2727272727273,158,32,3,3
"27638","bf34d2e6409fb4604caf76ae859d1f3f",12,12,0,12,12,0,1,2
"27639","bf3862c31721cf7b0a21171f89fd11dc",13,13,0,13,13,0,1,2
"27640","bf394e8e63a5158655ea770dcf0ab19d",60,36,46,9.1304347826087,60,0,2,1
"27641","bf39f8629c2eb6e689190e29a2a2f5b6",179,114,61,20.5409836065574,179,0,3,3
"27642","bf3a745388a2a3d5f1aeb10843cf3aac",103,63,84,8.58333333333333,103,0,2,3
"27643","bf4105909e0b8733bdbd1f01b292fced",180,103,56,22.5,180,0,3,3
"27644","bf4418798508c95adb58124b738dce72",121,57,63,13.4444444444444,100,21,3,1
"27645","bf46435dc48de2bac2f10aaf2775a415",17,17,0,17,17,0,1,2
"27646","bf46ed17bd7054baf349d4f56afc3f7a",21,21,0,21,21,0,1,2
"27647","bf498bd2a8bfbb5458da5b0e47d293d7",49,43,58,5.91379310344827,49,0,2,1
"27648","bf49b4b0feea5063ec5933483eeeab6c",58,46,34,11.9411764705882,45,13,2,1
"27649","bf4b285e0ca56e73a703d6f40cdc6d45",15,15,0,15,15,0,1,2
"27650","bf4b3d9058ed09de55695e39e18cf5e6",15,15,0,15,15,0,1,2
"27651","bf4d6fc0c13ce6e1996f57463dfcc75c",60,53,68,6.17647058823529,36,24,2,1
"27652","bf50fd0ec7858d6988d510773421d6aa",234,134,80,20.475,208,26,3,3
"27653","bf5354ef6d959d0ba903f2e2e30d6ed8",38,38,0,38,38,0,1,2
"27654","bf54984c1d46b3396be1047569a59093",43,23,25,12.04,23,20,2,1
"27655","bf5569cdccff943a5c2ca185ed8dcf78",52,43,9,40.4444444444444,52,0,1,2
"27656","bf5658ae5f9be5c957f5118c0500358d",138,76,63,15.3333333333333,93,45,3,3
"27657","bf5676b5a21dc7961f1372ccefb706e6",181,125,83,15.2650602409639,136,45,3,3
"27658","bf575038b5381d114358007dba0743f4",120,97,67,12.5373134328358,120,0,3,3
"27659","bf576abdb252b610ced296ebf1ca5e70",62,42,65,6.67692307692308,48,14,2,1
"27660","bf5847f4085c0e187d3a47d9c808c328",51,51,0,51,51,0,1,2
"27661","bf5878dbff0d2ea58dde9c6c86da4f49",94,37,77,8.54545454545454,89,5,2,1
"27662","bf59b307c9d7a969f923f155f0b4e695",63,56,78,5.65384615384615,30,33,2,1
"27663","bf5fd7ba6eb26d0005577da16eab2dd7",72,64,67,7.52238805970149,72,0,2,3
"27664","bf61dcdba6b97f8cfa551d56dd50e044",32,32,0,32,32,0,1,2
"27665","bf622ad06c7aab6a60e4e15212055c0d",14,14,0,14,14,0,1,2
"27666","bf622be7858a535a17b17cb309af73f0",20,19,11,12.7272727272727,20,0,1,1
"27667","bf62e6efa7be07fe16da409b0727f61e",75,45,61,8.60655737704918,51,24,2,1
"27668","bf645cf35b84d014f96c3aa5e3b20386",29,29,0,29,29,0,1,2
"27669","bf657cc7bda43b00744a9cdb86054379",31,31,0,31,31,0,1,2
"27670","bf65a5d244ac0637ac6d4ea8b8b03a82",111,56,56,13.875,81,30,2,1
"27671","bf678dbdc9f6a79c8df7d396d361595d",134,38,77,12.1818181818182,134,0,3,3
"27672","bf683395544349a725b4fb1a88907aba",82,57,59,9.72881355932203,59,23,2,1
"27673","bf68a058baa2fb342d1c262fc3bcf03f",50,48,7,50,0,50,1,2
"27674","bf691bbe7afcd370458c8b29b6786885",44,34,33,9.33333333333333,44,0,2,1
"27675","bf69ebf96cbe43034d4a6300c2d5f1d1",26,26,0,26,26,0,1,2
"27676","bf6d9a10be39cc26b832584a053e7e29",20,19,9,15.5555555555556,20,0,1,1
"27677","bf6e51e309a7965768402d84b49dbaf9",2,2,0,2,2,0,1,2
"27678","bf6fbef0724e09256b0ceedfaaaba528",139,99,62,15.6935483870968,139,0,3,3
"27679","bf714f3f4f83bea8fe51fc6812d4c975",33,33,0,33,33,0,1,2
"27680","bf72acdb75a675c4477e2f7bd55891d7",63,56,36,12.25,35,28,2,1
"27681","bf743be7196fc7bccb7dd3fc9e0c1ad4",40,40,0,40,40,0,1,2
"27682","bf744993a429771cc5454e26f64d235d",12,12,0,12,12,0,1,2
"27683","bf78b8dbcaa4e8558c77339654805587",107,71,56,13.375,107,0,3,3
"27684","bf7a50906e284507c1e2e8654b462c77",11,11,0,11,11,0,1,2
"27685","bf7b8ac37beea41239ebde480d15ad97",32,25,32,7,32,0,2,1
"27686","bf814a0bc695390e7785316fe467d03a",94,56,54,12.1851851851852,94,0,2,3
"27687","bf81da02d2e04a318e1d7c771306c11b",83,63,35,16.6,83,0,2,3
"27688","bf851828688efb14b219a09fdbf2e036",4,4,0,4,4,0,1,2
"27689","bf86ab910017b8e0f28c744003ead2c8",83,49,43,13.5116279069767,83,0,2,3
"27690","bf871f036c6ab733b5b52167e8e8a6b6",159,117,70,15.9,139,20,3,3
"27691","bf8784b33da839247c4a810cce623a35",11,11,0,11,0,11,1,2
"27692","bf8889c61cbd1aff81604a57e822ac07",147,108,56,18.375,147,0,3,3
"27693","bf893cb7d64cff78376f66928cac98fc",21,19,23,6.39130434782609,7,14,2,1
"27694","bf8982095a4e0228f39f063e34c77b4f",91,57,48,13.2708333333333,91,0,2,3
"27695","bf89dd9709faeb38c4d54b81ee264fb9",193,67,71,19.0281690140845,163,30,3,3
"27696","bf8e6c6238dbe4854d40145bdc9b1729",47,39,11,29.9090909090909,29,18,1,2
"27697","bf8ead543ad71fc7967c29206bb8657c",45,45,0,45,45,0,1,2
"27698","bf92a517eb14bd0d53c630a4aa0f6403",92,73,20,32.2,92,0,3,3
"27699","bf9463d8d899dd67673b2fc49f54ad18",63,44,10,44.1,63,0,1,2
"27700","bf974d97d8d79f14be82edceb656fa26",52,35,68,5.35294117647059,52,0,2,1
"27701","bf9756f2fcdee86d1648a67149767a30",19,19,0,19,19,0,1,2
"27702","bf984e3b3b299c0237211bd3825af92d",202,84,77,18.3636363636364,202,0,3,3
"27703","bf98ad123cb4b86382069602c9abf1b8",4,4,0,4,4,0,1,2
"27704","bf9c7383ff6520b19552460a0c3edee4",15,15,0,15,15,0,1,2
"27705","bfa39bd9008d1898ac7d24abcc94598a",178,81,77,16.1818181818182,178,0,3,3
"27706","bfa4103ced28fe4e3ae9db5342403ad6",42,31,31,9.48387096774193,31,11,2,1
"27707","bfa60a723840cf25d19912700b5f1980",99,75,27,25.6666666666667,99,0,3,3
"27708","bfab443f3a6c3478c216a775d9c3b44a",53,53,0,53,0,53,1,2
"27709","bfb027b6dfe82012d57e84c9ddd5d430",177,94,75,16.52,153,24,3,3
"27710","bfb4f0c2b48fe7e00d76d08618a33e20",103,68,69,10.4492753623188,103,0,3,3
"27711","bfb6e7d7526ab0a139a242da681156da",28,28,0,28,28,0,1,2
"27712","bfb79ffc553f4fa0f6e6eccae4095f73",77,66,18,29.9444444444444,36,41,1,1
"27713","bfbce277af6a11dc5f0871d40964b5db",11,11,0,11,11,0,1,2
"27714","bfbd55aefc7c9fe9bb8dbbcd5373ae04",15,15,0,15,15,0,1,2
"27715","bfbf54eeba5708f906d16d8b2ebdf963",52,52,0,52,52,0,1,2
"27716","bfbf856b8539fd393469a3eba8dd1e73",128,76,72,12.4444444444444,128,0,3,3
"27717","bfc11321c46bcbc2c01d88c1d62a007d",20,20,0,20,20,0,1,2
"27718","bfc1989050382def1c39c99f57edc31b",63,47,42,10.5,45,18,2,1
"27719","bfc20cdc7dea8637ded47ec801f106ec",43,31,33,9.12121212121212,22,21,2,1
"27720","bfc395e7c719361490529d90ab7e6705",65,31,82,5.54878048780488,57,8,2,1
"27721","bfc86c4112cd0bf154a8befa34d5a239",54,46,64,5.90625,54,0,2,1
"27722","bfcf505e68929aa8a2a3f7297e4f79fc",101,75,37,19.1081081081081,57,44,2,3
"27723","bfd32847d04ead9940c5e07f6708fa45",26,26,0,26,26,0,1,2
"27724","bfd5772f1d999f410acc5b6e3055147b",24,24,0,24,24,0,1,2
"27725","bfd7299381516b2fa14d18ea22d5657b",107,79,47,15.936170212766,107,0,3,3
"27726","bfdacbb360efdfca8c1c0901035c70e1",32,32,0,32,32,0,1,2
"27727","bfdb098e08466c67da000e1ecba5d48b",23,23,0,23,23,0,1,2
"27728","bfdca975dffa01611e8048b22a3b2b93",185,112,68,19.0441176470588,143,42,3,3
"27729","bfde67b579586922d2be22b195433b17",12,8,28,3,12,0,2,1
"27730","bfded533eb2e9c7807d44e0a9dfdf279",45,37,28,11.25,45,0,2,1
"27731","bfe0005f8f9068295e592db6ec4ceac0",107,72,46,16.2826086956522,107,0,3,3
"27732","bfe165bd63bbb80a900f7f47a5320d3c",6,4,57,0.736842105263158,6,0,2,1
"27733","bfe3680e8a18db2835b6436e99e2a3b4",215,69,77,19.5454545454545,184,31,3,3
"27734","bfe39b8719878ad1beccfbed9da8af7d",61,35,46,9.28260869565217,15,46,2,1
"27735","bfe4edebb6bf98ed143b0f659b9c81ee",133,103,74,12.5810810810811,104,29,3,3
"27736","bfe95742a7998653bfd1dc6b569a136e",50,44,32,10.9375,50,0,2,1
"27737","bfe96630bd586c2df4d183b6976bfa6b",191,85,69,19.3768115942029,191,0,3,3
"27738","bfed4ee0143e56321e75f6366d1b0810",15,15,0,15,15,0,1,2
"27739","bfee52d6d6c782f5891cb4e81eaa0eb7",17,17,0,17,17,0,1,2
"27740","bfee76f35b23c4d090d314b8f775eed1",52,52,0,52,52,0,1,2
"27741","bfef77f8aaa6dd6020cb82c553ef8306",64,56,70,6.4,64,0,2,3
"27742","bff2a17883bb14cf69dd081adee46f9d",19,19,0,19,19,0,1,2
"27743","bff750a0ea3e2885ab66264fe05f33e9",27,21,48,3.9375,27,0,2,1
"27744","bff77e720c264ae4cc721f13e2825919",21,21,0,21,21,0,1,2
"27745","bff9e744a247a4bd921a558424d3bfa2",14,14,0,14,14,0,1,2
"27746","bffb3176977d5e7319f714f67430ec23",121,80,49,17.2857142857143,121,0,3,3
"27747","bfffcd4dbe255e5772a9c029f104938d",23,20,32,5.03125,23,0,2,1
"27748","c001c9c612365bcc371525f667d336f9",14,14,0,14,14,0,1,2
"27749","c002880f7ea9ba2943fef6cc76980b7b",27,27,0,27,27,0,1,2
"27750","c0031ff7abca4fda9a402900ecb4feab",88,77,43,14.3255813953488,88,0,2,3
"27751","c004f8aa7c2cc1e55783985606704f4b",60,48,79,5.31645569620253,60,0,2,3
"27752","c0054e5d25476a1bf5ff11101cbcf161",180,121,71,17.7464788732394,180,0,3,3
"27753","c0079d2b03bfcf68d28d4e5259eaa352",168,123,62,18.9677419354839,168,0,3,3
"27754","c00bd414e7e45b44de19ec46b4cafa49",29,26,16,12.6875,25,4,1,1
"27755","c00bd892d8081503131eae1716eb2aaa",82,61,13,44.1538461538462,82,0,1,2
"27756","c00e2356198087c6ccc4d498ec57ee80",51,51,0,51,51,0,1,2
"27757","c00e4482d6331f01386e87d2674731f0",80,54,32,17.5,39,41,2,1
"27758","c01057b36221af495af71caca78010d0",24,24,0,24,24,0,1,2
"27759","c01124699470a7271c0468e1076f59f4",120,79,47,17.8723404255319,120,0,3,3
"27760","c01141b109e773e91bca2492d30c304d",210,93,64,22.96875,171,39,3,3
"27761","c014188e2cc0437543569188bbab863a",139,83,39,24.9487179487179,139,0,3,3
"27762","c01689d89de025b477ebd42b0a1470a4",34,34,0,34,34,0,1,2
"27763","c0174b7791198f956e80b2509e033b32",33,33,0,33,0,33,1,2
"27764","c01ab8b162c55f9a17cbd6d58c18f599",147,70,81,12.7037037037037,147,0,3,3
"27765","c01bc3778d0672c78c3abe53b50bda40",116,78,68,11.9411764705882,116,0,3,3
"27766","c01d3b8ad3dfdb725bf652c41ae3981f",86,67,60,10.0333333333333,52,34,2,1
"27767","c01e6c29c6d751654aaf67fbaedbfb76",81,59,38,14.9210526315789,81,0,2,1
"27768","c01e99386f64e441c92657f588915407",40,40,0,40,40,0,1,2
"27769","c01ebe25c1a1f33d78ba5b7f6d9534cc",62,45,69,6.28985507246377,62,0,2,1
"27770","c01fffb18d78076a85b716bac6d447bd",37,36,47,5.51063829787234,37,0,2,1
"27771","c020a02577bb9c874dccb822c6416e03",15,15,0,15,15,0,1,2
"27772","c025ef386c2ce85cdf7d7489dc0ab50c",96,58,40,16.8,47,49,2,1
"27773","c02b6786f6aeaaab0ea71973458530f1",140,69,65,15.0769230769231,105,35,3,3
"27774","c02c6f11479a6a3d6beeb4408815b7e9",222,102,84,18.5,195,27,3,3
"27775","c02d8a900d0cfce51b645e761de5066c",117,93,22,37.2272727272727,62,55,3,3
"27776","c02f664a1671deef2741963f27536641",147,107,80,12.8625,99,48,3,3
"27777","c02fd151ddc5807536ce306ac6a03c94",63,50,58,7.60344827586207,33,30,2,1
"27778","c0303ca7be4d09201e6f29ca5b11c33f",154,65,84,12.8333333333333,117,37,3,3
"27779","c0312cb3437a5764920a6435f9273921",43,37,33,9.12121212121212,13,30,2,1
"27780","c032339a76ec9291fccd9dd7136117a4",116,73,77,10.5454545454545,116,0,3,3
"27781","c0323f3241d64716b1fa90f64daacb41",125,76,79,11.0759493670886,103,22,3,3
"27782","c03300b4fe3be80cf9a0970d7b145a78",32,24,57,3.92982456140351,32,0,2,1
"27783","c03b62672fbcb28ee84da8a52149cc51",72,48,62,8.12903225806452,72,0,2,3
"27784","c03bdda6faf7a9a733b070bca46fa4bc",216,102,81,18.6666666666667,216,0,3,3
"27785","c03deed0f2a7e241f5a5113751efe923",17,17,0,17,17,0,1,2
"27786","c03e62c88a27738c778c71e6de687690",21,21,0,21,21,0,1,2
"27787","c041ee36b16b6a166e1984378ca9c7cc",24,24,0,24,24,0,1,2
"27788","c0444471f741ab40224d5f6381a319bd",153,121,66,16.2272727272727,131,22,3,3
"27789","c0449d204c338144cc51e2bf58583675",127,75,70,12.7,127,0,3,3
"27790","c048a22b40551a179bf01673ca2313ab",34,26,27,8.81481481481481,34,0,2,1
"27791","c04953e94a56cc03e121b304df06a8da",44,41,35,8.8,44,0,2,1
"27792","c0559d66f49dae921446e390b0b95389",59,40,22,18.7727272727273,59,0,1,1
"27793","c056cc24e74114685bcc29b2eccf72fd",36,32,71,3.54929577464789,36,0,2,1
"27794","c05ab06d972aea915778ceed26a5a5b1",54,54,0,54,54,0,1,2
"27795","c05ac9c36cd66d30d595dbd25fc72d6c",24,24,0,24,24,0,1,2
"27796","c05b3dbb24f06da39e34f5b1efbb60db",44,44,0,44,44,0,1,2
"27797","c05b6153fbe43666aaf57b58833998aa",122,79,56,15.25,122,0,3,3
"27798","c05f912d06a5ca5403dcc77babb67629",12,12,0,12,12,0,1,2
"27799","c06001e7c7a6628ad6204b160c871b2d",111,50,49,15.8571428571429,111,0,2,3
"27800","c0616d42fa9adad77019e4588936853c",28,28,0,28,28,0,1,2
"27801","c062a3b444e295b623f6fee8c3e56845",8,2,63,0.888888888888889,8,0,2,1
"27802","c06463030a5bb4fd270cfcedbd61dbac",44,44,0,44,44,0,1,2
"27803","c066a1dce2188e22d1dfeafaf4cafe98",151,91,57,18.5438596491228,120,31,3,3
"27804","c067780ec0f474780bb0e43c41a2fb30",25,25,0,25,25,0,1,2
"27805","c067910b16edc162a46f118e60de6346",57,33,73,5.46575342465753,40,17,2,1
"27806","c06a24bdd87c926be0507f6af101b2a8",115,53,65,12.3846153846154,115,0,3,3
"27807","c06c7158c3651f4fba3972e5907b6675",26,26,0,26,26,0,1,2
"27808","c06e8acef77ae71fa7d9f402354f5529",34,34,0,34,34,0,1,2
"27809","c06ffd99504fdd227885d3415119b716",28,25,33,5.93939393939394,13,15,2,1
"27810","c071c88584d43c54b3cc03f02b54eb5a",84,54,72,8.16666666666667,84,0,2,3
"27811","c072b3575b5c6cb3223cebe9b17eeea7",92,69,83,7.75903614457831,92,0,2,3
"27812","c0730f4fce61a4f4b43640efb7433a3f",58,43,74,5.48648648648649,33,25,2,1
"27813","c0736d963614195315e62635a2aa8ef1",32,32,0,32,32,0,1,2
"27814","c0779bb4dc5f23eb1a66f45f8b113436",27,27,0,27,27,0,1,2
"27815","c079f2931ed8cf5b4b24a8233a016bca",42,42,0,42,42,0,1,2
"27816","c07bca2d781454af720089caaea0faf7",44,44,0,44,44,0,1,2
"27817","c07ecd4d4ed2a66ab4bd0f71cf7b3744",107,78,44,17.0227272727273,66,41,3,3
"27818","c08220c2cce4384102196e76ad33a2c4",43,40,20,15.05,43,0,1,1
"27819","c083713fe46b331f13207824b9d72f12",73,52,17,30.0588235294118,73,0,1,2
"27820","c0838334b587d06caff478613d9ae260",16,16,0,16,16,0,1,2
"27821","c083a4027f6b6f7af09c0e04625f6e06",20,20,0,20,20,0,1,2
"27822","c08622b805bd50a47fdfd55bdebf1652",61,38,14,30.5,61,0,1,2
"27823","c086807b252e0ea39dcfced9f09d9be3",7,7,0,7,0,7,1,2
"27824","c087667b07bbd6dfe82d683a5adfb9b5",41,41,0,41,41,0,1,2
"27825","c0889ed278349c38e99de019b12aa4d0",135,100,70,13.5,135,0,3,3
"27826","c08baf542a037129db9cb60c9e42b433",62,43,63,6.88888888888889,62,0,2,1
"27827","c08c33bcb1011a3b51451e96d7b37dbc",31,31,0,31,31,0,1,2
"27828","c09063ba44514598cfa95a7ebc388d65",39,39,0,39,39,0,1,2
"27829","c0921a6513c102b3fbe375d2dc0345da",24,24,0,24,24,0,1,2
"27830","c093102145e4f0e7ba9599aa37b293d3",157,70,78,14.0897435897436,106,51,3,3
"27831","c095187d9524b7f61fbf93bda81f0157",111,85,26,29.8846153846154,111,0,3,3
"27832","c09763ff5a845971fd7962fe18f7f6cf",29,29,0,29,29,0,1,2
"27833","c097894c51575a4ce831bec2f0e8bebc",70,58,44,11.1363636363636,40,30,2,1
"27834","c09a1aef73098dad7d06ba87e7f5ade5",24,24,0,24,24,0,1,2
"27835","c09ad67a5296e6f9e54d1c04dc880d2f",89,61,42,14.8333333333333,89,0,2,3
"27836","c09ffcd51c146a57914e2898ffd248b2",38,38,0,38,0,38,1,2
"27837","c0a09b4482559703c96ab1d23816ec7b",42,42,0,42,42,0,1,2
"27838","c0a36f66ad9638fe65c0ed7750a5116f",141,81,34,29.0294117647059,141,0,3,3
"27839","c0a546c6135f2f05ba2442b3f6d401ca",10,10,0,10,10,0,1,2
"27840","c0a668fdea97b691436c6aa0ad6f9bf9",151,92,71,14.887323943662,112,39,3,3
"27841","c0a7dff6a89b4f6800ecc58853fc4ddd",112,73,21,37.3333333333333,112,0,3,3
"27842","c0aa3cd6102cb2f32eb131075132df08",95,39,73,9.10958904109589,72,23,2,1
"27843","c0ab8d26b890735914bafc8a48190394",79,60,77,7.18181818181818,74,5,2,3
"27844","c0ad51b5c177ce078b924a85312563ac",14,14,0,14,14,0,1,2
"27845","c0ad755ef6ffcec80c630c24c78d90f1",40,33,61,4.59016393442623,40,0,2,1
"27846","c0aebe0cbb54a5e8e2269ef478427913",26,26,0,26,26,0,1,2
"27847","c0afc2d01f0183fa83ac34879ca2c548",37,37,0,37,37,0,1,2
"27848","c0b0caa361bf4d84895f4cfb0b8f4d84",47,47,0,47,0,47,1,2
"27849","c0b1b13406e521d9f341c23d526a682a",17,17,0,17,17,0,1,2
"27850","c0b242eb6fea1dcbe637099f9d5dc243",35,35,0,35,35,0,1,2
"27851","c0b81df4da4a53a694678512ef20a63b",13,13,0,13,13,0,1,2
"27852","c0b902b424fab5486ce0f389f0a61b6a",42,42,0,42,0,42,1,2
"27853","c0bac1d4614ccaa108b70e12c4b553fa",92,57,40,16.1,43,49,2,1
"27854","c0bdb497c1e13014a89242fc119295a0",28,28,0,28,0,28,1,2
"27855","c0c03d30dc3e36ecb229458d4aff23be",26,24,50,3.64,26,0,2,1
"27856","c0c04eba8574b0fd68a335a90e18ab7e",173,97,70,17.3,173,0,3,3
"27857","c0c064b464e0772582d45c1023804293",21,21,0,21,21,0,1,2
"27858","c0c1369f1ee68fd8760635219b337d75",11,11,0,11,11,0,1,2
"27859","c0c8087fd4ec31bb9e912738ba87fec1",37,35,63,4.11111111111111,37,0,2,1
"27860","c0c8c549d6492b9e95d9688801ce883a",102,85,56,12.75,102,0,3,3
"27861","c0ce1749b30ec16c3e0bdff0a11dc123",52,49,28,13,52,0,2,1
"27862","c0cf02b6cf750b87a43c8ce41aaa418a",20,20,23,6.08695652173913,20,0,2,1
"27863","c0cf725aaa6f424ba4e07a302dd141dd",28,28,0,28,28,0,1,2
"27864","c0cfaef0d0c8e1119fca4a79905d77e5",6,6,0,6,6,0,1,2
"27865","c0d10df1c672231c825b9e8a3c61fe4b",92,77,33,19.5151515151515,92,0,2,3
"27866","c0d129d2fe5f5da052d82f6358cf95c6",34,34,0,34,34,0,1,2
"27867","c0d48f7720e28a51a15fc68b89f8b021",205,75,77,18.6363636363636,205,0,3,3
"27868","c0d70bdfd82970430176251c7c70ea53",48,48,0,48,48,0,1,2
"27869","c0da4bf77e45ce0b18adf33b6d43b79a",98,71,22,31.1818181818182,51,47,2,3
"27870","c0daf474464c5c8b4a114f7b55f00a87",97,57,70,9.7,97,0,2,3
"27871","c0daf623ccde9b809e47523ffb5df1bd",143,79,62,16.1451612903226,143,0,3,3
"27872","c0db694435ab42700f42d31334ce1dff",32,32,0,32,32,0,1,2
"27873","c0de865452969b54be1f93422bf6ae05",25,25,0,25,25,0,1,2
"27874","c0dfa9d193dddc9555c79234b863a6ba",120,72,73,11.5068493150685,120,0,3,3
"27875","c0e21db278d5552d5565b02d4e8832b1",130,87,70,13,130,0,3,3
"27876","c0e407679be825c62a4de5c74f3dcc63",37,31,14,18.5,37,0,1,1
"27877","c0e488c1c8dbaa1e6742b8d436406fb0",29,29,0,29,29,0,1,2
"27878","c0e9323fbc3ca252e07bd8e03ec5fb3d",24,24,0,24,24,0,1,2
"27879","c0ea51be997250c099309442b7a5ea6e",14,14,0,14,14,0,1,2
"27880","c0eac66d1471b65e66706f0a48adbef4",109,82,42,18.1666666666667,109,0,3,3
"27881","c0ec4ea39b556b5ca5b20816a50219bb",19,19,0,19,19,0,1,2
"27882","c0ecbf5bf00a3bb2fa66ccb2311672f1",70,44,59,8.30508474576271,70,0,2,3
"27883","c0ed1877fb944ebe74c375ba8a6744a6",81,67,58,9.77586206896552,81,0,2,3
"27884","c0ed8a9ba19fa4ae849510421b9915a6",28,28,0,28,0,28,1,2
"27885","c0efa42463537e2fb2c0aab7cce8258d",116,61,67,12.1194029850746,116,0,3,3
"27886","c0f1fba424081c7d633ad065c88da539",202,89,70,20.2,202,0,3,3
"27887","c0f20f233ee5da8ed2dc1160af448b76",49,19,58,5.91379310344827,49,0,2,1
"27888","c0f4c4e8fed00601f54e38d391d0f349",21,21,0,21,21,0,1,2
"27889","c0f7e5e5a5a262cf581ab6be321bdbf0",23,23,0,23,23,0,1,2
"27890","c0faa92663e60058e128d7a8bd36be2b",9,9,0,9,9,0,1,2
"27891","c0faaa9280fa89196beb8058abb64312",15,15,0,15,15,0,1,2
"27892","c0fde64ef38d0dd1e92658b64b0a55bc",112,80,35,22.4,112,0,3,3
"27893","c10299444ceecbe73be908018670d960",127,95,71,12.5211267605634,79,48,3,3
"27894","c1029c23fc50f17ebfecfec83baf2aad",22,22,0,22,22,0,1,2
"27895","c102a9ef47f26902f3b18be240af26ef",171,99,84,14.25,132,39,3,3
"27896","c103d429e962b91b94f8fb73a2c85798",170,76,70,17,170,0,3,3
"27897","c10438a7ea1cbb889872ca05ae4100b1",9,9,0,9,9,0,1,2
"27898","c106f710b3122e0e512361ec5f260fa4",35,35,0,35,35,0,1,2
"27899","c1094dcff42baa3e0b8c62f5f7e51014",28,28,0,28,28,0,1,2
"27900","c10d0bc0fb367edd30457316a9015258",38,38,0,38,38,0,1,2
"27901","c10ea5526fcd60e51f8da08d3ef8dd4c",67,55,30,15.6333333333333,67,0,2,1
"27902","c10ed65ad0b91388db4bd1a673efdcb2",91,61,55,11.5818181818182,91,0,2,3
"27903","c1121b81832a38ddd2fdd901f49db1fc",35,25,50,4.9,35,0,2,1
"27904","c112b6de6cc8fa9652bbfb415a5caf65",62,54,41,10.5853658536585,62,0,2,3
"27905","c1131e9b8b2f8f4ed6efdb35bcc73523",60,44,33,12.7272727272727,60,0,2,1
"27906","c1135a37152ad2a3ced927d6d799832f",23,23,0,23,23,0,1,2
"27907","c114277c608eda0da27537315a32f2e4",17,16,61,1.95081967213115,17,0,2,1
"27908","c11512b8173fc9ee2eaa20f9e762b114",12,10,49,1.71428571428571,10,2,2,1
"27909","c11691e6d320931c0b39335dfdb60bb6",29,29,0,29,29,0,1,2
"27910","c1198fdc197ff8c8f44c22e27d47ea5e",125,59,75,11.6666666666667,106,19,3,1
"27911","c119c07c8e85ba781293b06963e77e14",135,85,59,16.0169491525424,135,0,3,3
"27912","c11a795d1c1cf682a7128ef0c6255244",6,6,0,6,6,0,1,2
"27913","c11e0e476a7dfa91d9b148980fd785f4",108,62,46,16.4347826086957,94,14,2,1
"27914","c11ff0bb2bb5ce17182631eb30a843ce",70,53,49,10,18,52,2,1
"27915","c122a91333bf6ad857d6e4edcd7807d7",65,53,23,19.7826086956522,40,25,2,1
"27916","c1242ede9cbf3d21b69c3188da615676",95,69,85,7.82352941176471,70,25,2,1
"27917","c125bb7df6e93135c416ff1e9b9d4b26",91,61,67,9.50746268656716,91,0,2,3
"27918","c12826803bedaa78c5cdfe9e936409a8",22,22,0,22,22,0,1,2
"27919","c12e48be53d7fdc76a76238371e1abc1",29,29,0,29,29,0,1,2
"27920","c131d88e526181bb97a518dd362b3ac1",155,142,45,24.1111111111111,155,0,3,3
"27921","c135112e3cdab925bbc09465716f3764",190,98,81,16.4197530864198,148,42,3,3
"27922","c135a5f2b4b53f1c3d90df283e5ec83d",64,54,40,11.2,64,0,2,3
"27923","c13d67e6220c04430968a7c822eeffca",149,81,70,14.9,149,0,3,3
"27924","c1429067b6e28f81cfc37e5f146d029a",81,61,16,35.4375,81,0,1,2
"27925","c142fbe7add004e627af17c9889dba7d",29,29,0,29,29,0,1,2
"27926","c1438cb38578204a5ca72f9be2264ad6",46,36,64,5.03125,46,0,2,1
"27927","c1483281e731fbb89129cc11f524c001",86,68,37,16.2702702702703,86,0,2,3
"27928","c148d296e206ca6d0530a021961559f8",149,65,45,23.1777777777778,111,38,3,3
"27929","c14c38aa47c59a87ced09cdcd20ee9c1",22,22,0,22,0,22,1,2
"27930","c14e2b8de1de55791b8470f9d48dc775",187,97,59,22.1864406779661,187,0,3,3
"27931","c14ee91e615badf8b16d8d7dbb2776d6",36,31,26,9.69230769230769,36,0,2,1
"27932","c14efd86b8f1bfb330422c53f4a5b2da",56,56,0,56,56,0,1,2
"27933","c14f1a3744770b5049682372058f2959",1,1,0,1,1,0,1,2
"27934","c14fba5701f85c6958c27ca554992a05",39,35,14,19.5,0,39,1,1
"27935","c15035e058fc3c86652cfd5f776aee71",26,26,0,26,26,0,1,2
"27936","c150bbe327a0497e3d7f19989ecf31d5",28,28,0,28,28,0,1,2
"27937","c151cd7be138cad90a829f02dcb3d928",74,47,36,14.3888888888889,74,0,2,1
"27938","c158a22de8cf19a5d9e7c8862c47d584",21,21,0,21,21,0,1,2
"27939","c15acae2f150330b703ed0a5e7dd8a75",33,33,0,33,33,0,1,2
"27940","c15bcb6589ea43844e3e7ef516e08e65",55,31,64,6.015625,55,0,2,1
"27941","c16052ba95676a119a0f97c25e418fad",17,17,0,17,17,0,1,2
"27942","c160ee2df9644261dc5ca09a0b2b1329",168,85,49,24,168,0,3,3
"27943","c1615886172533e525a6c481f4f246d8",36,36,0,36,36,0,1,2
"27944","c1632ac586e7017efc238221f433a9ff",77,66,28,19.25,77,0,2,1
"27945","c1645f5dc42bda6ff3361b97464cb1dd",23,23,0,23,23,0,1,2
"27946","c16609d5e452660156e3b6c058493453",40,40,0,40,0,40,1,2
"27947","c166acb305f8fe5184cc3f0fbd4c70b0",33,29,60,3.85,21,12,2,1
"27948","c1690f7c9f146541155b6f7b401ef24d",116,75,77,10.5454545454545,76,40,3,3
"27949","c1695a0d58cd9e5230c45a68edb6255f",23,23,0,23,23,0,1,2
"27950","c16bbed66128c0d3189e34ff9fea45a3",108,80,47,16.0851063829787,90,18,3,1
"27951","c16d1d04c3a1acde724966cb97594942",205,111,70,20.5,205,0,3,3
"27952","c16d6d64c5a02a175998d00c7ff1c2aa",56,44,69,5.68115942028985,56,0,2,1
"27953","c16df6435f48cc964a7c74bf46d8c863",181,80,76,16.6710526315789,143,38,3,3
"27954","c16eb4a3f7b191bd17cf403fa6f19867",62,47,64,6.78125,62,0,2,3
"27955","c171ae2b6562180373d5ff5db7f51bb7",32,25,62,3.61290322580645,32,0,2,1
"27956","c172182503c0ed575173b4d64a3d98ac",136,66,88,10.8181818181818,136,0,3,3
"27957","c1730181ba85bd40287a603895a4ad0f",138,68,69,14,138,0,3,3
"27958","c173495b64fd9ea7107aa292b88822bf",99,48,81,8.55555555555556,73,26,2,1
"27959","c17448c55d368aaf77a94a1d422f0e2c",218,46,84,18.1666666666667,210,8,3,3
"27960","c17490935d8ab2164a75134b62ae214c",22,22,0,22,22,0,1,2
"27961","c1756c5766a36edbcdc622b291eca635",23,23,0,23,0,23,1,2
"27962","c1761936c31072348a7ef6bf15233732",229,115,77,20.8181818181818,187,42,3,3
"27963","c1764c69087ad83f49d5e311f02a3846",208,84,73,19.9452054794521,208,0,3,3
"27964","c1777fcdd31fe3afb5e126ede4eb0cf1",26,25,40,4.55,26,0,2,1
"27965","c17a1a884dcb4dea45523e9c3d770eeb",37,34,26,9.96153846153846,27,10,2,1
"27966","c17a40b3240feda0700faf51efc507b1",94,65,90,7.31111111111111,77,17,2,1
"27967","c17a68ab7cc0ab8e85931509006095ad",40,40,0,40,40,0,1,2
"27968","c17ba0b150fa4b8fce08fcb880d9ff03",26,26,0,26,26,0,1,2
"27969","c17cb23b441613f252850c904b4f7c8e",25,25,0,25,25,0,1,2
"27970","c17cf752d9a6360b40ec7db46685072c",141,68,67,14.7313432835821,103,38,3,3
"27971","c17e6e970f89716a0a0da1b5639ec744",79,64,23,24.0434782608696,43,36,2,1
"27972","c181056a419f122c449667ce6319b6f4",83,51,53,10.9622641509434,56,27,2,1
"27973","c182b3e80d4f6a06b6de01d9e46c123d",18,18,0,18,18,0,1,2
"27974","c185696661bd30ebef1032c77adf6f63",28,20,16,12.25,24,4,1,1
"27975","c18813b33dd228d969dde26a51258560",2,2,0,2,2,0,1,2
"27976","c18c88b9775b20ae256ae0fd43b46932",25,25,0,25,25,0,1,2
"27977","c18f8d6ce0dd2762eede7f4ce44043e3",33,33,0,33,33,0,1,2
"27978","c19001df074c0ece2273616be2e4d3ab",63,51,11,40.0909090909091,32,31,1,2
"27979","c1925d973518d1f1cdfe3859b4de20bc",98,46,77,8.90909090909091,67,31,2,1
"27980","c194d16c1833204ceacf319fe2e3cba7",37,31,42,6.16666666666667,37,0,2,1
"27981","c195f550c69b273b22f9de81a69b5763",233,115,78,20.9102564102564,197,36,3,3
"27982","c195f78429c6cc274d7cde2aa125706d",21,21,0,21,21,0,1,2
"27983","c197591cf3a6f25455b2286e1250652c",170,92,73,16.3013698630137,118,52,3,3
"27984","c199c235aca13057ff20a7d7d7a3197d",18,18,0,18,18,0,1,2
"27985","c19e29a95f613de598225f01af737019",23,23,0,23,23,0,1,2
"27986","c1a282618c534c669d033269682283c1",63,51,33,13.3636363636364,63,0,2,1
"27987","c1a33dc5c15303b6d9087b008e7a073c",1,1,0,1,1,0,1,2
"27988","c1a4a76b5915e646777eaf068189ac10",20,20,0,20,20,0,1,2
"27989","c1a4e1bed9702aa39a01861da75c6bae",9,9,0,9,9,0,1,2
"27990","c1a7059ee2126ea5e2621bfe99cb2948",169,105,63,18.7777777777778,169,0,3,3
"27991","c1aaec553d0ff3815356b778aa2942d8",20,20,0,20,20,0,1,2
"27992","c1af9fdb4a35788d0c7df0c360918738",193,99,80,16.8875,158,35,3,3
"27993","c1b0a04922059e0e567117f9de5ca363",183,119,61,21,183,0,3,3
"27994","c1b54e96818b956404ce17151fa7374d",215,93,78,19.2948717948718,168,47,3,3
"27995","c1b9ab4d631b329fb0a83591e35bd361",26,26,0,26,26,0,1,2
"27996","c1bcb1884abf23aafdaa45149dd4d38e",75,44,35,15,55,20,2,1
"27997","c1be25c13ddd808343ac1ceca82836fe",63,58,52,8.48076923076923,32,31,2,1
"27998","c1c0a789f55b639f06c24fba32dd152f",26,26,0,26,26,0,1,2
"27999","c1c1a0513ac199651e07ddd1e615f3de",46,46,0,46,46,0,1,2
"28000","c1c2a99fa7fe8945a91992a20cfefbdc",105,78,34,21.6176470588235,105,0,3,3
"28001","c1c302b18b904cae1c92aa1b25c428fb",57,42,69,5.78260869565217,57,0,2,1
"28002","c1c39ffcf9c86bf7435aade947f1d9e7",43,43,0,43,43,0,1,2
"28003","c1c638bc64e2f7b8011b22432f2f2c19",166,116,71,16.3661971830986,166,0,3,3
"28004","c1c72cf4bf45a4190420274845dc51c7",32,32,0,32,32,0,1,2
"28005","c1ca6a945ac816f71c89756345abaab7",137,94,73,13.1369863013699,137,0,3,3
"28006","c1cb4238368bfb8dc02f0dc737295cda",147,91,82,12.5487804878049,147,0,3,3
"28007","c1ce088c83a24e2a51b6ecee87ef4c58",53,53,0,53,53,0,1,2
"28008","c1cf59ea555e0ca09747301d3c09d340",196,99,79,17.3670886075949,196,0,3,3
"28009","c1cf9c199a61250fdfd7a5c36019b150",138,85,67,14.4179104477612,138,0,3,3
"28010","c1d22b98e8c8e41f4d7940b6d6658877",66,60,18,25.6666666666667,35,31,1,1
"28011","c1d4e019f348af2c6b340ddba6ad96e3",22,22,0,22,0,22,1,2
"28012","c1d6c609ea238826aa33a0a2987b1cbc",146,110,60,17.0333333333333,106,40,3,3
"28013","c1d7ad1ca845f904920997ee9322dafc",91,71,24,26.5416666666667,64,27,2,1
"28014","c1ddb5fe1bf0de81646e7493396297a0",45,25,41,7.68292682926829,45,0,2,1
"28015","c1ddbee8f14b718d69fb179a90e97270",137,80,63,15.2222222222222,137,0,3,3
"28016","c1ddd6cf5b33e913b6f8ca38f92c0108",23,23,0,23,23,0,1,2
"28017","c1e28423fb0b5d630098f6bfd30ea662",12,10,39,2.15384615384615,12,0,2,1
"28018","c1e2fa93cbbce40a51ef7b8e7b146cb0",189,128,80,16.5375,154,35,3,3
"28019","c1e4af41623d2bbf7c2bfcf6002352fa",57,46,25,15.96,57,0,2,1
"28020","c1e614b30ea9aba3ec12b7569a14a7f5",4,4,0,4,4,0,1,2
"28021","c1e72e68d550e251ea70547816331314",161,90,69,16.3333333333333,161,0,3,3
"28022","c1e8068ab891e56ab3696f0268072cc6",33,33,0,33,33,0,1,2
"28023","c1eae1dafde381c1e6423c8ef7d76b9c",44,20,70,4.4,44,0,2,1
"28024","c1eb9f05824c26355d400c1ba9fd724f",41,41,0,41,41,0,1,2
"28025","c1ee9635bdb367ebb79d3e1065d9b873",109,79,35,21.8,109,0,3,3
"28026","c1f0d8f0f707383558765a344437107b",38,26,39,6.82051282051282,38,0,2,1
"28027","c1f20ba95600ce5f75f9cbfd634ae265",55,51,34,11.3235294117647,55,0,2,1
"28028","c1f4016d3ddab960640064b8691b8a3a",47,23,74,4.44594594594595,37,10,2,1
"28029","c1f5746c17a35315df2a4f109cf11543",141,77,85,11.6117647058824,98,43,3,3
"28030","c1f6334287f766beb9b63e1ca90b2e3b",64,45,42,10.6666666666667,64,0,2,1
"28031","c1f6b62f372778c79ac68d0e8692de56",65,51,46,9.89130434782609,32,33,2,1
"28032","c1f8a9077b2ad28d9bb48613cd694015",104,77,43,16.9302325581395,104,0,3,3
"28033","c1fcfd2e04f06617372aa308705d36a9",66,61,71,6.50704225352113,66,0,2,3
"28034","c1fd9c331ef515e7c56501a4ab6a4cff",92,66,59,10.9152542372881,61,31,2,1
"28035","c201e7e7810d202735436e6967cd4067",18,18,0,18,18,0,1,2
"28036","c20432a930ecd34d46220bc48c3c7cbf",15,15,0,15,15,0,1,2
"28037","c20476fcb6623fad21dd1e8cd29f4dbe",133,100,40,23.275,96,37,3,3
"28038","c205eaea03bd5374542e11cb3429f1fc",21,21,0,21,21,0,1,2
"28039","c2062e1ff1c0821655fdd5b8d92eb845",37,37,0,37,37,0,1,2
"28040","c20bebf0f5c0aef23cfebaa956086ee6",52,34,70,5.2,52,0,2,1
"28041","c210975387eee1591bb23010d13b6ef2",153,94,74,14.472972972973,112,41,3,3
"28042","c212e27a7ffa5cd0b534828641e5e68a",118,91,42,19.6666666666667,118,0,3,3
"28043","c213352a2a7e6fa79e10a68ae2792518",108,79,61,12.3934426229508,53,55,3,3
"28044","c2146732845f8d093ed7519ad12b5936",40,40,0,40,0,40,1,2
"28045","c216447052f446417b4fd97805427edb",1,1,0,1,1,0,1,2
"28046","c21974b4fbdb3dc4285ca475126bc3c1",52,37,89,4.08988764044944,52,0,2,1
"28047","c219d6e010154df52052caf7371cece4",47,40,23,14.304347826087,22,25,2,1
"28048","c21d2e74f83447cb54f244447b51764c",146,95,73,14,146,0,3,3
"28049","c21d8791681732373be4a9a2db608dfd",14,11,42,2.33333333333333,14,0,2,1
"28050","c21de1a9d14949777f8b72b1ddc523b5",37,37,0,37,37,0,1,2
"28051","c21f30f84a134318b0f40a225bb460f8",14,13,3,32.6666666666667,14,0,1,2
"28052","c221f8392b37d3ac6037c2e375e71828",7,7,0,7,7,0,1,2
"28053","c225b3d3e690b2e173085f2e67a8e2eb",146,92,67,15.2537313432836,115,31,3,3
"28054","c226ab77a9bfdb4e02019ae6e9d049f2",93,74,75,8.68,93,0,2,3
"28055","c228bec54dee571e417c37adf7bf7cee",190,134,63,21.1111111111111,190,0,3,3
"28056","c2297cb88bcbbae156c5091b94471f1e",20,20,0,20,20,0,1,2
"28057","c22e42aa879e0411c329f3f7e98c0b11",32,32,0,32,32,0,1,2
"28058","c230d9532361fd8c0d72ec2a4c7db43a",188,96,63,20.8888888888889,188,0,3,3
"28059","c2388bf1dcbc862b0a1babff1a459c2d",50,50,0,50,50,0,1,2
"28060","c24140febbabf8634b48095276463763",79,45,76,7.27631578947368,79,0,2,3
"28061","c24149897f9b766d3850ab7ae353804e",85,60,73,8.15068493150685,63,22,2,1
"28062","c24325d533366b5fe1a3665b7d56d603",1,1,0,1,1,0,1,2
"28063","c2438ae6193c0d72e1a615182c6a2f12",26,18,63,2.88888888888889,26,0,2,1
"28064","c24432aa971bff9176cdb785c83e47e4",132,93,83,11.1325301204819,132,0,3,3
"28065","c249730e4a1d127c3df2e2251ad6a48e",30,30,0,30,30,0,1,2
"28066","c24a1792b2826a0faf2e013352e32e0b",13,13,0,13,13,0,1,2
"28067","c24d4592e28df4ba95383b0494b64aec",86,63,72,8.36111111111111,59,27,2,1
"28068","c24d7667919909ff9d2c6d023a5ea9f1",242,148,69,24.5507246376812,216,26,3,3
"28069","c24ef2dca35e66d2bc0c2d95c15fb7db",47,47,0,47,47,0,1,2
"28070","c25156af6fa7424d0497072d81919c6c",85,60,35,17,85,0,2,3
"28071","c253469c37c4ee510e9a3351a957ecac",46,39,49,6.57142857142857,0,46,2,1
"28072","c254405b647fca6304596fb2ba8b5884",80,50,62,9.03225806451613,80,0,2,3
"28073","c2550a79b8b7b4ed3595d0dc622180d9",63,47,51,8.64705882352941,17,46,2,1
"28074","c255712bfcba6689689c6d35afdab517",20,20,0,20,20,0,1,2
"28075","c255d49d70ffcf68fcd7e76734d9ecf7",41,41,0,41,41,0,1,2
"28076","c256af712256a023f5c9d0915dbe0697",53,42,29,12.7931034482759,53,0,2,1
"28077","c2584a816d54174ec3ab7d336731cb59",73,64,30,17.0333333333333,73,0,2,1
"28078","c25908777c054d551dc4328f3afc681f",43,43,0,43,43,0,1,2
"28079","c25920b3aa4fcde387636403c7580797",20,20,0,20,20,0,1,2
"28080","c25aaa5db99a39e64aee6c7926598468",50,32,77,4.54545454545455,42,8,2,1
"28081","c25c1ce1f48043dd9ebbd2f89bb74f4a",99,52,61,11.3606557377049,50,49,2,1
"28082","c25df69b41e7b99078f5ec65d9a3d6e3",71,55,61,8.14754098360656,48,23,2,1
"28083","c26060c8f0af9a284c23d60f67c37a45",52,52,0,52,0,52,1,2
"28084","c260f40a9b8b6e93f5bc2e9efaf6f99e",53,53,0,53,53,0,1,2
"28085","c264b519bf256bdff419f7d0e6d6a51d",90,54,60,10.5,90,0,2,3
"28086","c265591683815850e348ca54880aaee0",46,46,0,46,0,46,1,2
"28087","c26619b9232f484e078865fcba09ffbe",26,26,0,26,26,0,1,2
"28088","c266b1a19e846e31876e4b649dda3ad7",8,8,0,8,8,0,1,2
"28089","c2688f05c29ebeb224b3464c5ad7569c",30,17,59,3.5593220338983,30,0,2,1
"28090","c26b9814d0aff638dbd037b56632dac0",109,80,59,12.9322033898305,109,0,3,3
"28091","c26c33ee5cdef95584826a9b480a58fa",54,36,51,7.41176470588235,54,0,2,1
"28092","c26d699fc68519276dd89d32679ff69d",193,105,65,20.7846153846154,193,0,3,3
"28093","c26d77c897231c54a6bb19e6828ea7bd",18,18,0,18,18,0,1,2
"28094","c2711df8c63b8fd598b88beca63970ac",1,1,0,1,1,0,1,2
"28095","c2740e738775e79a74466dd8c37c6aff",10,10,0,10,10,0,1,2
"28096","c274866829463dbfdd8036df415785ef",61,44,77,5.54545454545455,61,0,2,1
"28097","c275f6992f7698c7c692817e559f07c8",100,76,55,12.7272727272727,100,0,3,3
"28098","c27793c3aea84310ceea21ca83175904",10,10,0,10,10,0,1,2
"28099","c27a4bdcd47561bd2ed62eed4bca6fd9",1,1,0,1,0,1,1,2
"28100","c27d019f28e88c8220c9fc5bf2567a8a",85,60,41,14.5121951219512,85,0,2,3
"28101","c28181a30fc97151e0de5474d376e661",33,33,0,33,33,0,1,2
"28102","c28235044f84a1c85c43feeceb02ac77",144,68,54,18.6666666666667,100,44,3,3
"28103","c28774fabef02ec88b29083e0db230dd",57,53,13,30.6923076923077,57,0,1,2
"28104","c289b6ed42fba8494d9047096ec9bdb7",80,61,69,8.11594202898551,37,43,2,1
"28105","c28f45fa75ae3d944772ea1ca21be227",95,76,27,24.6296296296296,95,0,3,3
"28106","c2940a7e1e35ef67cc9c58b40504d40c",117,79,31,26.4193548387097,86,31,3,3
"28107","c294303149ef1e7eca9cb6604bf18908",8,8,0,8,8,0,1,2
"28108","c2957df5ba85674dd231d845e99eabf6",43,43,0,43,43,0,1,2
"28109","c29610fad77551e0429214569570bd91",48,48,0,48,48,0,1,2
"28110","c2966b1fa3d47bc114a2e8c0219f7735",169,98,74,15.9864864864865,169,0,3,3
"28111","c29684975ebdab7a9e8a58d94f0c9855",137,103,84,11.4166666666667,137,0,3,3
"28112","c299ee8d8be37fb98ab28717d69f70d3",18,18,0,18,0,18,1,2
"28113","c29a320b9101ab55855e81aaed31a3d5",73,59,11,46.4545454545455,42,31,1,2
"28114","c29e1eed886a08a7a48f904b9867841c",63,47,49,9,63,0,2,1
"28115","c29f6885e6455bdbfa6d55ae71273038",179,97,63,19.8888888888889,179,0,3,3
"28116","c29f9dccb5b6716e9f59de24dcb96ad1",27,27,0,27,0,27,1,2
"28117","c2a2d4e5c5ee0955db431e45ef2b9ca7",22,22,0,22,0,22,1,2
"28118","c2a367d01494b76f71a92fd800ac2315",18,15,46,2.73913043478261,9,9,2,1
"28119","c2a3a7ed03bb753ee09dacb7ed7abd76",67,61,14,33.5,67,0,1,2
"28120","c2a4af66d75777d6b22159d79a363e3f",19,19,0,19,19,0,1,2
"28121","c2a5530bcb14e120b3458c3acd35c08f",135,84,88,10.7386363636364,135,0,3,3
"28122","c2a64de0290bbab0e2f6fb4011f5dceb",123,84,76,11.3289473684211,123,0,3,3
"28123","c2a6a45efac7383a2450f6e3aaebb163",65,38,38,11.9736842105263,65,0,2,1
"28124","c2ab41a42dee1b5c74946ac64d93827d",129,81,67,13.4776119402985,129,0,3,3
"28125","c2ab892cc02e69417d51027e876f0fee",49,49,0,49,49,0,1,2
"28126","c2af34caba68062db72f8876f8a7fad4",115,68,70,11.5,115,0,3,3
"28127","c2afb1e54a1c7164afaec793bab44ee6",86,49,56,10.75,86,0,2,3
"28128","c2b06f31e89b078be6c113cabf32e87e",18,18,0,18,0,18,1,2
"28129","c2b080c9f148d57aa4f806f85fe7ddf2",51,51,0,51,51,0,1,2
"28130","c2b1f02ce8b116e47f59562d41c63f0d",9,9,0,9,9,0,1,2
"28131","c2b2e2478330ff451b7af9eac912e554",23,19,74,2.17567567567568,23,0,2,1
"28132","c2b3826338f781536f07b6719a60f62d",53,48,42,8.83333333333333,53,0,2,1
"28133","c2b61d308a67b21354c2f83c4461c8a0",147,120,30,34.3,147,0,3,3
"28134","c2b987b484bc30030850d1d4cd270257",157,92,67,16.4029850746269,157,0,3,3
"28135","c2badcd8289d47666e52cb90cc75c896",50,50,0,50,50,0,1,2
"28136","c2bc8571a62ff66fe57fb751a98f93ca",53,53,0,53,53,0,1,2
"28137","c2bd46af60056e168bcd07716f93e5da",133,70,63,14.7777777777778,133,0,3,3
"28138","c2bd75e097620bacd8926776e19e5082",183,107,71,18.0422535211268,183,0,3,3
"28139","c2bfce9af88f5b37c93ad4c4ca9b722e",21,21,0,21,21,0,1,2
"28140","c2c3301d6b65a1a74110b0070db74175",30,30,0,30,30,0,1,2
"28141","c2c49023d3789d7e3c8ed26156ba5fec",26,26,0,26,26,0,1,2
"28142","c2c5c5f7cc4bb25472bd71e4635bcae9",21,21,0,21,0,21,1,2
"28143","c2c63775153d396f3157d1e28c23db99",89,63,79,7.88607594936709,52,37,2,3
"28144","c2c7fcfb2d098af5eb5e69e988c1b019",25,25,0,25,25,0,1,2
"28145","c2c84717bbb2f36e2242c60a231f8984",2,2,0,2,2,0,1,2
"28146","c2c964bb117282e34117fc23481f6545",64,46,59,7.59322033898305,64,0,2,1
"28147","c2cd1ae97bc4e640591c118aa9928979",104,63,75,9.70666666666667,104,0,2,3
"28148","c2cd1ead39b8e8a540aee00d6c299631",137,78,75,12.7866666666667,137,0,3,3
"28149","c2cfbd548212484fcb4b44fee1921f07",26,26,0,26,26,0,1,2
"28150","c2d0d7d94d0b0a07c6a159925f02e82f",107,81,26,28.8076923076923,107,0,3,3
"28151","c2d1aaf8082f3652290a8a988f77212e",44,44,0,44,44,0,1,2
"28152","c2d1c12268fde9da5c71f39712f2dccc",105,67,61,12.0491803278689,105,0,3,3
"28153","c2d324593ce86c5256ac0b0c70dd9e1d",33,33,0,33,0,33,1,2
"28154","c2d35b5f759da98bf7758ac9e7712a35",114,85,74,10.7837837837838,96,18,3,1
"28155","c2d7370dd5ece8137612077367ce3729",74,41,53,9.77358490566038,74,0,2,3
"28156","c2d7ce5a42463f1a940f7966db27ae08",57,44,41,9.73170731707317,25,32,2,1
"28157","c2d7fe36a8eac3a5af16b95fec2fcf6f",130,76,66,13.7878787878788,130,0,3,3
"28158","c2db280b276d7d0f94beb658f4cefd5f",1,1,0,1,1,0,1,2
"28159","c2dd05357489b5a4c7afb56806216318",78,57,39,14,78,0,2,3
"28160","c2e30a0c61be2b118cc59f0338d3fcac",18,18,0,18,18,0,1,2
"28161","c2e326a7c0284586acedeabeba739a65",95,71,65,10.2307692307692,45,50,2,3
"28162","c2ea1e3fe1077d84edfe632a0dfa7700",108,58,84,9,85,23,2,1
"28163","c2ec882ae535bf92d2345b278d70d228",23,18,48,3.35416666666667,23,0,2,1
"28164","c2ef1b7621feea601f5a6de1ae60e304",151,90,85,12.4352941176471,151,0,3,3
"28165","c2f055a73afb6428c47e57e8237be036",52,44,54,6.74074074074074,28,24,2,1
"28166","c2f0ed34f5cfe9f7d0e6b441c14e432e",60,33,73,5.75342465753425,47,13,2,1
"28167","c2f24ea06f38771583c8e6c400c28642",74,64,45,11.5111111111111,41,33,2,1
"28168","c2f2d2b1e20634c9d3a359aaa25b176c",86,73,30,20.0666666666667,86,0,2,3
"28169","c2f31f5a1a86795056b2a35c9b9f9012",116,55,80,10.15,116,0,3,3
"28170","c2f67f76dd1e1d2d0223b396dfb19448",49,41,26,13.1923076923077,49,0,2,1
"28171","c2f6b1989aca29bf40b248ba0f987860",20,14,74,1.89189189189189,20,0,2,1
"28172","c2feeb69d35849b2b34f33bf92ecb2c8",35,35,0,35,35,0,1,2
"28173","c2ff47d4df0b2d996a0bbeccaa17cece",37,37,0,37,37,0,1,2
"28174","c2ff9dd7c16e359b1d9be17362ff6c3f",32,30,8,28,32,0,1,2
"28175","c3019c596c7561540a95844ecb38ea74",15,15,0,15,15,0,1,2
"28176","c3026f5096bc5f552b4dfc8a9fba3d28",82,44,70,8.2,82,0,2,3
"28177","c30338829d5d609eed5e7d04e2f5bc43",41,41,0,41,41,0,1,2
"28178","c3044697490f79055f0626dba616e3c1",44,44,0,44,44,0,1,2
"28179","c305b04048428ff0f3cfcb3fca5a9fb9",148,98,64,16.1875,148,0,3,3
"28180","c307df45f143b5b5e945458217b71811",26,26,0,26,26,0,1,2
"28181","c308006556b25ac2bc4e5b67bd345805",84,60,48,12.25,84,0,2,3
"28182","c309e939378bb6e20820ffc183a324af",53,42,15,24.7333333333333,29,24,1,2
"28183","c30e2b31abeff43f4e402a9fe88e8707",17,17,0,17,17,0,1,2
"28184","c30fdb2e64c5d146920b0a1d621b42b0",49,43,8,42.875,49,0,1,2
"28185","c310d19f4a30caa311ea9fe46856a7c3",18,18,0,18,18,0,1,2
"28186","c3192206e68690c038543cccf06de0c6",46,46,0,46,46,0,1,2
"28187","c31bbcc1b6ee61a1e4825756cc72d563",90,76,31,20.3225806451613,90,0,2,3
"28188","c31c2b57facee4520e92977dd4e45050",11,11,0,11,11,0,1,2
"28189","c31c7487cefb61388a278b099e27f419",12,8,21,4,12,0,1,1
"28190","c31dc0b5a9e2ff961e6726309888c106",17,17,0,17,17,0,1,2
"28191","c31fe01b5084fd7e273bc0cdf5a3d160",85,45,64,9.296875,85,0,2,3
"28192","c320284fd36da2102558d2a1d5738e41",58,49,35,11.6,58,0,2,1
"28193","c323446433cd67a484ad30c844fe87c2",96,52,50,13.44,63,33,2,3
"28194","c323df9975f3c7566f31b4b9127af01f",47,47,0,47,0,47,1,2
"28195","c323ebc97c0eeecd3289b71ded76136b",128,105,77,11.6363636363636,128,0,3,3
"28196","c325cc4e48eb1885b0cd79cedb7add76",84,66,40,14.7,84,0,2,3
"28197","c32e05fd6137e0deaddb0f89a523fa94",46,46,0,46,46,0,1,2
"28198","c32f7bca42d0a76064b8905dc9bed779",47,47,0,47,47,0,1,2
"28199","c3320771117281bf9eb20f4c003f7ee8",14,14,0,14,14,0,1,2
"28200","c3333ac9d52c97911b096bd5edab55dc",10,7,43,1.62790697674419,10,0,2,1
"28201","c3342e01dae6c47e832f1237983aa151",15,15,0,15,0,15,1,2
"28202","c334ef961cd69ac026f3b43b94eaf33f",210,142,52,28.2692307692308,210,0,3,3
"28203","c3354d74fcb78ad82c0a1faf17c6070e",78,53,58,9.41379310344828,78,0,2,3
"28204","c337c864033733682a8a74e9e27e3cdd",7,7,0,7,0,7,1,2
"28205","c339f36a87c7fa49b7712de526b9a55c",94,66,40,16.45,94,0,2,3
"28206","c33a48fc0af4a584f75fe7432ef6d0b5",31,25,24,9.04166666666667,17,14,2,1
"28207","c33f210784e2e19200cc3b89595378db",141,62,89,11.0898876404494,141,0,3,3
"28208","c341b66666b600a5755a22f59e1ca6a6",65,14,69,6.59420289855072,32,33,2,1
"28209","c342a03f7fa948b60334cabc19f81c5f",101,52,89,7.9438202247191,70,31,2,1
"28210","c344a353f8d008ab957af1fd840d53dc",205,115,37,38.7837837837838,205,0,3,3
"28211","c345382cafadab70ba4374ddc2c53e36",105,81,45,16.3333333333333,105,0,3,3
"28212","c3464b967cb3911e2f85728210672346",32,21,24,9.33333333333333,21,11,2,1
"28213","c346e331b01617c38c27cee48003a5cf",71,41,70,7.1,71,0,2,1
"28214","c346e5d30994daa9818b076cdc729e7d",12,11,35,2.4,12,0,2,1
"28215","c349edbe164d5b20e31e373bef7883ca",187,114,60,21.8166666666667,187,0,3,3
"28216","c34bfeae691275d75b1d39e671ed36bb",136,93,50,19.04,136,0,3,3
"28217","c34e943b0998b385d62a8345f6140c4f",48,48,0,48,0,48,1,2
"28218","c34f32d06875fc0537c346f63af654ea",19,19,0,19,19,0,1,2
"28219","c350fe0f258dd52ba9d3db31a998a845",8,4,7,8,0,8,1,2
"28220","c351b9b22691dae8f15778ff64eb43a2",118,70,27,30.5925925925926,118,0,3,3
"28221","c3569fe23b8bf4c279d18158f0b03d4b",47,47,0,47,47,0,1,2
"28222","c35a12977bf986029d2f84c61aab60d7",30,11,69,3.04347826086956,30,0,2,1
"28223","c35c3f83daaa1bda1b6fcb8b557b3005",88,72,60,10.2666666666667,46,42,2,3
"28224","c35d5e48e2491cb79cd8c7c0f57f481f",17,17,0,17,17,0,1,2
"28225","c35df5b7709006b8ae2016e4933db21a",34,27,14,17,0,34,1,1
"28226","c360a1cfbda016be1a1e0a78730caec9",18,18,0,18,18,0,1,2
"28227","c36208f9be2c9e15104f18167b854046",70,43,58,8.44827586206896,49,21,2,1
"28228","c36234ba8576a0fa5be1187d08bf4c48",1,1,0,1,0,1,1,2
"28229","c36836469a0c4b2514293cd0909b1db8",117,85,31,26.4193548387097,117,0,3,3
"28230","c3688875a26cd9d29726564e44891e4a",47,47,0,47,47,0,1,2
"28231","c36a669e7740deb32125f329a5dfe678",2,2,0,2,2,0,1,2
"28232","c36c562cc41e6e81900c3c491d927be6",13,13,0,13,0,13,1,2
"28233","c3711159000a33611e80734ca09386f8",70,55,9,54.4444444444444,70,0,1,2
"28234","c37127e3011bf03cae0d16844b58f7c8",59,43,71,5.8169014084507,43,16,2,1
"28235","c3713083aa77bfb254d5b637fc16e407",38,38,0,38,38,0,1,2
"28236","c37163915806929eab2614ad6c2f40cf",80,50,61,9.18032786885246,51,29,2,1
"28237","c37352b24acd288dd9137d718d9adcb6",48,48,0,48,48,0,1,2
"28238","c37938c7354143ea65b0b586e708a477",18,18,0,18,18,0,1,2
"28239","c37a9945238d15e963fabe9e1a357665",98,72,70,9.8,98,0,2,3
"28240","c37b3859ad1205d95750fc12d677af65",18,18,0,18,18,0,1,2
"28241","c37b81b5d7f7c3b06575fb5693244d04",177,104,56,22.125,126,51,3,3
"28242","c380287aa2ab07bbc3496865ea872a9f",58,52,12,33.8333333333333,58,0,1,2
"28243","c38119b9913319d16a3337ce4fac6a5c",230,112,77,20.9090909090909,198,32,3,3
"28244","c38126f5364d97d468c0e9a225d0f429",25,25,0,25,25,0,1,2
"28245","c382b852a8a5c8237bf645b9193786b0",107,69,38,19.7105263157895,63,44,3,3
"28246","c382ce92d9a00fd0e67ffc722c19d2dc",11,11,0,11,11,0,1,2
"28247","c385d533a4c761c783064721bcfb57a4",32,32,0,32,32,0,1,2
"28248","c3866352adaf7e2a994840c8585fe013",33,33,0,33,33,0,1,2
"28249","c387fbac0d36ab72702c8a6f226e4d04",85,74,46,12.9347826086957,85,0,2,3
"28250","c3884e5a8d2bdc3df0ed70ad8baf8e17",31,31,0,31,31,0,1,2
"28251","c38e7cfa1eed7c2012c183b1b9078f84",14,14,0,14,14,0,1,2
"28252","c39001b319c808fcd1596b2e76d46611",65,54,50,9.1,65,0,2,3
"28253","c392e75c8260be95f920f8b41be7c1c7",181,110,71,17.8450704225352,128,53,3,3
"28254","c395afb5d3fd234e7e5d267087d82d86",41,41,0,41,41,0,1,2
"28255","c39604c9e055dd249fbdf49237cbf035",63,55,13,33.9230769230769,63,0,1,2
"28256","c397c4c6474657cd4b850597a382a3cf",53,53,0,53,53,0,1,2
"28257","c39bb99012f5658bb4359bbf25e84f3a",53,43,42,8.83333333333333,53,0,2,1
"28258","c39e354235c2bcb27a17de07ae644c7f",18,18,0,18,18,0,1,2
"28259","c3a2446faffb5c8bd94b23baaf99b562",31,31,0,31,31,0,1,2
"28260","c3a4411690a9c59f0394a73d78004b88",41,41,0,41,41,0,1,2
"28261","c3a76c0ebf2ecc9a7170781c8a081b69",142,77,56,17.75,142,0,3,3
"28262","c3ab91a79a8b20f69e2e5ddb59faf649",20,20,0,20,20,0,1,2
"28263","c3ace3f8ee5d3c661f42ec34c386f649",114,63,61,13.0819672131148,114,0,3,3
"28264","c3ad06780ebb53875b2aedb783f6834a",192,110,71,18.9295774647887,168,24,3,3
"28265","c3af1f7fb732abed18a8ff8b965e4df9",47,47,0,47,47,0,1,2
"28266","c3af370693347d941a204905bcd18c61",59,48,21,19.6666666666667,59,0,1,1
"28267","c3b214d0f525981fb8d943ca0d6f6391",174,79,71,17.1549295774648,174,0,3,3
"28268","c3b3c3cf9d340f520f078d541a8c4a52",49,44,51,6.72549019607843,49,0,2,1
"28269","c3b4fa6365e387c24909a2786319c24e",96,65,78,8.61538461538461,54,42,2,3
"28270","c3b7cf354852003bf5935e93120e8970",44,44,0,44,0,44,1,2
"28271","c3b7e6d609ee24d8628001f4a2b1768a",168,104,70,16.8,153,15,3,3
"28272","c3b88b8fdbccd5b8cecdc7c0c600836f",24,24,0,24,24,0,1,2
"28273","c3b9cfa359b1f0ff8e3229333b9826dc",40,40,0,40,40,0,1,2
"28274","c3bb41b46f8c07f31b436716ca5bc6ab",54,43,51,7.41176470588235,30,24,2,1
"28275","c3bf70c03f8ab6e853cfa4c11d5a80da",64,61,48,9.33333333333333,26,38,2,1
"28276","c3c1b782632fa3d456ea34728f63583a",73,51,24,21.2916666666667,73,0,2,1
"28277","c3c567aee2a205e8832baa15c4f50c72",1,1,0,1,1,0,1,2
"28278","c3c66731bd87682eaf69880a2081d1ee",43,43,0,43,0,43,1,2
"28279","c3c808e26407756676a39e8e724bca12",2,1,37,0.378378378378378,1,1,2,1
"28280","c3cbcf21e8c7d0bf33ad601c01cb751b",43,30,36,8.36111111111111,43,0,2,1
"28281","c3cdbae6fcfc3ac474f0d562464307a0",20,20,0,20,0,20,1,2
"28282","c3ceab64463172e2abe0de6d14b100aa",17,17,0,17,17,0,1,2
"28283","c3cfc0e242860fe9b6ad7c0701117e1d",7,7,0,7,7,0,1,2
"28284","c3d20e24980430d3f480c4fd4c69061b",84,68,47,12.5106382978723,84,0,2,3
"28285","c3d2cfc4ad2848de161a94e1ec0eb396",15,15,0,15,15,0,1,2
"28286","c3d2f86a19485f20a7c52a47bfb1f535",123,84,40,21.525,91,32,3,3
"28287","c3db6d1b5082cdde21d2ba5ed6251228",202,78,82,17.2439024390244,202,0,3,3
"28288","c3dc042322d22b63f5e2d183297d9f73",108,80,59,12.8135593220339,65,43,3,3
"28289","c3dc0ca361eb6fcbfbd356eac5e56b59",44,44,0,44,44,0,1,2
"28290","c3de9e08f1f30ddd04b0df5c5af241db",81,63,52,10.9038461538462,81,0,2,3
"28291","c3e0d4af70af7d8ea0c8240c5a9203e9",16,16,0,16,16,0,1,2
"28292","c3e1eb924105f8f198e6dcf591b8156e",40,34,49,5.71428571428571,40,0,2,1
"28293","c3e3d613b3444a740137d7712640baec",71,55,45,11.0444444444444,52,19,2,1
"28294","c3e58f7f422ecc62b1d280a0a78073f8",22,22,0,22,22,0,1,2
"28295","c3e8e99334be0486c82c39976b5c1c25",64,63,9,49.7777777777778,64,0,1,2
"28296","c3eac715758de871aaa9e8cca973f835",31,31,0,31,31,0,1,2
"28297","c3eacb37f220ed39b7864f180ad0cce2",82,61,28,20.5,82,0,2,3
"28298","c3ed61ba1850a30f11c1fd85e8f0243b",145,88,62,16.3709677419355,145,0,3,3
"28299","c3ef311ffdfb8b74b5e1a2e4cbe6885d",93,85,31,21,93,0,3,3
"28300","c3efdd9407108a463f12c7477ddb8c98",16,16,0,16,16,0,1,2
"28301","c3f0b95785b38fb503bb6450010489f0",53,30,46,8.06521739130435,39,14,2,1
"28302","c3f47018ce6edfbad2af48cc02c3cd5e",135,113,70,13.5,85,50,3,3
"28303","c3f4e323e6e772b253745d87c156aefb",42,36,28,10.5,42,0,2,1
"28304","c3f6c783a5be7e9104f2d03286b6b2a0",11,11,0,11,11,0,1,2
"28305","c3fa85e5504c1ea088f2d5064f7315a8",76,41,15,35.4666666666667,47,29,1,2
"28306","c3fcb99d4002df86666a0b814750c866",23,23,0,23,23,0,1,2
"28307","c3fe449c6024f983ce8da8d961e53415",99,74,72,9.625,99,0,3,3
"28308","c400a1f430f4ed09cb0902029d841436",78,65,36,15.1666666666667,78,0,2,3
"28309","c4027404bd5ab672e66b0ff6dc730f81",59,46,76,5.43421052631579,59,0,2,1
"28310","c402afec692b4007fa703cd42a8288c5",145,83,82,12.3780487804878,145,0,3,3
"28311","c408b24404ba1549fa8a0fef7252ce72",7,7,0,7,7,0,1,2
"28312","c408d9a22bebb57f36e360b316349f1f",58,44,61,6.65573770491803,58,0,2,1
"28313","c40a7a478a72a4671de1258c965407fe",55,28,77,5,42,13,2,1
"28314","c40f3274aa9706263e11201802867026",72,54,62,8.12903225806452,72,0,2,3
"28315","c40ff2a7bc51429bab4d68d97ec90bec",23,23,0,23,23,0,1,2
"28316","c4128ede829245cb649b605893b7c1ce",71,65,19,26.1578947368421,71,0,1,2
"28317","c4162dff8e0170dff1b855824682cecc",39,32,35,7.8,0,39,2,1
"28318","c419a5033b0534f4a267a3611cda5579",2,2,0,2,2,0,1,2
"28319","c41baf81482d5e55714d0bf0731fdd2a",40,29,28,10,40,0,2,1
"28320","c41cfbb392830cc8034ec06dd5229a45",160,104,77,14.5454545454545,160,0,3,3
"28321","c41e7d2af22b0c4d7510ccba9f1256b4",34,34,0,34,34,0,1,2
"28322","c41f537e43b5d9e2e3bf5fdf165a71ad",23,23,0,23,23,0,1,2
"28323","c4207c81510fc6458dc79fbea528431e",32,32,0,32,32,0,1,2
"28324","c420d5b36e0981755dbaf3a1c921c8cd",22,22,0,22,22,0,1,2
"28325","c42479f9267106263eece135ed34c8c0",46,30,50,6.44,46,0,2,1
"28326","c424d890b5f796f01da8859a53e3018a",39,39,0,39,0,39,1,2
"28327","c4250327c9b6bd5c0f283e484c14e34a",146,102,68,15.0294117647059,140,6,3,3
"28328","c4257c49605def665041eb25dc1af3a3",28,28,0,28,0,28,1,2
"28329","c4265e13eaf24dc9190bdf07d4dc14d7",204,136,80,17.85,160,44,3,3
"28330","c426908f51b3163cf603f9918c82f691",14,14,0,14,14,0,1,2
"28331","c42951eb496ff27dfc9beaa8ec1dc173",37,32,62,4.17741935483871,37,0,2,1
"28332","c429c55362fb702455f965cb66472128",66,44,42,11,66,0,2,1
"28333","c429f21ad529c810acce5940b1ae52c7",96,71,56,12,96,0,2,3
"28334","c42ac73b701c3daba72fdc292e74526e",28,28,0,28,28,0,1,2
"28335","c42b2103745a7b3f14a41d04dffaca25",24,24,0,24,24,0,1,2
"28336","c42c6c6e93c2ef5f8beeddaed9e43da9",180,119,69,18.2608695652174,180,0,3,3
"28337","c42d2ece9b3d7a9fc7b0163f9a05fd1e",128,72,75,11.9466666666667,128,0,3,3
"28338","c42e2c3adc57f15db88fab27225d0c17",16,16,0,16,16,0,1,2
"28339","c42f52912226a68dcb75598868fe69b6",22,16,40,3.85,22,0,2,1
"28340","c42f8cc493ec2b2ca909ef23188f624f",17,17,0,17,17,0,1,2
"28341","c431706eccab59804d3d83ceee734a8b",19,11,70,1.9,19,0,2,1
"28342","c431e4c086e58921fb3a8d90c4de846d",189,101,66,20.0454545454545,189,0,3,3
"28343","c4340364bc02a2225c920053331a51f6",51,39,29,12.3103448275862,29,22,2,1
"28344","c434ea6b97256032e30023be29c79b27",102,85,41,17.4146341463415,102,0,3,3
"28345","c43515f5a1632ca58bdfd539717b0e3e",153,79,67,15.9850746268657,153,0,3,3
"28346","c43693724c773a42ebb7d2742f7440ea",24,24,0,24,24,0,1,2
"28347","c436b25494c775ec288a503c5da7a3a9",11,11,0,11,11,0,1,2
"28348","c437371ae5d8465fe5a9ac296b598289",20,20,0,20,20,0,1,2
"28349","c437fa23bb9408fbbfd113e2f143e7b5",36,29,28,9,36,0,2,1
"28350","c437fb14ac5d26de4120d7724c87773e",16,16,0,16,0,16,1,2
"28351","c438d05ae9a0c7deae3f9d7701ecc08d",43,34,13,23.1538461538462,23,20,1,2
"28352","c43d40ec64259ec36de6f3a4478b7cba",46,37,70,4.6,0,46,2,1
"28353","c44301b3fdb716089af32154de7e3feb",97,74,33,20.5757575757576,50,47,2,3
"28354","c44378d7dca3c94fbc83f0e43abc2f28",37,37,0,37,37,0,1,2
"28355","c443bd5bb4b66b5d33700cbcd2fb7eda",45,45,0,45,45,0,1,2
"28356","c4459074a364854910040ce49e415d2a",58,52,13,31.2307692307692,58,0,1,2
"28357","c447c287134847a5cba2a9daca77c208",32,32,0,32,32,0,1,2
"28358","c44891bd58b55ff96d6b2d6cc5c6111b",131,105,35,26.2,91,40,3,3
"28359","c4496a11298daf469a954e6e4b2cc1bb",111,60,72,10.7916666666667,111,0,3,3
"28360","c44b1280f08eb35ef2209ec30a7aaca8",36,36,0,36,36,0,1,2
"28361","c44b179dd5ab9b0c4df95ada4cd92a07",15,15,0,15,15,0,1,2
"28362","c44ba99d89de4c217d45dc8ffaf93b23",162,136,33,34.3636363636364,162,0,3,3
"28363","c44c5e76d66d13f62024a5b93479015c",21,21,0,21,21,0,1,2
"28364","c44de530d2c0140e6659014a5066cc59",26,26,0,26,26,0,1,2
"28365","c44e6960b597c91134f1b8900fd1a0da",59,52,11,37.5454545454545,22,37,1,2
"28366","c45421e31131e870dc9e050d0400747f",87,73,66,9.22727272727273,56,31,2,1
"28367","c4552e18ab691ac67652de9a4d54a24f",92,73,34,18.9411764705882,92,0,2,3
"28368","c455cfa4007c02cee668acab77836bc4",90,70,72,8.75,41,49,2,3
"28369","c455f54fb3527c90d1662441fcdc0bc6",85,66,67,8.88059701492537,51,34,2,1
"28370","c45a325c7cf4316121fa1e2b47306012",21,21,0,21,21,0,1,2
"28371","c45a8dd5edfcbeadf243fc13fe8bd29a",31,31,0,31,31,0,1,2
"28372","c45b016a7cae11314fd6eb82de33003a",23,23,0,23,23,0,1,2
"28373","c45b14a5a64d608732e4f110bb714039",33,33,0,33,33,0,1,2
"28374","c45c5d4932cb517fb22e4c6feb8eaa5e",118,96,36,22.9444444444444,118,0,3,3
"28375","c45df24da42c560e97ac2b4a282cdd26",73,41,45,11.3555555555556,73,0,2,3
"28376","c45e0869f3bdbda2b1c26ba5cb78507a",36,36,0,36,36,0,1,2
"28377","c45e0b33113715d7e1dfb309f7f71fd5",141,115,57,17.3157894736842,141,0,3,3
"28378","c4609dcd098a139e68b770894106abeb",9,9,0,9,9,0,1,2
"28379","c463a3de8609b74a10b652fd41c881e3",151,105,80,13.2125,151,0,3,3
"28380","c464d6089249f644eaaa6d72379396b8",14,14,0,14,14,0,1,2
"28381","c465dfae829f289c7f8b69b345b80dfe",29,22,15,13.5333333333333,29,0,1,1
"28382","c4673b9e64442627f259d75df574d1a3",15,15,0,15,15,0,1,2
"28383","c46f1c4dc8020e51726972602b1cb6a6",40,40,0,40,40,0,1,2
"28384","c47c10dd1008d81cd79b7baf99abf117",20,20,0,20,20,0,1,2
"28385","c47e61c99bcff7fa5d322e60279488a6",15,15,9,11.6666666666667,15,0,1,2
"28386","c480ca0ca688dade15aa61e3a9410088",61,39,64,6.671875,61,0,2,1
"28387","c486d152ca24d874bde527feeca64ece",24,24,0,24,24,0,1,2
"28388","c488072cf274f2f95df54214ef0f0e43",81,62,43,13.1860465116279,81,0,2,3
"28389","c48961f90284668d3232928efac4ce61",21,21,0,21,21,0,1,2
"28390","c48df71b06ee9f0aac60b3b55f599f52",140,61,66,14.8484848484848,140,0,3,3
"28391","c4988404e1d101c7aa4fc324c322032d",122,70,52,16.4230769230769,122,0,3,3
"28392","c49970407f7f4bb313df52cf27408448",36,36,0,36,36,0,1,2
"28393","c4997262c0b6528d8436a179763bcad5",43,42,18,16.7222222222222,43,0,1,1
"28394","c49ecf8001dd08e33ff2815ac6783af7",29,29,0,29,29,0,1,2
"28395","c4a2c7a2e5e07814d79a07789ef3bb5b",2,2,50,0.28,2,0,2,1
"28396","c4a398285ee0bc69f990aec4482bec7b",10,10,0,10,10,0,1,2
"28397","c4a6f771193c80d494cdc5b546d71a61",27,25,21,9,27,0,1,1
"28398","c4a8022f49968e9d5dfbf01efb09fec3",67,57,24,19.5416666666667,67,0,2,1
"28399","c4a8f335ca0b3c53ae7ffcd388e2269a",140,87,62,15.8064516129032,140,0,3,3
"28400","c4ac37eaaa0b9dd2b949e27a6319f97c",153,83,83,12.9036144578313,153,0,3,3
"28401","c4ad3c6bb1a876925f5af8dd0b644ea2",83,60,35,16.6,83,0,2,3
"28402","c4ade4c301bc1c5f6a85d7d61c7e25f6",71,58,23,21.6086956521739,71,0,2,1
"28403","c4aff814fc6530c46945f1edaa4745c4",175,88,90,13.6111111111111,140,35,3,3
"28404","c4b2d14e1c64a4fff61da6ea91bd9214",52,52,0,52,52,0,1,2
"28405","c4b865f329c36218a2bc3da010d25abb",24,24,0,24,24,0,1,2
"28406","c4b9ced872ea8929fe41028f30aadb86",28,28,0,28,28,0,1,2
"28407","c4baebab6403be0827cf342bf8881e28",52,37,70,5.2,18,34,2,1
"28408","c4bd0c4facbdccb844046fd2ee75bf2d",103,79,39,18.4871794871795,61,42,3,3
"28409","c4bf0a0cd74dec526babec50e7a1ead3",2,2,0,2,2,0,1,2
"28410","c4bf3a5e3f5ac2d74a95159d3532328f",82,52,75,7.65333333333333,82,0,2,3
"28411","c4bf3c8a6a776db5526f4f432d0ea401",114,94,88,9.06818181818182,114,0,3,3
"28412","c4bfa720249207dc8a8a13c5e8239d0e",44,36,67,4.59701492537313,18,26,2,1
"28413","c4c42a190088970867965473834cb90a",47,47,0,47,47,0,1,2
"28414","c4c51112cc7d7705886546e8135129a3",126,87,77,11.4545454545455,92,34,3,3
"28415","c4c81cb80fdc8b652b279b6f004ab52d",2,2,0,2,2,0,1,2
"28416","c4cb7f9cef81251ea8b64d86a05b697c",9,9,0,9,9,0,1,2
"28417","c4ceefc191ac8e45410008f76f78653a",42,36,14,21,0,42,1,1
"28418","c4cfa0a063ddfe5e76ea7778fab03898",7,7,0,7,7,0,1,2
"28419","c4d12380e071d667611e78b852d42f3c",206,72,81,17.8024691358025,206,0,3,3
"28420","c4d24f13d0a5dd4b2bb83eb56cd7aa45",6,6,0,6,6,0,1,2
"28421","c4d2b3b4dc6a94618e9fec71d8397d39",141,88,39,25.3076923076923,98,43,3,3
"28422","c4d521dec735058d99f9289a70b13d8f",114,95,36,22.1666666666667,63,51,3,3
"28423","c4d690e3e8b411339665a600cbce5523",24,24,0,24,24,0,1,2
"28424","c4d80113c149f400f6bdaaa15f0fb95a",55,50,77,5,55,0,2,1
"28425","c4dadb018329b83d67838dc0706a1ef3",83,55,65,8.93846153846154,52,31,2,1
"28426","c4dbc47aba637713b3a1ef94f73dd71a",101,78,50,14.14,101,0,3,3
"28427","c4dbdba6ee41ea7e01cd4217044bd88b",28,27,6,32.6666666666667,28,0,1,2
"28428","c4dc0600c839a06a4bf608236c123569",31,25,77,2.81818181818182,31,0,2,1
"28429","c4dc2e0e4c9568fddf7396f2279c4647",57,50,64,6.234375,57,0,2,3
"28430","c4dc45339ecf1cd7ca6c5910b42ef8bd",28,28,0,28,0,28,1,2
"28431","c4dd0caae5d3832024d101fb32b3f4ba",37,35,11,23.5454545454545,22,15,1,2
"28432","c4dffd9186149e0bcfe4397e6bc70243",29,26,55,3.69090909090909,29,0,2,1
"28433","c4e39c5c585ce347392c9362592ab98c",24,24,0,24,24,0,1,2
"28434","c4e94436e9e05d975ac3be87bd106ac7",199,93,70,19.9,199,0,3,3
"28435","c4f138967a9903edf7efa18cd5d8a444",33,33,0,33,0,33,1,2
"28436","c4f2f3b1b5930c8697d22c5a2c7e6b3a",143,81,59,16.9661016949153,97,46,3,3
"28437","c4f2ffe95087a3012fb912bef4b83002",18,10,77,1.63636363636364,18,0,2,1
"28438","c4f72eb294c30e02ab034084f25037aa",118,73,70,11.8,118,0,3,3
"28439","c4f79d00e7fbdf9a60ac76b276206895",14,14,0,14,14,0,1,2
"28440","c4f998c0f433092cf694bb4c9292e2ce",21,21,0,21,21,0,1,2
"28441","c503ffae8de6e7d4a569bac95c973740",49,41,28,12.25,49,0,2,1
"28442","c506284388b155fd0b996dfbaf3e0b81",50,41,48,7.29166666666667,50,0,2,1
"28443","c50b8da36faa8c4e6a2a02f1e3f1f8ae",22,22,0,22,22,0,1,2
"28444","c50c98595ed66ad00c077aded7b8a2db",20,20,0,20,20,0,1,2
"28445","c50e82725072a2b444411e24877c5ab5",142,84,81,12.2716049382716,107,35,3,3
"28446","c50f4b98f42d6642f4791e26c4e8c758",40,30,49,5.71428571428571,40,0,2,1
"28447","c511b0698cc36c5fd26945ddd67d79d0",30,13,85,2.47058823529412,28,2,2,1
"28448","c512810486cd598d59b9d9de7d0e734c",48,48,0,48,48,0,1,2
"28449","c516badc18a60764d1eec8480c9d0b89",65,56,30,15.1666666666667,65,0,2,1
"28450","c516de92950c1a705d851d5d85848179",79,63,60,9.21666666666667,79,0,2,3
"28451","c518bf597d2db8e77b6ff2a2d55461f0",15,7,65,1.61538461538462,11,4,2,1
"28452","c51c8eca6115a88d91aa80bd92f96a5a",42,42,0,42,42,0,1,2
"28453","c51f1def486e1e5f17d67c5e9020b0ab",144,94,80,12.6,144,0,3,3
"28454","c5207cfcdeef52617193b1c8057e8de3",138,71,77,12.5454545454545,138,0,3,3
"28455","c520ce5b32e2ab85f82579ee97369548",17,17,0,17,17,0,1,2
"28456","c52358fde87bbf3070cac0a51e7b3658",54,49,67,5.64179104477612,54,0,2,1
"28457","c524a87434273fe2f647a36814179c76",53,53,0,53,53,0,1,2
"28458","c527eb37f09b9c59a1b92b9b85e292c1",79,55,35,15.8,79,0,2,1
"28459","c528a59955d9d6323d872d5efd39cbc9",180,86,61,20.655737704918,146,34,3,3
"28460","c5295df367490aef21a780300bb40ec1",15,14,5,21,2,13,1,2
"28461","c52e29d19b76d0650e851c82d4d4d456",36,36,0,36,36,0,1,2
"28462","c530be18f5a49ab3d9fb28cc255b4db4",13,13,0,13,13,0,1,2
"28463","c533f974da1307340e384866a6f2b691",168,117,75,15.68,151,17,3,3
"28464","c534c83620b99cde2bdc5e9773c55f3c",27,27,0,27,27,0,1,2
"28465","c534cfe63ddab2d3a52b545b2a17db4b",19,19,0,19,0,19,1,2
"28466","c5357b217aa38c6f704e1354f4afca4c",35,35,0,35,35,0,1,2
"28467","c536cf99df99034e8d5f4b50a8661d0f",235,93,80,20.5625,214,21,3,3
"28468","c537ced4d842afa39b0e4b9f6804b666",106,69,32,23.1875,106,0,3,3
"28469","c5414bf46fa0056babd9a6d441548534",1,1,0,1,1,0,1,2
"28470","c542c15eea52e9335d58953f5aed2326",216,142,59,25.6271186440678,216,0,3,3
"28471","c542f557ab174bf31940efdd97c82ad3",41,41,0,41,41,0,1,2
"28472","c544046c432d35ef83177f3fd12f85c0",218,82,78,19.5641025641026,218,0,3,3
"28473","c544b4f0ca27a39ddd1594acb3bfb118",30,30,0,30,30,0,1,2
"28474","c545f10ea2056e5b667d71beffbfd475",41,41,0,41,41,0,1,2
"28475","c546196d9b2e454035c413b97c064a02",27,27,0,27,27,0,1,2
"28476","c5492eac8ad0cfda9dcf7fe662798a0b",244,141,71,24.056338028169,193,51,3,3
"28477","c54969dc3dd3d12da9f211066c367bd4",197,131,64,21.546875,197,0,3,3
"28478","c54ab520d5200b0a2497025a1cc66e91",177,94,82,15.109756097561,130,47,3,3
"28479","c54b82d0ff84bc615d63b3e5ab82d651",70,47,35,14,70,0,2,1
"28480","c54c91b122c2e022063138c00f6d498a",198,137,59,23.4915254237288,144,54,3,3
"28481","c5559941fd0f7d9097199802cff09933",88,52,49,12.5714285714286,88,0,2,3
"28482","c556bfaf57e95f63ed1b7d9cac4a2d37",91,65,53,12.0188679245283,91,0,2,3
"28483","c55b680eced2caab82b73f329a8f4f05",21,21,0,21,21,0,1,2
"28484","c55ca23c1dc4a160966a2da303853f0e",69,40,47,10.2765957446809,69,0,2,3
"28485","c55cca7263c7a3e80e40431d11c82985",20,15,34,4.11764705882353,20,0,2,1
"28486","c55da05d8fd00eecda379a213afca445",18,18,0,18,18,0,1,2
"28487","c55da780a1209fb2d2fa95bc1418aa42",150,106,76,13.8157894736842,150,0,3,3
"28488","c55ebe9d01f2c4242a3c3e4c4a5783f3",41,41,0,41,41,0,1,2
"28489","c55ec7df41c0f5c7033a8d6225ae718a",69,49,64,7.546875,52,17,2,1
"28490","c55f6182d9aad3e0cca720dc20b11f40",79,72,35,15.8,79,0,2,3
"28491","c56167634ce3f05d5e9d5a25d975517f",11,11,0,11,11,0,1,2
"28492","c561f0b7bc015d3b85906127994e14e4",34,34,0,34,34,0,1,2
"28493","c564674fba2f4aa7a2f2ef10f5ec3585",13,13,0,13,13,0,1,2
"28494","c5673afc4fc7d555a32a19836f5e3537",37,37,0,37,37,0,1,2
"28495","c568f15055dd6775fa879b5975fb7abc",35,35,0,35,0,35,1,2
"28496","c56a3672f806ecec4b33080d2dca776a",30,30,0,30,30,0,1,2
"28497","c56bfd11e60feceb21769d4478ca8629",78,46,55,9.92727272727273,78,0,2,3
"28498","c56d10b2db37f156a4bfb15e7c30f98d",104,72,61,11.9344262295082,104,0,3,3
"28499","c56dad4b18c981f06e8c7ede7c62fddd",22,18,15,10.2666666666667,10,12,1,1
"28500","c57455517d6abc5e6d44e8efa4ca7e47",51,46,18,19.8333333333333,29,22,1,1
"28501","c577418a97817ab3461e9f886294b3b7",17,17,0,17,0,17,1,2
"28502","c57e98e26bf11926a8a7a544ce6cd14a",42,42,0,42,42,0,1,2
"28503","c5809078667be1cf4b079fc42b999778",21,21,0,21,0,21,1,2
"28504","c581336c22c6e311f731cb33d125176d",37,37,0,37,37,0,1,2
"28505","c5820b0f4af18b1f57d0eac962bdbd1f",35,35,0,35,35,0,1,2
"28506","c583920d0fb2c4a422d5434c598d18af",44,31,38,8.10526315789474,31,13,2,1
"28507","c5841a1ddff7bb32f9918b54cb0af1e4",35,26,21,11.6666666666667,0,35,2,1
"28508","c5851fed4f325e0b84a4f290ddfb4783",23,23,0,23,23,0,1,2
"28509","c58831fa1524f3b3b6cf262afa6fc000",35,35,0,35,35,0,1,2
"28510","c588e4c12ad8a4add2099ec78b2fae9c",180,113,65,19.3846153846154,127,53,3,3
"28511","c58982f7759d95c6c55c4d61edc7acd3",81,49,57,9.94736842105263,81,0,2,3
"28512","c58a4b2f2fe6b7f0ad975ec1510521ec",46,46,0,46,0,46,1,2
"28513","c58c8b71426065f0674b4a5cf4938862",141,71,62,15.9193548387097,141,0,3,3
"28514","c58d169927354d5afd03c908a5e72b12",114,86,53,15.0566037735849,114,0,3,3
"28515","c58f74491a1dba906ca0275717b152f2",2,2,0,2,2,0,1,2
"28516","c5902cbf13c809e562533a2e32ef1f4f",130,93,56,16.25,130,0,3,3
"28517","c5921fd337486240de513ed6ebb355c7",66,60,15,30.8,40,26,1,1
"28518","c5979adfd9907fe93f4e56200451eb6f",61,46,21,20.3333333333333,61,0,1,1
"28519","c59a5c8df91e167ed5cde826fa362b44",78,50,47,11.6170212765957,24,54,2,1
"28520","c59b3bbab114931f03b1b1df022d6d90",11,11,0,11,11,0,1,2
"28521","c59b97b54452c35b741f7b504e8e29b1",48,48,0,48,48,0,1,2
"28522","c59c02c4902232be03446ae6a89f66de",39,39,0,39,0,39,1,2
"28523","c59df98b9413bc21d4b6f20e7e59cebf",29,29,0,29,29,0,1,2
"28524","c59f3d3b9b4f16a0b654c3cb8872aa32",39,39,0,39,39,0,1,2
"28525","c5a2e29fc086ac197f92aabb8260675e",110,88,27,28.5185185185185,110,0,3,3
"28526","c5a2e8f113188a756f3e7ffae3a92b8a",83,49,62,9.37096774193548,83,0,2,3
"28527","c5a568de98e7a737dd91dc38e4f010cc",104,47,76,9.57894736842105,104,0,2,3
"28528","c5a99243c65db07d1a336df71e5237ce",35,35,0,35,35,0,1,2
"28529","c5aa524d5d342f2c6658a651401a23c7",15,15,0,15,15,0,1,2
"28530","c5aba6f8e12cb7c9943ec5ae9d35335e",36,28,44,5.72727272727273,36,0,2,1
"28531","c5ac0b88840cefa247e5309b0805babb",11,11,0,11,0,11,1,2
"28532","c5acde3caddedf05207ab5a696c44586",25,25,0,25,25,0,1,2
"28533","c5ae82a738d937182aab4c628bbf2401",65,56,83,5.48192771084337,65,0,2,3
"28534","c5b07b675a27938a8b93b094dcecd555",35,35,0,35,35,0,1,2
"28535","c5b0c60a296e0937201bf7887b493ef1",25,23,23,7.60869565217391,11,14,2,1
"28536","c5b26ef9e8cdbb98fe86422708d9400c",100,69,50,14,100,0,2,3
"28537","c5b3d11e9dbbb7a044705ac1a2661f9b",39,39,0,39,0,39,1,2
"28538","c5b5914cfe21aae34b3d2af35b20c431",21,21,0,21,21,0,1,2
"28539","c5b906217a215780331d57e5825f7715",15,15,0,15,15,0,1,2
"28540","c5ba4ce62dd4edbb7dc7394beb16f969",23,23,0,23,23,0,1,2
"28541","c5baf9137196d9ee599d6cf5259f4a55",54,47,34,11.1176470588235,54,0,2,1
"28542","c5bc5196d09dbafe2f7e805c1a5d4b8a",11,7,61,1.26229508196721,11,0,2,1
"28543","c5be6fccec5734e399da0257c7e5da64",54,48,47,8.04255319148936,54,0,2,1
"28544","c5c184a4968854c9c4f4d79e50f2774f",137,72,64,14.984375,110,27,3,3
"28545","c5c3abaf789eba6893f7b314d6384c05",172,89,62,19.4193548387097,138,34,3,3
"28546","c5c420390357cf12a0bbb6b1449cbe4f",25,25,0,25,25,0,1,2
"28547","c5ca9fc47f0cb647768f1f65e56349f3",21,21,0,21,21,0,1,2
"28548","c5ccb5dd00397f2d43509c0f33cae750",34,34,0,34,34,0,1,2
"28549","c5cdac06741a10d22db5553408a80c74",17,17,0,17,17,0,1,2
"28550","c5d1650bb6b8ca820b3751226a80fe0b",116,63,61,13.3114754098361,116,0,3,3
"28551","c5d36d2aadf10afa7b9cb53393c9e9eb",13,13,0,13,0,13,1,2
"28552","c5d3aec517a2c6f0919a17142f005687",40,40,0,40,40,0,1,2
"28553","c5d449fa7a28a8edd30e57235b45be2e",58,48,11,36.9090909090909,58,0,1,2
"28554","c5d584f786c216c2afef8b09b7462ca9",198,94,76,18.2368421052632,198,0,3,3
"28555","c5d7965db6f0c1d6873748757a7e98e6",12,12,0,12,0,12,1,2
"28556","c5d8926b1b21c0b5cd72cd08f007481c",57,50,31,12.8709677419355,57,0,2,1
"28557","c5d9e1d73fa77ca0c49602450392dfea",47,37,42,7.83333333333333,47,0,2,1
"28558","c5d9fae11e3e87458385124254dfd46f",218,95,75,20.3466666666667,190,28,3,3
"28559","c5df6f678c0b1b2d8b370ea81475ae8e",5,5,0,5,5,0,1,2
"28560","c5e16e947b691defbd24f4d9848a19f2",85,74,90,6.61111111111111,85,0,2,3
"28561","c5e2391c4f60cefab14cbcd2c53b234d",31,31,0,31,31,0,1,2
"28562","c5e671ec943868e1a2564bd5b761490b",63,53,57,7.73684210526316,63,0,2,1
"28563","c5e81e3963e90292ed7a1f5aa7631ada",16,16,0,16,16,0,1,2
"28564","c5ecf5ba3f8be7702f0515f739b35658",104,71,48,15.1666666666667,104,0,3,3
"28565","c5eeb974b189570c9fb07ba0dfea3c8b",39,39,0,39,39,0,1,2
"28566","c5f281d24e6a63d752779403c262b3e1",89,65,30,20.7666666666667,44,45,2,3
"28567","c5f31603cc76bfd48c5912a79690ef90",42,42,0,42,0,42,1,2
"28568","c5f31eb030f939d962a262faa68d3046",82,75,22,26.0909090909091,82,0,2,3
"28569","c5f33822b06e633ccb117c51ca78a62b",56,56,0,56,56,0,1,2
"28570","c5f53d9e8cd09daa23105e28308c12f7",6,3,25,1.68,3,3,2,1
"28571","c5f62c8f3bedd61be62cec440b5bd67e",97,76,74,9.17567567567568,97,0,3,3
"28572","c5f8d52df7e90f45946c5946176613db",29,29,0,29,29,0,1,2
"28573","c5f8d636692ece9c055406516972395d",49,49,0,49,49,0,1,2
"28574","c5f9b71d3ad388112f954222b84805c1",37,27,50,5.18,37,0,2,1
"28575","c5faf808f36d3632475ced654ea8902c",22,22,0,22,22,0,1,2
"28576","c5ff674421796985035e83f59e5a7b06",94,56,67,9.82089552238806,73,21,2,1
"28577","c60121c77cf6f4dedbc7670f1c82ccc3",40,32,49,5.71428571428571,40,0,2,1
"28578","c6024db626401f978474b1dccd796e24",40,37,43,6.51162790697674,23,17,2,1
"28579","c60561a89e4764345b4b52e5bcf5feb3",18,18,0,18,18,0,1,2
"28580","c60b34d547d7f7516c6ef2069afb358c",97,70,33,20.5757575757576,44,53,2,3
"28581","c60d34f40dcd108a758507fefacb89fc",49,38,23,14.9130434782609,49,0,2,1
"28582","c60f584e6dc0a8a263cc7b2e99d6a3b8",14,14,0,14,0,14,1,2
"28583","c61167c2792f80462888d701da517e9a",31,31,0,31,31,0,1,2
"28584","c61186ee36de2a31fe3dac06133a1721",29,29,0,29,29,0,1,2
"28585","c611a84efdd58cc5adb8f97adeb6dcaa",45,33,50,6.3,45,0,2,1
"28586","c61272d66055a59a845f5570270272ba",79,72,71,7.7887323943662,46,33,2,1
"28587","c6140dbdbf3ab7adf2d87bca241146a3",26,26,0,26,26,0,1,2
"28588","c615f4f4609c060cadc5f61eddc7cef7",256,115,55,32.5818181818182,216,40,3,3
"28589","c617671bb7c0385326ffb16600f4412e",35,35,0,35,0,35,1,2
"28590","c6176c2021b2d1fdd0ceb569c968a87e",216,109,62,24.3870967741935,194,22,3,3
"28591","c6188bab5f595ab1d372f56873583ea9",22,22,0,22,22,0,1,2
"28592","c619c1fe9b403ce1bc7fb9629c674d90",10,10,0,10,0,10,1,2
"28593","c61a44fde6098bb6efbfd6dc64dd45f1",195,94,82,16.6463414634146,195,0,3,3
"28594","c61bcf39cfddff2e10708da88132f241",38,38,0,38,38,0,1,2
"28595","c61c06b195a65068307d427020e61827",41,41,0,41,41,0,1,2
"28596","c61f08bbd9f510c5154c5ae32dd1ce4d",186,80,66,19.7272727272727,186,0,3,3
"28597","c6222357f49d617b03296ae78243528c",73,56,32,15.96875,25,48,2,1
"28598","c6228c9fc1f5ad3e61d08c565cdb8a1e",8,8,0,8,8,0,1,2
"28599","c6251ab05d6db4872853e605dba1ea52",37,24,61,4.24590163934426,25,12,2,1
"28600","c625db6ad847cdb14710277b628988bc",27,27,0,27,27,0,1,2
"28601","c62619209079b7ccb1e55d1871016639",98,53,56,12.25,71,27,2,1
"28602","c62635dfcf3134ea86f340ffdb6b187f",40,40,0,40,0,40,1,2
"28603","c628ab27d20f1b984600cf0b68de2634",88,65,22,28,88,0,2,2
"28604","c62ade3985a528e2d6ca04c300b60568",39,29,44,6.20454545454546,39,0,2,1
"28605","c62b44ddfb537fc4595c292c6050afa3",85,56,50,11.9,85,0,2,3
"28606","c62c831962018d64e5eacc00e1afc923",11,11,0,11,11,0,1,2
"28607","c6300aa75cc216783598523d59962ac1",25,25,0,25,25,0,1,2
"28608","c6309ef73375164cb501263f384184bf",19,19,0,19,19,0,1,2
"28609","c6341662999c8ce93ab53c01ea4f595e",44,40,19,16.2105263157895,22,22,1,1
"28610","c634ea32153f6192f1eed463c19e415f",26,26,0,26,26,0,1,2
"28611","c6355ca005be38539c85978047d55aba",74,48,42,12.3333333333333,74,0,2,3
"28612","c635c1e9146ebe568f6dd4b544d31198",46,36,58,5.55172413793103,36,10,2,1
"28613","c6370996f7890dd8bc8cdc8b3139d9d5",197,95,69,19.9855072463768,159,38,3,3
"28614","c637f44a2327b91571fd289e58aa23f9",158,95,68,16.2647058823529,158,0,3,3
"28615","c638e8f62b64bb2d35704b43d24967e6",41,36,12,23.9166666666667,41,0,1,1
"28616","c63d949b997db21f806c491423100280",96,81,45,14.9333333333333,96,0,3,3
"28617","c63e3e21876c7947c1cde48fbd94db61",37,23,74,3.5,13,24,2,1
"28618","c64372621e2f6d5ebf467fb44b57246f",79,46,56,9.875,64,15,2,1
"28619","c64485e8a82cccd0232ece930bc04f68",16,16,0,16,16,0,1,2
"28620","c646b8aa35e62996405905a03ab28412",62,45,43,10.093023255814,44,18,2,1
"28621","c646d46f7cfb3d2bd210b4ad03f26553",30,30,0,30,30,0,1,2
"28622","c6485cdb2308c506352685f40c49a52f",70,60,69,7.10144927536232,70,0,2,3
"28623","c649fb20466655b8b96a6de7476df20a",42,31,77,3.81818181818182,42,0,2,1
"28624","c64de7897faf7148b2c91e36ff145543",27,27,0,27,0,27,1,2
"28625","c652360de93a419e64bfc9690fdf9309",42,42,0,42,42,0,1,2
"28626","c6530afe4122a8ea5d1999930240eeb3",23,23,0,23,23,0,1,2
"28627","c654626cbd758ae02d18a48308b3835b",13,13,0,13,13,0,1,2
"28628","c656df0f76ea594e510d7197779de709",247,88,84,20.5833333333333,203,44,3,3
"28629","c658221f33fa796189913a66c4b96aa0",214,88,83,18.0481927710843,188,26,3,3
"28630","c659c04968e7ff32cca840c986481d15",126,94,68,12.9705882352941,126,0,3,3
"28631","c65a66ce39558795a1046e1a4c227b54",104,64,63,11.5555555555556,104,0,2,3
"28632","c65a9416e1397ec5e716c039aaf43579",130,89,54,16.8518518518519,79,51,3,3
"28633","c65bf41eb4b1f23eb86237b8d90ec3f0",185,95,73,17.7397260273973,185,0,3,3
"28634","c65c04cb4ce85fd38966df449399bbe3",71,52,30,16.5666666666667,36,35,2,1
"28635","c65cf68cdd0eda40b83ae1ee39dc0917",28,28,0,28,28,0,1,2
"28636","c65cf79f0a6bea05471137092a26b94d",93,80,13,50.0769230769231,93,0,1,2
"28637","c65d6cc19acf6d8d33c3a095f0ad7037",87,65,27,22.5555555555556,87,0,2,3
"28638","c66100ba5f2b954653c7feb6e1515d7f",50,36,44,7.95454545454546,50,0,2,1
"28639","c6640d89d6457b236cfda0163e400f86",37,37,0,37,0,37,1,2
"28640","c6668f384462047432e564fdb3ea3fcd",25,25,0,25,25,0,1,2
"28641","c668fd826e14e9c090ea790887b5dbb9",31,31,7,31,31,0,1,2
"28642","c66906c31ac60aeb52562a7841ef5afd",159,120,63,17.6666666666667,159,0,3,3
"28643","c6696d4692bacc3e83bada11b6688507",12,12,0,12,12,0,1,2
"28644","c669beaf88ce96b9cfdcf9f4e57ea8f9",10,10,0,10,10,0,1,2
"28645","c66b0010848fdc004f21c537d793fb62",40,35,35,8,40,0,2,1
"28646","c66bf34931c4c34d830b20b03de00d46",37,37,0,37,37,0,1,2
"28647","c66fe143950e1cc9f418db5bde75b7af",114,77,57,14,114,0,3,3
"28648","c6709cdb914cb0f1434071312006c256",126,85,78,11.3076923076923,105,21,3,3
"28649","c670b389f08638f0cb0e6b846b624482",22,22,0,22,22,0,1,2
"28650","c670f1c3151b0848c6d1c37c9c1e76eb",8,8,0,8,8,0,1,2
"28651","c67167a1b47140198c1faf04cdd0407d",154,96,65,16.5846153846154,154,0,3,3
"28652","c676376b67f855381b2856eb10f25464",18,18,0,18,18,0,1,2
"28653","c67770b85a3dab439469b69513ff4369",96,70,40,16.8,96,0,2,3
"28654","c677f6012c9b8c3ed6d9260185a0bdb2",9,9,0,9,9,0,1,2
"28655","c67b2f881627d9f965d38a92c94ad752",10,9,41,1.70731707317073,10,0,2,1
"28656","c67c9460591a667023cb05a1155d22a1",15,15,0,15,15,0,1,2
"28657","c680bbd907a404662bed44a1444f8b8e",55,43,21,18.3333333333333,55,0,1,1
"28658","c6829331b29895f88a3830e7c5906608",24,24,0,24,24,0,1,2
"28659","c6839392376247ec96217070c510eff0",17,17,0,17,17,0,1,2
"28660","c685279b4eddc547823c221af6f15944",233,93,77,21.1818181818182,194,39,3,3
"28661","c6887735464c7481b33ffb9976757dd4",20,20,0,20,20,0,1,2
"28662","c689149fb9e5c9ccb66efa01d2bd01b7",140,93,34,28.8235294117647,140,0,3,3
"28663","c68936fd15a35b137489007cbae18057",25,25,0,25,0,25,1,2
"28664","c6896989d9d45eb2390f0ac47cb10926",10,10,0,10,0,10,1,2
"28665","c68af96d2792bb6e0343d75941745037",95,71,32,20.78125,41,54,2,3
"28666","c68ca44a5ee3199c030e94e8061bb576",31,31,0,31,31,0,1,2
"28667","c68e3378c40a2574f6891448a8198196",123,80,77,11.1818181818182,123,0,3,3
"28668","c691c3918cb4c02da3f2d13c49f56fac",34,34,0,34,34,0,1,2
"28669","c691db721d3c6bf8288c9731fc2a29ac",151,104,62,17.0483870967742,122,29,3,3
"28670","c69203cff3b2ded1083c142fa1263904",16,16,0,16,16,0,1,2
"28671","c694082e6b5b8d3974717828450ea5e3",52,52,0,52,52,0,1,2
"28672","c694a02efdf1f547f44c07f3c201fe7e",19,19,0,19,19,0,1,2
"28673","c697f79a30dfbe4a4f469d4ed48d2774",76,61,24,22.1666666666667,76,0,2,1
"28674","c69877fcb989671bf73f16fdb01d4bbb",67,63,20,23.45,67,0,2,2
"28675","c69d2e1e5ec431bc5c9f2e1186edff59",67,43,82,5.71951219512195,45,22,2,1
"28676","c69d7692b1554693ae0e4c12a7ebcd10",108,38,74,10.2162162162162,108,0,2,3
"28677","c6a031ad555617e2d024f7fce64f955d",129,69,65,13.8923076923077,104,25,3,1
"28678","c6a13dec295dd1c9fb41b9ab15e74164",92,80,39,16.5128205128205,92,0,2,3
"28679","c6a29274cdab3eb17234583f16d20b38",172,92,42,28.6666666666667,172,0,3,3
"28680","c6a51cc5633256489cfaa8d3270181bd",27,27,0,27,0,27,1,2
"28681","c6a55739189cb22edf03466b2d3c795b",50,38,50,7,50,0,2,1
"28682","c6a8afc7ad453cd6dc291b1191926d0f",9,9,0,9,9,0,1,2
"28683","c6abbceb5d7b4ddd4e5ff92d3e17694e",38,30,45,5.91111111111111,38,0,2,1
"28684","c6ae94907b6b5ae55a4779c6a5413b30",19,19,0,19,19,0,1,2
"28685","c6b4ac314c3a5498c9a023e1f4a3c3bc",22,21,63,2.44444444444444,22,0,2,1
"28686","c6b4e2b3117427a0c8357cfb4356ab1c",12,12,0,12,12,0,1,2
"28687","c6b50a204b4e6f0b1ca620cb6ffb957e",28,25,15,13.0666666666667,28,0,1,1
"28688","c6b57705bea614e1de36dd3e2d3f729c",116,90,59,13.7627118644068,116,0,3,3
"28689","c6ba6b15f8b6e8fbed66659b2fcce88f",35,35,0,35,35,0,1,2
"28690","c6bdb61453b752cc75b089e8fd1a2a19",99,82,27,25.6666666666667,54,45,3,3
"28691","c6c25115592cfe0c314675c3b90e0c0d",56,49,19,20.6315789473684,56,0,1,1
"28692","c6c3c0929ec724ffbc90c541a8ea1966",187,81,90,14.5444444444444,187,0,3,3
"28693","c6c4b05b33acdfc4ae8ccaff0a0022fa",131,82,20,45.85,131,0,3,3
"28694","c6ca50f5bbf9b7ec479248f41bf8afab",79,56,63,8.77777777777778,79,0,2,3
"28695","c6cb9ad2e29070a15e081ac6f29849c3",74,63,68,7.61764705882353,51,23,2,1
"28696","c6cbadb417dbd00dab75bd2b2de792ea",98,48,72,9.52777777777778,72,26,2,1
"28697","c6d53c1c0b5f26f0d8484dea615cbb8f",96,77,43,15.6279069767442,96,0,3,3
"28698","c6d5d163878faa8f39cf90f9c283c820",95,69,41,16.219512195122,95,0,2,3
"28699","c6d694c393a19750ed70e31206e4da27",20,20,0,20,20,0,1,2
"28700","c6d89e827de38a434a43f7d24ff1367b",58,49,51,7.96078431372549,58,0,2,1
"28701","c6d8d0b35a806155361470270ea487bb",47,47,0,47,47,0,1,2
"28702","c6d915fac702456613de633e077da168",11,11,0,11,11,0,1,2
"28703","c6db3829aabec45b4a68026b1f7870bf",26,25,50,3.64,26,0,2,1
"28704","c6db674a0d6bab9c3749238b92248185",32,32,0,32,32,0,1,2
"28705","c6ddff839afebbc44e8d4ff81befdb99",53,50,48,7.72916666666667,53,0,2,1
"28706","c6e1a748d68657b306f986bf549a7d92",37,37,0,37,37,0,1,2
"28707","c6e1dcec1af94f5b36f07474e0acf573",47,36,62,5.30645161290323,47,0,2,1
"28708","c6e3af07301a1f603f7585239bcb8b83",23,23,0,23,23,0,1,2
"28709","c6e41bab4f4b233bbe60b5f5481b1774",98,71,30,22.8666666666667,50,48,2,3
"28710","c6e4c527b5c9f31d9c2ec95052a86869",19,19,0,19,19,0,1,2
"28711","c6e6995e1205e890bd3bdac45488a074",47,47,0,47,47,0,1,2
"28712","c6e85b8d7814af448eefaa0339c6202a",43,43,0,43,43,0,1,2
"28713","c6e87ce654d4c83ce36a29cb558f49f8",12,12,0,12,12,0,1,2
"28714","c6eaef64f25aefacec71175823335624",26,13,63,2.88888888888889,26,0,2,1
"28715","c6efbb3e1334f0e450d97a422f66aa59",54,54,0,54,54,0,1,2
"28716","c6f2a080d300582753cae7dda6655407",4,4,0,4,4,0,1,2
"28717","c6f2c31661e8809e41f53a86e4ea33c0",40,38,78,3.58974358974359,40,0,2,1
"28718","c6f4345a5e0c05b1ba422572b2ea5cbb",36,36,0,36,36,0,1,2
"28719","c6f5390c121f18ff7cf434bebf3f9fed",10,10,0,10,0,10,1,2
"28720","c6f5fc743919c1b467e91cd86482cdd7",16,16,0,16,16,0,1,2
"28721","c6f770e1a1e2770951b7fd143c919744",198,109,77,18,167,31,3,3
"28722","c6f8ec082951d6f4d327a2164fa2ff5d",18,18,0,18,18,0,1,2
"28723","c6f9b5b0a234ac3b93bcc1c6596a8d15",28,28,0,28,0,28,1,2
"28724","c6fd4d6c523f4503b0ad7b901aaaf5e2",95,51,61,10.9016393442623,76,19,2,1
"28725","c6fee635f3e21c7998b56791f767f73a",6,4,36,1.16666666666667,6,0,2,1
"28726","c70012b1a9d72d07cf5eb2e041adf814",42,42,0,42,42,0,1,2
"28727","c7003eaa494a6c0f7fabb1d4ee542fa7",51,51,0,51,0,51,1,2
"28728","c70136ed13e8ae85fe3acce1014d6e7f",122,91,89,9.59550561797753,70,52,3,3
"28729","c702723079538986d09b3af7daa59021",45,37,11,28.6363636363636,29,16,1,2
"28730","c705223af4eee415313d7e3b5ce4f0c7",38,30,40,6.65,38,0,2,1
"28731","c706cb097978a6399b5d5b53c0613605",90,60,67,9.40298507462687,58,32,2,1
"28732","c70a288c6030878cc7a0029c88b3b089",21,21,0,21,21,0,1,2
"28733","c70e72e5f87e004c55e647f31e47f40f",43,43,0,43,43,0,1,2
"28734","c70e735201415e2453bb9b2dd9e239f5",14,14,0,14,14,0,1,2
"28735","c70f8ccc094c58eb4518aaf7dd1ac7e6",94,59,64,10.28125,48,46,2,3
"28736","c71400473c1d647818fef323658a043b",65,46,42,10.8333333333333,65,0,2,1
"28737","c714f8df0dfcaf4501ad1f56c781f0e6",44,35,20,15.4,44,0,1,1
"28738","c715b793857cbfd5d7c57fe4aad2b82f",19,19,0,19,19,0,1,2
"28739","c7174ba85756805c3e24f299c3eaca8d",10,10,0,10,10,0,1,2
"28740","c718d7a27e4fe914736dd40a9ecd06be",132,88,70,13.2,94,38,3,3
"28741","c71dded2e29581b464ff6050b9ba4b6f",35,35,0,35,35,0,1,2
"28742","c720e6f577e90b18255e219f4cacd625",171,79,82,14.5975609756098,171,0,3,3
"28743","c7222b115a652800cc627ab8c37a5424",52,28,40,9.1,52,0,2,1
"28744","c7231010107e5f54d6c06fe48b7ea449",47,38,50,6.58,33,14,2,1
"28745","c726036c1752018c45dbd04d0db8b742",246,110,66,26.0909090909091,202,44,3,3
"28746","c72902a929a610a43336a4aefc6ed494",24,24,0,24,24,0,1,2
"28747","c72b248d84d1f5874070f996c276a230",35,29,52,4.71153846153846,20,15,2,1
"28748","c72d5f06a63f9743f301e3f68a5b6744",57,19,76,5.25,57,0,2,1
"28749","c72d6de91aaa1cb95f8d307739942d91",12,12,0,12,12,0,1,2
"28750","c72f03eff9751bf94d0b38c26f47c294",85,64,77,7.72727272727273,85,0,2,3
"28751","c7319c24ff3021a89b6e81450777d65a",52,49,73,4.98630136986301,18,34,2,1
"28752","c732d0c0020d951b1dcf6d110f6c9332",32,32,85,2.63529411764706,32,0,2,1
"28753","c734d25ea5af4fe673f71bd5d5b6043e",21,21,0,21,21,0,1,2
"28754","c7374a0135e57bd385c8c42cc14d8cab",83,65,81,7.17283950617284,38,45,2,3
"28755","c73e07b7440da19b6f6c6cf7516f6d2b",45,45,0,45,45,0,1,2
"28756","c73ee071495eaf91600051e00d4a8ef4",17,17,0,17,17,0,1,2
"28757","c73f5397b744a4fe018e2e2d3c2cc9f2",11,8,49,1.57142857142857,11,0,2,1
"28758","c741fd88684959719b21a9103d7c0cac",77,63,68,7.92647058823529,77,0,2,3
"28759","c7431050a3865b3abdd1085b4373861d",35,35,0,35,35,0,1,2
"28760","c7449c3de4d362803684b76e5d57ece6",34,34,0,34,0,34,1,2
"28761","c74505ccaee477c90d9ca85326375504",35,35,0,35,35,0,1,2
"28762","c7457683caf144c3fd638cfe4a58890e",53,53,0,53,53,0,1,2
"28763","c74886df37b6b01b044c8141fbe42f97",155,126,74,14.6621621621622,108,47,3,3
"28764","c74a0be9395dbc7dd53c22939e121418",145,89,86,11.8023255813953,129,16,3,3
"28765","c74d2b3f13483756c330efb1c3250553",62,55,62,7,62,0,2,3
"28766","c74f55fec292a52fe7b077700a3f22d9",104,80,48,15.1666666666667,104,0,3,3
"28767","c7534554b6c8753770dfde13f7354b48",82,59,57,10.0701754385965,64,18,2,1
"28768","c75b36b54f965f92f30838e40b8bef90",95,78,49,13.5714285714286,95,0,3,3
"28769","c75c0db5b680f8a01d7b86c9b7c59e18",5,3,56,0.625,5,0,2,1
"28770","c75e0e8a7b37c7051243cfa5c8251fd3",20,20,0,20,20,0,1,2
"28771","c75ed5b35ee4822ede3ae280d00f322d",143,95,89,11.247191011236,142,1,3,3
"28772","c75fdecc6807660e3bac2762e44ab5a3",52,52,0,52,52,0,1,2
"28773","c762ac4b80fa2db79f6fa95ca58c0f98",29,29,0,29,29,0,1,2
"28774","c762f7ed891f9d9595b9ec1e0eea7521",22,22,0,22,0,22,1,2
"28775","c763873fe5d18d71fc8047480447a6d4",23,23,0,23,23,0,1,2
"28776","c76609bf8bf7898976c8972f55a01e2a",84,60,64,9.1875,42,42,2,1
"28777","c7671f0978844fa8aca172bd548941a7",18,18,0,18,18,0,1,2
"28778","c7676054eace88a1887ffcf40b74a2c3",37,37,0,37,37,0,1,2
"28779","c768f7e96e572bbb2bab792deeed962f",164,97,72,15.9444444444444,164,0,3,3
"28780","c76a60d04c6247d45c80bf810cc8ad41",5,5,0,5,5,0,1,2
"28781","c76c5d0ccd42160ca822dd12ef0992be",19,19,17,7.82352941176471,9,10,1,1
"28782","c76d21c2d69b0e06ef65111410a39ec1",27,27,0,27,27,0,1,2
"28783","c77029a57262655e6bb4afd9ac6582c4",187,150,61,21.4590163934426,150,37,3,3
"28784","c77155086aa5bb0ce16cf5c7241a6b59",31,25,48,4.52083333333333,31,0,2,1
"28785","c77485a1b9e3e0b567dfdb81a1535ddf",46,46,0,46,46,0,1,2
"28786","c7780314293dc8677af731cb206766e7",29,11,54,3.75925925925926,29,0,2,1
"28787","c7788180d7ff02718e20133e9d1b4993",30,30,0,30,30,0,1,2
"28788","c77cc30aeb8f2f5dba6671e4c0d1c1e5",166,113,63,18.4444444444444,166,0,3,3
"28789","c77dc90466053407866944852f39d88a",33,26,47,4.91489361702128,33,0,2,1
"28790","c77e98558d1df2b971cd9e66dca58008",59,44,87,4.74712643678161,36,23,2,1
"28791","c782cbfa2bd0c7935a34de22e3ac7b90",107,59,54,13.8703703703704,107,0,2,3
"28792","c782ffc2fb27b81bfc4548652b96acbb",17,17,0,17,17,0,1,2
"28793","c7842672d3ccbf046859a1c7b91921fd",180,112,74,17.027027027027,180,0,3,3
"28794","c787c25183417fd11961885d8e723c21",37,37,0,37,37,0,1,2
"28795","c78b5cdafa7e14d8cf69abd80fe93eaf",113,81,75,10.5466666666667,87,26,3,1
"28796","c78dcc5aebb7a5c69d5b872b311f44a4",45,43,46,6.84782608695652,45,0,2,1
"28797","c790be9dd47c407f2eccf269a9509957",88,51,43,14.3255813953488,59,29,2,1
"28798","c7926480bafc31df487ee0ad687db0cd",43,43,0,43,0,43,1,2
"28799","c792b4ff03f32d5a758843d2e7c4153e",9,7,64,0.984375,9,0,2,1
"28800","c7974e2e23a2fe19534375116991776a",24,24,0,24,24,0,1,2
"28801","c797f095c6a8abdb77dbde06a0b37b81",3,1,73,0.287671232876712,3,0,2,1
"28802","c7989ecd273f1bcf5424568895f47779",7,3,81,0.604938271604938,7,0,2,1
"28803","c79cb41b577fb673232d6218c648b3c1",101,74,34,20.7941176470588,51,50,2,3
"28804","c79f5123233545ba4634eee9a594e942",110,74,76,10.1315789473684,66,44,3,3
"28805","c7a64ae2a9fd2f5846416257c386319b",40,40,0,40,40,0,1,2
"28806","c7a68450eeb25a5ec578dd9522021b30",37,24,67,3.86567164179105,26,11,2,1
"28807","c7ab21b686e533f9e89c2d145943555c",17,15,17,7,17,0,1,1
"28808","c7b0bbe6a4bbff7812be015791263c25",187,92,80,16.3625,166,21,3,3
"28809","c7b1aed8921fb92716911293e7f6afd7",87,78,47,12.9574468085106,59,28,2,1
"28810","c7b3ed8cb10dccd3219c0fb92537ed19",87,63,58,10.5,87,0,2,3
"28811","c7b585f26aaccd4c651ed3c1c5646797",38,38,0,38,0,38,1,2
"28812","c7b9286a7e8065b7d8cbbca3a7b5f332",20,18,81,1.7283950617284,20,0,2,1
"28813","c7bf1ee45860f99189e8b928001b79db",146,97,44,23.2272727272727,146,0,3,3
"28814","c7c036d0711313e06d14ad48a7e72367",29,29,0,29,29,0,1,2
"28815","c7c1ab36710ed75ae8593a80f1c263d6",36,36,0,36,0,36,1,2
"28816","c7c49a7c9c34f8872eba7e54038ef79b",98,83,15,45.7333333333333,98,0,3,2
"28817","c7c49d23923328ec1601cb29663fe017",21,21,0,21,21,0,1,2
"28818","c7c570f73d6cf1aa7c4e4ac2cc4728cf",11,11,0,11,11,0,1,2
"28819","c7c9117c69f4fea07bb3ea9ee428b8c8",127,86,69,12.8840579710145,127,0,3,3
"28820","c7ca8b1ccf766448addd1265dc1b1825",37,30,60,4.31666666666667,15,22,2,1
"28821","c7ce4252349686aa947d2405e4083ca3",3,3,0,3,3,0,1,2
"28822","c7cfcffa6f2fd1c1595d5287d6aac94e",53,34,76,4.88157894736842,37,16,2,1
"28823","c7d006bd88d37f495dea8bdb902f32b0",47,47,0,47,47,0,1,2
"28824","c7d573c3f6d7277f0cf8f8b1bdde7633",91,58,62,10.2741935483871,91,0,2,3
"28825","c7d5b81b6302e2780d1a94befca56cbf",42,42,0,42,42,0,1,2
"28826","c7d70b50a58ff18a0755948d77ca0fe5",43,28,7,43,43,0,1,2
"28827","c7d76b5d967343f39c9abaa3a836e75f",23,23,0,23,23,0,1,2
"28828","c7d7ba41a203366096aa2ed6c41d36b2",55,38,64,6.015625,39,16,2,1
"28829","c7d7d809b7750a1ac2837e52991c40be",44,44,0,44,44,0,1,2
"28830","c7d9416d94f5b4a1ffbb1529b3fb73b7",129,92,42,21.5,129,0,3,3
"28831","c7dcdeaec6683a03e23beec36954ad35",144,103,78,12.9230769230769,92,52,3,3
"28832","c7dd8653e54cd636cd6fc784c57862b6",77,44,70,7.7,63,14,2,1
"28833","c7de02343a4d2c89bce86ab7f9abcb0e",37,37,0,37,37,0,1,2
"28834","c7ded3b3427cfddd9eb542687a79a8a1",18,18,0,18,18,0,1,2
"28835","c7e02a6f4a0550ecae8652b3302b4985",125,59,73,11.986301369863,80,45,3,3
"28836","c7e03e2f20d55828740a7eea332e7b5d",74,47,52,9.96153846153846,74,0,2,3
"28837","c7e55df719490741cf20604e8fbdb005",167,120,60,19.4833333333333,167,0,3,3
"28838","c7eaa3eb1fe3707fc94db98284ac4080",33,33,0,33,33,0,1,2
"28839","c7ece25bd89c6fe96727451127482014",97,74,59,11.5084745762712,97,0,2,3
"28840","c7ed3741a7e65968f9129d2c291affc8",13,13,0,13,13,0,1,2
"28841","c7ee267d494934c866c7b28b6167892b",16,16,0,16,16,0,1,2
"28842","c7ee6c6ab98d84f54985dcfcdfeca7a1",117,60,71,11.5352112676056,98,19,3,1
"28843","c7ee93c24255b5e210d8c75f443fe2d0",97,58,71,9.56338028169014,54,43,2,3
"28844","c7f1263dce651f43bee9779992ca63ad",100,64,64,10.9375,84,16,2,1
"28845","c7f1515ee3d7db0bb1b864d1fa681238",155,85,80,13.5625,123,32,3,3
"28846","c7f1a975145155252dc4aea36726132b",34,34,0,34,34,0,1,2
"28847","c7f4ac8d6595815d2e61eb8c6c745ea7",120,65,55,15.2727272727273,76,44,3,3
"28848","c7f7d426c8eee3844c6c243e695f7c06",4,4,0,4,4,0,1,2
"28849","c7f82e5c51bf8673259bb9eed66972e1",74,59,46,11.2608695652174,43,31,2,1
"28850","c7f92a4be090d6934e0705c5399fb789",24,16,46,3.65217391304348,24,0,2,1
"28851","c7f94e9877444bfb9d2e4542d3dd2f9a",113,72,73,10.8356164383562,113,0,3,3
"28852","c7fa53287af287e3ecc60c79babb2072",18,18,0,18,18,0,1,2
"28853","c7fae0e3865cc2f2a1366d3eec8afe4c",125,86,28,31.25,125,0,3,3
"28854","c7fbc5fea0fdfbf1bd2b05d769422b13",128,51,74,12.1081081081081,128,0,3,3
"28855","c7fcae944e78510d587bdc8df29c3b7b",25,25,0,25,25,0,1,2
"28856","c7fd279becb37b0d98cc2c5e9ddfaab3",16,16,0,16,16,0,1,2
"28857","c8013766326b4a34d7637cc92d0c8d54",21,21,0,21,21,0,1,2
"28858","c8017e7f2c8d60b008cc371e7e89777e",55,44,28,13.75,0,55,2,1
"28859","c801ef8937800647aa50f666b58f1d61",23,23,0,23,23,0,1,2
"28860","c803b2738ff8a367e0798537466f3914",27,27,0,27,27,0,1,2
"28861","c80523bd96fe5c8dff0b89b6680ec83b",186,94,84,15.5,186,0,3,3
"28862","c805ea247d8a15e8e556d2fd87df5f57",36,27,40,6.3,36,0,2,1
"28863","c809d51760786baca593b2cb1a4e4c1d",22,22,0,22,22,0,1,2
"28864","c80e39dbe1460e42c65e51c35c5c1ff8",19,19,0,19,19,0,1,2
"28865","c810273fa82dbd2b7f7d616b96c099b1",182,110,85,14.9882352941176,182,0,3,3
"28866","c811c9c7661f385c6e0056386fe0b008",56,35,59,6.64406779661017,38,18,2,1
"28867","c8120d3e9306170e8fc0f348614061ce",52,39,28,13,52,0,2,1
"28868","c8123ca362ee4b80897edc28836a6972",14,14,0,14,14,0,1,2
"28869","c8125e0e7cad449ba6afd10303d6f736",68,55,35,13.6,68,0,2,1
"28870","c8138921567eabde5fde502e033b32e4",45,45,0,45,0,45,1,2
"28871","c813d73c8d9be894846c838e05afea7f",105,75,56,13.125,105,0,3,3
"28872","c8147782d3aafee32e1b9bf8f137c26a",47,38,30,10.9666666666667,27,20,2,1
"28873","c8175f13551be7e61ad0d29bacaa1c5b",5,5,0,5,5,0,1,2
"28874","c81b5a32083ade7323f978a2bb03ffed",188,78,78,16.8717948717949,161,27,3,3
"28875","c81d2b985f245a286131fc74edc08a37",30,30,0,30,30,0,1,2
"28876","c81e6b5f9a8c5995ac4a48ce300ee549",26,26,0,26,26,0,1,2
"28877","c81f018f7ef1044e1f0505e66a38f251",130,64,70,13,130,0,3,3
"28878","c81f8532eb929ac8c758ed9ed177dc73",46,46,0,46,46,0,1,2
"28879","c82284682f2807a1fc05621998e814fe",98,82,43,15.953488372093,98,0,3,3
"28880","c8267bc6b992f7fa412f0d7e69f338b1",42,42,0,42,42,0,1,2
"28881","c82954fb5f9fb121afeec0d251563556",21,21,0,21,21,0,1,2
"28882","c82996b72f6773604a075b78e2145e7d",17,17,0,17,17,0,1,2
"28883","c829f1e2d825bc0d850fedce8511c271",8,8,0,8,8,0,1,2
"28884","c82c9351aca483269c40ff062939419f",45,45,72,4.375,44,1,2,1
"28885","c82e314144a050117c1daa750e402fcf",32,32,0,32,32,0,1,2
"28886","c82ec8479b9c51e8c9a65141d619b2b2",157,65,82,13.4024390243902,157,0,3,3
"28887","c8306227837ba031d1e3755870a6e7eb",210,132,70,21,210,0,3,3
"28888","c83180aaf20c3bbbc876c363d6b36897",16,4,75,1.49333333333333,16,0,2,1
"28889","c832e33ca8bc1e6454fe4e464049ba1f",38,38,0,38,0,38,1,2
"28890","c8341cc0266dfbe3bf8586e12f4dcac4",18,18,0,18,18,0,1,2
"28891","c835235a1cf282410d86bee5fdb03795",147,62,34,30.2647058823529,147,0,3,3
"28892","c8359b3c6d035fcd63680a7a26261400",26,26,0,26,26,0,1,2
"28893","c8384c83d324d0e12353b202df0e62dc",52,47,10,36.4,24,28,1,2
"28894","c8397f137e184b7c27ad2c9e9bde8c9b",119,56,64,13.015625,119,0,3,3
"28895","c83c7e75e6d1fa535155e6cd0c1ebfbb",31,31,0,31,31,0,1,2
"28896","c83d366c9febd2e1ab08abd7959f4531",25,19,6,29.1666666666667,14,11,1,2
"28897","c83d4a79c1545fe3c195a22e8dca6780",61,53,51,8.37254901960784,61,0,2,3
"28898","c84606540e0b6c1b08680fa0738049ec",180,136,61,20.655737704918,180,0,3,3
"28899","c8461d1f2e95f419f1160bd5ca306c78",39,39,0,39,39,0,1,2
"28900","c8463d5b8e64b75a4087ce3d148122ea",121,75,70,12.1,121,0,3,3
"28901","c848af55f3152897b79f74cf8e4c0726",90,74,21,30,90,0,3,3
"28902","c849eaf4964df015d790f3a92dc6e9f6",6,6,0,6,6,0,1,2
"28903","c84a1ad2f75a025bd1543089be567c6d",20,20,0,20,20,0,1,2
"28904","c84ac76e3d3a80743f64623a51f1919b",35,35,0,35,35,0,1,2
"28905","c84b7a4a86c409ee1473bc396def506e",13,13,0,13,0,13,1,2
"28906","c84bc6a6a94ea348306b1400b32cd15d",47,40,33,9.96969696969697,29,18,2,1
"28907","c84bd262098c2c055070fe673a1b4d10",36,22,50,5.04,36,0,2,1
"28908","c84c3bb0def63c3098ca3d12c8740193",93,71,49,13.2857142857143,93,0,2,3
"28909","c84c8a4e3b75d8fadb3e8cd723fb74dd",5,3,35,1,5,0,2,1
"28910","c84d4ba185a1470b062bd1187c3355a6",85,60,51,11.6666666666667,71,14,2,1
"28911","c84f22d064d18974736264ef530fcd7c",20,20,0,20,20,0,1,2
"28912","c850d36c627cd570a94235c38a4c4db7",77,43,55,9.8,52,25,2,1
"28913","c859730c9e5869caf0b6082c4a523d3b",24,24,0,24,24,0,1,2
"28914","c85ba00187a1eec95740982a7722f842",45,40,56,5.625,45,0,2,1
"28915","c8608cbc2d7bd1a8d7ac9a114fcbd242",151,76,69,15.3188405797101,117,34,3,3
"28916","c863969fb96dc0d9428c61c9040e4cb5",86,70,17,35.4117647058824,39,47,1,1
"28917","c86ab4b4cf16eae5f8b5f50831e2c432",40,40,0,40,40,0,1,2
"28918","c86f384bc4b8482a3b3f1c63cafdbb0e",19,13,57,2.33333333333333,19,0,2,1
"28919","c8704a8fab795837869651e0239fb97f",18,18,0,18,18,0,1,2
"28920","c8720f2f378571da0a6b2a77a3777df5",142,83,70,14.2,142,0,3,3
"28921","c8752acf7513c56fc762c9c09c85bf09",45,35,28,11.25,45,0,2,1
"28922","c87738e5659bdb61bcc02c8090814535",10,10,0,10,0,10,1,2
"28923","c87896b11d0753b0ad483fa86c818d84",1,1,0,1,1,0,1,2
"28924","c87ab4df923152b54483cd2dee0fd42c",26,20,42,4.33333333333333,26,0,2,1
"28925","c87ae0ef02c43d5d1e577f36022eb105",62,45,52,8.34615384615385,62,0,2,1
"28926","c87cea2554547b14c6452fab6d4a6b5a",23,19,15,10.7333333333333,8,15,1,1
"28927","c87d60e92f513d090a155ce53bca50a5",22,17,35,4.4,22,0,2,1
"28928","c87dd88996c4e9cb744c85d358654b3e",175,81,77,15.9090909090909,175,0,3,3
"28929","c87f7dd80d3eda1356753a796cc56e98",66,51,21,22,66,0,1,1
"28930","c881261686788b66c991006c2e17eafe",50,44,29,12.0689655172414,31,19,2,1
"28931","c88938be4e413055624974dc8986d6a0",14,14,0,14,14,0,1,2
"28932","c88a43254ed3081a56669e4909355cd4",21,21,0,21,21,0,1,2
"28933","c88b51e533d76100903547fc0f799176",43,43,0,43,43,0,1,2
"28934","c88dcb2fbed164061d82d5a56fee7457",49,49,0,49,49,0,1,2
"28935","c88e672a6484ccb179eacb61b0ea48e0",38,38,0,38,38,0,1,2
"28936","c88f95be999e27f2033ff25c7628713e",16,16,0,16,16,0,1,2
"28937","c892fb43757a9642c4ae724c4fb15bdd",78,54,78,7,59,19,2,1
"28938","c8941803311fa2a6ab7cd5ad7026886c",18,18,0,18,18,0,1,2
"28939","c895101e281edc26e6615a668e2a8407",33,33,0,33,0,33,1,2
"28940","c896421444c6c2e4263e35d0f5acc974",50,50,0,50,50,0,1,2
"28941","c89805ea8fd2c4d6761e82337c38866b",59,55,37,11.1621621621622,59,0,2,1
"28942","c89a591941ab94daddeaaef623937de3",213,81,84,17.75,213,0,3,3
"28943","c89c010a7ac4a8cf0e05d0c66f638daf",115,70,63,12.7777777777778,88,27,3,1
"28944","c89c7da5422744f9b416517e9b560b7a",55,42,54,7.12962962962963,55,0,2,1
"28945","c89d827094c14c56739f69470f930297",61,54,33,12.9393939393939,61,0,2,3
"28946","c89f92b68b1c2ea5fb5f86526def1f86",38,38,0,38,38,0,1,2
"28947","c89fb4d83380a4cc6dddde94aa2fa12b",130,94,52,17.5,130,0,3,3
"28948","c8a1085ed068fad0c89bf7a35ef28a3c",65,42,60,7.58333333333333,27,38,2,1
"28949","c8a233e055e7e519be4d9b7a4090b588",75,52,20,26.25,75,0,1,2
"28950","c8a30061825891ed9199c71f9d350bf4",79,61,44,12.5681818181818,56,23,2,1
"28951","c8a6fe449b9d44bad5913c08776fe78f",119,84,52,16.0192307692308,119,0,3,3
"28952","c8a7ef024a2f28fd97ee944b92a277fe",210,85,73,20.1369863013699,167,43,3,3
"28953","c8ad535883492090be7e524e1026126d",31,31,0,31,31,0,1,2
"28954","c8aefbf8344f4400541041d7e6656516",100,56,63,11.1111111111111,80,20,2,1
"28955","c8af6530386e27fc781e0912873619c7",94,86,32,20.5625,59,35,3,3
"28956","c8b0254eef2cb94d7e27dc88216eb628",3,3,0,3,3,0,1,2
"28957","c8b0703e5ea59f2b8a8b572f67e32a9d",27,27,0,27,27,0,1,2
"28958","c8b09ba64d7bfbc9841d536fe3b0cb11",78,58,61,8.95081967213115,63,15,2,1
"28959","c8b898e0931d29724dd525fda9a4d157",131,113,50,18.34,131,0,3,3
"28960","c8b9273bbd341553834fc9dc4156e98a",20,20,0,20,20,0,1,2
"28961","c8b995b48c30e5844dd8c8291908e6b6",136,50,60,15.8666666666667,136,0,3,3
"28962","c8b99f9dd28e7d3c36ff71406adb064d",15,15,0,15,15,0,1,2
"28963","c8ba66912d5b545ef3dc5da15142d737",54,38,63,6,54,0,2,1
"28964","c8bd39ba7fd5004dc4067c517a7011aa",35,35,0,35,35,0,1,2
"28965","c8c4dea1d6ad2b78e4d9caafd181afac",72,55,14,36,72,0,1,2
"28966","c8c5417fff3bf56ae81d3af6eacf6f80",68,43,83,5.73493975903614,39,29,2,1
"28967","c8c8a3f9b3c6e3b390dcdac2502ac14c",72,56,60,8.4,49,23,2,1
"28968","c8c8db4801b39ad56da5c580663522af",20,20,0,20,20,0,1,2
"28969","c8c9bca1b2dcf49401486aeb3d982b6e",10,10,0,10,10,0,1,2
"28970","c8cc79abe531e1f805a2980c6da95b90",89,48,82,7.59756097560976,89,0,2,3
"28971","c8d35e05bb8735853335fbbcdb65b5fc",11,11,0,11,11,0,1,2
"28972","c8d43b1e6668dac103ab45700367d51d",25,25,0,25,25,0,1,2
"28973","c8d767871529a08ab7639c7814c4e1a7",27,27,0,27,27,0,1,2
"28974","c8d80dcb5a301eb2f692d630b955216e",14,14,0,14,14,0,1,2
"28975","c8d85733214a384ebe80149b9d6f328b",98,56,27,25.4074074074074,98,0,2,3
"28976","c8d8d3189c670c82f70b1ef1c8431830",35,35,0,35,35,0,1,2
"28977","c8d939b3422075e37bd79d68f9a6ec8c",22,15,51,3.01960784313725,22,0,2,1
"28978","c8de8ac7b0aa4ac53b088c5f1073406f",67,60,27,17.3703703703704,48,19,2,1
"28979","c8dfcb7002ab8b42390603a60a1fe842",14,14,0,14,14,0,1,2
"28980","c8e16643d7d70697c0e6dd8a095d9d6b",76,41,60,8.86666666666667,76,0,2,3
"28981","c8e25c3b0e7839d430743e1e21310b2d",62,53,63,6.88888888888889,62,0,2,3
"28982","c8e2dc86f179549566979e0581a01f10",8,8,0,8,8,0,1,2
"28983","c8e380891e7987cca1871bd23fe70f09",39,39,0,39,0,39,1,2
"28984","c8e4bf8cbce01990ff0925b616376899",153,95,70,15.3,153,0,3,3
"28985","c8e9300a8046f441048b06f1a11f3f5c",237,138,66,25.1363636363636,191,46,3,3
"28986","c8ea61219422ec87b3f8e6eb9fe76251",38,38,0,38,0,38,1,2
"28987","c8ea9ac8ca23955b7626e529af7ea6d0",84,75,89,6.60674157303371,84,0,2,3
"28988","c8eb9e5b9a1e82db8562bf8784bfd2e2",161,90,70,16.1,161,0,3,3
"28989","c8ecab5423c5d8e5edd0364f5513d66e",218,125,63,24.2222222222222,218,0,3,3
"28990","c8ed6e980078b7675f6f63b9b182090d",28,28,0,28,28,0,1,2
"28991","c8f0291abedf2c68168d1862dddeb463",100,49,76,9.21052631578947,53,47,2,3
"28992","c8f3c26fa8becb12b24237507837e3cb",156,90,74,14.7567567567568,156,0,3,3
"28993","c8f57aae241aa27ae410bb5261525ae0",44,29,49,6.28571428571429,30,14,2,1
"28994","c8f9894c3dcab2e9439017e245136824",203,89,84,16.9166666666667,203,0,3,3
"28995","c8f9ff036e11745b6f44bbeac3da725e",37,37,0,37,37,0,1,2
"28996","c8fa0d68d0582262bc5d7ec9c047ff17",54,44,43,8.7906976744186,54,0,2,1
"28997","c8fb4abe18a5df8f2c67f15dd01a8177",186,120,68,19.1470588235294,145,41,3,3
"28998","c8ff50186816195ef52cf181613d910f",29,29,0,29,29,0,1,2
"28999","c90669fa3629a57f91b5c2aaa7a5eeb7",159,76,62,17.9516129032258,123,36,3,3
"29000","c90843d0f1e69f00cb85726ec67841e6",2,1,51,0.274509803921569,2,0,2,1
"29001","c908c27fde065893f97e1aef919693a8",151,100,58,18.2241379310345,151,0,3,3
"29002","c90eaa10ad7fb48739d6ff16bf26065e",38,33,14,19,0,38,1,1
"29003","c9103f78332fd5e45b683e7aa0ecea9e",35,29,62,3.95161290322581,35,0,2,1
"29004","c912f32c28a32ee785c084c3251102eb",22,21,11,14,1,21,1,1
"29005","c913185502445c31110ba3f3d51fb0fb",115,45,70,11.5,115,0,2,3
"29006","c9148b82e20bca65dfd1e5af803cfaf5",29,29,0,29,29,0,1,2
"29007","c914f6e8cde8a2bbb303db69a87469b5",5,5,0,5,5,0,1,2
"29008","c9150bc0289e50c4e59b94e80b7879a6",171,97,42,28.5,171,0,3,3
"29009","c91538156f73d0d42ebe835b527444d4",14,14,0,14,14,0,1,2
"29010","c91a6fd3630a605c1948390fc37526eb",109,66,78,9.78205128205128,109,0,3,3
"29011","c91ab182ed48f8d6c8c66f9c09e9e0a9",175,81,70,17.5,153,22,3,3
"29012","c91b26f1bdb99047d3915d203dd152de",45,45,0,45,45,0,1,2
"29013","c91ccf21d0271438343100857f326964",65,44,72,6.31944444444444,57,8,2,1
"29014","c91de09db4199b9b06c0ff7d1375c365",130,98,33,27.5757575757576,130,0,3,3
"29015","c91e685dd4f4a32455f7d306f5637568",34,34,0,34,34,0,1,2
"29016","c91f4bbec6eb1a41f5ab6336cfdecba6",43,43,0,43,0,43,1,2
"29017","c92021e9ce84d0ae02719bde8ab0eab0",39,34,70,3.9,30,9,2,1
"29018","c929ce30481aa9743bdf38c22561cf20",100,75,31,22.5806451612903,54,46,2,3
"29019","c92b428ed4388e2321c839cee33a272b",35,26,5,49,35,0,1,2
"29020","c92b5b0f454297803cce9ada1501c3f8",87,70,47,12.9574468085106,87,0,2,3
"29021","c930971037df88b74c15222df45435c4",49,49,0,49,49,0,1,2
"29022","c931f8f3d0195d47d51db668a53840e3",27,27,0,27,27,0,1,2
"29023","c9325cf8a43eb5d59752137766ad84d0",194,112,70,19.4,148,46,3,3
"29024","c9329a205656808ef885cf821349239f",51,41,28,12.75,51,0,2,1
"29025","c932ce7ab8f2b0590a9d37903b3f66dc",17,17,0,17,17,0,1,2
"29026","c93323fda402e8590cefdef809dcea2a",34,25,40,5.95,34,0,2,1
"29027","c937a2ffc2e670c1436e16cc758baefa",16,16,0,16,16,0,1,2
"29028","c9382115eb5d776db80b83e5de2d914d",42,29,81,3.62962962962963,42,0,2,1
"29029","c9387345f9198a746a31994294a81ba2",57,51,12,33.25,57,0,1,2
"29030","c93a5de5bf5b0f8c7a498f989443ed0d",45,45,0,45,45,0,1,2
"29031","c93ac4eca15ca071fa0c51e68854f79b",96,75,15,44.8,96,0,1,2
"29032","c93c79edb402594497cdcb6546b3cc2a",23,23,0,23,23,0,1,2
"29033","c93e89e53b06fb034a6d9e815754f21d",21,21,0,21,0,21,1,2
"29034","c940a3a7285122adb53feee647453477",110,100,19,40.5263157894737,110,0,3,3
"29035","c940a69bca3d1a1ad3579b0cf1f2d5d9",80,59,37,15.1351351351351,42,38,2,1
"29036","c941f39774bbcdef750fd9bb16c1eacc",32,26,6,37.3333333333333,32,0,1,2
"29037","c943f9ff72232a695ea41fc724fbcf04",27,9,77,2.45454545454545,27,0,2,1
"29038","c944a494cc43b93b4bf8713df8cb5b12",28,28,0,28,28,0,1,2
"29039","c9458c37eac17370db4064ce34821192",62,41,50,8.68,27,35,2,1
"29040","c94687bdcccdf3012e667dea242c8e26",124,63,59,14.7118644067797,98,26,3,1
"29041","c947ed8ae61cffdd890122e19f4775c5",55,55,0,55,55,0,1,2
"29042","c948480c51ae45cf8cff46977ca028ff",138,110,61,15.8360655737705,106,32,3,3
"29043","c94993572a343bcea9eb31976a5d537b",48,44,43,7.81395348837209,48,0,2,1
"29044","c94aa47733098199534e82c8493cd2a3",9,9,0,9,9,0,1,2
"29045","c94ce179f69d854aabd21c9a1576e970",176,95,68,18.1176470588235,140,36,3,3
"29046","c94cf277413ac11d2726a0e4b866b298",85,68,60,9.91666666666667,85,0,2,3
"29047","c94d19c72a52efbf14f0b4790c38b726",69,58,61,7.91803278688525,69,0,2,3
"29048","c950adf8206b3384d8be0215d1622c53",10,5,25,2.8,10,0,2,1
"29049","c95167ee0574bfd5351beb59cd1ae3a6",88,63,43,14.3255813953488,70,18,2,1
"29050","c951735035992212a0009b67cc0840a9",35,27,7,35,0,35,1,2
"29051","c955c27b5a2f7ba3fefe5bfee41a1018",17,17,0,17,17,0,1,2
"29052","c9563b215e671f410c970359afc2a3ed",25,25,0,25,25,0,1,2
"29053","c95a6952f6ff393e91b643764d754464",145,100,75,13.5333333333333,122,23,3,3
"29054","c95d17d689978a917410010c74ab9a84",8,8,0,8,0,8,1,2
"29055","c95fe04f4a300a4695698d4e3fd3752f",53,34,49,7.57142857142857,53,0,2,1
"29056","c9645f1ef02fc55d0d84b1ae3728ae10",25,25,0,25,25,0,1,2
"29057","c964d73dc16123b5aec08e5de06bd5d6",8,8,0,8,8,0,1,2
"29058","c965ed49fb1549a64810acb36e507b1d",21,21,0,21,21,0,1,2
"29059","c96d355baa64fc7149925f0b9894e440",47,47,0,47,47,0,1,2
"29060","c97096d81ff8f968f3e40ff995b0ea88",10,10,0,10,10,0,1,2
"29061","c970fd609c9288ad2278c978d0026b07",16,16,0,16,16,0,1,2
"29062","c97273fb8aa95e50614039b8538596ef",55,55,0,55,55,0,1,2
"29063","c97363c43432401e3883c57067de0fc3",23,23,0,23,23,0,1,2
"29064","c97375a469109dd8fe354d946451d7d8",146,105,41,24.9268292682927,146,0,3,3
"29065","c976c20a649e06de0f35ad1af164ae2f",64,53,27,16.5925925925926,64,0,2,1
"29066","c97729041f4db43996cfe158ca2c79c1",225,120,71,22.1830985915493,182,43,3,3
"29067","c97a1688e3c576c7c456fbe72add1856",33,29,36,6.41666666666667,33,0,2,1
"29068","c97a61bcfcd59563cd9d84009956be85",233,92,82,19.890243902439,205,28,3,3
"29069","c97d25e7258d042ec1e6cdb70ec270b3",22,22,0,22,22,0,1,2
"29070","c97de55a73dd471d19f8722300748017",9,9,0,9,9,0,1,2
"29071","c97fa16ae0d8a42f79505631671348b0",134,105,33,28.4242424242424,134,0,3,3
"29072","c98067e562fcd4eefeceb049a8ae1ffe",55,45,28,13.75,55,0,2,1
"29073","c980a65253f7eef4970e6e6488067c73",74,58,65,7.96923076923077,74,0,2,3
"29074","c9826c7f815bfd106abb86e387af08a4",26,24,7,26,26,0,1,2
"29075","c98552331465d95662ddb04ab9a13423",64,42,85,5.27058823529412,53,11,2,1
"29076","c98791c72de5feb8d18f8c7332b799e4",29,29,0,29,29,0,1,2
"29077","c987a37fcf2bf87f51f55c256f102061",20,20,0,20,0,20,1,2
"29078","c987cb29516bad523d82bd34a92d6f10",13,10,10,9.1,13,0,1,1
"29079","c99242dc499348419606660b76573e10",134,99,51,18.3921568627451,134,0,3,3
"29080","c99273c8d15ff3a8706d45504d3bbc3c",36,36,0,36,36,0,1,2
"29081","c99422c3c1d1d61195e1e482e5cbee0e",53,53,0,53,53,0,1,2
"29082","c998b8b85cee33e336d698604b505a4e",83,58,81,7.17283950617284,83,0,2,3
"29083","c999abf7921078e4d52f1c3784fbca94",234,90,81,20.2222222222222,194,40,3,3
"29084","c99a8ce5efa8806acfcc679316da3e33",142,99,56,17.75,115,27,3,3
"29085","c99c33c98e9ac8f0f59adbcf33b69ae4",27,23,59,3.20338983050847,26,1,2,1
"29086","c9a39c8de89770f717253a4b28c04f17",31,27,31,7,13,18,2,1
"29087","c9a514f9af265949e3efd31a9ff41ab9",1,1,0,1,1,0,1,2
"29088","c9a62462ecfc8425062c205c45b6131f",16,16,0,16,16,0,1,2
"29089","c9a6df80616ad9ac9f46c93b04d9eace",46,46,0,46,46,0,1,2
"29090","c9a70b6537bd09c98f49dd6e4a3d5783",47,47,0,47,47,0,1,2
"29091","c9aa710469464ba6ab8d7be7f8c37734",38,38,0,38,38,0,1,2
"29092","c9ab713aa9a88477a4e37c5b069d10d1",27,27,0,27,27,0,1,2
"29093","c9ad251c2479a282bbb35d89374b5141",165,103,78,14.8076923076923,165,0,3,3
"29094","c9ae585de280c7bf4717c4011e673150",103,83,32,22.53125,52,51,3,3
"29095","c9b0d0571321a045545512ce5eb33aa0",30,24,33,6.36363636363636,30,0,2,1
"29096","c9b3dae745a477bf38b70b0c94616d02",50,40,30,11.6666666666667,25,25,2,1
"29097","c9b95edfbf72cc4a59169ffe81c5b3f9",22,22,0,22,22,0,1,2
"29098","c9bdbe6b06639382effc6215f467cd8c",21,21,0,21,21,0,1,2
"29099","c9bfe1a559e7432fa51f88a8e92a08fc",58,50,77,5.27272727272727,41,17,2,1
"29100","c9c1faff5edbe88797c4c9bcfd7d57d4",23,23,0,23,23,0,1,2
"29101","c9c26f293cae836b9c4f0486d6b68cda",44,38,28,11,44,0,2,1
"29102","c9c32733649e8083232850af24e0b7f3",37,35,25,10.36,14,23,2,1
"29103","c9c35bc9442c32907e9f529ec69241c1",15,15,0,15,15,0,1,2
"29104","c9c4adb2949b20deb6e293399bd164cb",2,2,0,2,2,0,1,2
"29105","c9c521e5fadba91e1b974b0636457e03",101,64,49,14.4285714285714,101,0,2,3
"29106","c9c5a1eaa0596da76e65fece2988956d",14,14,0,14,0,14,1,2
"29107","c9caa9024b04d2f819bf7b11026f58b1",91,47,63,10.1111111111111,91,0,2,3
"29108","c9cae4b3cec0739746092f4a15a17d97",35,29,32,7.65625,35,0,2,1
"29109","c9cea9e2b0756fba93679d7602a45f0d",103,47,60,12.0166666666667,103,0,2,3
"29110","c9ceb2c53d87a0db8de0d6b3bec010d5",52,37,32,11.375,52,0,2,1
"29111","c9d12228d6966df577d36dd73bb9801d",146,69,67,15.2537313432836,146,0,3,3
"29112","c9d1cf955d26ee36c607d948171ef6f0",77,70,40,13.475,47,30,2,3
"29113","c9d28268a19956a59e7519e3a2a5ef92",55,49,74,5.2027027027027,34,21,2,1
"29114","c9d37b45caa0114d72595bc78098b728",86,59,68,8.85294117647059,86,0,2,3
"29115","c9d45185a055a434ef24982f59db9a87",53,48,45,8.24444444444444,53,0,2,1
"29116","c9dbf3dd2a1f0b24725e19cccd282474",54,54,0,54,54,0,1,2
"29117","c9dfa6f82f88a03b0481af17661755fd",31,31,0,31,0,31,1,2
"29118","c9dfa895f3f38b2792f44ee86a71cad0",66,58,55,8.4,66,0,2,3
"29119","c9e043862468048934ddf98e8995ec1a",15,15,0,15,15,0,1,2
"29120","c9e26f5f312f0aabeb1687be09f5ed50",46,38,17,18.9411764705882,46,0,1,1
"29121","c9e4800fc19dd26b13e6108f41a99209",24,24,0,24,24,0,1,2
"29122","c9e49b829dcadd968ba48c2bc113d318",29,29,0,29,0,29,1,2
"29123","c9e5eacea0ea9ec92fbfa831358ff70d",168,99,79,14.8860759493671,138,30,3,3
"29124","c9e7a7a871425e2755d5d36fd05bc9e5",12,12,0,12,12,0,1,2
"29125","c9e9425bd9b56746572c96146d9160c5",28,24,59,3.32203389830508,28,0,2,1
"29126","c9ec477220f04f6db37e4981c2fa8b95",98,77,36,19.0555555555556,98,0,3,3
"29127","c9ed872491f99abcbff1384037fe11cf",22,22,0,22,22,0,1,2
"29128","c9edb8c71e9858eda08027a78d77da59",69,37,58,8.32758620689655,49,20,2,1
"29129","c9f1e6c73d8efdbbf05352a712f7beb2",47,47,0,47,47,0,1,2
"29130","c9f3417c5fedbf0e85f9607490aff945",144,66,82,12.2926829268293,144,0,3,3
"29131","c9f60684db9be14320a86499e802d710",53,33,14,26.5,53,0,1,1
"29132","c9f7c64c8b8f07d6e49e2af81d50c66e",189,99,88,15.0340909090909,153,36,3,3
"29133","c9f8d395947aa04d0cbb7fd90c5d7398",11,10,12,6.41666666666667,11,0,1,1
"29134","c9fb123dd92425447a540526ac5b62d4",15,15,0,15,0,15,1,2
"29135","c9fc3e4ac311266b1d1fb5ff78355ef4",12,12,0,12,12,0,1,2
"29136","c9fc68b1d5a9ac39ad866e92ce95f4de",31,31,0,31,31,0,1,2
"29137","c9fcc6780336518bc149be40a0675124",94,67,41,16.0487804878049,94,0,2,3
"29138","c9fe05c35eb5b045ae089e25bcdf6398",24,24,0,24,24,0,1,2
"29139","ca02ac77b71409ac3ca57daaa8c795f4",231,130,83,19.4819277108434,181,50,3,3
"29140","ca038c9abfe11da296313bf3ee25387d",95,67,75,8.86666666666667,64,31,2,1
"29141","ca05d22d4c957c113c98e3886979adce",30,30,0,30,30,0,1,2
"29142","ca08497dcba399859e17e71eb01a23c5",90,64,76,8.28947368421053,62,28,2,1
"29143","ca0ce69806920a976e37c412bbe9f13d",3,3,0,3,3,0,1,2
"29144","ca0cf0e265915f07b2aec871d5ca62ab",33,28,32,7.21875,33,0,2,1
"29145","ca0d66a81aa8bfebc25ec57265401553",89,57,64,9.734375,89,0,2,3
"29146","ca153d0f22d2cd646848ed8b4da3ac09",13,13,0,13,13,0,1,2
"29147","ca15d11bf797d8ff08b7ad4c5d8f5700",17,17,0,17,17,0,1,2
"29148","ca171275b8f47b26cb6c1ad975a20e4d",13,13,0,13,13,0,1,2
"29149","ca1e737f7b7ac929daf9ad472a66f486",60,49,68,6.17647058823529,60,0,2,3
"29150","ca1fa13102710406988f29dd5f8484ba",42,42,0,42,42,0,1,2
"29151","ca21b450abefbfb423f4dc3bc82fdb84",45,45,0,45,45,0,1,2
"29152","ca2255c0d1c1ae6f5fd1b83ebb057060",106,59,62,11.9677419354839,106,0,2,3
"29153","ca2328aa2dd4d6a3105fe7e90d528cbe",10,10,0,10,10,0,1,2
"29154","ca272d7c5760cd75fec636abaeb5e00e",93,72,67,9.71641791044776,93,0,2,3
"29155","ca27d7244ff9ffb9dea52378cd589abe",47,43,18,18.2777777777778,47,0,1,1
"29156","ca28abc8a3f3e3475530a17f0c208e18",65,50,34,13.3823529411765,65,0,2,1
"29157","ca2b48947dbbc278db9bbd041fd6237f",120,73,78,10.7692307692308,120,0,3,3
"29158","ca2cd6816cb1e420c2e20f207feb0d71",33,33,0,33,33,0,1,2
"29159","ca2ddcdd8f5497d250df63c9089d75d1",139,83,87,11.183908045977,139,0,3,3
"29160","ca2e1cc3b4dd7c224d6205c5829160d2",94,68,58,11.3448275862069,94,0,2,3
"29161","ca307c9d3ffdc0ce5b9d45cca6d8f256",60,40,45,9.33333333333333,60,0,2,1
"29162","ca3093787a47f0be998c1e4c1e251584",12,12,0,12,12,0,1,2
"29163","ca31d5cbf5c0a320d7425594b43caf5a",27,27,0,27,27,0,1,2
"29164","ca3296485f0f5ae28e57868cfed2ac52",19,19,0,19,19,0,1,2
"29165","ca333bd320e5e7539ee917f4a6e4face",108,80,45,16.8,108,0,3,3
"29166","ca3399a0a710bdcf430dcac04247ced5",79,60,66,8.37878787878788,37,42,2,1
"29167","ca362b6a06e2a9dfee9aab365c82b535",60,32,53,7.92452830188679,20,40,2,1
"29168","ca3699a098cdabf827077931d4cb981b",7,7,0,7,7,0,1,2
"29169","ca38f05c82deceb3081b7660fa590bb2",12,12,0,12,12,0,1,2
"29170","ca390fd9c730d0f921d80d4e3e9a78c4",17,17,0,17,17,0,1,2
"29171","ca3a4fe86ff71ac3dae1ed23aeebaaa9",11,8,27,2.85185185185185,11,0,2,1
"29172","ca3bcc476306eccaf195fa4ea428efa3",15,15,0,15,15,0,1,2
"29173","ca3c6278b73eeb7ac00c293469c86419",47,38,16,20.5625,33,14,1,1
"29174","ca3d41c896fd5c799b0f86e23fb70a9d",25,22,16,10.9375,25,0,1,1
"29175","ca3df43e5852c9f627dfac16c91deb5b",75,60,61,8.60655737704918,75,0,2,3
"29176","ca3f25eacdfb47810536603412f62185",109,81,58,13.1551724137931,109,0,3,3
"29177","ca3f5638f16cd05aa67c27721c91ec8c",30,30,0,30,30,0,1,2
"29178","ca40a3dab7775a362c1cf4971a8fd1d5",12,12,0,12,12,0,1,2
"29179","ca419fa0665bf4474cf1345bc3399bdb",32,32,0,32,0,32,1,2
"29180","ca44b1d2df8c9bdd2aa56b50fc0921c8",233,130,63,25.8888888888889,188,45,3,3
"29181","ca4712cc1f60161b1f885c5d6e66e165",34,34,0,34,34,0,1,2
"29182","ca4760eb4e241cb4c867f4a917ac148b",118,77,81,10.1975308641975,118,0,3,3
"29183","ca47acc61be9ef2ba9171caefb8a644c",13,13,0,13,13,0,1,2
"29184","ca48cb2670d767812e0bab1b8813246d",158,89,89,12.4269662921348,158,0,3,3
"29185","ca49f58aa36a26bfddb69c6dd50fa226",18,18,0,18,18,0,1,2
"29186","ca4a6c072c85af3d347a4cde9f084818",76,71,29,18.3448275862069,76,0,2,1
"29187","ca4e173ca35da4b34f5c00a5ec145628",113,52,51,15.5098039215686,85,28,2,1
"29188","ca500fe8fd980e2b7e3b433d2d39eac5",141,81,73,13.5205479452055,141,0,3,3
"29189","ca50e0c9d6afe7045d5417afce540439",17,17,0,17,17,0,1,2
"29190","ca50eb5287bc8621f230f3ab792869f4",134,93,35,26.8,92,42,3,3
"29191","ca50fcfa83cb9828ae3723c01883fdab",32,32,0,32,32,0,1,2
"29192","ca524e506f0f8321abb060351a4e7223",11,11,0,11,11,0,1,2
"29193","ca568497c11abf6ad0e1bc3c700888ea",30,30,0,30,30,0,1,2
"29194","ca56d4ae0b3e6977c0f4c9835bebd42d",44,44,0,44,44,0,1,2
"29195","ca57a4bca03b2780441b61a602df0e3d",62,48,55,7.89090909090909,62,0,2,1
"29196","ca59d82981f52602113070b2af8f29f4",2,1,27,0.518518518518518,2,0,2,1
"29197","ca5b73a3c1a00d224306191d385c1655",37,34,47,5.51063829787234,37,0,2,1
"29198","ca5dd8fb8889d8d2d2ef124d4badc632",2,2,0,2,2,0,1,2
"29199","ca5ef6cf3b9556db5e3733199e81b584",15,15,0,15,15,0,1,2
"29200","ca606b3dcbd0dc1e0326c97ed58fa5d1",145,77,65,15.6153846153846,122,23,3,3
"29201","ca63537c6d141bff7516f06330009323",206,73,81,17.8024691358025,206,0,3,3
"29202","ca63665ae33e771e8a46ef051a710b5d",14,14,0,14,14,0,1,2
"29203","ca6430dece0b4f5f72abe2d13d12a34b",216,102,64,23.625,216,0,3,3
"29204","ca6457d72099d5130452d16b0a5cd8f3",61,49,52,8.21153846153846,61,0,2,1
"29205","ca6500f62be72f1a7af636eca0a4e822",176,76,82,15.0243902439024,176,0,3,3
"29206","ca65cdd44da8d9d3a68360c9326d1a70",36,36,0,36,36,0,1,2
"29207","ca6aba72efaf56c8da5adebacc5284c4",41,25,50,5.74,41,0,2,1
"29208","ca6e551b9ac35b4d50c8bd11a33c0f25",112,72,67,11.7014925373134,112,0,3,3
"29209","ca6fd521c2ab8b5364c67cc637756750",16,16,0,16,16,0,1,2
"29210","ca700495011a27d2764047f777dc7f80",70,50,75,6.53333333333333,48,22,2,1
"29211","ca7313ef55c4d4b1487ff94b315b21cb",168,66,71,16.5633802816901,168,0,3,3
"29212","ca743b9de5973808338ae738d846c5f2",22,20,42,3.66666666666667,22,0,2,1
"29213","ca75f69bd25f17843b146ecebba878ac",99,53,70,9.9,99,0,2,3
"29214","ca776408960dd66c60de5619d73e881b",39,34,42,6.5,39,0,2,1
"29215","ca780829023d35701afab15437da803a",50,45,36,9.72222222222222,50,0,2,1
"29216","ca82f05d28911100447a17ca8d28f88f",82,71,28,20.5,82,0,2,3
"29217","ca83cc00dfbf9c9670601420550c3f95",40,40,0,40,40,0,1,2
"29218","ca860954125933243ca9594a284166e1",33,33,0,33,33,0,1,2
"29219","ca86dab82c1c01c62b947f9e6a014f64",80,62,67,8.35820895522388,80,0,2,3
"29220","ca8a05c0443220084e3a8d8c3c598123",217,96,83,18.3012048192771,217,0,3,3
"29221","ca8c9b64f00e43943600073cb67ae35c",156,71,75,14.56,134,22,3,3
"29222","ca8f8edf5fe14a49f867e2e3347ad358",86,55,28,21.5,86,0,2,3
"29223","ca8ffa20ce9a2fd5103f48686b8c9e5c",34,34,0,34,34,0,1,2
"29224","ca90af9ecd16c672542785c96272233b",54,54,0,54,54,0,1,2
"29225","ca913e7b9af4025f856cae96a2fe6c8e",32,32,0,32,0,32,1,2
"29226","ca9669e8e5314bb17ec94edfc92e93ca",55,44,44,8.75,55,0,2,1
"29227","ca96df8b0c35661ecd9992c19f10f7aa",30,30,0,30,30,0,1,2
"29228","ca974adcc5b74cce70b16dc4a5d614a4",73,64,35,14.6,73,0,2,3
"29229","ca97eb55e7e2e6741afb1e5f599a7adf",183,98,89,14.3932584269663,183,0,3,3
"29230","ca9ac73c3487a8c9f1c4367a59c599aa",23,23,0,23,23,0,1,2
"29231","ca9b1fe6d3688788ec028e954513b3ca",17,17,0,17,17,0,1,2
"29232","ca9b7b7bdca1d1bc8655de7cbece0b99",9,9,0,9,9,0,1,2
"29233","ca9cff9996fe255f755b8c2545a016c5",133,98,65,14.3230769230769,133,0,3,3
"29234","caa3231e5bdeb491bae7336fb4c1c814",125,105,34,25.7352941176471,125,0,3,3
"29235","caa981597686ae94f31067b4fcf0eabb",34,34,0,34,34,0,1,2
"29236","caa9cf0a444e6a6dcac751c146473c1f",96,77,60,11.2,96,0,3,3
"29237","caaaba82d035d760c91dae9a820ca069",43,43,0,43,0,43,1,2
"29238","caaea2b5e9d8dd7121abfcfb67d78415",6,6,0,6,6,0,1,2
"29239","caaec6d104f8a85a7a77fec58d805bbe",10,7,28,2.5,10,0,2,1
"29240","cab10369b909b45631186edff9535646",32,32,0,32,32,0,1,2
"29241","cab14f980f3851c0030d6803b77d5446",31,31,0,31,31,0,1,2
"29242","cab1d610af67075332db964eccacffcc",30,30,0,30,0,30,1,2
"29243","cab1eead3a2a1798631c9983dc72f66f",34,34,0,34,34,0,1,2
"29244","cab36f460a0b76dfff157ffaef925df6",16,16,0,16,16,0,1,2
"29245","cab87b37d41809544d2778041a581db6",12,12,0,12,12,0,1,2
"29246","cab9351ba4fd6f254e1d091837c512e5",51,39,44,8.11363636363636,51,0,2,1
"29247","cab93bb0eaa68d259d1449e3b7a5182e",11,8,55,1.4,11,0,2,1
"29248","cab93d3e9bfb3f34eb079cf19229b884",64,54,66,6.78787878787879,30,34,2,1
"29249","cab94b3eba1b71341b7838fd94aefbcb",2,2,0,2,2,0,1,2
"29250","cabcf488ce9f47bffe5f6945727944f0",121,81,57,14.859649122807,83,38,3,3
"29251","cabd3f3c0eba905bfab510fac9ccd9a2",11,11,0,11,11,0,1,2
"29252","cabd96309a60973c490b3c365dbd1836",88,54,40,15.4,38,50,2,1
"29253","cabea62079f5d2aeb93346b0c91b37fb",161,78,71,15.8732394366197,136,25,3,3
"29254","cac03af8c0b663d283c1a151ed3da4cd",101,70,31,22.8064516129032,84,17,3,1
"29255","cac6a8dba404bc96295c3cf7347de799",73,61,11,46.4545454545455,73,0,1,2
"29256","cac8017adbc857eb3608feed9ef020b7",63,57,39,11.3076923076923,17,46,2,1
"29257","cacbdc2894443ccaf7d85fbb82269633",47,41,14,23.5,47,0,1,1
"29258","cacdbbd4d4f99f090b21745a206878c3",41,41,0,41,41,0,1,2
"29259","cace9f4194e015b5abf346a9227d1951",82,44,37,15.5135135135135,69,13,2,1
"29260","cacfe515aa322ce81faae31ba55de278",23,22,27,5.96296296296296,23,0,2,1
"29261","cad087734c305ea28aa7f67fcec6fc2e",92,81,24,26.8333333333333,63,29,3,3
"29262","cad0b41ff72638317340eac89dc809c0",121,75,76,11.1447368421053,121,0,3,3
"29263","cad0d0ccb72f368554b725fa9ff7c5b0",103,87,35,20.6,103,0,3,3
"29264","cad0f3dc4a756b1b1e1dc50a8ce55a9f",22,14,80,1.925,22,0,2,1
"29265","cad2428741829b0cab647347ad029b9d",66,57,36,12.8333333333333,30,36,2,1
"29266","cad32af83afe4019307fd2ac95eb3a73",23,23,0,23,23,0,1,2
"29267","cad3494a3a99b11968cec70ec6cd5712",6,6,0,6,6,0,1,2
"29268","cad48e72abba75c3419f81d4d561e4c2",57,49,13,30.6923076923077,57,0,1,2
"29269","cad4de3204c9e63dccdc88cddc89cad8",24,24,0,24,24,0,1,2
"29270","cad556cc4bdd8b9ced428e6174f14fb7",13,13,0,13,0,13,1,2
"29271","cadbdbfd2212d9cbaebc5fa6879530c8",68,50,17,28,38,30,1,1
"29272","cade15f6a75d831b51d842e7853cad4e",175,127,56,21.875,175,0,3,3
"29273","cae0fe1436c6bf479208d6718081a212",33,33,0,33,0,33,1,2
"29274","cae160685b2041a9a5010580fe53d6a3",13,13,0,13,13,0,1,2
"29275","cae49f9662b9c70339c79f90abe0ee76",37,34,13,19.9230769230769,28,9,1,1
"29276","cae5299af4d5d35eee969698ac451c0c",136,89,57,16.7017543859649,136,0,3,3
"29277","cae6947ac3f1344b7160048cf53e0e2b",151,80,62,17.0483870967742,151,0,3,3
"29278","cae74202a5c41ae85127d6354513947a",75,42,50,10.5,34,41,2,1
"29279","cae879e3a26e3b88005ce0c4e5146b28",24,16,54,3.11111111111111,24,0,2,1
"29280","cae88edc246482f2c11ee487ddaf3f6f",13,10,57,1.59649122807018,4,9,2,1
"29281","caea3ae8c90b382a1cfc4d3a18ecd533",72,36,67,7.52238805970149,72,0,2,3
"29282","caea5b6a65236109a901ab68b6959fe7",33,33,0,33,33,0,1,2
"29283","caea6e2a0e20eaaa4191e3da6263f0b1",24,17,78,2.15384615384615,17,7,2,1
"29284","caeac163047cecc2df4a66437dab7a94",46,35,55,5.85454545454545,46,0,2,1
"29285","caf06f33c1c380d3e7dbbbde4812ab4e",64,60,65,6.89230769230769,64,0,2,3
"29286","caf0aab657acf0e3f97c3e4ef9e7236f",17,17,0,17,17,0,1,2
"29287","caf4ae846ef19661c118eec8d678d90d",74,58,25,20.72,74,0,2,1
"29288","caf537590b70e9ec5d71b5a710118d71",88,64,59,10.4406779661017,59,29,2,1
"29289","caf5bde11b1e9f092f838258b54c2a9c",121,55,64,13.234375,121,0,3,3
"29290","caf5d26689ac0742c0861d70abb73e2f",17,17,0,17,0,17,1,2
"29291","caf785acb8cd6c2b5a1640af8bedd94f",57,42,69,5.78260869565217,57,0,2,1
"29292","caf7c5fca9f453f1a03b0af2806a3be6",35,35,0,35,35,0,1,2
"29293","caf8840ed2ef42de9a0eaff630edd618",76,62,59,9.01694915254237,48,28,2,1
"29294","cb02bf2a3011b58b6ac05614e406e108",211,94,61,24.2131147540984,165,46,3,3
"29295","cb02cf62a49430eb0a009bc96cb842a8",29,29,0,29,29,0,1,2
"29296","cb0832f9a633534644e5cf0b353fbb13",33,33,0,33,33,0,1,2
"29297","cb0875b78957f139a0a6947793bf5b7f",102,79,62,11.5161290322581,102,0,3,3
"29298","cb095e2ae33fda67957e5f2f76781e11",36,33,80,3.15,36,0,2,1
"29299","cb098128572c3ddec6ff722a6636f620",43,43,0,43,43,0,1,2
"29300","cb0b60d1d71bab6f194172d9f3410cc9",15,15,0,15,15,0,1,2
"29301","cb0bf622c6a939817fb656ccbf88f74d",165,103,85,13.5882352941176,122,43,3,3
"29302","cb0c7b63311f324ff462a798465b1f6b",1,1,0,1,1,0,1,2
"29303","cb0c8bb3094dcdf8ebbe199c6291bb28",16,16,0,16,16,0,1,2
"29304","cb0e819cb18e2619290c0eeae00b31ae",33,33,0,33,33,0,1,2
"29305","cb156ee7abacdde114ab4ce9fe5d1aa7",8,8,0,8,0,8,1,2
"29306","cb15b1914f7d3bec655becf13af8e2b3",6,6,0,6,6,0,1,2
"29307","cb17d645d4e889a6ecea96f6f2a7d14b",159,95,82,13.5731707317073,144,15,3,3
"29308","cb1999204085fd551254e5c2a15c95d3",31,31,0,31,31,0,1,2
"29309","cb1b9a4011e164bf736da3ed85a557c5",214,133,43,34.8372093023256,214,0,3,3
"29310","cb1cb0e6d860c19c8786063a1785ed96",30,30,0,30,30,0,1,2
"29311","cb1fe585c4f2de35a624aa50ca3aff69",18,18,0,18,18,0,1,2
"29312","cb204b09071887fc6f7eff6fff7f9fd9",139,80,57,17.0701754385965,139,0,3,3
"29313","cb22025ac97415dc584542f042a2e80c",32,24,50,4.48,32,0,2,1
"29314","cb23503ffd152689963fa3e6a381eca5",89,68,67,9.29850746268657,60,29,2,1
"29315","cb25830f07da7e43469439f112f3f40f",50,50,0,50,50,0,1,2
"29316","cb271824e42dfe1cd33f1c2f3daefb6b",67,45,61,7.68852459016393,52,15,2,1
"29317","cb281fe4dcf1cc1bca52de84fe4ffca3",106,54,80,9.275,106,0,2,3
"29318","cb2d6d10a7fe7b032f176c4c3ce3b88e",43,37,27,11.1481481481481,43,0,2,1
"29319","cb2ebee1431a8d1e38caef053f3036ff",25,25,0,25,25,0,1,2
"29320","cb321d09076c242174bcfc451b330f4f",18,18,0,18,18,0,1,2
"29321","cb3232f4d184f9d79d51ac1bf7e9c9d5",188,99,80,16.45,147,41,3,3
"29322","cb3268407cfb23482a492bb12a431a74",113,69,83,9.53012048192771,113,0,3,3
"29323","cb32ffff7e5f17b20ce2937fed12ebcd",45,38,62,5.08064516129032,45,0,2,1
"29324","cb3a908d970527c97a064d08d424fbb7",28,28,0,28,28,0,1,2
"29325","cb3aa82bd95d049ed6b35d18bf86f80d",43,29,28,10.75,43,0,2,1
"29326","cb3c712ab0f6143fe273f28c53aac440",26,26,0,26,0,26,1,2
"29327","cb3e6fbcf377f4f4f51a2b512b6c6b4f",104,81,43,16.9302325581395,104,0,3,3
"29328","cb3ec81a29eae2048450fba1c3c97bee",47,44,38,8.6578947368421,23,24,2,1
"29329","cb3fd2045ace6560b5b5296a1e87ad95",41,41,0,41,41,0,1,2
"29330","cb40271a1095403c042bda586d22d7b2",28,28,0,28,28,0,1,2
"29331","cb412a52f5c961e14a33874bbc739f79",32,32,0,32,0,32,1,2
"29332","cb4706dbfbc172143867daa184aabf18",24,24,0,24,0,24,1,2
"29333","cb480bf52e9dfba77829ff011680f4f6",171,105,47,25.468085106383,171,0,3,3
"29334","cb48b140a4ed4b523838c2f35eadec98",77,54,78,6.91025641025641,77,0,2,3
"29335","cb4b55a402c979870e7c94f196d92fac",102,70,29,24.6206896551724,102,0,3,3
"29336","cb4cbafbaabbb6595fb83972940b7827",155,104,47,23.0851063829787,155,0,3,3
"29337","cb4e11f8ed1dd1632bf67d763f7f97f6",22,19,28,5.5,22,0,2,1
"29338","cb50926192b572721cdb5c7701bb0d0f",50,50,0,50,50,0,1,2
"29339","cb53449d7808cdbd475963b047611094",3,2,37,0.567567567567568,3,0,2,1
"29340","cb5427f044bb58cf14fbc534b3a59adc",56,50,8,49,30,26,1,2
"29341","cb54f60907fed4b9478f394b0351ea1c",32,32,0,32,32,0,1,2
"29342","cb55cb4b5930e89fa25620a8badbacea",128,78,58,15.448275862069,106,22,3,1
"29343","cb57de97250eae1e1d6777eadafc8ad0",60,52,15,28,60,0,1,2
"29344","cb5870a12d88a145c71864d992a9f75d",32,32,0,32,32,0,1,2
"29345","cb592b0117741ce50499d2b0920090c6",31,31,0,31,0,31,1,2
"29346","cb5d774b48428c23b9cb200bdecaec12",60,50,51,8.23529411764706,60,0,2,1
"29347","cb5d9322bc37f848bbfe35f427b32c0a",49,48,30,11.4333333333333,49,0,2,1
"29348","cb5dbdff865af9db9d3af30331a60079",43,41,9,33.4444444444444,2,41,1,2
"29349","cb5faa9544603cfac48127b706a300e9",121,62,85,9.96470588235294,121,0,3,3
"29350","cb60a1cf045acdb6da75091690666bbe",64,52,17,26.3529411764706,64,0,1,1
"29351","cb65dd2e9736b676f630c5a424d4b6bc",35,35,0,35,35,0,1,2
"29352","cb660fcbc925a4b63a4e9f28a89a81d7",46,35,70,4.6,46,0,2,1
"29353","cb67ebf2d197019b7a8499d078ebde53",120,85,53,15.8490566037736,120,0,3,3
"29354","cb69d723732e235324ed2b67786a3072",23,23,0,23,23,0,1,2
"29355","cb6a9f07d37602d75ae09cd3ad4fecf9",42,37,27,10.8888888888889,42,0,2,1
"29356","cb70ad42386796a934fb555c6342b1b9",92,58,57,11.2982456140351,63,29,2,1
"29357","cb7101f2f4290fefde8dc61d197f0f6b",51,43,90,3.96666666666667,51,0,2,1
"29358","cb730e931be1399885a88e67178cf105",54,46,24,15.75,54,0,2,1
"29359","cb754067b858a936566160913302cfd8",45,44,0,45,45,0,1,2
"29360","cb75590a9934f8f7301a2c1a5404e698",9,9,0,9,0,9,1,2
"29361","cb75b0276087949e1033262793f36bf2",144,79,80,12.6,98,46,3,3
"29362","cb762e5f2794e88acb1a8e379505a033",16,16,0,16,16,0,1,2
"29363","cb7912cb72d4fe6e966cbefbfdb25510",24,24,0,24,24,0,1,2
"29364","cb79286010ce0b5cdbd87396c6052c28",232,89,87,18.6666666666667,195,37,3,3
"29365","cb7947f8a44ff31f12791300750d78d1",30,30,0,30,30,0,1,2
"29366","cb7a4231dccc71f32ae7dfedcd3ffb8a",62,51,9,48.2222222222222,62,0,1,2
"29367","cb7b860cece6b651337a3273a5fcbc76",6,6,0,6,6,0,1,2
"29368","cb7d32e0f3cecae22dd784551e5bfdda",81,65,70,8.1,81,0,2,3
"29369","cb7f28b5d922a1a2643aea5cb05a06a0",13,13,0,13,13,0,1,2
"29370","cb83f64d6f207271838a3a47299819fb",37,37,0,37,37,0,1,2
"29371","cb85a371bba9649209f8bbed017d2e8d",102,68,56,12.75,102,0,2,3
"29372","cb889e03192164838665643dbe1764c9",79,59,42,13.1666666666667,79,0,2,3
"29373","cb8dc8fd440377901bddb0e33c18213e",64,42,23,19.4782608695652,36,28,2,1
"29374","cb8df9accf689270b121416acf2c6aaf",51,51,0,51,51,0,1,2
"29375","cb8e58a9f73b0fc9b539ab33eff96862",56,46,61,6.42622950819672,56,0,2,1
"29376","cb8e9545fcc70b6e23bcd30af462f879",20,20,0,20,20,0,1,2
"29377","cb90f78b7ede19b8367dfdd43deeee8b",125,89,42,20.8333333333333,125,0,3,3
"29378","cb94e82ba793f53e94c61f63abe53eba",11,11,0,11,11,0,1,2
"29379","cb9570048aa23505bfed560d3dec29bc",156,100,71,15.3802816901408,156,0,3,3
"29380","cb96500ef9777bed30fc7d1ce1b12ede",123,63,68,12.6617647058824,123,0,3,3
"29381","cb970e0441b73e0943d5dfa26cf9031a",167,97,67,17.4477611940299,167,0,3,3
"29382","cb9758196a8ef488ec8bd07991adab9f",79,59,44,12.5681818181818,34,45,2,1
"29383","cb98ac486b493c8b2c8be13b89971806",91,65,31,20.5483870967742,91,0,2,3
"29384","cb99a8a7cfafc035ed7fdd531474333e",11,11,0,11,11,0,1,2
"29385","cb99cb23cdf7f2ba27a5df44d98917f8",15,15,13,8.07692307692308,15,0,1,1
"29386","cb9c1a5be531906a2d7d4982f4f994a9",179,84,61,20.5409836065574,179,0,3,3
"29387","cba0a7af8669584239665c222b024c08",33,33,0,33,33,0,1,2
"29388","cba1b2e972105e4bcc3f192d88268ee6",35,35,0,35,0,35,1,2
"29389","cba215ff2bea80542e42524d8b9f8371",208,121,71,20.5070422535211,208,0,3,3
"29390","cba4b2b6e328cf345d4e221379f6729d",25,25,0,25,25,0,1,2
"29391","cba4c6d4eb24e9b9eb94e87d03c487d8",153,91,65,16.4769230769231,153,0,3,3
"29392","cba600b53b134a5a59d53bda92110164",30,29,9,23.3333333333333,1,29,1,2
"29393","cba66d6d372d4de2884792ca3abb956e",7,7,0,7,7,0,1,2
"29394","cbaa4559c3d36a4c96342cfc9a8bdf86",182,79,69,18.463768115942,182,0,3,3
"29395","cbab3b640a7aea925187d0ecc0c91699",27,27,0,27,27,0,1,2
"29396","cbac36f5f683575bf66d8844e6df1ca1",22,22,0,22,22,0,1,2
"29397","cbaf5352373cf77e4defa5f556024800",162,114,61,18.5901639344262,127,35,3,3
"29398","cbafa25c8df477a1e111d0f64b6a66d9",74,66,32,16.1875,74,0,2,1
"29399","cbafffa002c2eebdde251d41bef791f2",5,5,0,5,5,0,1,2
"29400","cbb0a24b243f3f4fdc6579287d6b0f0b",28,24,14,14,28,0,1,1
"29401","cbb29da33ce74ef4136edbd838fdd6f0",54,47,19,19.8947368421053,54,0,1,1
"29402","cbb47599e4753ba3fab9ace4fb84442b",81,46,85,6.67058823529412,45,36,2,1
"29403","cbb58df5ac52e7138403b2d8ecd2ba8f",46,39,72,4.47222222222222,46,0,2,1
"29404","cbb5b95a50d4e14c802de4032b6afd4d",9,9,0,9,9,0,1,2
"29405","cbb7592b32b052ab8048591c25f2ee27",27,27,0,27,0,27,1,2
"29406","cbb8f15c993872d52f29cbd15104a164",89,48,81,7.69135802469136,89,0,2,3
"29407","cbb95ff4800981ddc0146bd878208e2e",22,22,0,22,22,0,1,2
"29408","cbb985f154a95269f2f0c77a6420dfb4",2,2,0,2,2,0,1,2
"29409","cbbd478d5f806230f1a6da4a07325a70",16,16,0,16,16,0,1,2
"29410","cbbf41d925fa6663b5fe9380bb12b29b",20,20,0,20,20,0,1,2
"29411","cbc146c1980ca6e3eb1df7c88746ee36",90,34,63,10,90,0,2,3
"29412","cbc1792ffdc3c80f24737c78b6d9b257",4,4,0,4,4,0,1,2
"29413","cbc2cc8141f5c9ee630a637f8c6ca5d2",118,98,58,14.2413793103448,67,51,3,3
"29414","cbc58dd1695e22b4d325f8a0a02fe104",43,32,74,4.06756756756757,43,0,2,1
"29415","cbc5a951df4cad80abde6acb7b716ddf",63,58,21,21,63,0,2,1
"29416","cbc721f9ad89b79deb0f0338d5731ac6",89,57,68,9.16176470588235,89,0,2,3
"29417","cbc82269c189daf684803a5afbe2ad57",53,51,17,21.8235294117647,53,0,1,1
"29418","cbc84a155424c0969c15ceddc8f9366e",83,55,81,7.17283950617284,83,0,2,3
"29419","cbc8f6c1cc1fbc81a8340002613e0544",15,15,0,15,15,0,1,2
"29420","cbc926033ae8df164cec333f241831b4",185,79,51,25.3921568627451,185,0,3,3
"29421","cbd2822384b182fe79d2dade2df02f71",12,12,0,12,0,12,1,2
"29422","cbd551d9660315e069fb79f0656b002e",20,20,0,20,20,0,1,2
"29423","cbd663f410cd095c2253cdbeb2721f11",147,93,42,24.5,147,0,3,3
"29424","cbd7760f17804f072e30d0818b34426c",148,73,82,12.6341463414634,148,0,3,3
"29425","cbd85a29485b25d5a2c836c845a3492a",23,23,0,23,23,0,1,2
"29426","cbd8651607dd16dfe82882ec88388d6c",24,21,50,3.36,24,0,2,1
"29427","cbdaffc66a51b19460bf2ceec950b072",37,33,9,28.7777777777778,37,0,1,1
"29428","cbdd903afb90025c0f72a304be9b99b7",118,69,64,12.90625,118,0,3,3
"29429","cbddc4ace66611766fe374494521044f",71,58,26,19.1153846153846,32,39,2,1
"29430","cbde396f3e9cc7ad319d461cf66ce6ab",133,78,62,15.0161290322581,133,0,3,3
"29431","cbdec8d1dfed19de6e97b8db64ec8356",94,41,35,18.8,94,0,2,3
"29432","cbdecf52a2d7609975a3f85098a19ee1",49,49,0,49,49,0,1,2
"29433","cbdfb5e117e822de1fdc49cd35d47269",37,37,0,37,37,0,1,2
"29434","cbe22624a2112ba16d11b5e346aa4f8d",35,29,55,4.45454545454546,35,0,2,1
"29435","cbe288fb7431e320ff042478402a6f22",70,45,70,7,70,0,2,1
"29436","cbe28ebd91337a7662a31ec0a5df4957",149,88,68,15.3382352941176,149,0,3,3
"29437","cbe393191d6fc49d60c900646e0cc2c2",34,34,0,34,34,0,1,2
"29438","cbe509420b869060808df15195d9cdba",58,43,39,10.4102564102564,58,0,2,1
"29439","cbe92d1bd74a2b175a7b5087769cfd65",152,106,74,14.3783783783784,152,0,3,3
"29440","cbeaa2a9970db4bd12cab1fa67fe3240",32,29,36,6.22222222222222,32,0,2,1
"29441","cbeaaa347db2c51c164b2c78e04efc69",47,44,11,29.9090909090909,25,22,1,2
"29442","cbeb60485cb0a87f5e69a14321c1c4e0",26,26,0,26,0,26,1,2
"29443","cbeec2f8caf19695e842cc0047086dbf",120,92,74,11.3513513513514,91,29,3,1
"29444","cbef0dad72cafac5d0f0e54c51eba035",42,42,0,42,42,0,1,2
"29445","cbf05266494a6b0ec21d84d0c49532f2",8,8,0,8,8,0,1,2
"29446","cbf085026712f993bd889a4b32e55091",19,19,0,19,19,0,1,2
"29447","cbf0af11e202dcd1850b9fb67bf206d2",222,102,79,19.6708860759494,182,40,3,3
"29448","cbf1b914fb217edea7226a4974f740b2",29,29,0,29,29,0,1,2
"29449","cbf41f080350202c8cc21a6262957e10",43,43,0,43,43,0,1,2
"29450","cbf472f76bfc66ca20e99270396d6687",42,42,0,42,42,0,1,2
"29451","cbf4ed0be3c6dec5e7d44435d576acfd",123,59,49,17.5714285714286,123,0,3,3
"29452","cbf60c65d18377526c2126d3626b2e0d",2,1,2,7,1,1,1,2
"29453","cbf621035f363fcbc8520dcdb44dda01",87,52,84,7.25,87,0,2,3
"29454","cbf7c460b5807431b7c1d70ff542e93a",22,22,0,22,22,0,1,2
"29455","cbfd67260024b6989991ed8da3467194",79,55,64,8.640625,55,24,2,1
"29456","cbfddc9e0d7e5d7b681534964066bbc6",239,108,67,24.9701492537313,200,39,3,3
"29457","cbfe1470d49d0724bd7ef1fb182166cb",49,49,0,49,49,0,1,2
"29458","cbfeed09d359b1920cde88c79624567e",131,106,51,17.9803921568627,131,0,3,3
"29459","cbfef2f246c0ff20df3d584dc320798d",17,17,0,17,0,17,1,2
"29460","cc01c77330b824d4c0bbc735cc8d41a3",11,11,0,11,11,0,1,2
"29461","cc0610601824a109bd92a5f131447b71",31,31,0,31,0,31,1,2
"29462","cc078e87b35a45729e916a2c1717ae21",151,121,48,22.0208333333333,151,0,3,3
"29463","cc0a5bc45de4ab590265549198aa3a31",11,11,0,11,11,0,1,2
"29464","cc0c0ef9246abad991343a9b3a240719",147,94,60,17.15,92,55,3,3
"29465","cc0dd67c669c929e002e8e296edc439a",63,48,40,11.025,33,30,2,1
"29466","cc0fb4a3bb6011b77064843ae0fe6994",100,69,64,10.9375,100,0,2,3
"29467","cc1642393b146eafb29dd1c59b79f36b",22,22,0,22,22,0,1,2
"29468","cc177a52bc9fa9b923e77780ec69b955",10,9,16,4.375,1,9,1,1
"29469","cc1b6c34a2f5833356df1dcfb8c2204d",1,1,0,1,1,0,1,2
"29470","cc1f16c28bc8455624033a4f3a8b22f7",108,81,28,27,108,0,3,3
"29471","cc1ff351d92416d7a719fc685402413c",45,32,43,7.32558139534884,45,0,2,1
"29472","cc21efab89fedca970fe121e7f851de1",36,30,35,7.2,36,0,2,1
"29473","cc23c9cbbbf9ceb4f16144c92a43e9ef",27,27,0,27,0,27,1,2
"29474","cc23d0a6d5be95c76e133fb3d35da5d0",43,43,0,43,43,0,1,2
"29475","cc264adf140c6ba7232816ee41e0a2eb",34,34,0,34,34,0,1,2
"29476","cc2791ce1d9a8c05c20d5d21b94926de",25,25,0,25,25,0,1,2
"29477","cc2a38c0fb40d2aaaf27ca98da0bf244",2,2,0,2,2,0,1,2
"29478","cc2a58ac56d0d5ffe6cacf98eace1835",36,36,0,36,36,0,1,2
"29479","cc2a8fa9aaf2f0bddf0ef246a7015896",59,48,83,4.97590361445783,59,0,2,1
"29480","cc2ae93db1923458c1dc39e22a7ae81c",47,40,76,4.32894736842105,23,24,2,1
"29481","cc2c352dd11d2cee1cfcd85b3e61238b",46,46,0,46,0,46,1,2
"29482","cc2fdffd44d0bb74d63e0a81b0dcfa76",160,76,78,14.3589743589744,160,0,3,3
"29483","cc335d2f7ddeb6d7817a7e6487369642",22,22,0,22,22,0,1,2
"29484","cc34229f2b34dcf294114ac9931a404b",9,9,0,9,9,0,1,2
"29485","cc34247ef970c6fa4d2fea50fe34d405",29,29,0,29,29,0,1,2
"29486","cc343ae8720352ddc98114b70e86987e",18,18,0,18,18,0,1,2
"29487","cc36541f830ddc4b827c5891dd42ce77",86,65,35,17.2,86,0,2,3
"29488","cc37ab877e6de0271d154439be4d568a",91,60,64,9.953125,91,0,2,3
"29489","cc397e77f968909e183d5a054369e5d9",47,47,0,47,0,47,1,2
"29490","cc3b168d469a1909314c05b3497b6371",93,88,28,23.25,93,0,3,3
"29491","cc3ba24d6d371776ba8ae15d3dd22a8a",16,16,0,16,16,0,1,2
"29492","cc3c8ef82cee77317b457d0eacc2b66f",52,39,38,9.57894736842105,52,0,2,1
"29493","cc3ca03d8eb9c3a6db7099b8fb03fd56",70,45,56,8.75,19,51,2,1
"29494","cc3fc74427df02685a4cc86dd8d44b1c",17,17,0,17,0,17,1,2
"29495","cc40a96b66742a0090d41ee70a8d1026",25,25,0,25,0,25,1,2
"29496","cc43b1a4833b7253642d3c1cadce3f5b",39,39,0,39,0,39,1,2
"29497","cc46b5dea877c4aa18ed1db2ee7151af",11,9,29,2.6551724137931,11,0,2,1
"29498","cc489fab599837fc7e407af54dfc6bdb",155,103,58,18.7068965517241,155,0,3,3
"29499","cc4904c375cc57b204c32e751648c10b",128,95,36,24.8888888888889,94,34,3,3
"29500","cc4c9ff7645c02b034e7cf5ceb0d72fe",62,51,36,12.0555555555556,25,37,2,1
"29501","cc4cc6a99e87f0fa91db5ff07eff4adf",29,29,0,29,29,0,1,2
"29502","cc52470633b2e84c77591bd40f42a401",32,25,36,6.22222222222222,32,0,2,1
"29503","cc524faa8d0e25f226cb70aa5d303448",20,20,0,20,20,0,1,2
"29504","cc53610c979531d6fcbccb77ee01e7ce",4,4,0,4,4,0,1,2
"29505","cc539473d4b81a1612a95ac51242f8f9",146,80,62,16.4838709677419,146,0,3,3
"29506","cc55b62f4ab76517340202f53f24848f",169,94,77,15.3636363636364,147,22,3,3
"29507","cc5a0eef55fd417cdc991a5f11f47646",12,12,0,12,0,12,1,2
"29508","cc5d6e887c4f9ea26e3ce61aafbecc7f",49,31,68,5.04411764705882,49,0,2,1
"29509","cc5e5839f61dad7192a438a3f3c1083a",30,30,0,30,30,0,1,2
"29510","cc5f1f7ecf9be6b2625fd1f72a080169",40,40,0,40,40,0,1,2
"29511","cc5fdad1968d7b0f90bb3ae1544330e8",63,52,35,12.6,63,0,2,1
"29512","cc6251c6e668ca67bb56f197e85fb680",28,28,0,28,28,0,1,2
"29513","cc62ee835b4aaeb6b3437087c2e875f5",208,104,56,26,208,0,3,3
"29514","cc63995e78f7748984b591fd0bd1ef68",19,19,0,19,19,0,1,2
"29515","cc648381b05b781701362aaffd8f57a0",245,106,72,23.8194444444444,201,44,3,3
"29516","cc65e45fdfdc708d2689825acfba351e",36,36,0,36,36,0,1,2
"29517","cc670487b1b2f9c6eed12cb343f01362",121,84,61,13.8852459016393,83,38,3,3
"29518","cc6992f33cd601cce9f16689af164428",68,63,44,10.8181818181818,68,0,2,3
"29519","cc6b9b5bc237c8bb5fab00c8a82cd723",24,24,0,24,0,24,1,2
"29520","cc6d14cf1cf27c4ef13c5dbe6a76d504",61,48,34,12.5588235294118,61,0,2,1
"29521","cc6ebb5ee4cb4dbb50202173feb25d36",19,19,0,19,19,0,1,2
"29522","cc71701d14541a80993f82e7d6677ede",91,61,81,7.8641975308642,74,17,2,1
"29523","cc727f31ff30ff47da36c11a674f49cf",136,112,55,17.3090909090909,136,0,3,3
"29524","cc73df705d8277315a58e40fda17412c",89,63,42,14.8333333333333,89,0,2,3
"29525","cc7416d1b35831a53787eb67b5ca1207",14,9,49,2,12,2,2,1
"29526","cc751e39706553e7f229958844cc58cc",32,32,0,32,0,32,1,2
"29527","cc7603327763d1b3b05564a93b971b04",20,20,0,20,20,0,1,2
"29528","cc762156a7de9d45fea353e109feab21",22,22,0,22,22,0,1,2
"29529","cc767cc248a3317286e8a45ddd505018",2,2,0,2,2,0,1,2
"29530","cc7754ac82036cc84c09259c77429381",125,82,69,12.6811594202899,125,0,3,3
"29531","cc77f16197554a01c8a2a23b1fc34d6c",34,34,0,34,34,0,1,2
"29532","cc7b11c2d9c4262a8dfcb3a6d1c46e0a",18,18,0,18,18,0,1,2
"29533","cc7c49eaa55c181f326dd381bd1566e5",42,42,0,42,42,0,1,2
"29534","cc7c802ff0aa6028d78ae7b112e4cd69",174,98,63,19.3333333333333,174,0,3,3
"29535","cc7d3afec367761f7bea0ac2485348d0",40,34,7,40,0,40,1,2
"29536","cc8106adf9f793788cd8d33aabf55faa",56,43,54,7.25925925925926,27,29,2,1
"29537","cc83b992c6b374b2d9980a4dc25a8390",200,120,90,15.5555555555556,200,0,3,3
"29538","cc84ed819cbe7dbbd8c435dc4b3472bb",28,28,48,4.08333333333333,28,0,2,1
"29539","cc86f730c36f04d289d8b07be7a25a10",55,54,13,29.6153846153846,1,54,1,1
"29540","cc884be995f1b6d580795ce05b25ecb4",24,24,0,24,0,24,1,2
"29541","cc8dc5f8ef3dc49373cdce4c57e97327",34,34,0,34,0,34,1,2
"29542","cc929ace8794bba63864551e326fe83f",34,34,0,34,34,0,1,2
"29543","cc934101368c0cb9e99a65262536008e",15,15,0,15,0,15,1,2
"29544","cc938135868624a29debfc8f7634e6c9",42,42,0,42,42,0,1,2
"29545","cc975f830725946c19e8f680da8895fd",146,74,75,13.6266666666667,146,0,3,3
"29546","cc9784c648173fb4d487478c676c185c",95,85,43,15.4651162790698,95,0,3,3
"29547","cc97f4c8adc0822e9738e2686ef9db30",3,3,0,3,3,0,1,2
"29548","cc982155972a657414b71b4b25ee52b9",36,34,25,10.08,28,8,2,1
"29549","cc9beeef7d899ced86169d6ce6759205",6,6,0,6,6,0,1,2
"29550","cc9c5df71e4892d94fec6971dff1f696",23,19,22,7.31818181818182,23,0,1,1
"29551","cc9c8b7ebb88bb56efb7962ba9080c23",22,22,0,22,22,0,1,2
"29552","cc9ce018a1ae36f57c1ee6112d6eec21",91,69,55,11.5818181818182,91,0,2,3
"29553","cc9d0f10e9309619bc8da2e38ceb66d8",37,37,0,37,37,0,1,2
"29554","cc9da799de16e86bbdb4806b8a8a0edf",37,37,0,37,37,0,1,2
"29555","cc9ee78aea718d89ad24e5181cd16b14",32,31,12,18.6666666666667,32,0,1,1
"29556","cca0334b6deba270b9e5bd8644dc6bdc",18,18,0,18,18,0,1,2
"29557","cca0cd080156d65ce1b64bb920671075",215,142,60,25.0833333333333,215,0,3,3
"29558","cca1b27af2a33c55ecb14b75fd531c5b",253,144,78,22.7051282051282,217,36,3,3
"29559","cca9776bd1753f5dc70831e67affedfc",79,60,19,29.1052631578947,79,0,1,2
"29560","ccab155c17081c3efec7d890d781f98b",31,31,0,31,31,0,1,2
"29561","ccacdff679f504e774322b546697e343",51,51,0,51,51,0,1,2
"29562","ccb30544d33b06f43592ab3856b7c6e6",35,34,21,11.6666666666667,35,0,2,1
"29563","ccb35fa51ff8ae6c4dc31e14570636cb",64,54,31,14.4516129032258,64,0,2,1
"29564","ccb3db94a804e8c43269d29f85cb3df0",143,76,51,19.6274509803922,124,19,3,1
"29565","ccb5bbaefa87e72b574677ea990aaee3",21,21,0,21,21,0,1,2
"29566","ccbb3a6270d1a4d35559ab82d667204d",63,49,61,7.22950819672131,63,0,2,3
"29567","ccbdba074c972328c3a320549d99f1e0",38,35,78,3.41025641025641,38,0,2,1
"29568","ccbe4b34512ee6acfcf733b8ffaeb0a1",38,38,0,38,38,0,1,2
"29569","ccbfaa49f92a475fa061fc160f052658",145,80,70,14.5,113,32,3,3
"29570","ccc052ed25cea5c978a306d8a59adf76",196,95,71,19.3239436619718,152,44,3,3
"29571","ccc1320ccc53b574ee27bef7a600cbba",30,30,0,30,30,0,1,2
"29572","ccc1850769ab7e53591cf20b954a8ee3",89,80,31,20.0967741935484,46,43,2,3
"29573","ccc2539ff579510e01b9d21c5f57dc51",37,37,0,37,37,0,1,2
"29574","ccc4f823a1c128f2a429b1006c75962b",47,38,45,7.31111111111111,47,0,2,1
"29575","ccc8c612230de0ca2fe74e5f40c6dd49",95,64,79,8.41772151898734,95,0,2,3
"29576","ccc8cdf4400b2681d39f4d545988e10b",47,44,33,9.96969696969697,17,30,2,1
"29577","cccba9fea74fea3b6f48c6df9b27d49f",46,34,47,6.85106382978723,46,0,2,1
"29578","cccc1355cd751719358dd4e7d0c18ca3",61,43,57,7.49122807017544,31,30,2,1
"29579","cccc43b1452f218ddfaf2ccd094f6c42",27,20,10,18.9,27,0,1,1
"29580","ccccdfc6fd8396c1f847c1e846db6424",124,73,60,14.4666666666667,124,0,3,3
"29581","ccce0c0896785f743129b8bdfc9da902",28,28,0,28,28,0,1,2
"29582","ccd01e2bd5eaa202aae4c2164f3b9529",33,33,0,33,33,0,1,2
"29583","ccd1cc04128f9f5a673cfe34933f6a17",73,58,81,6.30864197530864,73,0,2,3
"29584","ccd1f83dbd19e516b1f672347b5d9087",55,27,60,6.41666666666667,36,19,2,1
"29585","ccd31eda234194ea2edb51eb2cc2300f",16,16,0,16,0,16,1,2
"29586","ccd32fdf9804106bfdfcebbfdbdba469",23,23,0,23,23,0,1,2
"29587","ccd57de5d9ec1036c948ee64bc5f4d30",20,18,25,5.6,11,9,2,1
"29588","ccd59cdb1198d697367f366f5e9fd12c",202,98,70,20.2,202,0,3,3
"29589","ccda9746392dc9f69ab932062ce5a05c",33,33,0,33,33,0,1,2
"29590","ccdb812b7d81f19b4eb21ae3e5664fc5",15,15,0,15,0,15,1,2
"29591","ccdd1b8d949675268f134415a074283a",39,39,0,39,39,0,1,2
"29592","ccdda7d145538f947070cbce5b761550",29,29,0,29,29,0,1,2
"29593","ccddad5b687017d178262191dadb3fd0",179,123,43,29.1395348837209,179,0,3,3
"29594","cce125a9952e94d909cb634785b4796f",35,35,0,35,0,35,1,2
"29595","cce25fae41c302339d9afbc61f82f015",28,28,0,28,0,28,1,2
"29596","cce2b5193a7f2d3acdeaf8dae4f288cd",13,13,15,6.06666666666667,9,4,1,1
"29597","cce362d65d4ed99b85cbd8c65895e2b0",95,71,42,15.8333333333333,95,0,2,3
"29598","cce3b1b01e1a98c6f0a9beb9fcccaa91",17,13,45,2.64444444444444,17,0,2,1
"29599","cce3bc32e8f0099095cec82126dac6db",61,50,13,32.8461538461538,61,0,1,2
"29600","cce7a5f98484b40b5ad43fdc1d1673eb",33,33,0,33,0,33,1,2
"29601","cce81f6b4650025c34ab29f83d731a26",121,87,61,13.8852459016393,121,0,3,3
"29602","ccea9c2d2ac49255dc1da3e55294fe32",22,22,0,22,22,0,1,2
"29603","cceab8a331229f1d0df74a09df52e2b4",12,12,0,12,12,0,1,2
"29604","cced7ca9f9b64bff750a8587a9c22408",164,102,84,13.6666666666667,164,0,3,3
"29605","ccf2988708ea4bdfae72ed7f6d4feda7",65,40,71,6.40845070422535,65,0,2,1
"29606","ccf511442f36cc4971dc76a7b9e2c1e2",46,46,0,46,0,46,1,2
"29607","ccf53d2be052814ba02a0ba0e56c13e6",32,32,0,32,0,32,1,2
"29608","ccf58ddaee02848c7250067a82f8bd7a",38,32,20,13.3,38,0,1,1
"29609","ccf64199429e8022c64809b6a5c71a76",1,1,0,1,1,0,1,2
"29610","ccf7d013da35b61d8a9401eb7a95791b",211,111,82,18.0121951219512,211,0,3,3
"29611","ccf9fbee997e06c35976652725ca5d14",23,21,12,13.4166666666667,23,0,1,1
"29612","ccfb3c3f8c1da4815f1a4861fde15771",24,24,0,24,0,24,1,2
"29613","ccfce5d71850196a89ff458a7ff2849a",2,2,0,2,0,2,1,2
"29614","cd015246c9bdaddfc8af8e40618b20fc",22,22,0,22,22,0,1,2
"29615","cd02c9c0388d6306bd73f5899d773249",28,28,0,28,28,0,1,2
"29616","cd04a929cbd9e906ab5edde1a7ed96e4",109,80,84,9.08333333333333,109,0,3,3
"29617","cd058c3ba61007941414819b4d9008d2",31,31,0,31,31,0,1,2
"29618","cd0808bed617524b95503391c4195603",99,83,66,10.5,73,26,3,1
"29619","cd093764bf9075cde02c4ff93295254e",46,41,64,5.03125,46,0,2,1
"29620","cd097d6409fa7d965aae465674f63778",28,28,0,28,28,0,1,2
"29621","cd0a7ba0c2b766cf952c8972a8b00c90",23,14,71,2.26760563380282,23,0,2,1
"29622","cd0c62376831bb0daf6031ca4fca41dd",51,37,56,6.375,51,0,2,1
"29623","cd0d491bcf7fca703ea4d9c701e4e02e",34,34,0,34,34,0,1,2
"29624","cd0f35f7fe85122ed1f8f80f79694333",17,13,43,2.76744186046512,11,6,2,1
"29625","cd11c7d554ddd84c6784497bd7dfb490",89,71,81,7.69135802469136,89,0,2,3
"29626","cd12018272e380da6a18d9180672d12c",69,58,78,6.19230769230769,69,0,2,3
"29627","cd13fdd6585ba7a253af69feaac87597",42,42,0,42,42,0,1,2
"29628","cd15a1678f16b6bd9b329b962ddec4bd",45,45,0,45,45,0,1,2
"29629","cd15a3091acc9093f4848e40e21efbd0",127,79,87,10.2183908045977,127,0,3,3
"29630","cd16ae0e38776d18b6c520d3554d6f2a",12,12,0,12,12,0,1,2
"29631","cd16b19617d5bd3f8d446e0a8c6d63c3",126,77,78,11.3076923076923,126,0,3,3
"29632","cd16f7e1a7c12b1c5dadb72366cda662",56,56,0,56,56,0,1,2
"29633","cd177acff00ea5447639db99587394fc",24,24,0,24,24,0,1,2
"29634","cd190ea34c3b611448d779edfdb22c37",72,48,65,7.75384615384615,72,0,2,3
"29635","cd19cebcba23dbc537487c9d0fc148b7",105,64,64,11.484375,81,24,2,1
"29636","cd1b6f4a14128c279ee47e3cbdb082f3",105,53,58,12.6724137931034,73,32,2,1
"29637","cd1fe9fc3a0bd6e61c8bd0e572632b55",16,16,0,16,16,0,1,2
"29638","cd203fa90aa9f62d3305676f3adce7f7",54,38,24,15.75,54,0,2,1
"29639","cd21663df9c517f9fc8c523714a3ee34",49,35,34,10.0882352941176,49,0,2,1
"29640","cd236ba23b9028c350e78d43d8889108",48,48,0,48,0,48,1,2
"29641","cd2379e6e25fd39e8bd0e55842ca4be8",143,81,51,19.6274509803922,91,52,3,3
"29642","cd23f5d8fd7808ef0816bf64d7c258dc",88,47,55,11.2,88,0,2,3
"29643","cd25179236a376fa4695dac1960e9d34",36,36,0,36,36,0,1,2
"29644","cd2622decdf1d5c1ab7351aa39bd2b50",12,7,52,1.61538461538462,12,0,2,1
"29645","cd270852f106f1ff3d1bd716443b5203",19,19,0,19,19,0,1,2
"29646","cd27ddc3b11958789fcd481d70d26f4a",27,27,0,27,27,0,1,2
"29647","cd2b4cc7faa97a15967ffaf976a8fad5",198,90,76,18.2368421052632,198,0,3,3
"29648","cd2cb26328d8eb1a90a5ae6b0e812395",24,24,0,24,24,0,1,2
"29649","cd2d7928225f9733849e4d7a5c7419a9",24,24,0,24,24,0,1,2
"29650","cd2fe9f84846b79fdd485329864b3139",1,1,0,1,1,0,1,2
"29651","cd3216de5a815d4f24384269662dd701",52,52,0,52,52,0,1,2
"29652","cd33143b17835d5c6e2f5e5b0ded6d48",24,24,0,24,24,0,1,2
"29653","cd388b2304092178a040308d8f3ff57b",34,34,0,34,34,0,1,2
"29654","cd39f026b93c676c70cbe939b2c13bfd",84,55,43,13.6744186046512,84,0,2,3
"29655","cd3b073254f85b20a2a401a60666eb38",98,70,46,14.9130434782609,53,45,2,3
"29656","cd3b55b9919b51e0e9d4285c46351edd",73,41,26,19.6538461538462,73,0,2,1
"29657","cd3eb60d534ee900e88c4f655976e905",91,66,42,15.1666666666667,91,0,2,3
"29658","cd41fe1b16b249d81bf212b66e5dfd63",118,97,51,16.1960784313725,87,31,3,3
"29659","cd43177bbc7cdaf455d1a41501aaccf0",9,9,0,9,0,9,1,2
"29660","cd4387ee7ffa8489e4a4679c010b27b7",140,98,55,17.8181818181818,93,47,3,3
"29661","cd43eb7126e81f29908addd612dc1e21",187,102,75,17.4533333333333,145,42,3,3
"29662","cd4409f03ceda49da33cdd3c1b38f975",10,10,0,10,10,0,1,2
"29663","cd44be6b95f1eba5322ad6ba6e56dc5a",24,20,43,3.90697674418605,16,8,2,1
"29664","cd4530b740a00690ca38ee81d8092517",100,43,85,8.23529411764706,100,0,2,3
"29665","cd456b06be10d4e7fef9d68fa75d974d",97,58,45,15.0888888888889,97,0,2,3
"29666","cd4b265667cf83d66c676247ed0502f7",90,76,49,12.8571428571429,90,0,2,3
"29667","cd4b9c57ed5fba93b27ab8f54c2fd78b",53,47,40,9.275,53,0,2,1
"29668","cd4f136a6d4ab60544ee538c55917408",36,36,0,36,36,0,1,2
"29669","cd513e0140160a75a2d62724e56133d4",24,24,0,24,24,0,1,2
"29670","cd51bb8541b04e8ccc1577c161b866e2",56,43,21,18.6666666666667,56,0,1,1
"29671","cd546f89b64021d9ac1506f9b4a3a2b7",47,41,35,9.4,47,0,2,1
"29672","cd56067c01d4cb8468663bd268fd1096",54,37,89,4.24719101123596,54,0,2,1
"29673","cd566f2e17c1af2ae8a8987480a3f8c3",70,47,65,7.53846153846154,70,0,2,3
"29674","cd57616dd82dfd1202cffddd58981e71",24,23,4,42,14,10,1,2
"29675","cd57d494bb67d50f060887159fcc904f",30,30,0,30,30,0,1,2
"29676","cd59c8e5fca5106ba78a3ae9449378b7",82,51,63,9.11111111111111,82,0,2,3
"29677","cd59f7284af156456dbff14032134bb9",7,7,0,7,7,0,1,2
"29678","cd5a252c8fff53015523048ab91d7272",52,49,45,8.08888888888889,52,0,2,1
"29679","cd5aa5b3cc70129acab4e0ff75e0a48f",216,108,77,19.6363636363636,216,0,3,3
"29680","cd5d0fd4668889ee9b966ac9b9d40f9c",18,18,0,18,18,0,1,2
"29681","cd5d63646ae5792c6e91eddef1ff2550",16,10,68,1.64705882352941,16,0,2,1
"29682","cd5de900704bff57029ae110ae740bcd",37,37,0,37,37,0,1,2
"29683","cd5e24327a6964bd324470cf2a363e5b",42,42,0,42,42,0,1,2
"29684","cd5e472d011ac693c4c88fcd34fd37f8",24,24,0,24,0,24,1,2
"29685","cd5e542c848c6de792cf0fe6140a5ebb",32,32,0,32,32,0,1,2
"29686","cd620fe9311a5e51230cad5bb7c96ab4",10,10,0,10,10,0,1,2
"29687","cd67ad9969e8412012cc883f41f4d9cd",25,25,0,25,25,0,1,2
"29688","cd6958ff2eba456781e7ebaabf4705f6",57,43,61,6.54098360655738,57,0,2,1
"29689","cd6e38350a25cc8c67a66af2f58b2917",30,30,0,30,30,0,1,2
"29690","cd6fe5f30db41124a1eb761faeb2b90b",113,75,77,10.2727272727273,113,0,3,3
"29691","cd6ff77d9c694b1a7abf6ac63cf3257d",140,88,60,16.3333333333333,140,0,3,3
"29692","cd7040086e67108023ee58e0003829ad",20,20,0,20,20,0,1,2
"29693","cd72c81075fca6acd02afee0f5cb326c",35,35,0,35,35,0,1,2
"29694","cd73bdef09167abbdfa56def3063ad0b",37,37,0,37,37,0,1,2
"29695","cd74a6843f3dafc05a7f405065e6d0d4",70,59,68,7.20588235294118,70,0,2,3
"29696","cd780e06c229c4bbbd1c82f8f110f611",45,41,18,17.5,45,0,1,1
"29697","cd781d56679b0dad0c5e56af3f4796b8",12,12,0,12,12,0,1,2
"29698","cd79703a30ca861767147ce872afa6bc",33,33,0,33,33,0,1,2
"29699","cd798c6a2131a3267efab02f8b324d1a",32,27,13,17.2307692307692,32,0,1,1
"29700","cd7c7b2ff75355ef5f4424dc4c67cf2c",26,26,0,26,0,26,1,2
"29701","cd7c87ba6428a1acdad379b912eaefe8",87,59,28,21.75,87,0,2,3
"29702","cd7fa54f593685fb992ce6e36357c614",166,105,46,25.2608695652174,166,0,3,3
"29703","cd80e3b74d3b5ea35cd0b7e9a54fe0a5",62,44,77,5.63636363636364,45,17,2,1
"29704","cd815a12e3deeb9eb6f448742aee7740",56,41,49,8,56,0,2,1
"29705","cd82eb4e3b3684256e85b7b72a426acc",141,55,82,12.0365853658537,141,0,3,3
"29706","cd848ab7253401948f31b8e7a39fa409",30,30,0,30,30,0,1,2
"29707","cd85177484c507291f4e7fefdcbb2ef3",21,16,58,2.53448275862069,21,0,2,1
"29708","cd866e272a11b225ae86b0ddb633354c",21,21,0,21,21,0,1,2
"29709","cd86c44f6a626e97067d638120d63217",39,35,37,7.37837837837838,39,0,2,1
"29710","cd9255bd236763b42628532e79c6bc4f",201,139,85,16.5529411764706,201,0,3,3
"29711","cd939d1b87263815a8d017c2b5a86bf0",57,52,49,8.14285714285714,57,0,2,1
"29712","cd941104c052b2c6be8e687e319b644d",121,80,59,14.3559322033898,97,24,3,1
"29713","cd949fc719db7d5349d56d37a3960440",25,25,0,25,25,0,1,2
"29714","cd9693dec51cccb959773ec50a901365",26,26,0,26,26,0,1,2
"29715","cd9842e5e1b4d30586ebaf6a46a43200",28,28,0,28,28,0,1,2
"29716","cd9867f794da4caced7167e17a8daa3c",21,21,0,21,21,0,1,2
"29717","cd98d736688adf49ec5aa94ce5977352",158,89,64,17.28125,138,20,3,3
"29718","cd99447d84815ab0b81fbcbf425eb4d8",36,36,0,36,36,0,1,2
"29719","cda0cf36957ec0d27fb6a94eeed287b9",43,43,0,43,43,0,1,2
"29720","cda0ea9ef08058c36d6f99370bff4357",82,69,21,27.3333333333333,82,0,2,2
"29721","cda252306c882f4448db4c179eb2496c",19,19,0,19,19,0,1,2
"29722","cda3d355ecfffe43777acf5c845f9e17",34,24,61,3.9016393442623,34,0,2,1
"29723","cda57576a85ac7d0e7ce4db64f426912",40,36,15,18.6666666666667,40,0,1,1
"29724","cda5a91e8083a0f4909228baef685a73",12,12,0,12,12,0,1,2
"29725","cda73c33769008d834191913230000ce",45,45,0,45,0,45,1,2
"29726","cda78e2e4dcd286d2dec97322fce7c9e",62,44,28,15.5,62,0,2,1
"29727","cda880d9510e4dca92511bba2d947cff",190,96,78,17.0512820512821,145,45,3,3
"29728","cdabf4a172fa11666e60e9de03f82a90",131,90,64,14.328125,88,43,3,3
"29729","cdac023206357bc50bb143442494bae7",69,48,70,6.9,69,0,2,3
"29730","cdaf89684802345ccbf2b37c0aa554a0",48,48,0,48,48,0,1,2
"29731","cdb1ffbf53edbef6b315be99a30bf2bf",62,58,9,48.2222222222222,62,0,1,2
"29732","cdb204688a97735fb394ec6146215d9c",27,27,0,27,27,0,1,2
"29733","cdb9fb2e123a74797456f144c6fedd01",50,15,75,4.66666666666667,41,9,2,1
"29734","cdba69d866257f91978a2c435be49bd6",13,13,0,13,13,0,1,2
"29735","cdbbee0054a35503638f95de4c88dec9",65,38,82,5.54878048780488,45,20,2,1
"29736","cdbd2a01fa5f74f8c2f107327515fce4",9,9,0,9,9,0,1,2
"29737","cdbf43158fb443d338b0ca25ee031cb7",37,37,0,37,37,0,1,2
"29738","cdc29fc70feabbe04df7f0a903a3d6e2",39,37,49,5.57142857142857,39,0,2,1
"29739","cdc2fc755090847fb1a962cfa97a1325",32,32,0,32,32,0,1,2
"29740","cdc389b71a85400f457d4948ec25225c",62,53,35,12.4,62,0,2,3
"29741","cdc57fa79dbb5341b3717c384470b4a9",21,21,0,21,21,0,1,2
"29742","cdc80da035fb6f835183c6a55495f149",11,11,34,2.26470588235294,11,0,2,1
"29743","cdca572731d702e949f0f0d03b564170",36,20,30,8.4,17,19,2,1
"29744","cdcb0c9e6a19f72e9b60d3ab649cb922",52,45,34,10.7058823529412,52,0,2,1
"29745","cdcb5300a6b85f94b298b8a473840c1d",13,13,0,13,13,0,1,2
"29746","cdcc3e9591366d58a8f90c0e5b6f2698",103,68,71,10.1549295774648,103,0,3,3
"29747","cdcd928f03e9e22cc1c44e6191637b79",9,9,0,9,9,0,1,2
"29748","cdcdeed5ae24032ef995feb5fa249795",51,36,56,6.375,51,0,2,1
"29749","cdd09e90b92303569d863eb8e29689b1",63,46,25,17.64,63,0,2,1
"29750","cdd2c09eabf61e0d36bb34d0fb5500b3",83,52,42,13.8333333333333,83,0,2,3
"29751","cdd38255e48c981639fab2ce63e98b7f",53,53,0,53,53,0,1,2
"29752","cdd4d796b88a2e3ad6f408930e6f7442",157,102,70,15.7,157,0,3,3
"29753","cdd5cd87741a2ebff65c42a9004f9563",27,27,0,27,27,0,1,2
"29754","cdd7676d852f6968a592e4183f0f53fd",96,80,61,11.016393442623,96,0,3,3
"29755","cdda3c71b7e3c332f9a104f6cfe98635",32,32,0,32,32,0,1,2
"29756","cddcf94d69318fd1798a26fd9b3db422",21,21,0,21,21,0,1,2
"29757","cddd9f7f470c8ccf983ba701e0281076",16,16,0,16,16,0,1,2
"29758","cdde6b2d587e290425d6a7783792a576",106,96,58,12.7931034482759,106,0,3,3
"29759","cde0c6a88e7a73821998ec22988f3ed4",42,36,42,7,42,0,2,1
"29760","cde252395db039c070f471f44c96ccb8",37,37,0,37,37,0,1,2
"29761","cde2650d80ea3655463b50033f099f8a",36,36,0,36,36,0,1,2
"29762","cde2c0370b46f2405e3b4285d3ab8209",50,36,31,11.2903225806452,50,0,2,1
"29763","cde2f8b92a484338195833fe91ae2287",145,103,52,19.5192307692308,145,0,3,3
"29764","cde381b1124f0e775cb018c1004e65d8",4,4,0,4,4,0,1,2
"29765","cde4562677d2322f5c0782c32c1f6ae5",65,56,30,15.1666666666667,65,0,2,1
"29766","cde4cfc30de6a3192d831628bc97cfa3",111,63,59,13.1694915254237,87,24,3,1
"29767","cde4feac709a61a1e8f9029337468b3b",5,2,32,1.09375,5,0,2,1
"29768","cde84064630c4c057585c24e5a63bb07",14,14,0,14,14,0,1,2
"29769","cdec3482b361fce05eea2f92dab2ef12",30,30,0,30,30,0,1,2
"29770","cdec3a79d7717878f9e03e00645e83a1",14,14,0,14,14,0,1,2
"29771","cdee33da14b237a1fe52cc5e1dfcb3ef",163,92,70,16.3,163,0,3,3
"29772","cdf2003836c4d2d0f87fe2de268fbe3b",27,26,7,27,27,0,1,2
"29773","cdf213f32a6c5323211ea80fc00c7b43",24,24,75,2.24,24,0,2,1
"29774","cdf34b4f1829e32f4365eb3f20cd575b",76,61,26,20.4615384615385,76,0,2,1
"29775","cdf5d71f1a7318aaf3f8f4d4a9e5c8b4",22,22,0,22,22,0,1,2
"29776","cdf5ec07a9880da94d437ba718ee7a71",2,2,38,0.368421052631579,2,0,2,1
"29777","cdf869719045e75db4a6296aa75a56cd",17,17,0,17,17,0,1,2
"29778","cdf89935e1310f479887db2bf6f243f3",72,46,50,10.08,45,27,2,1
"29779","cdf976e79714faa014f147eeb3a7c08d",6,3,52,0.807692307692308,6,0,2,1
"29780","cdf98c05d6f1cedc621d2c669bafa1a9",148,66,69,15.0144927536232,120,28,3,3
"29781","cdfa87c64efcd06682236f35d4118c93",36,30,46,5.47826086956522,36,0,2,1
"29782","cdfac21bf81a73abe0e6ffd3fb62304e",19,19,0,19,19,0,1,2
"29783","cdfbd9bd316e2a60138ddbd747c342d2",212,122,83,17.8795180722892,165,47,3,3
"29784","ce00cdb0c4f78a485b8811d9da3348e1",43,43,0,43,43,0,1,2
"29785","ce013105e81928771de9bec50ed21679",41,41,0,41,41,0,1,2
"29786","ce029ed75313855c5d177e8a52257f77",39,35,71,3.84507042253521,29,10,2,1
"29787","ce0349d444e813e6a2fc604469a790a5",123,87,32,26.90625,123,0,3,3
"29788","ce03754a89bb7a05a3d493b83f9fe131",30,28,39,5.38461538461539,30,0,2,1
"29789","ce08e07cf9a0832c36daf1f7b1efa406",38,38,0,38,38,0,1,2
"29790","ce0a483ff1eda92dc4a14cc60ccea62f",137,107,46,20.8478260869565,137,0,3,3
"29791","ce0a7f5ce67cd5600a56fe29056e21e2",70,56,51,9.6078431372549,70,0,2,3
"29792","ce0c68d0c5dd64510bbd9711c03bb809",2,2,0,2,2,0,1,2
"29793","ce0d113497db49f2780be98ec7583f35",37,37,0,37,37,0,1,2
"29794","ce0e1b92cbc059bbd53693512a606a62",43,43,0,43,0,43,1,2
"29795","ce0e473237b81dc72d7d004032cf8f3a",50,50,0,50,0,50,1,2
"29796","ce147c05a327d284df862655df40df21",48,48,0,48,48,0,1,2
"29797","ce14a9b687095b224d862a942b58ff85",17,17,0,17,17,0,1,2
"29798","ce1617a100b4fc75df533b09e9b00c38",134,91,65,14.4307692307692,104,30,3,3
"29799","ce1b6420dc6a0c1625119020c20cf5d7",33,33,0,33,33,0,1,2
"29800","ce1c06e690148776ecb5149cfdace8d6",74,55,54,9.59259259259259,74,0,2,3
"29801","ce1db19ac8f14ca48a536ab9ccaffdd1",183,68,66,19.4090909090909,142,41,3,3
"29802","ce216a14a4ee1f0fb2c7e50a888ba429",27,27,0,27,27,0,1,2
"29803","ce22d1aa0949ec3a33d1e07e4a8a81cf",49,36,36,9.52777777777778,23,26,2,1
"29804","ce23e8520b0e36eb1aef3a22e5be8369",4,2,78,0.358974358974359,2,2,2,1
"29805","ce265f930672794482d415b084b0ee21",91,73,41,15.5365853658537,51,40,2,3
"29806","ce2733c52616f777ff86919914c22ca1",43,43,0,43,0,43,1,2
"29807","ce27a73862b3813a5d4aa539ebf9beaa",38,38,0,38,38,0,1,2
"29808","ce285d6f9c9ec5b3145b97e01d11722c",65,44,42,10.8333333333333,65,0,2,1
"29809","ce2c2c1b2a11dcc27c424761ec2740ab",47,39,59,5.57627118644068,47,0,2,1
"29810","ce2d568879c37d448f85cfb19eb17564",8,8,0,8,8,0,1,2
"29811","ce2dc8dc1e08879c0338d262581a6729",26,26,0,26,26,0,1,2
"29812","ce2eefbc60eacfbefdfa1d7f794fe5d8",53,45,22,16.8636363636364,15,38,2,1
"29813","ce2f136155070f79875731860612a95c",51,51,0,51,51,0,1,2
"29814","ce2f1c42be00a9acfebde646e553102e",166,96,81,14.3456790123457,166,0,3,3
"29815","ce33acdb001704dee3e832e832a278d8",5,5,0,5,5,0,1,2
"29816","ce35c7dc3a1706449904957139ab198d",157,94,55,19.9818181818182,102,55,3,3
"29817","ce36206ff939c6ea4b13bb2ba1858f35",12,12,0,12,12,0,1,2
"29818","ce369a59953deaa855739bbfc97470df",86,74,59,10.2033898305085,86,0,2,3
"29819","ce3a84cb15f0e99e43089c969606b826",26,26,0,26,26,0,1,2
"29820","ce3b47bd8a9ccce8bb3498d89a949164",71,60,40,12.425,50,21,2,1
"29821","ce3c3ffb2c199efbaad68411250603d6",64,39,74,6.05405405405405,32,32,2,1
"29822","ce3c9650450b82445b8e2fe9791df600",39,32,15,18.2,39,0,1,1
"29823","ce3ca0bf0941aa2530101f44d9625f28",94,61,45,14.6222222222222,82,12,2,1
"29824","ce3cc89e1de35082b9c4c790168d091a",122,96,40,21.35,122,0,3,3
"29825","ce3e3f5686b1420bd6fa8a12f2a2fa40",75,64,22,23.8636363636364,40,35,2,1
"29826","ce4156a8cf0ad621195a387221f4b0b4",8,8,0,8,0,8,1,2
"29827","ce416f8d019288aed4437622973774e0",189,90,83,15.9397590361446,189,0,3,3
"29828","ce4338ea0e9b4825fdcdbf570d0141d5",76,43,72,7.38888888888889,66,10,2,1
"29829","ce46b0e0e8c40d2b7cd838a66383445d",29,29,0,29,0,29,1,2
"29830","ce46faf88ec8cff8b16a0f5f6d1ef1fa",3,2,15,1.4,3,0,1,1
"29831","ce48588bd311c4567f0fceb4f4ed83b7",54,44,57,6.63157894736842,32,22,2,1
"29832","ce486b9e49bf446aedfa4054c8aca93a",129,73,63,14.3333333333333,129,0,3,3
"29833","ce49aec04f6c4ea259520d26249f8e6f",114,65,64,12.46875,79,35,3,1
"29834","ce4ab4ca9f014c9ebce7256d663f109e",73,58,58,8.81034482758621,42,31,2,1
"29835","ce500a907b478b8ee6cd1e80469407c0",22,22,0,22,22,0,1,2
"29836","ce52167293f214b53b9954c6590cf355",4,3,13,2.15384615384615,2,2,1,1
"29837","ce53bafbe7ac92ba99cbd5d9a733675c",24,24,0,24,24,0,1,2
"29838","ce5471f48e0824456bf933b9dab9f3d3",3,3,0,3,3,0,1,2
"29839","ce55ecb82a6bb6dce0099d3670c3b5fb",131,87,63,14.5555555555556,131,0,3,3
"29840","ce5668fa9183a4e068da1696a2ffc6cc",66,50,69,6.69565217391304,48,18,2,1
"29841","ce5dfea21e4f6c3b2bb31a190abcd109",157,82,69,15.9275362318841,157,0,3,3
"29842","ce5e39dabf354113d4ec96c313e7079a",43,26,34,8.85294117647059,43,0,2,1
"29843","ce5f84840f18054774e3768033985c75",140,72,66,14.8484848484848,99,41,3,3
"29844","ce5fabff745df6a435031d31ddcfefe8",10,10,0,10,0,10,1,2
"29845","ce5ff629e68e898c57edb4a80b52c005",116,63,68,11.9411764705882,84,32,3,3
"29846","ce6081abdc1977b6ddad0412daacad26",167,84,62,18.8548387096774,167,0,3,3
"29847","ce60f019dd71aa8d6e11378453689bb8",71,58,63,7.88888888888889,71,0,2,3
"29848","ce6104e96fa19e5d304ac022acf32c18",37,37,0,37,37,0,1,2
"29849","ce63407e0b791d66f82f2a2661c85bc3",14,14,0,14,14,0,1,2
"29850","ce63858ab3f1a1e6238de043f23bf882",39,16,67,4.07462686567164,29,10,2,1
"29851","ce64dfd66939eff8d2dffe4966ee8e9e",18,17,3,42,18,0,1,2
"29852","ce6606b7db11d4acc4d9ddfca076fc69",177,103,71,17.4507042253521,130,47,3,3
"29853","ce67bfcb1f09f4ddee0551f4299ee6f8",64,26,76,5.89473684210526,24,40,2,1
"29854","ce680b90921f63c61b57f694056db21f",11,11,0,11,11,0,1,2
"29855","ce681a6e2f8d5941b4fa328d2085c874",30,30,0,30,30,0,1,2
"29856","ce68727fb678810cf6a03faf5a6afa7f",127,95,38,23.3947368421053,86,41,3,3
"29857","ce6ba5b5996a2415e6ffdc6ac11277de",131,63,73,12.5616438356164,88,43,3,3
"29858","ce6c3f7973e68811fb6ceda1861ec0e2",103,83,46,15.6739130434783,70,33,3,3
"29859","ce70019ccd74eba24dd371322edb1c25",61,45,19,22.4736842105263,61,0,1,1
"29860","ce71b42abb8fbc04c231b7588a16e1b4",87,47,60,10.15,60,27,2,1
"29861","ce765f6430d1335520c6bf00ea189b39",94,84,43,15.3023255813953,94,0,3,3
"29862","ce78793d3c1704bcd6f37341e9652786",47,23,56,5.875,27,20,2,1
"29863","ce7b92c94cae88ec15684ea614712694",31,31,0,31,31,0,1,2
"29864","ce805b434e206a98cf9f801734d7e628",163,102,48,23.7708333333333,163,0,3,3
"29865","ce81a47f651133516623f31c1338dfbf",31,30,35,6.2,31,0,2,1
"29866","ce81ca62b59560e69a407254a6c0713d",12,12,0,12,12,0,1,2
"29867","ce82eb88b7094b39200cefcaa0bb9fe4",47,47,0,47,47,0,1,2
"29868","ce863fea67fb250a18544b8f30a8ff3b",81,63,71,7.98591549295775,81,0,2,3
"29869","ce89dacc388ad08570da3c5229972ddc",18,18,0,18,0,18,1,2
"29870","ce8c073ce77a53eea92b8e9821249806",52,38,70,5.2,52,0,2,1
"29871","ce8f7a20c0b6de47901932b6be2cfc7c",10,7,34,2.05882352941176,10,0,2,1
"29872","ce904461b398855479d06d82b7114b24",25,25,0,25,25,0,1,2
"29873","ce906944c79a5a5e6d18f85183176155",90,53,67,9.40298507462687,90,0,2,3
"29874","ce913a939cdc512e9a83dd8900f97447",119,79,43,19.3720930232558,119,0,3,3
"29875","ce915cd0768651655ed71ea121498c09",61,51,38,11.2368421052632,61,0,2,3
"29876","ce91df77eaf80886ec52510adbefe22a",80,54,63,8.88888888888889,64,16,2,1
"29877","ce93121c6022ce0727cac27752a0ae70",24,24,0,24,24,0,1,2
"29878","ce943a95d48380f4740bcf890afadd29",137,81,84,11.4166666666667,137,0,3,3
"29879","ce9760876b4a2fe085d25f0c4310b162",67,60,13,36.0769230769231,67,0,1,2
"29880","ce9819f40eb591428d331cadefe4d2c7",27,27,0,27,0,27,1,2
"29881","ce996811a909f7460775005d542eadd4",25,25,0,25,25,0,1,2
"29882","ce9acf0ce468e58fd4b4550dfbc2a3f6",233,122,71,22.9718309859155,180,53,3,3
"29883","ce9b6fa8bfc5f0d7d6a7ce3dbd6d1be3",81,50,63,9,52,29,2,1
"29884","ce9e887c200fe781a88cb46c7bc4ec1e",174,127,56,21.75,174,0,3,3
"29885","ce9f8ef2b26d1c6a8fc5a658190d4965",62,53,17,25.5294117647059,62,0,1,1
"29886","cea07a1c5895565aa344f0691a9587a3",16,16,0,16,16,0,1,2
"29887","cea09f146647332b32cbfd0a0b423d5f",75,39,54,9.72222222222222,51,24,2,1
"29888","cea152313e228d183717ac6ca97dfce8",120,77,55,15.2727272727273,120,0,3,3
"29889","cea2f3149e3ab929122ddbb240b4a60e",54,54,0,54,54,0,1,2
"29890","cea36f07895ae34f1b7fb3076d6d3593",13,13,0,13,13,0,1,2
"29891","cea3f4514782297937d2f58865163485",32,32,0,32,32,0,1,2
"29892","cea54d0cb33381f735b0a377c37d3e30",150,78,72,14.5833333333333,150,0,3,3
"29893","cea7c5878f2021c2e8d9fc7ff2b0512e",12,12,0,12,0,12,1,2
"29894","cea817d3daa1caed1b99de6fb2e85723",36,32,7,36,0,36,1,2
"29895","cea85ecae6de857e6f27e75fa697d05d",22,22,0,22,22,0,1,2
"29896","cea8fb52cb6635c74bac83edf8927d85",8,8,0,8,8,0,1,2
"29897","ceac88130ff794f1145386cbee3866ec",18,14,55,2.29090909090909,18,0,2,1
"29898","ceade91140314d2ae6be816780825805",29,29,0,29,29,0,1,2
"29899","ceb1d78f500435138a087b0c62a717d2",85,49,63,9.44444444444444,85,0,2,3
"29900","ceb2ca67c4b04db351c3a68775bfb8fc",67,51,30,15.6333333333333,67,0,2,1
"29901","ceb7103be32823d7fe015a60cfc517b2",14,8,61,1.60655737704918,6,8,2,1
"29902","ceb895e4e8a5fd84de902469eb56c0ba",8,8,0,8,8,0,1,2
"29903","cebc23834e52e3311f885a61b7994a4d",206,92,83,17.3734939759036,206,0,3,3
"29904","cebef8cf1dc623c7c85c3a5d322d7d91",18,18,0,18,18,0,1,2
"29905","cec2841d62eec994226db812a74cfb4f",168,112,42,28,168,0,3,3
"29906","cec484c1e991c0c03087635265e56a90",106,79,73,10.1643835616438,74,32,3,1
"29907","cec4b1b585d88c99b4e4cc6e7782a894",11,11,0,11,11,0,1,2
"29908","cecbb4156d51a993e5d4887d11db4e77",243,107,72,23.625,192,51,3,3
"29909","cecc41c6701b7f6a631e135c544bd825",32,16,75,2.98666666666667,32,0,2,1
"29910","ced46d9000d36255e4d7445f6bfe43bd",11,11,0,11,11,0,1,2
"29911","ced649186b9e4c757ae618e3c96cf6d2",73,48,64,7.984375,73,0,2,3
"29912","ced735f38b4e99d31cc09f03c4c26157",16,15,12,9.33333333333333,16,0,1,1
"29913","ced77ebf1cb44458778d8db5b4604d17",42,42,0,42,42,0,1,2
"29914","ced7e0d9134bdf5be1bda7a700d573d7",45,43,7,45,45,0,1,2
"29915","cedbdafb92e5aa9628b5c2a0cf4d80fe",66,60,65,7.10769230769231,46,20,2,1
"29916","cedc395af96a5aa3c7f616d2e2b855ce",27,27,0,27,27,0,1,2
"29917","cede0fbaff2aa3d83b05833c023eaca9",59,48,46,8.97826086956522,59,0,2,1
"29918","cedef8842c5aa9c0ac34d78e73fba7d8",188,89,70,18.8,188,0,3,3
"29919","cedf09d147f6ee8389a7011417416af6",142,79,63,15.7777777777778,142,0,3,3
"29920","cee0bf1fb20f6e6ffe42992dfc8f762f",25,25,0,25,25,0,1,2
"29921","cee2216738260fe3fb9b125122ab9ffc",146,102,88,11.6136363636364,129,17,3,3
"29922","cee4bec60200bdff2a7c9f12215bda6e",128,98,68,13.1764705882353,128,0,3,3
"29923","cee5417beeb98963712f44c55e8599c5",178,113,64,19.46875,178,0,3,3
"29924","cee81091b1c4522e2967c76ac9df2843",41,22,61,4.70491803278689,28,13,2,1
"29925","ceebcbae3d48a2a1477f10fc104a80c4",66,44,42,11,56,10,2,1
"29926","ceed3878ab2ea76f8b652a3fc591cb84",114,73,84,9.5,114,0,3,3
"29927","ceeefe19860ca3e7a1ec0dbb745931e3",9,9,0,9,9,0,1,2
"29928","cef08f2bfcc8b24ea3a865a0bb0689bc",62,55,35,12.4,62,0,2,3
"29929","cef16d74be3c8ffe74d028b0e409ae18",143,85,83,12.0602409638554,143,0,3,3
"29930","cef3d9005e17e5f79ff64d3e13b99fb2",20,20,0,20,20,0,1,2
"29931","cef71852308edbcbca7b5c20d9b67bc1",26,24,21,8.66666666666667,26,0,1,1
"29932","cef982044b90977f0bd5d6d79c612539",28,28,0,28,28,0,1,2
"29933","cefdaff028765b91c42324353f3fa412",28,28,0,28,28,0,1,2
"29934","cf0037b3b45511ee4f3a0a56cb3f48bd",30,30,0,30,30,0,1,2
"29935","cf00dd22dd86302e41002938488256f2",123,90,37,23.2702702702703,75,48,3,3
"29936","cf012c6335a1a6daa028bbefe9b0489a",33,25,54,4.27777777777778,33,0,2,1
"29937","cf0302dc9cc2a064b53c4c26a8cf83ea",8,8,0,8,8,0,1,2
"29938","cf041586e936649e26e3d35c7699521d",114,83,46,17.3478260869565,114,0,3,3
"29939","cf0a76359a0aad5d52a6d2ca5503e8e6",2,2,0,2,2,0,1,2
"29940","cf0c83ecbb7e74fa7c8dc6db159a3107",34,34,0,34,34,0,1,2
"29941","cf0f5d5f2fa7fefdeb3b12619fb09564",18,18,0,18,18,0,1,2
"29942","cf0f60dce30221995b855e2c8f5e0f7f",45,39,76,4.14473684210526,33,12,2,1
"29943","cf122255ee21620239736276a33cbcf8",206,112,75,19.2266666666667,206,0,3,3
"29944","cf14bdcdd8add907644ec98fe27a263c",72,59,12,42,72,0,1,2
"29945","cf189639c90c38d9435fab68707459ae",42,42,0,42,42,0,1,2
"29946","cf1b2d817be76d800229e788f2ed1251",35,31,42,5.83333333333333,35,0,2,1
"29947","cf1be53ee6574a85649c4e404e8ede9e",29,29,0,29,29,0,1,2
"29948","cf1ea6da4d3e6e74e9d72d89d22f4d80",102,76,55,12.9818181818182,102,0,3,3
"29949","cf1fb903019c6851b9c065ba65656ebf",82,66,48,11.9583333333333,82,0,2,3
"29950","cf1feebced2e92380c0933452b563920",22,14,35,4.4,22,0,2,1
"29951","cf210f13477b560549ca4d96d414eabe",37,37,0,37,37,0,1,2
"29952","cf21559ac37b8f7a18e5a1f74d7d7045",30,25,39,5.38461538461539,30,0,2,1
"29953","cf219c279cf8d0024e5f7a475e831850",36,36,0,36,36,0,1,2
"29954","cf23ec1ee78db2811fa4a777d9d7274d",3,3,0,3,3,0,1,2
"29955","cf248eed584112676de66582279241eb",5,5,0,5,5,0,1,2
"29956","cf2682a12c567c560faec3a0d4ac93ea",21,21,0,21,21,0,1,2
"29957","cf26c752878d3a813fec3f9b57f50954",52,49,33,11.030303030303,29,23,2,1
"29958","cf3166f4d1fd7c6eb780429d9e830ba3",55,55,0,55,55,0,1,2
"29959","cf396ceb2abc59379dd2d1a6ff831357",16,8,45,2.48888888888889,16,0,2,1
"29960","cf3ac128d4579cd46f0d8f0c28ac2116",38,38,0,38,38,0,1,2
"29961","cf3c49a07b3802b62d2b08cdac86e139",65,57,83,5.48192771084337,65,0,2,3
"29962","cf3c9a60cff383e74c377f4afa39477f",55,46,28,13.75,55,0,2,1
"29963","cf3f5393188aa3c67224bb52b209118d",3,3,0,3,3,0,1,2
"29964","cf3f73e3e2952d20ef7a5f6353d4e830",6,6,29,1.44827586206897,6,0,2,1
"29965","cf3fecf24b118d29ba0a65d62703be71",22,22,0,22,22,0,1,2
"29966","cf403d6a0d0791fa845bdf48215e9d2a",16,16,0,16,16,0,1,2
"29967","cf417575f1623efcd156553adfa74575",212,131,49,30.2857142857143,212,0,3,3
"29968","cf425edd45f7f192c8e69f49df575176",49,49,0,49,49,0,1,2
"29969","cf438a1b40ab66272ca8c0527faaf758",83,57,56,10.375,83,0,2,3
"29970","cf4515cc09873a317fb2909b20326e18",13,13,0,13,0,13,1,2
"29971","cf4696edce7f2833e5c16fbd98b2a9a3",19,15,48,2.77083333333333,19,0,2,1
"29972","cf488a683440e1b9aa1aba9e75fe676e",206,91,70,20.6,169,37,3,3
"29973","cf4960fd2c92146c3e391d3f6b16478d",22,22,0,22,22,0,1,2
"29974","cf4a26b4e48a826a46742e1a0f1fb843",27,27,0,27,27,0,1,2
"29975","cf4a9c391269eda5eba1139a9920936b",76,57,63,8.44444444444444,76,0,2,3
"29976","cf4baa31bb362ecbc34283ab685de822",57,46,28,14.25,57,0,2,1
"29977","cf50967bac5e0a096b20f6519519ddd6",40,37,35,8,40,0,2,1
"29978","cf552cc89d9244ec90f2651e0d7bd0b9",54,54,0,54,54,0,1,2
"29979","cf5a92d4d8293ac061b54554a357ea06",28,28,0,28,28,0,1,2
"29980","cf5c5adbb328072d73d2af7f4c6d0b77",41,34,14,20.5,41,0,1,1
"29981","cf5f4e74f603b18d91b0e41bad1c4f92",52,44,14,26,52,0,1,1
"29982","cf61b02f6b6348bcb715a2771a17534f",141,95,69,14.304347826087,96,45,3,3
"29983","cf649e2a19485f0cb0178f352f3efb5b",40,40,0,40,0,40,1,2
"29984","cf65bfde1b19b3c7b6c7459a32f94af0",102,70,50,14.28,76,26,2,1
"29985","cf65df2a51ebcb45668037371d230cd2",29,27,6,33.8333333333333,29,0,1,2
"29986","cf662ccdab25bd868eac84a765efb5a1",68,55,30,15.8666666666667,33,35,2,1
"29987","cf67fc49ab49889295f73f20a18b61eb",18,18,0,18,18,0,1,2
"29988","cf68c29cc6b0c81ac86813508821e7d2",56,41,56,7,56,0,2,1
"29989","cf6963bfeabdb0526fc73ad28b0dabf3",54,43,74,5.10810810810811,54,0,2,1
"29990","cf6965ffd6350b73fc9b13dcbb4ee9c8",48,48,0,48,48,0,1,2
"29991","cf69f164da888a9e0caa9cbe0bcd1c2d",20,20,0,20,20,0,1,2
"29992","cf69f2384d6e94fb274ef7ae892aff35",1,1,0,1,1,0,1,2
"29993","cf6a52a72d7606cd7015e3ff322ce87a",108,60,38,19.8947368421053,82,26,2,1
"29994","cf6adfbfeda8c46b55d0470b7bf40601",20,20,0,20,20,0,1,2
"29995","cf6bb31eca03762e18bbea5eae9b14d4",70,62,37,13.2432432432432,70,0,2,3
"29996","cf6c2365970751b6ccdb467dcebd053f",62,53,41,10.5853658536585,62,0,2,3
"29997","cf6dbe385b9182185c184ad6f9f64588",30,30,0,30,30,0,1,2
"29998","cf6ed2533f4daf2eb60cc18ca0c4acd6",10,10,0,10,10,0,1,2
"29999","cf7208615fec49d5ec8de8654444cbd7",102,53,62,11.5161290322581,102,0,2,3
"30000","cf7571e8a9ad4fb2e677577aa009def3",18,18,0,18,18,0,1,2
"30001","cf789b0a151ca1784f6b72a08b8f44c1",4,2,49,0.571428571428571,4,0,2,1
"30002","cf7b7696f36e714cc862c2b464920832",28,28,0,28,28,0,1,2
"30003","cf7b7d5df850e214c84418f937e253fd",146,97,61,16.7540983606557,146,0,3,3
"30004","cf7bea962cb3e92421445177c7a75a61",76,39,63,8.44444444444444,76,0,2,3
"30005","cf7d61c100941db3dd0fcaebeab9ea08",102,95,51,14,102,0,3,3
"30006","cf7f173be5cf89a027cda696af920301",33,33,0,33,0,33,1,2
"30007","cf7f43d5cd21da08104bc03db1783766",33,33,0,33,33,0,1,2
"30008","cf807ccab8fcd73b9d2b105ed8b2c8bf",89,79,29,21.4827586206897,89,0,2,3
"30009","cf824fda0429beec6222f90e8492fc7f",16,16,0,16,16,0,1,2
"30010","cf8321f2dddcfbb1b80dd5e84f881301",50,50,0,50,50,0,1,2
"30011","cf834808144379f6b02e651fc517ba94",78,62,37,14.7567567567568,39,39,2,1
"30012","cf84610a992efa29c796576b462b8892",109,72,51,14.9607843137255,109,0,3,3
"30013","cf855e0f0e2cbfd98d532320f5537b28",42,34,33,8.90909090909091,42,0,2,1
"30014","cf87e5623827d92fa33812f2ed1ff66e",10,10,0,10,10,0,1,2
"30015","cf8972d92f2eb2b1a4ad1b600c6ba214",13,11,8,11.375,13,0,1,2
"30016","cf8b9fc0efd5e242e0a07e6b845617e9",243,82,76,22.3815789473684,210,33,3,3
"30017","cf8e460766c86c5f1c8c97b0c598d8f4",11,11,22,3.5,11,0,1,1
"30018","cf9283a6737be018ceffb6769bd42590",6,6,0,6,6,0,1,2
"30019","cf92cb83865c1fcad6b6cd0017390918",29,29,0,29,29,0,1,2
"30020","cf94af01b36a36ba4ce0d68f1ddad1b7",54,54,0,54,0,54,1,2
"30021","cf966b46f0d6356b90504b3f79b8d158",184,92,36,35.7777777777778,184,0,3,3
"30022","cf9ced8d92e4d6e9463f4c3f7a493d2f",44,38,33,9.33333333333333,44,0,2,1
"30023","cf9d03d6ace77ad595b29e2a31612f8f",24,24,0,24,24,0,1,2
"30024","cf9d83bb31536fc0396e4cdeed14dc12",74,50,38,13.6315789473684,74,0,2,1
"30025","cfa0243482ab9c8370ebe82b709c0de4",146,109,69,14.8115942028986,146,0,3,3
"30026","cfa59d77f8c5209c22b7f07b283dadab",8,8,0,8,8,0,1,2
"30027","cfa5f9ce9ed22f992af5baee28f11de2",35,35,0,35,35,0,1,2
"30028","cfa8a59fa3ded67a2a39ad932b7eb3cf",22,20,60,2.56666666666667,22,0,2,1
"30029","cfa980f692bd44b1a35060acc0d9b07c",34,34,0,34,34,0,1,2
"30030","cfaaf461736b6ce6a8db84671b2f2733",46,41,34,9.47058823529412,46,0,2,1
"30031","cfad73094199dff6e90279cabbffd574",29,29,0,29,29,0,1,2
"30032","cfaed48797c7d8760f1356d728fe7427",183,96,79,16.2151898734177,183,0,3,3
"30033","cfb039265fd39366eafc060fc1480235",42,42,0,42,42,0,1,2
"30034","cfb053d60120e9943054faea5a50e6cd",14,14,0,14,14,0,1,2
"30035","cfb083552dd60ccb8d63d5ce29999f5a",68,58,10,47.6,68,0,1,2
"30036","cfb0a7b9b438d64674f0254c224c32fd",217,113,76,19.9868421052632,217,0,3,3
"30037","cfb1f086e0320c0aee19234434accc25",73,56,49,10.4285714285714,73,0,2,3
"30038","cfb2f02fe6834344a0d31bacfa119aa3",43,37,50,6.02,43,0,2,1
"30039","cfb5838aa0144d6d65dff2c613ce4129",29,29,0,29,29,0,1,2
"30040","cfb7a3a7e626c4c49bbad888b4b96489",219,113,69,22.2173913043478,177,42,3,3
"30041","cfbc83efa2508fec9093adae558ba1e1",18,18,0,18,0,18,1,2
"30042","cfbe8ab6156528076ab66b614f0c7278",2,2,0,2,2,0,1,2
"30043","cfbfaa132d18cac85eeb8a64da9c53e8",1,1,0,1,1,0,1,2
"30044","cfc015b7b8f537d74fd0bf097be9e1fb",102,63,64,11.15625,77,25,2,1
"30045","cfc15ed145b065266d37a1b700883249",33,25,30,7.7,33,0,2,1
"30046","cfc35eb47c475db26e1078ff47038c54",108,80,49,15.4285714285714,108,0,3,3
"30047","cfc5d72c0fb39844ff56d8af3d80fd7c",36,36,0,36,36,0,1,2
"30048","cfc83105d1693d6ce51ab4a18ff3ef65",165,104,59,19.5762711864407,135,30,3,3
"30049","cfc973f09ae9b9754264a74bd396a79a",57,45,16,24.9375,30,27,1,1
"30050","cfc9b240c03b98eda0fca945b6d61f68",28,28,0,28,28,0,1,2
"30051","cfce03f6a994c30e6c3d6361324c7886",62,54,67,6.47761194029851,62,0,2,3
"30052","cfd0f59a625429dea9bc615f12f1a0f0",124,76,77,11.2727272727273,97,27,3,3
"30053","cfd3371fe70f74d11093053184006a39",90,52,86,7.32558139534884,60,30,2,1
"30054","cfd3fe2cdf5a9dde6102358fe146cc96",30,30,0,30,30,0,1,2
"30055","cfd9752b1735b79aa24b07b3e516aa27",19,18,65,2.04615384615385,19,0,2,1
"30056","cfdb1874633a3951a058ebfb98c6e38c",34,34,0,34,34,0,1,2
"30057","cfdcf816046cbde012876442253c9628",49,49,0,49,49,0,1,2
"30058","cfde42cf6afe3f9efb32bce7bd49e28e",15,15,0,15,15,0,1,2
"30059","cfde953c9af96c0ab994a692846ffdcc",34,34,0,34,34,0,1,2
"30060","cfdf642480babb3ee3189e8860e56683",88,76,36,17.1111111111111,66,22,2,1
"30061","cfe2d2c718a988c6dd98a5378cb6047f",18,18,0,18,18,0,1,2
"30062","cfe53f5e7bb722048ea98622e38da367",121,75,63,13.4444444444444,121,0,3,3
"30063","cfe57a2b51b4b0e659dbfb1cee92e3af",41,34,28,10.25,0,41,2,1
"30064","cfe75259378835891c06f8cfa6063985",124,77,55,15.7818181818182,124,0,3,3
"30065","cfe89b3b299cc91563d9e31871ea4ec5",54,46,74,5.10810810810811,21,33,2,1
"30066","cfea0f6bfff628eea314947d8da7eec2",44,44,0,44,44,0,1,2
"30067","cfeee912c7c47d32fb690775606387f3",151,88,56,18.875,151,0,3,3
"30068","cfef56e4de9c134fd7a40008310e30c4",33,33,0,33,33,0,1,2
"30069","cff01d9657beaa45e3720ba0fbebb437",31,31,0,31,31,0,1,2
"30070","cff12acbe8b74ab79a34ed4ec3a29e20",73,60,69,7.40579710144928,55,18,2,1
"30071","cff154fcadd5cbb800a677a734c5d9df",40,37,74,3.78378378378378,40,0,2,1
"30072","cff32ed5f4f6232dd8ec131862d3098e",25,25,0,25,0,25,1,2
"30073","cff3cc7e1ebe0cd871fb2e9373df00c0",236,101,70,23.6,200,36,3,3
"30074","cff4258d802a461ea6cd28f0b936a12b",10,10,0,10,10,0,1,2
"30075","cff4a575a9c64ea1ea03ec6518a8a3ef",64,55,58,7.72413793103448,64,0,2,1
"30076","cff5412b88e18c77920a48877c3901d4",50,50,0,50,50,0,1,2
"30077","cff77248c12cfe4cf64a500c60b0e1fc",36,36,0,36,0,36,1,2
"30078","cff97af1a2c9f44dce252f923fdcb521",24,24,0,24,0,24,1,2
"30079","cffb379ee744b79c93a09540beac8658",8,8,0,8,8,0,1,2
"30080","cffcaa1aa0a3386a27a3c4e8d2e9779f",49,49,0,49,49,0,1,2
"30081","d0001a7ea5b290508e3309a3e66c8b29",146,101,64,15.96875,146,0,3,3
"30082","d00436a435cda317397fdfb0bc458433",4,4,0,4,4,0,1,2
"30083","d005312cbe1c82435e12106bfe3ae583",111,91,74,10.5,111,0,3,3
"30084","d00647060e03f17acc2db3fe2ba6b44d",29,29,0,29,0,29,1,2
"30085","d00aab63de65251eedd2c7d25783ebf6",133,89,83,11.2168674698795,93,40,3,3
"30086","d00ad7fac3bae43965e4c51b06909151",14,14,0,14,14,0,1,2
"30087","d00c5ecab488d7967d337f1af92f72a2",10,10,0,10,10,0,1,2
"30088","d00cf6bbb74d4aeb8898c6a4a7458efc",9,8,26,2.42307692307692,9,0,2,1
"30089","d00d3fa201965b3e074f1e186f50b060",47,34,77,4.27272727272727,47,0,2,1
"30090","d00ed84c0ada57f77b23ce0054df7ae6",23,23,0,23,23,0,1,2
"30091","d00f80607c4b69da51e890ec7ee75b82",16,16,0,16,16,0,1,2
"30092","d01176d3d2dd84000b110c9eb95acbfb",15,15,0,15,15,0,1,2
"30093","d0138356229e3c678fc92bbf722ac2db",14,14,0,14,0,14,1,2
"30094","d01680fb730e5a8971debc2596efc540",89,88,62,10.0483870967742,89,0,3,3
"30095","d0175fb3ce599ea9f5a6790ba21a20db",65,35,54,8.42592592592593,65,0,2,1
"30096","d01a1e2c296b21196f95e0b57c8107a8",38,36,49,5.42857142857143,38,0,2,1
"30097","d01c7bd30d866e627270478e603b6e02",17,17,0,17,17,0,1,2
"30098","d01d2947f8f582ebc2b48d1e67bc15f4",117,89,69,11.8695652173913,117,0,3,3
"30099","d0211fc994360fcef7a0e3748aaf6450",18,18,0,18,18,0,1,2
"30100","d02195555b0f9f67b2479c182ade9b76",24,24,0,24,24,0,1,2
"30101","d022264240d4a102a57d34ec509d67f9",101,62,59,11.9830508474576,101,0,2,3
"30102","d023c0bfbb223a8c184b72517cf3380e",46,38,29,11.1034482758621,24,22,2,1
"30103","d0258f5e2afbdf787ebc7c23e8eafc21",26,26,0,26,26,0,1,2
"30104","d02b058011614ff1299a842ac6c9a554",78,55,63,8.66666666666667,78,0,2,3
"30105","d02c6e88adad4c08680578856f792af7",212,143,65,22.8307692307692,157,55,3,3
"30106","d02dd16fc3cafa5251cb388acbaaace8",24,24,0,24,0,24,1,2
"30107","d02f4de968c8c78a882767363683e658",19,19,0,19,19,0,1,2
"30108","d03173d6f6f5e4fa8970ed18251124be",151,74,63,16.7777777777778,99,52,3,3
"30109","d03199c36cc3cd7ebde5911d90ed80dd",35,35,0,35,35,0,1,2
"30110","d031b2363641705b7a8b0611cffffbbc",42,37,43,6.83720930232558,42,0,2,1
"30111","d03777835d66c71fbbb87cc24cbacaae",89,61,59,10.5593220338983,89,0,2,3
"30112","d04074e347e0e4eb5acc88cd3045b4ae",36,31,16,15.75,24,12,1,1
"30113","d0424da23e74e324f8c49b16816b2c4a",39,39,0,39,39,0,1,2
"30114","d042be7a319ac19fc3536bf7ede20e93",31,31,0,31,0,31,1,2
"30115","d044b4441d8ffadf217b8bde364ef9f3",106,75,56,13.25,76,30,3,1
"30116","d046872479512f433e90d8cdcbe94b35",61,56,61,7,61,0,2,3
"30117","d04af2bef1763b5d8d9df4629e26358f",89,69,36,17.3055555555556,89,0,2,3
"30118","d04b840d5054dff930991124a8010e80",67,60,14,33.5,67,0,1,2
"30119","d04bd1b544e39cfb756476c4c889bb0a",157,106,54,20.3518518518519,157,0,3,3
"30120","d04db6ce16887dd717de2001fc315939",26,26,0,26,26,0,1,2
"30121","d0508f9f149d95463a8a67d80fef2db2",12,12,0,12,12,0,1,2
"30122","d0519e59e70cca45722f7b426c4e86b7",41,41,0,41,41,0,1,2
"30123","d058856dc7890ac4474aa0d4448bd377",15,15,0,15,15,0,1,2
"30124","d058bac93e34cc62e4154c1c107a9f81",6,3,56,0.75,6,0,2,1
"30125","d05a9a42428a01115bada7711b25b1f7",44,26,69,4.46376811594203,44,0,2,1
"30126","d05c69cb43b8f39ddaa6b6870bfd0a4a",156,78,67,16.2985074626866,156,0,3,3
"30127","d05c95c9d18904aafb73b153fb73028c",83,66,51,11.3921568627451,47,36,2,1
"30128","d061ab789870e2648ab8b8a229a7917b",128,73,49,18.2857142857143,128,0,3,3
"30129","d061cc4cee68650a3d5c2bfee3fca42a",22,22,0,22,22,0,1,2
"30130","d063413d736f9531f378e8a8e2612c49",102,52,71,10.056338028169,102,0,2,3
"30131","d064a005186906070cddd5b59f7ffb57",13,13,0,13,13,0,1,2
"30132","d06a46cd53cf66447dcc07a1758cd50b",127,66,74,12.0135135135135,127,0,3,3
"30133","d06ce85b4d1851be05b761c12a8faa57",44,44,0,44,0,44,1,2
"30134","d06dfc75025a670f17577959dc25657d",22,22,0,22,0,22,1,2
"30135","d06f44d8a0bb7f0874709760e4bb0b75",17,17,0,17,17,0,1,2
"30136","d0704c794f9e3e3874d05467c5d4f934",47,40,76,4.32894736842105,41,6,2,1
"30137","d070753d2e2a4524e776d8a2ba973c05",27,24,37,5.10810810810811,27,0,2,1
"30138","d0707e698ae3784a066e367812c54f9d",142,91,54,18.4074074074074,129,13,3,3
"30139","d0710ed734d76c331791395bb2f80ee2",42,42,0,42,42,0,1,2
"30140","d07158fea2bafbd1a80dbf3b4b672f99",62,47,49,8.85714285714286,62,0,2,1
"30141","d07466bda63b14c826badd22f1a8f637",20,20,0,20,20,0,1,2
"30142","d0746cf25622db7812b0c73375d0acd4",118,74,62,13.3225806451613,118,0,3,3
"30143","d07593f6a992c267b47c923455336df1",169,89,57,20.7543859649123,169,0,3,3
"30144","d07826929273d4254aa69cf44d3bd712",42,42,0,42,42,0,1,2
"30145","d078a9c8e5469aedd9fa03a04331a467",11,11,0,11,0,11,1,2
"30146","d078b32d9c9ed394d731ba4d7a65efc9",152,86,64,16.625,152,0,3,3
"30147","d07a77a62583d82486456ae95dea0842",34,34,0,34,0,34,1,2
"30148","d07cfede5f2c90687d43f8c41161dbea",72,60,12,42,72,0,1,2
"30149","d0824e0fbb6f86f59d273f61865b492e",147,90,46,22.3695652173913,147,0,3,3
"30150","d082781f044560d0c5fa28df296374f4",108,78,64,11.8125,80,28,3,1
"30151","d082b4f3f8ea8b68ba48a6cc52610dd8",60,45,39,10.7692307692308,35,25,2,1
"30152","d085de0ce1981867f320d72f2784c8d9",46,39,39,8.25641025641026,46,0,2,1
"30153","d087ead273bf9052b2bfdf9c80c39526",41,41,0,41,0,41,1,2
"30154","d08852cc0437a275f076b977eb2abc2f",32,29,58,3.86206896551724,17,15,2,1
"30155","d0893bfa5d52e9e6feae15a983aba408",18,14,54,2.33333333333333,18,0,2,1
"30156","d089523f4a2b3ba2817cdee608f59e7e",34,34,0,34,34,0,1,2
"30157","d0896b8bf9374872a3b09f27fc22c5fe",35,35,0,35,35,0,1,2
"30158","d0899bd3e6a1eec37f2915dfdcbbcdf9",57,43,20,19.95,57,0,1,1
"30159","d08b72fc5e8e2c5d33c3e89a141499f6",36,36,0,36,36,0,1,2
"30160","d08be1c87b6525dc53068112767b8626",12,12,0,12,12,0,1,2
"30161","d08eb00d7d66960652bca521256a299f",43,43,0,43,43,0,1,2
"30162","d090c3b690832e1147ee5b952c961cac",30,30,0,30,30,0,1,2
"30163","d093de65d2c2b01e348163c388e06f6b",1,1,0,1,1,0,1,2
"30164","d0973dd03cc73f53798db73484344680",34,34,0,34,0,34,1,2
"30165","d09756ffb33e59b5b552d77f1988d529",16,16,0,16,16,0,1,2
"30166","d097ee5e2dea012a0bba14ac15cbfc57",75,50,26,20.1923076923077,33,42,2,1
"30167","d09aa26179facf0e6bc439c08d4a521f",36,36,0,36,36,0,1,2
"30168","d09be0de0dc8fc87414fd54688c71585",158,105,50,22.12,158,0,3,3
"30169","d09ef6646441a0673898e0670b6d1601",43,43,0,43,43,0,1,2
"30170","d09f32cffd5fb8977e6d6b05a3e3505e",13,13,0,13,0,13,1,2
"30171","d09f7df292b68db053d271aa77e2c876",14,14,0,14,0,14,1,2
"30172","d0a04a125a9af11515f2d5367aaaf5f6",17,17,0,17,17,0,1,2
"30173","d0a054cba71b2787f546e3583ec773e7",63,56,24,18.375,63,0,2,1
"30174","d0a3728cf080250327ebd4c9ea46e356",37,37,0,37,0,37,1,2
"30175","d0a969c23f889666402f75a8d927b03e",43,43,0,43,43,0,1,2
"30176","d0a97417b1b800c68f0ae8a17d88f778",101,44,23,30.7391304347826,101,0,1,2
"30177","d0acae7b2f494f649d65b3665b4b9017",86,45,66,9.12121212121212,86,0,2,3
"30178","d0ad8b5ce02ac998ead633b8d8086371",93,68,17,38.2941176470588,64,29,1,3
"30179","d0b34be383157578c65e15dcecdce013",62,55,22,19.7272727272727,62,0,2,1
"30180","d0b38d4726c42f73d314dd131c91e63d",155,92,58,18.7068965517241,155,0,3,3
"30181","d0b4b5584c60221b2a874857a206112a",33,26,40,5.775,33,0,2,1
"30182","d0b4dbecbb4849b233f2f386eb8a2107",34,34,0,34,34,0,1,2
"30183","d0b696ee47e4585385df7068b9816500",13,13,0,13,13,0,1,2
"30184","d0b8ecafa6897b0f23fa7c50763e4013",68,62,53,8.9811320754717,26,42,2,1
"30185","d0bae4c36046e87832c2074f69b865ef",41,41,0,41,0,41,1,2
"30186","d0bded86970f30edca0a38d901518dfd",2,2,0,2,2,0,1,2
"30187","d0bf3d710c418455cfb6b03b0aacb111",14,14,0,14,14,0,1,2
"30188","d0c14f1e2438a5aa0a1df6978a84adfd",41,35,52,5.51923076923077,41,0,2,1
"30189","d0c31d657bb76749aa8ed4e3477e52dc",31,31,0,31,31,0,1,2
"30190","d0c406e96eb656466fd6eee7286b1233",20,20,0,20,0,20,1,2
"30191","d0c416c6acd449a703e4227cf645b6cf",32,32,0,32,32,0,1,2
"30192","d0c43fe92a0c8ad571976e193e1a7a12",117,101,49,16.7142857142857,117,0,3,3
"30193","d0c4762209700fce23ddecf8927eb74e",23,23,0,23,23,0,1,2
"30194","d0c4e271cd8a9b0d5f6d71d9f464913d",148,91,70,14.8,148,0,3,3
"30195","d0c872b201700f0b727a4dc386f62f6d",25,25,0,25,25,0,1,2
"30196","d0cc4ab81ebaff08ac0c17a07ba7b334",104,63,56,13,104,0,2,3
"30197","d0cc8b35ca22c9b0949589b1a3e8e89a",30,30,0,30,30,0,1,2
"30198","d0cd6add8f352f3316bc938bcadaa459",131,71,69,13.2898550724638,84,47,3,3
"30199","d0ce56b96d40dcf88c3fc43ac3bbeec6",190,72,76,17.5,157,33,3,3
"30200","d0d23d4405f116f92e7a1c11e38835ef",71,57,71,7,71,0,2,3
"30201","d0d32821b1cbcf1426a41b4e63e8b2e6",80,51,62,9.03225806451613,80,0,2,3
"30202","d0d5d86fb7f9008bb9bb66fbe0b72444",20,11,31,4.51612903225806,20,0,2,1
"30203","d0d70c504effcbc902a7a13d2c566955",244,129,82,20.8292682926829,203,41,3,3
"30204","d0d7d7a0cf2678e736bbf0fc3b468605",135,93,56,16.875,135,0,3,3
"30205","d0d8fb37359fe5df2fef717e4a190ea3",202,67,79,17.8987341772152,184,18,3,3
"30206","d0db7c3789ce40d54a4ce0e3db6faa85",119,50,70,11.9,119,0,3,3
"30207","d0e17fa6aed66996f45b70f07a4b5290",58,52,17,23.8823529411765,31,27,1,1
"30208","d0e2df2f4885b80504fe73c0fe568052",44,34,42,7.33333333333333,44,0,2,1
"30209","d0e650016d8dcbc5726e3b82f6b0d0d8",27,27,0,27,27,0,1,2
"30210","d0e6abfd497f240745dfb008226c86b8",35,35,0,35,35,0,1,2
"30211","d0e769472ab7f129df2ce559a494c285",39,36,48,5.6875,39,0,2,1
"30212","d0e86f0684e063f94f8574ea35c173b0",13,13,0,13,13,0,1,2
"30213","d0ea16a62699e5e690a35c699b173bba",26,26,0,26,26,0,1,2
"30214","d0ea67de767967bc500272c2d3a519ec",214,68,63,23.7777777777778,214,0,3,3
"30215","d0eb73d77c3a30d0145d6a628d1fb9fb",85,69,45,13.2222222222222,85,0,2,3
"30216","d0ebf5279fa8eefed68668efa2523ee2",18,18,0,18,0,18,1,2
"30217","d0ec2f78f93fa6ba11a4e8a021045381",94,51,41,16.0487804878049,94,0,2,3
"30218","d0ec6ad242e29f8dec3d91a9211c879a",87,61,53,11.4905660377358,42,45,2,1
"30219","d0edcdbe90e4b6627221f892147932d5",64,51,71,6.30985915492958,64,0,2,3
"30220","d0ee59fb5cd286e397004bbdb0ef7bdf",23,23,0,23,23,0,1,2
"30221","d0eedca7d244a641b796e1b904471f6e",74,47,53,9.77358490566038,74,0,2,3
"30222","d0f002fadffeaac99ba03a02fb7ac419",18,18,0,18,18,0,1,2
"30223","d0f15cfbcd926ef5c97a5386874b9f04",48,48,0,48,48,0,1,2
"30224","d0f2a4fb1fb1c665ab3ed94cf539e660",55,43,68,5.66176470588235,55,0,2,1
"30225","d0f2baa98d10a09d03c55cdd49e789ab",137,77,76,12.6184210526316,137,0,3,3
"30226","d0f323fe76003bff5b745ab925f77298",18,18,0,18,18,0,1,2
"30227","d0f43a558da16fbc3aab548d654d02eb",30,24,35,6,30,0,2,1
"30228","d0f60e7b4e98a1dedccc1fe99127f459",46,40,30,10.7333333333333,17,29,2,1
"30229","d0f8aee1ecb064507b16178e5a7f7538",35,27,50,4.9,35,0,2,1
"30230","d0f8ed992c03cbfa6cfa621b99410d0e",66,50,31,14.9032258064516,66,0,2,1
"30231","d0faa86fa729cc48e52aae330ab70771",28,28,0,28,0,28,1,2
"30232","d0fdcb9439d1b46d7924ff1fb35281e4",134,94,28,33.5,134,0,3,3
"30233","d0ff6528abfb5567f207dd39aa76fef6",72,51,43,11.7209302325581,72,0,2,3
"30234","d0ffbedd1d580361f0acfc4715dee081",8,8,0,8,8,0,1,2
"30235","d100528226f0e7d2a8199d42a0c3f92d",15,15,0,15,15,0,1,2
"30236","d100a8fe14bbf1d96865cd08ba7231f3",51,40,12,29.75,51,0,1,1
"30237","d102f63ae3d2d25602e2570f6f2b0e64",164,82,68,16.8823529411765,148,16,3,3
"30238","d103654a7de6a3683c83f50c7ee0e390",37,32,64,4.046875,37,0,2,1
"30239","d10868e1d2322bb8c18d44231f67cfde",58,46,75,5.41333333333333,58,0,2,1
"30240","d10cc3d79629d8f9a27d14cc1f454ff2",126,88,39,22.6153846153846,126,0,3,3
"30241","d10d3a16c1c5bbbc34d1f7d4a638fbe4",68,55,54,8.81481481481481,68,0,2,3
"30242","d10d49bf972bc8ce58e928496885d57f",211,67,85,17.3764705882353,211,0,3,3
"30243","d113440dfb54a50bdc802e6a88aceb7c",48,48,0,48,48,0,1,2
"30244","d114120752df8c60768aa0c8f965ea9b",17,17,0,17,17,0,1,2
"30245","d11441dfd0cf5c45e7d1f6d67f27f5a1",58,54,51,7.96078431372549,48,10,2,1
"30246","d115ab52f5bc41aa66a265230b2e0b3d",16,16,0,16,16,0,1,2
"30247","d115f6be6ec2841a438c21fb1d682e78",63,44,74,5.95945945945946,40,23,2,1
"30248","d116433881c0c31a97c6dc8fe39c71eb",17,17,0,17,0,17,1,2
"30249","d1165ce07b539adda18b8d52602ea79b",27,27,0,27,27,0,1,2
"30250","d1177e8557d8d2cdc23f1601c53538b3",220,109,66,23.3333333333333,186,34,3,3
"30251","d117837f62cd6710cbf893d8f9c33445",30,28,56,3.75,30,0,2,1
"30252","d11b91a017265d4aa9ad0cc75dc801ae",13,13,0,13,13,0,1,2
"30253","d1210f6d5bc3a6a3cac129a54ba3ea81",82,57,41,14,82,0,2,3
"30254","d122c62d66e115cc8a066c635a6eb76a",21,20,73,2.01369863013699,21,0,2,1
"30255","d125bb6abf73b81ca0b0681d00c59c24",60,47,43,9.76744186046512,60,0,2,1
"30256","d127fb7137f5e83401cdfde63701d4a2",101,64,35,20.2,101,0,2,3
"30257","d1281a4f4478528d7267f2232aafdb06",200,116,56,25,200,0,3,3
"30258","d128ff9339188843dad8a6c9310e4884",26,23,29,6.27586206896552,26,0,2,1
"30259","d12a6721e682e75d8a52e1c128c915d6",38,38,0,38,38,0,1,2
"30260","d12def8c0e4a05541d5881fabddae164",46,46,0,46,46,0,1,2
"30261","d12f5b35aa41bb99a2ec72bedd1d2611",20,20,0,20,20,0,1,2
"30262","d12fd60e680402164fc426fbefba1963",24,24,0,24,24,0,1,2
"30263","d1345ee8333a36af68cad6becf87f59f",42,37,35,8.4,0,42,2,1
"30264","d134fb741c03e12be10e2d128e2e64f7",19,19,0,19,0,19,1,2
"30265","d135cd7a9a756609aab39a9146a38b32",21,21,0,21,21,0,1,2
"30266","d1366c71356d94a1dbeb302a9afb50e6",91,64,66,9.65151515151515,91,0,2,3
"30267","d1368fec58801bc92be9882edf4c174e",150,102,37,28.3783783783784,150,0,3,3
"30268","d1386e8eaa8b3ff409535986f42907f1",94,59,69,9.53623188405797,94,0,2,3
"30269","d13ba683861c7a63824982a68e24fb1d",112,83,51,15.3725490196078,112,0,3,3
"30270","d1436c32fed81f71fe4e408780c63bc0",20,16,61,2.29508196721312,20,0,2,1
"30271","d144e72c8d046f3c9d6c2c0eaef70d3c",33,33,0,33,33,0,1,2
"30272","d147658aa4c3a30a7ecca3f0c549b5e4",20,20,0,20,20,0,1,2
"30273","d149f45fef9eaab2516609944776f959",41,32,35,8.2,41,0,2,1
"30274","d14e93608aea65db45f4f63c3fb3f5ce",164,87,73,15.7260273972603,142,22,3,3
"30275","d14ee9ce404a2b95bafcba45f5bfc35c",127,68,81,10.9753086419753,83,44,3,3
"30276","d14fe07d4ff49ae3c6d4a005eb1bafb4",21,21,0,21,21,0,1,2
"30277","d1515e4572d9c3162de34b36513b497c",28,18,62,3.16129032258065,18,10,2,1
"30278","d1520b69dccd8aa537e5a04822e0618d",27,27,0,27,27,0,1,2
"30279","d1521813f9650ff7c0957a1e21437f2f",19,19,0,19,19,0,1,2
"30280","d15410ba8e402c863c2197e5cde67f0e",32,32,0,32,32,0,1,2
"30281","d15731e52fc9e2820020c03e5a00b7b6",13,13,0,13,13,0,1,2
"30282","d1573a328c9c3eee3c2273749837de3e",24,24,0,24,24,0,1,2
"30283","d1575608953734138f6d1a36cdd270c4",26,26,0,26,0,26,1,2
"30284","d15acac7334352d3a8df5e888e3354dc",24,24,0,24,24,0,1,2
"30285","d15b43b5546618f1fcf48590997e2fbc",4,4,0,4,0,4,1,2
"30286","d15e10794e2aec63f7368edaddaae431",47,36,81,4.06172839506173,28,19,2,1
"30287","d16532d1c0efb7b56c502eff8e70d884",174,95,63,19.3333333333333,174,0,3,3
"30288","d168070e924931c0a430c443363af3b4",110,86,76,10.1315789473684,110,0,3,3
"30289","d1688660f64e501e19779eb8e7e93a3e",47,40,57,5.7719298245614,47,0,2,1
"30290","d16ba77bc8255560ba82a3b167b6b651",79,69,34,16.2647058823529,79,0,2,3
"30291","d16c20faebaf8cd88e6696a7b09c00cb",56,48,13,30.1538461538462,29,27,1,2
"30292","d16d96f340eb7dd0787971a6675eb07a",3,2,53,0.39622641509434,3,0,2,1
"30293","d1709c7ee8ee95a280309df56fec9804",54,42,68,5.55882352941177,54,0,2,1
"30294","d170d185a3d21190bb7424120fdc5176",14,14,0,14,0,14,1,2
"30295","d1739e4a58866fc2ad7a8d1ba395f9ad",1,1,0,1,1,0,1,2
"30296","d173d6d03ca43b351009d193599c8bcc",18,18,0,18,18,0,1,2
"30297","d1773b911320c2cc0daed6d10c9754bc",18,18,0,18,18,0,1,2
"30298","d178ae091b12e71ba1991a677e2ebeed",7,7,0,7,0,7,1,2
"30299","d179f934c74a64330bceb968e824410e",76,66,10,53.2,76,0,1,2
"30300","d17d118fd99e1b7a7ed1220b30e7fd76",14,12,4,24.5,2,12,1,2
"30301","d17d2ab5e1341c42204a1289916cac64",35,35,0,35,35,0,1,2
"30302","d17d6f542394dc255e595978e4c8032a",42,33,72,4.08333333333333,38,4,2,1
"30303","d17ef9f3d78ce915cc341c61cd4eaceb",97,82,56,12.125,97,0,3,3
"30304","d17f5dc28257c07ad4f5116e7ec06b15",164,95,71,16.169014084507,164,0,3,3
"30305","d181aef4caa47c784ab22dafea460514",11,9,63,1.22222222222222,11,0,2,1
"30306","d18346c3cab53b04819df3b9356d3e18",53,46,43,8.62790697674419,53,0,2,1
"30307","d18582e36d6abd65cecc11c7b514ebdf",42,42,0,42,42,0,1,2
"30308","d18a21120eca7ea10b7590ac8e384c28",124,82,56,15.5,124,0,3,3
"30309","d18b08519c4c1f8fba1aba2299a3a2a4",69,61,34,14.2058823529412,69,0,2,3
"30310","d18d23dbb092ad183ebfdbe2095d2ba0",25,25,0,25,25,0,1,2
"30311","d191bbdfe293efe58e8b4fa8d1d459df",22,22,0,22,22,0,1,2
"30312","d191dda80520496f4c31d72f09c984c2",28,28,0,28,28,0,1,2
"30313","d1928557e99b136d97dbf77baee6d506",103,52,82,8.79268292682927,90,13,2,1
"30314","d192f33a61008e40803691e768a9f560",159,48,74,15.0405405405405,138,21,3,3
"30315","d1948df12bc1e92da9d211efc2036afc",9,9,0,9,9,0,1,2
"30316","d198b08715f5a689e6c448a88af1c7b6",190,93,60,22.1666666666667,159,31,3,3
"30317","d199c7339434d40672e57b4247244e12",39,32,45,6.06666666666667,22,17,2,1
"30318","d19aa083c5b5547286743b17669068a3",188,91,78,16.8717948717949,188,0,3,3
"30319","d19b7be6b076606dea2a44af2ed39b00",134,60,80,11.725,134,0,3,3
"30320","d19baa918b6056c76829bdf3d30ffaff",8,8,0,8,8,0,1,2
"30321","d19cc18da19293890c3df17d50ea2d59",11,8,55,1.4,11,0,2,1
"30322","d19e49265194ae7bf674d06da9b14264",12,6,2,42,12,0,1,2
"30323","d19e8cb1dfc346a5623f33f6436ce546",121,65,38,22.2894736842105,121,0,3,3
"30324","d19fe0055c5c10a1f336c5ab4f9ad54b",103,67,67,10.7611940298507,103,0,2,3
"30325","d1a3c7d2eb8eebd821695c07ee6e795b",9,9,0,9,9,0,1,2
"30326","d1a51a990b5e986e60324167ef9c4c0c",85,63,79,7.53164556962025,76,9,2,1
"30327","d1a5a89d11891b1cfd40df2aafb7f43f",6,6,0,6,6,0,1,2
"30328","d1a5d6f2fcdae57fdfbbaf9187c30598",51,51,0,51,51,0,1,2
"30329","d1a7bdcc9f3c67c0b73041e1d29926b0",21,21,0,21,21,0,1,2
"30330","d1a977107d0765b1641898c9888f9310",191,118,90,14.8555555555556,191,0,3,3
"30331","d1aa7f54c6f51cd753d6ca076f936b94",79,51,45,12.2888888888889,48,31,2,1
"30332","d1ab0702ecf60a4738ee6a18b6ee7bfe",5,5,0,5,5,0,1,2
"30333","d1ab4dbc5d9139fa12d0ed32d95df500",18,18,0,18,18,0,1,2
"30334","d1aba453fda3ba9c67e4bc7ec6ad881d",25,17,51,3.43137254901961,14,11,2,1
"30335","d1adaf48dd7a113afbe8107fb3bc75a8",83,63,42,13.8333333333333,83,0,2,3
"30336","d1af273a64027c58aa4614fe0dd8ef59",35,35,0,35,35,0,1,2
"30337","d1b2cd1c23cf1207e62b35d26a4d346c",68,57,28,17,68,0,2,1
"30338","d1b4733544f35a8f73062141c02dbe66",24,20,84,2,24,0,2,1
"30339","d1b4abdff9e6c30e34be296436018786",59,51,55,7.50909090909091,28,31,2,1
"30340","d1b5288544823f4cf3c9b013c099896c",54,43,77,4.90909090909091,54,0,2,1
"30341","d1b574f0bfb588fc8375a129d9f34652",43,36,30,10.0333333333333,22,21,2,1
"30342","d1b58c95240c04c481f9ba14ca3cd072",153,108,49,21.8571428571429,153,0,3,3
"30343","d1b6582c15d6b901b8753f78dabf5699",89,71,25,24.92,89,0,2,3
"30344","d1bac517ab7d5b30d2168662140df0d1",110,80,56,13.75,110,0,3,3
"30345","d1bdc1f00c74d17caa9580589c0f5a65",70,61,55,8.90909090909091,70,0,2,3
"30346","d1beb8df5e4e2cf85b651afe7e2fd959",2,2,0,2,2,0,1,2
"30347","d1c07c9380a5e9342c58527a8d9f1637",80,68,57,9.82456140350877,80,0,2,3
"30348","d1c2dee0be6e9ca5f86ddd5741a535f9",23,22,84,1.91666666666667,23,0,2,1
"30349","d1c3a88738b5e2ea48690ce691e852e7",20,20,0,20,20,0,1,2
"30350","d1c7716ff4347ca14f4d6b2ce6193842",204,88,77,18.5454545454545,156,48,3,3
"30351","d1ca1ccc561c02f67d7cd0a96e3fccb1",90,63,63,10,90,0,2,3
"30352","d1ca30c3a71f1070cec379921d327b51",95,63,56,11.875,95,0,2,3
"30353","d1cb2972aed8c34caee650a0deca8790",41,41,0,41,41,0,1,2
"30354","d1cd839b90c0c41b3829770b2423fd7a",27,13,54,3.5,27,0,2,1
"30355","d1cfea8a06b10416805c1aa02003940b",41,41,0,41,41,0,1,2
"30356","d1d2a428b436cb83331ed763f094d2ec",37,37,0,37,37,0,1,2
"30357","d1d50123bad70e727c33cca90bec4536",34,32,6,39.6666666666667,34,0,1,2
"30358","d1d58d8f8a069f39cec98b98faeef49f",45,45,0,45,45,0,1,2
"30359","d1d5b4ee1ee358d1c465fd4d36326b0c",29,29,0,29,29,0,1,2
"30360","d1d83cf05e9b1d59e2c462edb0eb637a",22,22,0,22,22,0,1,2
"30361","d1da820ca95078f7d015aeb958db5bae",14,14,0,14,14,0,1,2
"30362","d1daae94f2a66b8cf1afde8f8aba1b2e",162,82,68,16.6764705882353,120,42,3,3
"30363","d1db60b7b439f911e84abeef9c830d63",18,18,0,18,18,0,1,2
"30364","d1dc26fdbbb493b0e6ce2d9ad0f44040",100,65,60,11.6666666666667,63,37,2,3
"30365","d1e133dde4ea93798b51763ca36840b5",26,26,0,26,0,26,1,2
"30366","d1e2708feb5e4e0cb40d889819b0fb67",87,55,36,16.9166666666667,38,49,2,1
"30367","d1e3f7a7962ab91e4156b96b892bdbe1",20,15,56,2.5,20,0,2,1
"30368","d1e5ac5ba7badf4b41bb88b7e590e91a",69,43,81,5.96296296296296,45,24,2,1
"30369","d1e81450767eeab06388104cff36e502",90,61,52,12.1153846153846,52,38,2,1
"30370","d1e945e2b673acd97a22846d281e6a50",36,36,0,36,36,0,1,2
"30371","d1eb6dfe2b2afb33e8b1fac4f421c1b6",36,21,24,10.5,19,17,2,1
"30372","d1eb7d3e10314ee9add1764ea1a6fd3c",32,28,28,8,0,32,2,1
"30373","d1eb8f26f100a8d124c1b054578b70a7",213,96,82,18.1829268292683,213,0,3,3
"30374","d1f06515f4a1f22fb0260ddd2525a6c0",49,49,0,49,49,0,1,2
"30375","d1f1f816d186ac16cad81320fa5606a0",107,63,77,9.72727272727273,107,0,3,3
"30376","d1f371729dfa70ca73174dfd3f148722",42,42,0,42,42,0,1,2
"30377","d1f507661c3fdad6e3b351cc4c9e046c",121,55,80,10.5875,80,41,3,3
"30378","d1f54c8a71e4009b003365de26ad45ed",57,51,16,24.9375,57,0,1,1
"30379","d1f5afbb37ee620485e9d2929b3ff030",67,49,56,8.375,33,34,2,1
"30380","d1f6178447970c80672185f67bfe26bb",24,24,0,24,24,0,1,2
"30381","d1f75442b19afd82c13ed9deeb282458",22,22,0,22,22,0,1,2
"30382","d1f8474400eb8a9ee32ae0b6d3661fdb",96,65,80,8.4,62,34,2,3
"30383","d1f9dcd5669f93808cb6814947b7bc59",88,59,24,25.6666666666667,56,32,2,1
"30384","d1facc81aafe14cd63f420a23b39fe21",170,85,61,19.5081967213115,133,37,3,3
"30385","d2015b7668243551651a7d98b3326e8b",58,38,34,11.9411764705882,58,0,2,1
"30386","d2016d394584def7880cc18cd42d1db2",123,87,63,13.6666666666667,123,0,3,3
"30387","d2031fd5499a251021be6101b0597352",53,49,17,21.8235294117647,53,0,1,1
"30388","d2033b4038d51f3664a7d9b079dfb4fe",71,66,28,17.75,71,0,2,1
"30389","d206a2a6d5d776a6b189e62a971996b4",51,45,40,8.925,30,21,2,1
"30390","d20764bba449e7c724ab225a53ffaa52",35,31,21,11.6666666666667,35,0,1,1
"30391","d20a293fd26d5df7ab81d47448812209",108,73,70,10.8,108,0,3,3
"30392","d20df16a4df41eaf6e7ee9801ac7c8ca",9,9,0,9,9,0,1,2
"30393","d20e4ca2800aaf059c8118bbd24b7615",24,22,25,6.72,14,10,2,1
"30394","d20fd3ea1b3592e0109c19107d8bf917",227,113,74,21.472972972973,178,49,3,3
"30395","d21169e714c3721f8e0eccc8111a1799",12,12,0,12,12,0,1,2
"30396","d211d84d7539aac6eeeb776107cb66a8",132,107,53,17.4339622641509,132,0,3,3
"30397","d212e53ba4f6d0ee61b4833e2d063640",137,57,77,12.4545454545455,137,0,3,3
"30398","d2133165cd7d245cb26d6487530c5ac1",46,36,21,15.3333333333333,46,0,1,1
"30399","d218ffe13558737f74d54434d9694697",16,14,22,5.09090909090909,16,0,1,1
"30400","d219c599c97048a72bcecd3aac26f4c5",26,26,0,26,26,0,1,2
"30401","d21b1219cb0c446eef0fe7cd72d3eeb3",6,6,0,6,6,0,1,2
"30402","d21d52ab57f77b02e228e3a87412330c",67,40,60,7.81666666666667,67,0,2,1
"30403","d21e9fdbef4efef3d71a26c4491690a5",50,49,9,38.8888888888889,50,0,1,2
"30404","d21f43aca07f5f020d3db997cc40152f",68,53,72,6.61111111111111,30,38,2,1
"30405","d2209e96e2ecfcecf722c12dc1f4b1b8",20,20,0,20,20,0,1,2
"30406","d222efeeb1e1ed8c42a25c289b9aaf48",54,48,61,6.19672131147541,18,36,2,1
"30407","d22384f8939961422e4fbd407378f5d7",43,33,43,7,43,0,2,1
"30408","d223babb9bab6d405c0b5ed163a7de0c",32,32,0,32,32,0,1,2
"30409","d225d8d68735d35f514b93f7f36d6b47",84,67,56,10.5,84,0,2,3
"30410","d229c240dc24a719995a0c2995ef2546",115,55,55,14.6363636363636,115,0,3,3
"30411","d229c4784cd5135b5ae271f8c8b32866",24,24,0,24,0,24,1,2
"30412","d22c5b02c456b3c251672ef8d47c2b1d",76,60,54,9.85185185185185,76,0,2,3
"30413","d230f626b4307b11721123619a169fa8",78,59,50,10.92,78,0,2,3
"30414","d231322dd25837f958264342ee41da01",204,109,78,18.3076923076923,204,0,3,3
"30415","d233dc58f710d658c55c8c29c8819a69",30,30,0,30,30,0,1,2
"30416","d2363cda49c7a2333e10ffe8512ef358",28,28,0,28,28,0,1,2
"30417","d23ad8ffe58f4b2d7542668f4c2d3af7",1,1,0,1,1,0,1,2
"30418","d23cecebe3725a45eb3294bab3607a5f",55,49,63,6.11111111111111,0,55,2,1
"30419","d23d1c37c1f75765ec7de53341cca56d",33,25,58,3.98275862068965,17,16,2,1
"30420","d23d6d86ca845babf3b2151681ad4cdc",144,91,48,21,144,0,3,3
"30421","d2409c65165cbc0caebedd318664fd72",40,32,49,5.71428571428571,40,0,2,1
"30422","d244729dfbb7f5791f6e7480a0ec383f",32,32,0,32,32,0,1,2
"30423","d2459a45defdd75946b4935bb6e0d540",57,48,27,14.7777777777778,57,0,2,1
"30424","d24710fd1d55fcec1288654198f3adb4",37,37,0,37,37,0,1,2
"30425","d248b0992ee4c887a41a43c675098e90",21,21,0,21,21,0,1,2
"30426","d24c3bd7cbfef3ba93a9ffdbfa5cb23b",85,67,53,11.2264150943396,55,30,2,1
"30427","d24f3c167393053e6a18b362ca1e6591",20,20,0,20,20,0,1,2
"30428","d24f9516b7f328f67916070adc0f5748",8,8,0,8,8,0,1,2
"30429","d2518df3ae4c51049d1a57d57651857c",24,24,20,8.4,24,0,1,1
"30430","d251a9889a14c21973a31dddf47c4f7e",34,34,0,34,34,0,1,2
"30431","d251e7c1a30bef91bd1784881fc1ff65",13,13,0,13,13,0,1,2
"30432","d253631195e1c4beebe7cb3e51d5df9a",79,68,56,9.875,79,0,2,3
"30433","d2541a6d6258089bd974c6eb5dceb6f8",200,100,58,24.1379310344828,165,35,3,3
"30434","d2586423f348c95b3cda984197c7b4e1",73,58,21,24.3333333333333,73,0,2,2
"30435","d25c2091b06e29591f1e161a250ed04a",24,24,0,24,24,0,1,2
"30436","d25c86cfe5a4412a3bdec5e41001693a",82,56,71,8.08450704225352,55,27,2,1
"30437","d25fcc6b7b2b41ffe2011e131c6c5cec",19,19,0,19,0,19,1,2
"30438","d2606299dfc00c887b3f069d6c54654d",167,69,57,20.5087719298246,167,0,3,3
"30439","d260820a0d6fbf6807b35fc9efd27eb1",24,24,0,24,24,0,1,2
"30440","d2625d35e4246cdcb83302d9e7ece87e",103,80,26,27.7307692307692,103,0,3,3
"30441","d265dc1a2b352749c8fe48addc10e7a9",58,56,30,13.5333333333333,58,0,2,1
"30442","d26a8dbd4e7c993d2e64a9a483e7d9ab",38,23,76,3.5,16,22,2,1
"30443","d26afa02cf47e68ee42a32fb69923a8b",164,130,32,35.875,164,0,3,3
"30444","d26b68c6c98718aa7f4ee48745a084bc",41,41,0,41,41,0,1,2
"30445","d26ef62f27e2b0ca058697b99afd0b48",37,37,0,37,37,0,1,2
"30446","d2760e0446ced330ffce94326ad3c2fd",19,13,33,4.03030303030303,19,0,2,1
"30447","d276d34e94480c98943bf81364a39de5",81,57,75,7.56,81,0,2,3
"30448","d2788630af49738bca693c77e819d157",8,8,0,8,8,0,1,2
"30449","d27a724f8d3300a5e3a7752616ade017",13,13,0,13,13,0,1,2
"30450","d27a7d0389c1b6c9060572ae65f8fe57",76,74,10,53.2,57,19,1,2
"30451","d27aea7d5988c130eaca488c19409ab7",52,40,9,40.4444444444444,52,0,1,2
"30452","d27bca7d96c6933ada1d89f5e6ed5241",13,13,0,13,13,0,1,2
"30453","d27c468664e03e21902247679883fa9f",10,6,42,1.66666666666667,5,5,2,1
"30454","d27e94baeb3467cbceaa9b7498f8758d",34,34,0,34,34,0,1,2
"30455","d27ffd43db4d5f22111b85144c870b82",138,104,65,14.8615384615385,106,32,3,3
"30456","d2800401b7385c3e6355d6722e1a2440",29,29,0,29,29,0,1,2
"30457","d2800ff8b99e978a28114ecca0d89a70",41,41,0,41,41,0,1,2
"30458","d28123737968f95b061c3a38e5c50f1e",101,64,59,11.9830508474576,101,0,2,3
"30459","d283565bca2817b8a9c7915e3ac50fef",72,62,60,8.4,72,0,2,3
"30460","d284649cb5e9585838f67865feff7d11",22,22,0,22,22,0,1,2
"30461","d284868d7ce1657d317605f28aef5edd",175,68,84,14.5833333333333,175,0,3,3
"30462","d28497a0ea0480ec15ce936fb564d0e5",9,9,0,9,9,0,1,2
"30463","d2870a7f672f02268d778e0c0bd17b72",38,38,0,38,38,0,1,2
"30464","d288e60211213c877cce393b4f79867d",67,56,23,20.3913043478261,67,0,2,1
"30465","d28c4720b77d6282121f815965250be4",166,87,71,16.3661971830986,135,31,3,3
"30466","d28f6823d29107429986bdc3f7e3d986",26,26,0,26,26,0,1,2
"30467","d2955469e0cd3dec04eb208cfa14cee9",12,12,26,3.23076923076923,12,0,2,1
"30468","d2955e4dbb421989e4d63409f49986b3",70,49,37,13.2432432432432,33,37,2,1
"30469","d296c6170601653acf7b7ad92c46013e",53,51,47,7.8936170212766,53,0,2,1
"30470","d296d5bb56bcd399d2a66096f1dada00",23,23,0,23,0,23,1,2
"30471","d2971f2529a2c8e40dcd2cd694ed2a1f",40,36,23,12.1739130434783,24,16,2,1
"30472","d299ecd9f8120e3444a5cdecfa700a19",28,26,7,28,28,0,1,2
"30473","d29af1dccdc4d5904f503db446d6dd82",30,30,0,30,30,0,1,2
"30474","d29c28dbef8807eff5517ac37ffed3a9",49,38,78,4.3974358974359,49,0,2,1
"30475","d29cd40d7f1fcf044735208e770d4fae",41,34,76,3.77631578947368,41,0,2,1
"30476","d29d9a23fb640e349c1ae224186ea04e",162,98,83,13.6626506024096,162,0,3,3
"30477","d29dfa65397045bfd9874ab59f9a6952",65,58,27,16.8518518518519,39,26,2,1
"30478","d2a0c721b9c575f563153c4979b5980d",22,22,0,22,0,22,1,2
"30479","d2a4c76eb442009a810b5085103c2a2f",27,27,0,27,27,0,1,2
"30480","d2a58d52e36b822688bdbeac274e771c",25,25,0,25,25,0,1,2
"30481","d2a7b9a41be50d30cbed15c50a376298",41,37,66,4.34848484848485,25,16,2,1
"30482","d2aa749adb071fa21ca4cb13908a781f",29,24,73,2.78082191780822,29,0,2,1
"30483","d2ac9d55278b6d75761b0ec177dee7af",33,33,26,8.88461538461539,28,5,2,1
"30484","d2afb4deb1be0e14e270ab457cd5f8be",29,24,18,11.2777777777778,29,0,1,1
"30485","d2b0d8ee872cfbec58bc60f188fdd443",26,26,0,26,26,0,1,2
"30486","d2b1ed5e21b357fb6b39684eaed0aba5",45,45,0,45,45,0,1,2
"30487","d2b4b3d307ea5160af25629cdddd76c2",38,38,0,38,38,0,1,2
"30488","d2b5d419dc8fd6c24bb2abd8e8f29ffe",36,32,37,6.81081081081081,15,21,2,1
"30489","d2bfa9739c5584bcaedb6de724106950",42,36,27,10.8888888888889,42,0,2,1
"30490","d2bfd63f36c3c48882cc2dad0c735d6f",94,75,71,9.26760563380282,94,0,2,3
"30491","d2c1eafb33ae4ff6fc5c37c2f448b6a5",43,35,42,7.16666666666667,43,0,2,1
"30492","d2c2d2aec65bb762291cf4b4662d1f5a",6,6,0,6,6,0,1,2
"30493","d2c356988c163ad0d41d84175489456f",77,47,55,9.8,77,0,2,3
"30494","d2c3cf6a1e0020914a4132d59bfc465b",37,31,54,4.7962962962963,37,0,2,1
"30495","d2cbb0a07806d1e4ed3e6d4148ff4b20",29,22,56,3.625,29,0,2,1
"30496","d2cc50c598ff5190cc7711c19ab77f2d",61,29,74,5.77027027027027,26,35,2,1
"30497","d2cf6f355db2488f68915a0e6cae4b17",113,85,65,12.1692307692308,113,0,3,3
"30498","d2cf995d00f54d51ed56eb1b4a4d61c2",49,35,62,5.53225806451613,49,0,2,1
"30499","d2d00d044b94f9d3dd3f4c1ebe7f2015",15,15,0,15,15,0,1,2
"30500","d2d3c690bfc764b2cec91d99b3258c60",34,34,34,7,34,0,2,1
"30501","d2d3f231640c7ca001c7345c46f464ad",28,28,0,28,28,0,1,2
"30502","d2d73c3a3a06351df7fef170302a91ec",116,95,52,15.6153846153846,116,0,3,3
"30503","d2d8018ac42bec7edf54e5b72fb45e81",39,34,21,13,39,0,1,1
"30504","d2d95771c9221e8830a4a2d4d42e95c1",31,31,0,31,31,0,1,2
"30505","d2d9bf0d47bd0e370b0b47c73ccac8b9",17,17,0,17,0,17,1,2
"30506","d2da258cc27dcd7d2452cc6ca7b75609",216,101,53,28.5283018867925,216,0,3,3
"30507","d2db11b2ba19affba103cb45f9945efc",160,103,70,16,160,0,3,3
"30508","d2dbcad4627be02baeb37cca16002aec",19,19,0,19,19,0,1,2
"30509","d2e0511614e9dfb4846e12a9176cc1d4",100,67,62,11.2903225806452,69,31,2,1
"30510","d2e1b56aea495b462dba52e3cfb14dcd",79,62,21,26.3333333333333,79,0,2,2
"30511","d2e230017451386605bfeb96e364e1e2",124,105,32,27.125,124,0,3,3
"30512","d2e248b567f078d331fbbd97ee7901fb",180,106,63,20,180,0,3,3
"30513","d2e2a5b56d9afb11683e981afb733788",79,55,45,12.2888888888889,43,36,2,1
"30514","d2e36ad41e251b8e447b01153fe41196",163,88,65,17.5538461538462,163,0,3,3
"30515","d2e412ac27daa28a5deda81861695f7b",38,38,0,38,38,0,1,2
"30516","d2e61aa46d2c141254a823bbb144f5eb",103,75,21,34.3333333333333,103,0,3,3
"30517","d2e9bf36a1089b05ec3d080eff93c081",8,6,26,2.15384615384615,8,0,2,1
"30518","d2ea017a262aa72063def2fc979b60cc",25,24,4,43.75,25,0,1,2
"30519","d2ea742b278a0b758ace21b1f4d1c78c",25,23,52,3.36538461538462,25,0,2,1
"30520","d2ea8d4ad24b38b5fb23d5ee02925075",39,39,0,39,39,0,1,2
"30521","d2eac5ce41cd2bbf6302396029b4c221",3,3,0,3,3,0,1,2
"30522","d2eae95f088de77c49273877ce341a43",118,78,82,10.0731707317073,118,0,3,3
"30523","d2ec9874e7acf15fcd059280e57efaed",3,3,0,3,3,0,1,2
"30524","d2ee91f6b2f2a0c8d05f6cbc608ce6ad",68,60,26,18.3076923076923,68,0,2,1
"30525","d2f01a072eef4b64a02ba55c521e1fba",37,32,53,4.88679245283019,37,0,2,1
"30526","d2f06114938ad784273d4ecb0c98d481",52,52,0,52,52,0,1,2
"30527","d2f15c3beb103d861aa6402bbe3c5bf3",46,46,0,46,46,0,1,2
"30528","d2f27ff8e2d2ea19f80c2495fadd8118",33,33,0,33,33,0,1,2
"30529","d2f795f2b03ae1008d531bfbbf5bece1",19,19,0,19,19,0,1,2
"30530","d2f8014a3fda918125486087d07b23f4",20,20,0,20,0,20,1,2
"30531","d2fa7a27ffb38d3d6d448d3de1a8e089",178,117,60,20.7666666666667,131,47,3,3
"30532","d2fc9570905a943276888204228ac176",77,62,51,10.5686274509804,44,33,2,1
"30533","d2fceff9bbd2e500229fc25595870fd9",14,14,0,14,14,0,1,2
"30534","d2fe34fa29b9c347560c560afd8740e7",151,91,59,17.9152542372881,120,31,3,3
"30535","d2ffa92408e485b34d43f207b042cd20",134,92,64,14.65625,134,0,3,3
"30536","d300dc1275913a002d9e8b6cd3e3a668",13,13,0,13,0,13,1,2
"30537","d302854236282357cbdb0caa2f382f54",160,116,37,30.2702702702703,160,0,3,3
"30538","d304d6140846e759c68b09776f63e92f",93,72,57,11.4210526315789,93,0,2,3
"30539","d30695f5d96e15fe0fbd8d61180cbee0",8,8,0,8,8,0,1,2
"30540","d307c44e843c89947d2b4faa6fbf59bf",17,17,0,17,17,0,1,2
"30541","d30a0ac4a9f1777c8063181d8694fd55",160,92,73,15.3424657534247,160,0,3,3
"30542","d30c8cc2e0cbb6c869fef5bf04ea773f",49,33,62,5.53225806451613,13,36,2,1
"30543","d30dc78cd2e803da3b805b6398d1e673",89,67,14,44.5,89,0,1,2
"30544","d30e2ad09ee7678855401c4fe3d94b36",141,76,60,16.45,111,30,3,3
"30545","d30f20c7d8d014860b459924c9811c04",58,33,81,5.01234567901235,58,0,2,1
"30546","d31107de6ea14aa642e1d27c877b04a3",144,68,83,12.144578313253,144,0,3,3
"30547","d312b40a338676f10df3fd779179450a",3,3,0,3,3,0,1,2
"30548","d314c2a4035938df56f891e89b1223d7",41,41,0,41,41,0,1,2
"30549","d319b75a10774cbf58c28711345a9c3c",18,18,0,18,18,0,1,2
"30550","d31af1a916c4bf00443156532444c8f7",41,34,15,19.1333333333333,41,0,1,1
"30551","d31e2fed44fd434b966dde5baef2dea5",135,65,80,11.8125,103,32,3,3
"30552","d31fe093571a7a0cb0fd28176582e1cf",104,73,21,34.6666666666667,58,46,3,3
"30553","d320fb52135665d69862f435198f70a2",150,107,23,45.6521739130435,150,0,3,3
"30554","d3248f2d770ec391fbee584e043e7a06",165,84,56,20.625,165,0,3,3
"30555","d3263ac862b21098488ffb5cd81c880c",66,55,66,7,66,0,2,3
"30556","d32797ec1bae869dcddbbbd7319322be",27,27,0,27,27,0,1,2
"30557","d32977075b426ef0d7acff553e9d6116",140,105,52,18.8461538461538,140,0,3,3
"30558","d32a44aef4937709577220282e3554b6",41,41,42,6.83333333333333,41,0,2,1
"30559","d32a749a35c0992037f7630def8a0e5a",33,33,0,33,33,0,1,2
"30560","d32aa539511067a17c59094742d24327",242,125,77,22,212,30,3,3
"30561","d32ab64aad234f1acf08ea0d69db3ed3",156,97,57,19.1578947368421,102,54,3,3
"30562","d32af5e75944603ea3d00f2e47eaa586",12,12,0,12,0,12,1,2
"30563","d32b256acda9c881632eee805b8c021e",25,25,0,25,25,0,1,2
"30564","d32d918bb80bf56afd55e064227c2093",120,64,83,10.1204819277108,97,23,3,1
"30565","d32eb383989fc49ddb0d27e233c68d3e",18,18,0,18,18,0,1,2
"30566","d32ff42308d663465002edb671c79d0d",133,80,76,12.25,133,0,3,3
"30567","d330e9611f9b5560b4602b753da1357b",25,25,0,25,25,0,1,2
"30568","d3330b1b7f5e7522a421734d935e2445",27,27,0,27,27,0,1,2
"30569","d333bf1da9d3254da00ca3ab7a64755e",15,15,0,15,15,0,1,2
"30570","d33626e394cb0bd9097f098a90cb3913",53,53,0,53,53,0,1,2
"30571","d339246cff67170d715a974d69d45b7c",13,13,0,13,13,0,1,2
"30572","d33ad757afb3b2c7bf2eb1dc98da60ea",37,37,0,37,37,0,1,2
"30573","d33b49abf5f00e8fdc45e088bf9b22ba",11,11,50,1.54,11,0,2,1
"30574","d33b6181eb6ef1922fc518e5c0d23361",70,55,29,16.8965517241379,70,0,2,1
"30575","d33c4ff189b834f4d8e94bcb4ebaa675",149,92,63,16.5555555555556,149,0,3,3
"30576","d33c8b8affb00b37701e21d375063db3",32,31,36,6.22222222222222,32,0,2,1
"30577","d33f65d57ea1188c458ba734588d1d0d",159,64,88,12.6477272727273,159,0,3,3
"30578","d340ea0c2d3a5e8846ad0740b9a61c26",139,100,57,17.0701754385965,139,0,3,3
"30579","d343944b45ed8525c0b633e769aafb75",46,46,0,46,46,0,1,2
"30580","d344356a808185d6423f03a4ad9ddf9b",177,126,73,16.972602739726,177,0,3,3
"30581","d344ef4f8215057deba122b9ef53c9aa",19,19,0,19,19,0,1,2
"30582","d3462b91ea9561eda9484d8c6cb20c29",101,61,69,10.2463768115942,66,35,2,3
"30583","d3480e089da0ae4c2147ab47a3bfc5c0",23,23,0,23,23,0,1,2
"30584","d34950b22d95895d1a1896ef830abf64",82,63,77,7.45454545454545,82,0,2,3
"30585","d34b8da50ee3d885b0325795d045b742",33,33,0,33,33,0,1,2
"30586","d35020b5de1c6c10e037f0ea988bdd44",148,94,62,16.7096774193548,148,0,3,3
"30587","d35026709d5bdf779c403e6c91441f98",197,116,56,24.625,197,0,3,3
"30588","d351bc18548e8a4d3705e787f6deaf66",44,38,31,9.93548387096774,44,0,2,1
"30589","d3555c045aae8cdfae41992bcd7eb337",22,22,0,22,22,0,1,2
"30590","d3582edc133a7d31e780065a6ba8df21",20,20,0,20,20,0,1,2
"30591","d3587e534e5540a806936095c0b9b157",29,29,0,29,29,0,1,2
"30592","d359c9fdb3b35a37fd49a2e067602adf",66,59,53,8.71698113207547,66,0,2,3
"30593","d35a10db925124e54d86d380bebd6eb2",31,31,0,31,31,0,1,2
"30594","d35a56036e31d35b03bcff5e2410d95e",134,77,62,15.1290322580645,115,19,3,3
"30595","d35afcfa59555b7c78a76a89963e63cc",204,84,81,17.6296296296296,204,0,3,3
"30596","d35ccfad0325a54aaf70662afa5f7a0b",16,16,0,16,16,0,1,2
"30597","d360cbe350e119869f0227f34470dfea",44,29,59,5.22033898305085,44,0,2,1
"30598","d361286d177343310dc4703291fbbe31",85,65,46,12.9347826086957,85,0,2,3
"30599","d36437cf7a790a796781b7517c4fc86e",53,53,0,53,53,0,1,2
"30600","d36598fd1047894285851aa7400a43fd",161,101,52,21.6730769230769,161,0,3,3
"30601","d368a1ee2e7332f1c9babcb1e365195b",53,40,30,12.3666666666667,28,25,2,1
"30602","d36d55e66cc7d628da73401b6fd9643b",49,33,51,6.72549019607843,49,0,2,1
"30603","d371d7db28ecb9355b16425a45d1339b",48,41,25,13.44,48,0,2,1
"30604","d372770bea5c44373ea02b23275f0b3c",53,50,32,11.59375,19,34,2,1
"30605","d375f417c25ce73a4c6b3c68bf84c8a6",73,54,43,11.8837209302326,73,0,2,3
"30606","d378ab1575e466c25ba9b7fad2f16475",28,28,0,28,0,28,1,2
"30607","d379635734e83a9390a93ae764d65619",16,12,40,2.8,16,0,2,1
"30608","d3827efbd27b683d7640f7f07b97d2db",39,39,0,39,0,39,1,2
"30609","d38756dcbe050e5cc46a96f57c097642",38,38,0,38,38,0,1,2
"30610","d3879d67e558ccccedb417b3a22f9ff2",11,11,0,11,11,0,1,2
"30611","d388ce7b60ad643a82b628b8ec11e17f",20,20,0,20,20,0,1,2
"30612","d38967a88ffdd370ca7d50357ccbecac",219,103,74,20.7162162162162,219,0,3,3
"30613","d389aab6c9e480af3d3c4bb24583ce9f",25,25,0,25,0,25,1,2
"30614","d389f04c86ed252063a17ce69e3bf6f7",21,21,0,21,0,21,1,2
"30615","d38c5ac25ad39f5a86daba7db2e2fa29",51,37,73,4.89041095890411,51,0,2,1
"30616","d38ddae8901afa04238904f3c2111372",146,101,77,13.2727272727273,146,0,3,3
"30617","d38e9f0740f56ca616a569bbfb87a308",92,62,76,8.47368421052632,92,0,2,3
"30618","d38fcf979bc00f5d23824a2f1557d65f",44,44,0,44,0,44,1,2
"30619","d3929b66f4f2d299b5c50690106f0be8",177,127,67,18.4925373134328,161,16,3,3
"30620","d3931602a5840bc70be1dc89fdeb34c5",66,50,61,7.57377049180328,66,0,2,3
"30621","d393a9d9bedf7a4e93145185c14ac28f",30,30,0,30,30,0,1,2
"30622","d3941d7d88dcfb1bba51dc4a7aba4652",83,69,20,29.05,37,46,2,3
"30623","d3997196614938b0384fb52e65bac07c",38,26,39,6.82051282051282,38,0,2,1
"30624","d39b80ca996a199e700de1f02ed2bf80",38,38,0,38,0,38,1,2
"30625","d39b81c40c0532333f3e3c8bc847950b",162,89,66,17.1818181818182,128,34,3,3
"30626","d39f3bac3b6f034c39959257c8d216fb",40,40,0,40,40,0,1,2
"30627","d3a149b76ee06866b5a2efccad5f691a",37,37,0,37,37,0,1,2
"30628","d3a216c540518d29aeec9a0c0034b8ff",33,24,51,4.52941176470588,33,0,2,1
"30629","d3a2f4bec50a3886dd7ca03c1dc52b44",19,19,0,19,19,0,1,2
"30630","d3a31db98cfbc1c44825ee02a9d4c376",125,87,68,12.8676470588235,70,55,3,3
"30631","d3a82ac705dde9dfefb1a0eac2eae17b",28,28,0,28,28,0,1,2
"30632","d3a867dc9ba46095acca6d3d9880222b",72,62,52,9.69230769230769,72,0,2,3
"30633","d3aa900891ae9c6ec2a03280a649fc80",73,47,75,6.81333333333333,52,21,2,1
"30634","d3b1981f9272376e07bec162284a4548",40,40,0,40,40,0,1,2
"30635","d3b50ce2e5893b88691a83ff8fe46928",124,63,63,13.7777777777778,124,0,3,3
"30636","d3b668646140d35e2dc74ebd8e66be08",108,80,38,19.8947368421053,88,20,3,1
"30637","d3b6cfa21fd423d8080cc6e610d85241",182,107,59,21.5932203389831,182,0,3,3
"30638","d3b7b9b2ae86b37c21297cf86e1f7c2f",122,84,52,16.4230769230769,122,0,3,3
"30639","d3b84d45fcd3018e83feec29daa7632a",35,35,0,35,35,0,1,2
"30640","d3b9c03cacbd02443bce5847bed6258b",20,20,0,20,20,0,1,2
"30641","d3b9db698a329fd99b649ec9e591f05b",78,42,58,9.41379310344828,78,0,2,3
"30642","d3ba115643e22ae54663a3a781250e3e",26,24,7,26,26,0,1,2
"30643","d3ba17d916b8e9e7ea2378829c2cbf8c",45,45,0,45,45,0,1,2
"30644","d3bd367d8d9d86e160acc3ea33d74576",7,7,0,7,7,0,1,2
"30645","d3be38b7cc0f0a2bd9e8c824c73e4bd2",132,96,32,28.875,86,46,3,3
"30646","d3bfac948c87f5bf37eb3bbb286b4942",51,51,0,51,51,0,1,2
"30647","d3c3f13f4aacdb408b19eedd74da4273",214,84,70,21.4,214,0,3,3
"30648","d3c4875ba5978946087b9d2493b6de0e",24,24,0,24,0,24,1,2
"30649","d3c489949c49e2999e99095134a95f84",85,62,56,10.625,85,0,2,3
"30650","d3c4a5d7e952d78d2e65b6980da354fd",16,11,55,2.03636363636364,16,0,2,1
"30651","d3cced02e1cd5646336bb1c7cde01c71",53,43,34,10.9117647058824,53,0,2,1
"30652","d3cd515fd2705f09d3107fa2f3b987f0",39,39,0,39,39,0,1,2
"30653","d3d24dc9017d415d4095ff316f0d885d",16,10,38,2.94736842105263,16,0,2,1
"30654","d3d2a0eec3b0c62a54ee637dfa8d81fb",89,68,51,12.2156862745098,89,0,2,3
"30655","d3d61c4628a51faff71f7667e0cf871b",214,119,61,24.5573770491803,214,0,3,3
"30656","d3d6a5e76ef008eccb834e20b29c2c91",94,80,61,10.7868852459016,94,0,3,3
"30657","d3d7180f31b7f687d0ce37e6858b1e45",31,31,0,31,0,31,1,2
"30658","d3d9fbea8837121440300a3f7e8ea1b7",213,88,77,19.3636363636364,184,29,3,3
"30659","d3dae87b8486c563f0e26636ddc7ee31",71,56,25,19.88,37,34,2,1
"30660","d3dafd61e247599f67be023e8868c54e",19,19,0,19,19,0,1,2
"30661","d3db976906673be4911465f8aa9a7ac2",170,123,49,24.2857142857143,170,0,3,3
"30662","d3dc6cf1c937dd35bb150b3d02a29992",18,13,27,4.66666666666667,18,0,2,1
"30663","d3de5de16a27ff1e3fc0aa647e977a87",38,33,57,4.66666666666667,38,0,2,1
"30664","d3de6a293c887e7e5a98d62ed8d635e7",141,86,69,14.304347826087,141,0,3,3
"30665","d3de9d52d5e49b3c92c026c96d926221",50,37,12,29.1666666666667,50,0,1,1
"30666","d3deede6da46c38c8dc18ff6f017fcac",124,74,57,15.2280701754386,124,0,3,3
"30667","d3e2fc161e112a4ee5b673978e0a996d",65,45,61,7.45901639344262,65,0,2,1
"30668","d3ea2548a7a41b611774f8d62ad17203",33,33,0,33,33,0,1,2
"30669","d3eaca6791b36407d919774305512e14",25,25,0,25,25,0,1,2
"30670","d3ec0ecd73d7bfc636459ff8c8ef0aa0",51,51,0,51,51,0,1,2
"30671","d3ec1fec0da4f597683b2311cc9a9cbf",10,10,0,10,10,0,1,2
"30672","d3ee2b98305eddc16748b18de88560cf",53,53,0,53,0,53,1,2
"30673","d3f014a441599043dde0b0c037e8091d",65,57,49,9.28571428571429,65,0,2,3
"30674","d3f08268fb351af963b9892cf9c69db1",6,6,0,6,6,0,1,2
"30675","d3f1f733224838a1539ad11a579c14bf",101,76,66,10.7121212121212,101,0,3,3
"30676","d3f4ef3087b02dda4b0ef0abcbfc7b6a",35,35,0,35,35,0,1,2
"30677","d3f6c88f68244f257a32ead035e0ba24",24,24,0,24,24,0,1,2
"30678","d3f953ef478133cbbb191db137e9504b",131,64,78,11.7564102564103,131,0,3,3
"30679","d3f96a89b66265726c2401346b0d003a",51,36,52,6.86538461538461,51,0,2,1
"30680","d3fa6f06dbc848b033a0032fabbfd17f",25,25,0,25,25,0,1,2
"30681","d3fceeec0dfb71ae202e7e07e216b1ac",26,26,0,26,26,0,1,2
"30682","d3fdf52c62b68d0774b79ced0b0fd1ff",87,70,42,14.5,87,0,2,3
"30683","d3ffd5be20096bedda32b0b1591bf221",10,10,0,10,10,0,1,2
"30684","d4012a881483d822ab5fe76158463146",33,33,0,33,33,0,1,2
"30685","d401bf9de9c95e3654fc0ae8b0dd67a5",166,113,21,55.3333333333333,166,0,3,3
"30686","d401ce5045dbb1ed0925cd19fad3b290",146,85,78,13.1025641025641,105,41,3,3
"30687","d405135941c1157eb140110875cccb9d",7,6,3,16.3333333333333,1,6,1,2
"30688","d4062992813941645b2b5f95ec36fe8c",132,103,33,28,77,55,3,3
"30689","d40780da16369d40be77174a629c30df",12,7,59,1.42372881355932,12,0,2,1
"30690","d4096f7d78c4a642ed0c4a1fb064db32",49,41,60,5.71666666666667,25,24,2,1
"30691","d40982a2c56650b9f824d9aea33935a4",57,45,61,6.54098360655738,43,14,2,1
"30692","d40b21e785e0f14baea2bba5da2bbbc8",124,111,21,41.3333333333333,123,1,3,3
"30693","d40d04aa38993f4908b822d9398e532a",2,2,0,2,0,2,1,2
"30694","d4100212ff04a2d0ac4507ded9140b79",44,38,70,4.4,44,0,2,1
"30695","d4103c18a96f1af925d158dcf7fdd8a7",44,44,0,44,44,0,1,2
"30696","d41149dad23ddd4f5751cfe1ce5ea5c8",39,39,0,39,39,0,1,2
"30697","d4136c1afb79e1b3c23e8f649c728281",84,54,85,6.91764705882353,60,24,2,1
"30698","d4137f9ace65987ae555fa2672c12cab",94,58,82,8.02439024390244,94,0,2,3
"30699","d4148354c27df47e5592b6bb9e684877",1,1,0,1,1,0,1,2
"30700","d41b419b9d4fcc6cd7052e941c43d78c",19,15,14,9.5,19,0,1,1
"30701","d41bf24e726c64ccbf605ffcfa44bb1c",49,48,79,4.34177215189873,45,4,2,1
"30702","d41d5682529cb01c176462c4d6bd65a1",39,39,0,39,39,0,1,2
"30703","d41dbd6c5b4d042caa8f1e045a710e7a",29,29,0,29,29,0,1,2
"30704","d41e95e7d4a864e664b52ca3ec7c1ba0",46,41,63,5.11111111111111,0,46,2,1
"30705","d4206a71f954b792e4456a001147e55b",9,9,0,9,9,0,1,2
"30706","d420f8da9e517fcc57faaa10ae9033ec",67,52,46,10.195652173913,67,0,2,3
"30707","d4217e4601dfd142f6ac03c41b15a323",60,48,25,16.8,60,0,2,1
"30708","d422017dee58a3522ee856febfbeb388",22,17,68,2.26470588235294,18,4,2,1
"30709","d423db6b45d37e8e203e2fa6c24ff2b7",28,28,0,28,0,28,1,2
"30710","d4252553fd2f3b7246e1ef02dc13c37c",26,26,0,26,0,26,1,2
"30711","d42542ad17579251285c6f926385f281",29,29,0,29,29,0,1,2
"30712","d4272115d2c7e9926db762f895fec0e7",122,67,64,13.34375,104,18,3,1
"30713","d429a8d1856b264cd9d5a5630298f1bc",30,23,61,3.44262295081967,30,0,2,1
"30714","d42b16bb9bbb2bbe969625ab63c610a2",47,41,26,12.6538461538462,47,0,2,1
"30715","d42c696c2f3f85468957eca58a73848f",57,49,22,18.1363636363636,57,0,2,1
"30716","d42ccf518e25940a2f0a224764bc7acc",39,39,0,39,39,0,1,2
"30717","d42da9047c1d4e4ff812562d01cedfa5",69,48,30,16.1,43,26,2,1
"30718","d42f8072355800bc90b93e12ebf4097f",72,64,83,6.07228915662651,72,0,2,3
"30719","d43131b7857a849a5f2a53c9df06a65e",33,33,0,33,33,0,1,2
"30720","d4339a1497ae705f5485349e2d9b5731",52,39,41,8.87804878048781,52,0,2,1
"30721","d43474bc18e96edacdb6d7858c26a488",119,61,75,11.1066666666667,119,0,3,3
"30722","d4357e9a41dff7a795ac13ff8dcd6146",162,124,49,23.1428571428571,162,0,3,3
"30723","d4379de123561ff3427d0c31166e47ba",16,16,0,16,16,0,1,2
"30724","d43b5af1e01856e64a63b15318b95519",156,87,85,12.8470588235294,108,48,3,3
"30725","d4437b3b883fc3fb97769959a13ad92c",43,37,16,18.8125,25,18,1,1
"30726","d443d6bb37ee315022479d6f30dd6ba3",125,62,62,14.1129032258065,125,0,3,3
"30727","d444a3517e3f3986709cfe9de2658ef0",79,56,35,15.8,79,0,2,1
"30728","d444b715393804285b14c90c451c26bc",111,50,80,9.7125,102,9,2,1
"30729","d446b535d756ea0c946cd0a00ababafc",116,102,51,15.921568627451,116,0,3,3
"30730","d44937e98458e873d8661a28f9efd8a6",5,5,0,5,5,0,1,2
"30731","d4493a90ea4fc9b9bb5a26a79d866102",72,55,40,12.6,31,41,2,1
"30732","d449472916f72ce2fbcebc248a93bd2a",21,21,0,21,21,0,1,2
"30733","d44aa1ef1e843629afa8d03b160a23c1",106,77,52,14.2692307692308,106,0,3,3
"30734","d44bcfc1583fdbcbe3ce5348f541d954",72,41,44,11.4545454545455,72,0,2,3
"30735","d44d1ee7a0731f0540a9c4a8eae81e29",94,72,58,11.3448275862069,94,0,2,3
"30736","d44f4d1a22841765f453fd14f4a5a86d",78,66,63,8.66666666666667,78,0,2,3
"30737","d450fa44e1b743cbe783ad22106521c1",164,80,77,14.9090909090909,164,0,3,3
"30738","d453ad1566351dfb53b51dd429e4e9c6",22,22,0,22,22,0,1,2
"30739","d456d094626c92cf427cb04a0325f775",78,54,54,10.1111111111111,51,27,2,1
"30740","d458938261477c7eb79b5f26a6b6476a",28,28,0,28,0,28,1,2
"30741","d45b9d6e375732a644ae26eba7802de5",129,87,51,17.7058823529412,129,0,3,3
"30742","d45c1f10c1182aa6a501db48ca452acd",7,7,0,7,7,0,1,2
"30743","d45cc26da7926cc24f9cda785066e5eb",121,81,72,11.7638888888889,94,27,3,1
"30744","d45d19a8795d20f4c19c4ead4aa7024d",9,9,0,9,9,0,1,2
"30745","d45d3a9ce7561b284719da36a4803a04",19,15,22,6.04545454545455,19,0,1,1
"30746","d45eb6b77ab84cd9d61a40831681d960",122,92,54,15.8148148148148,122,0,3,3
"30747","d4602d063321d919b50c88733028182f",118,76,56,14.75,72,46,3,3
"30748","d46483deaec3fd8df39864ee0bd2f903",51,38,21,17,51,0,1,1
"30749","d465796f28c165f9183705e566a12b35",59,44,58,7.12068965517241,59,0,2,1
"30750","d4675d4ae99d916a1c4f23c0210ddac8",131,72,72,12.7361111111111,98,33,3,3
"30751","d468fb61993235c3e1d42a12080ce3c6",35,35,0,35,35,0,1,2
"30752","d472547153e4706480718007b2faf25e",108,67,66,11.4545454545455,108,0,3,3
"30753","d47597e3841b279392f7542324569667",20,20,0,20,0,20,1,2
"30754","d47633b5581986bf111dd25899cec78a",116,87,30,27.0666666666667,116,0,3,3
"30755","d476d2c7dc91c6525bf0753bc30aadd8",29,29,0,29,29,0,1,2
"30756","d4782965cab53d5be0a5a2053c6e741f",20,20,0,20,0,20,1,2
"30757","d47b1bba58e244a935f147fdde523dff",142,91,64,15.53125,142,0,3,3
"30758","d47b1d8dc7930c2317dd9bbfd48bb71e",33,33,0,33,0,33,1,2
"30759","d47bd190da658b35e58abba2aacaeb2b",62,51,39,11.1282051282051,30,32,2,1
"30760","d47c69a5e0a763cc9fd333e8bf7bf222",128,84,70,12.8,128,0,3,3
"30761","d47c8aa892bb5e6fba0f879b7594b866",40,35,50,5.6,40,0,2,1
"30762","d47e59c1720470d6b493a4d561660868",138,113,36,26.8333333333333,138,0,3,3
"30763","d47fd4030275b761ef2e399a2a706375",211,151,78,18.9358974358974,211,0,3,3
"30764","d4801e75b235e730afd46c837b795a05",22,22,0,22,22,0,1,2
"30765","d482ae2540911a0616d97b321e1519e9",203,100,56,25.375,203,0,3,3
"30766","d484705ff0c1a786c29a0c8039879a49",32,32,0,32,32,0,1,2
"30767","d4864ad39151d3282e4a2be52dcbfa6e",32,32,0,32,0,32,1,2
"30768","d487ed3200d8100abb45f7320a366816",21,21,0,21,21,0,1,2
"30769","d4883d497835a071a00c211e0c76aab7",124,82,68,12.7647058823529,124,0,3,3
"30770","d489bb8fe962281ebd226fed3485c9e1",16,16,0,16,16,0,1,2
"30771","d489dc4a7ab21b61046a9f9dd4695707",15,15,0,15,0,15,1,2
"30772","d489f827bb2dc70fd2e93a23266a4a32",94,46,77,8.54545454545454,94,0,2,3
"30773","d48bd2a0566b883a7c2addea4a91778e",40,32,59,4.74576271186441,38,2,2,1
"30774","d48c134c5c7e4d8ca0f32f334528c4ea",27,27,0,27,0,27,1,2
"30775","d48d5b1621be0daa6ada3bdda1522822",46,40,39,8.25641025641026,46,0,2,1
"30776","d48e6d3b2592efb33720a4ae4251130f",184,106,78,16.5128205128205,184,0,3,3
"30777","d48e77563df8b53a19176af20473cb7b",36,36,0,36,36,0,1,2
"30778","d49055fef724898539ec47a5529b2cd0",1,1,0,1,1,0,1,2
"30779","d4909c983a7761e3958c98b288749a8e",144,108,83,12.144578313253,144,0,3,3
"30780","d4919ccda2510421ea4a91f7aaa5c713",157,63,76,14.4605263157895,157,0,3,3
"30781","d493b8f7a1a2746241690ee4845d3c03",94,87,16,41.125,48,46,3,3
"30782","d4948ed6b80470383c596030cf494f9c",12,12,0,12,12,0,1,2
"30783","d4964792274844f1914ad44c639db3d0",121,69,63,13.4444444444444,85,36,3,3
"30784","d49b9535ca99a0517dddd597306bcd50",60,50,14,30,60,0,1,2
"30785","d49c69fbc131c3c2f47da26e79ae93e4",13,13,0,13,13,0,1,2
"30786","d49f47d7a4cc86a549ed34f3d56bcd75",18,18,0,18,0,18,1,2
"30787","d4a0aa06abdced1f3db7c1d63a6fd9e3",3,3,0,3,3,0,1,2
"30788","d4a1ab224f3a0dfce09314d890cf0d6d",95,69,32,20.78125,95,0,2,3
"30789","d4a37f68a87c64ee9dbb6364e03f2151",199,119,73,19.0821917808219,199,0,3,3
"30790","d4a3b72cab947914e802d8fa79ba0061",35,35,0,35,35,0,1,2
"30791","d4a4c78aa22dd908f64d392147a89006",177,93,59,21,177,0,3,3
"30792","d4aa30c2212a2ba0bd2f478f0140e2ee",28,28,0,28,28,0,1,2
"30793","d4aaccabf7bf7437b838389265cd191f",76,58,60,8.86666666666667,37,39,2,1
"30794","d4b21bfa4c530467ca6c939a635f4f8c",13,13,0,13,0,13,1,2
"30795","d4b37ba698289e928ef3b34d32a12b16",18,18,0,18,18,0,1,2
"30796","d4b81ff86c71d7daf0c7d5b9aa7957ca",56,43,26,15.0769230769231,42,14,2,1
"30797","d4b9e3a5bd22e70f1793e17a1aee587e",15,15,0,15,0,15,1,2
"30798","d4bbee1d1d0193d692f1aa986b5b2d50",31,31,0,31,31,0,1,2
"30799","d4bf0974e187a8c338a3484626cc34e1",31,31,0,31,0,31,1,2
"30800","d4c42b81eab377ddbdd5ddddbf1afe1f",84,68,66,8.90909090909091,49,35,2,1
"30801","d4c5441e58bc044068a44f5be4c0bb47",79,63,28,19.75,79,0,2,1
"30802","d4c579e8353416ec07fce2b994fb3748",16,11,8,14,16,0,1,2
"30803","d4c7edffbf15194b355c7156922f062b",35,35,0,35,35,0,1,2
"30804","d4c85d252e35331627aaeebf4ae80e70",62,53,30,14.4666666666667,62,0,2,1
"30805","d4c8ecab4f8664405c6fa8ef25896b14",95,78,56,11.875,95,0,2,3
"30806","d4cc23ab2c43e04f7264bc6f1906ccbf",16,12,46,2.43478260869565,16,0,2,1
"30807","d4cd53d0f66ab1aefa7f9f3766f1b64c",184,95,84,15.3333333333333,175,9,3,3
"30808","d4cde42b626c76b7195b7d50ea78a941",201,130,47,29.936170212766,201,0,3,3
"30809","d4ce93cc493de666668325c3119d8b8d",34,34,0,34,0,34,1,2
"30810","d4cfbf9c1d7a1df0165cdecf8e761451",16,16,0,16,16,0,1,2
"30811","d4d192dcd956b2e97e59d594d94b9536",20,20,0,20,20,0,1,2
"30812","d4d523e15248a95761bab148785a7efa",3,3,0,3,3,0,1,2
"30813","d4d52e9bff094586c7863f3ae2b19c36",17,16,14,8.5,17,0,1,1
"30814","d4d59930d68cb781a5eb89e21cf61183",81,53,80,7.0875,81,0,2,3
"30815","d4d8b0b71fbce2b9bd7f7c3090610727",117,66,53,15.4528301886792,117,0,3,3
"30816","d4e216293398286ca07cf72d63138886",25,25,0,25,25,0,1,2
"30817","d4e24676fcdf4bcec5b666621d9034c3",201,94,58,24.2586206896552,183,18,3,3
"30818","d4e33ec47d6c87522ca7fb4b04cda96c",41,41,0,41,0,41,1,2
"30819","d4e55f04f1667c8f31db843d41c1d891",214,104,78,19.2051282051282,186,28,3,3
"30820","d4e79ea13655a02354ce4c00f68bb092",57,43,56,7.125,57,0,2,1
"30821","d4e8c728f8d96aed4708ebb634567679",48,20,58,5.79310344827586,48,0,2,1
"30822","d4e93c67f6a1ad338d2f0f2b91dfbf6c",2,2,0,2,2,0,1,2
"30823","d4ea8e3aaaa760781dd0af4f7e1ff05b",36,31,19,13.2631578947368,14,22,1,1
"30824","d4ebfcbd0283069a2e481ef3863ff94d",196,87,77,17.8181818181818,196,0,3,3
"30825","d4ed0bcbc2c675aee7eae319a7f0edda",25,25,0,25,25,0,1,2
"30826","d4f3f0f910b8fcfdcea4442c8c7419e6",196,127,80,17.15,196,0,3,3
"30827","d4f56ae0a81b32a066310d4514351073",40,34,44,6.36363636363636,40,0,2,1
"30828","d4f72ce93fdb26483f86cca939a960f0",52,35,56,6.5,52,0,2,1
"30829","d4f85500d87da432c6eca22735e92787",31,31,0,31,31,0,1,2
"30830","d500ad59f55dfe69abf0f951003dfcd8",118,69,49,16.8571428571429,118,0,3,3
"30831","d50183995562a29dc1be1fb83eb6b00d",19,19,0,19,19,0,1,2
"30832","d50384cd6a79d45223d38f3d1d6b7164",100,57,61,11.4754098360656,100,0,2,3
"30833","d5061d658656bb4ccaab6b43fc4ea617",99,90,34,20.3823529411765,99,0,3,3
"30834","d50685c03889bbd81572c6713403e6ed",235,86,76,21.6447368421053,201,34,3,3
"30835","d507a6b3c8c11a71ed52540528b2a7d5",109,68,42,18.1666666666667,109,0,3,3
"30836","d507a71d19e74628d6dbc07a51871854",67,57,30,15.6333333333333,67,0,2,1
"30837","d50879a730f631b42598a6330b18597d",18,12,54,2.33333333333333,18,0,2,1
"30838","d5087c7b9c60a6eb4d277012ec66ba02",15,15,0,15,0,15,1,2
"30839","d508894dae73d379fa48c918d1a16000",96,53,55,12.2181818181818,96,0,2,3
"30840","d508a61d246263613065c4a06983f3c5",26,26,11,16.5454545454545,13,13,1,1
"30841","d50cdf2dfa1ff9eeee4d6eeb9c164e93",10,10,0,10,10,0,1,2
"30842","d50dfcff6079df18a7a45ea90262c7f2",44,40,21,14.6666666666667,44,0,2,1
"30843","d50ea80c5022b8f2dc248f4571de9f87",92,68,61,10.5573770491803,56,36,2,1
"30844","d50f560736611c6d9b67d8df6bcba8ee",54,54,0,54,54,0,1,2
"30845","d511a28992a8edc239b5be0b0416838b",21,21,0,21,21,0,1,2
"30846","d5121f00e571bd7f6cc25acc82eadbf3",75,46,61,8.60655737704918,37,38,2,1
"30847","d5135664243e94c3460cc0740a53c040",12,12,0,12,0,12,1,2
"30848","d515230848f0032fd71e4c7cead91b78",36,36,0,36,36,0,1,2
"30849","d515737c2aeecbb31c81b8b6f336bbab",22,22,44,3.5,22,0,2,1
"30850","d515e91ca42f8edd1a97392420e0d1fc",41,41,0,41,41,0,1,2
"30851","d518314041ac334cbb545c7c9d53039d",74,64,21,24.6666666666667,74,0,2,2
"30852","d51acbb3433001e5d2b31981be4e2171",72,65,81,6.22222222222222,72,0,2,3
"30853","d51c4b946026fd5b091726ca44c23f75",24,20,57,2.94736842105263,24,0,2,1
"30854","d52243e93b62d7d78c702d0aa1907802",20,20,0,20,20,0,1,2
"30855","d5263ecadc56c8512e5466e39f2268db",135,93,87,10.8620689655172,135,0,3,3
"30856","d52807a716915472fe430df631bb4426",56,51,56,7,56,0,2,1
"30857","d52c5b4c31291a16ac0c639f550a85f1",21,21,0,21,0,21,1,2
"30858","d530c235170b1284936c2459cd88ce34",122,80,61,14,93,29,3,1
"30859","d5344585cef8a7502762d9487584e6f2",1,1,0,1,1,0,1,2
"30860","d5344c99b982838770032874766a3376",110,79,71,10.8450704225352,84,26,3,1
"30861","d536ad4de1d8ff79b5819c43f0dad2dd",24,22,15,11.2,24,0,1,1
"30862","d5397f93ad5e12bafa55e1de8d8cf6c9",29,29,0,29,0,29,1,2
"30863","d53da382cd2c2d7bddb93ff939b07f72",17,17,0,17,17,0,1,2
"30864","d53ed085e9d6701f9ae84f23df43c7a1",196,116,65,21.1076923076923,196,0,3,3
"30865","d540924931bc01c9707bf05b26fca3ac",32,32,0,32,32,0,1,2
"30866","d5425db4099ec6cb01d5130987cfa0f2",24,24,0,24,24,0,1,2
"30867","d543f825020b4ce143d2fd75c8a814ca",96,55,78,8.61538461538461,78,18,2,1
"30868","d5444d96bfe0ce2bf5b425e8f3f6fd29",36,28,28,9,36,0,2,1
"30869","d5449084e64eeabc3d2462374760d0f3",26,26,0,26,0,26,1,2
"30870","d545571062a79107029f38bbb8ebc450",44,35,35,8.8,44,0,2,1
"30871","d546aeae42cf93ba59c867ced795b5d1",51,51,0,51,51,0,1,2
"30872","d5473a4ac4727946ae16edc2a8eabcac",219,105,81,18.9259259259259,219,0,3,3
"30873","d54a8175dd311d73b399d657a80ab023",49,49,0,49,0,49,1,2
"30874","d54c8289918e66b5c51b7fefe5f0c6eb",24,24,0,24,0,24,1,2
"30875","d54e7de8ed9175548bc1a483ae808055",53,53,0,53,53,0,1,2
"30876","d54fa70049f319dbf0e12f35369bd3c8",27,26,12,15.75,27,0,1,1
"30877","d5522f73b2d727b86dfc1364f5bb85e6",174,83,70,17.4,174,0,3,3
"30878","d552bf55d5eb7bc6ca9f16366fe142c9",44,31,32,9.625,44,0,2,1
"30879","d55336ed0ab3da52da5926ddb46e55c8",23,23,0,23,23,0,1,2
"30880","d553dcb1a1b6ef03dac69f4f6acfb9e2",54,42,29,13.0344827586207,23,31,2,1
"30881","d55427f96d172b552258878864871122",23,15,16,10.0625,23,0,1,1
"30882","d55645db3ffa98f393771845c8526912",117,71,40,20.475,78,39,3,3
"30883","d556baccf1be5d789cadd88b8a7903b7",223,113,59,26.4576271186441,198,25,3,3
"30884","d556bbfe4b8e3864739f29dfb890d74e",60,46,17,24.7058823529412,60,0,1,1
"30885","d5576807e31194c23ddb2dc698021a5c",41,41,0,41,41,0,1,2
"30886","d5588cfbcc2ba83dec3dfecb3f2db4fe",32,32,0,32,0,32,1,2
"30887","d55b4cb44a3cedb4d424622bee4c602e",28,28,0,28,0,28,1,2
"30888","d55c3ae2d1c13c202016feedf0b85966",45,39,21,15,45,0,2,1
"30889","d55f592d8fc4a418716763583c1c1e30",10,10,0,10,10,0,1,2
"30890","d5602ea57cbf945776bd924b7b33b6a8",179,81,87,14.4022988505747,156,23,3,3
"30891","d562c99416f0869ad7eb34c0f4314e50",36,32,44,5.72727272727273,36,0,2,1
"30892","d563f7668018b0387ffa32478771791e",27,27,0,27,27,0,1,2
"30893","d56461afa6e60a4e20085909b9282b81",218,68,84,18.1666666666667,218,0,3,3
"30894","d56500ddbf9aebb4e4a5e052d1779b39",68,61,24,19.8333333333333,35,33,2,1
"30895","d56827a3ae87dac8277fce400522ae72",75,66,29,18.1034482758621,33,42,2,3
"30896","d56d66cdbb8316c09ac2cd0bb9c43c0c",70,60,20,24.5,70,0,1,2
"30897","d56d815141a4b678a0b1aa9151b1eb1c",30,30,0,30,30,0,1,2
"30898","d56e5095db8ee4a76dbe71ba051244db",73,59,14,36.5,73,0,1,2
"30899","d57063a57988fd0f6c00e1fef44783ab",90,78,41,15.3658536585366,49,41,2,3
"30900","d5709d57c0807d4b630706d04b132939",46,38,66,4.87878787878788,14,32,2,1
"30901","d571adb51b62c78c0da3084f592c672f",81,70,75,7.56,81,0,2,3
"30902","d572231ebcb8d5c98c8f953421b5cb1c",2,2,0,2,2,0,1,2
"30903","d5732dc7245faceaf5ea5611ea28b7b7",103,50,63,11.4444444444444,103,0,2,3
"30904","d573aa7ee804a803e737dc2d238f92f7",57,53,52,7.67307692307692,57,0,2,1
"30905","d5755f4e38c663f9820f1a71f59b0f18",123,97,31,27.7741935483871,123,0,3,3
"30906","d5770d07efb104a8fa828b5e16364607",52,43,29,12.551724137931,52,0,2,1
"30907","d579273fa793a72c23a1cd9b17c44b84",23,23,0,23,23,0,1,2
"30908","d5793c4514acca9be9b8fbd7e9be5a26",25,25,0,25,25,0,1,2
"30909","d57aa6ae6625f9629c6b070357ca8773",75,37,68,7.72058823529412,54,21,2,1
"30910","d57aec63536a6a66f572dbe558c1e42f",18,18,0,18,0,18,1,2
"30911","d57b35969ad515624929f75f7dc3cb7f",12,12,0,12,12,0,1,2
"30912","d57df7a5403c4107b81d0efc2d6698f5",71,54,58,8.56896551724138,70,1,2,3
"30913","d57efd64a1b44e607156269567356589",12,12,0,12,12,0,1,2
"30914","d586c37a51f6ffb676a2ce4d404a77c3",7,7,0,7,7,0,1,2
"30915","d58818975c5b619b28e34f29496a4709",71,54,43,11.5581395348837,71,0,2,3
"30916","d5883da97c433df6e0c98014c196f643",35,35,0,35,35,0,1,2
"30917","d588ba064c0cfed13811ad7055dcd703",27,27,0,27,27,0,1,2
"30918","d588bcb6d7ee73637916658e0a94f6ac",21,19,54,2.72222222222222,16,5,2,1
"30919","d58b09db8cb2fba776dad3033d41e70c",172,94,74,16.2702702702703,172,0,3,3
"30920","d58f328962a77dba96eb77826a8f0dbd",154,97,76,14.1842105263158,154,0,3,3
"30921","d5910cacfd0d827aec6852d438f9856b",11,11,0,11,0,11,1,2
"30922","d591df82746be7a9c6dd27387bff81e4",201,96,83,16.9518072289157,153,48,3,3
"30923","d592b683f1edf5ddf1071a8ce1dafd7e",20,20,0,20,20,0,1,2
"30924","d59b97789bf31543d3eae89e1d13c267",55,55,0,55,55,0,1,2
"30925","d59c0581b6c652c93b237e0f6db29afb",18,18,0,18,18,0,1,2
"30926","d5a2fa254ee91b8fb385f04dd180bf4c",99,78,89,7.78651685393258,99,0,3,3
"30927","d5a42cf2afa7bf806702f01233514fb8",6,6,0,6,6,0,1,2
"30928","d5a9290942a948330fde2f60bb702b50",93,67,31,21,93,0,2,3
"30929","d5aa055690616646eedca547285a0402",54,54,0,54,54,0,1,2
"30930","d5aa16c9a58c824e87bc8a9090c8ae5d",135,98,44,21.4772727272727,98,37,3,3
"30931","d5aa4a0ef7a020310351f3e0e1c0038c",67,48,38,12.3421052631579,67,0,2,1
"30932","d5aa5bb805b13dfd95ee7f6ec8b4a47c",22,22,0,22,22,0,1,2
"30933","d5ac123b723b6e905149e52ec785c8a6",37,32,34,7.61764705882353,37,0,2,1
"30934","d5adc3b46103f88e7ceff66d2dbe8366",75,63,21,25,75,0,2,2
"30935","d5ae342b1a6eef8e7dc5bfd030de910a",32,32,0,32,32,0,1,2
"30936","d5b007557af5a9e7f9cd9282bc9e86a9",102,73,37,19.2972972972973,77,25,3,1
"30937","d5b037d2f839abc3228024f218596e8f",11,6,61,1.26229508196721,11,0,2,1
"30938","d5b22f05dfb7519ac852dbbaeda308c6",4,4,0,4,4,0,1,2
"30939","d5b7e705b49214ce4eed7b4c1d044cc6",11,11,0,11,11,0,1,2
"30940","d5bde002a4fc122fd5e5afa9b0995b28",25,25,0,25,25,0,1,2
"30941","d5bed7900ac7ccae1459cb16d3db7174",25,25,0,25,25,0,1,2
"30942","d5c325fabf9dd34d5b8de00a2b848198",205,100,79,18.1645569620253,156,49,3,3
"30943","d5c3d0865fde93cb99181bb3ee7d8f84",11,8,55,1.4,11,0,2,1
"30944","d5c3f5cf28a327022201db8c74b0fb69",19,19,0,19,19,0,1,2
"30945","d5c4538355267644ced78bd940282794",44,37,69,4.46376811594203,44,0,2,1
"30946","d5c5ea12b85be81b61ed161a3a73988c",219,92,70,21.9,219,0,3,3
"30947","d5c643611823c9a1e1778894d3b25325",63,40,42,10.5,63,0,2,1
"30948","d5c66be9d34719445528743dc325876a",47,43,29,11.3448275862069,47,0,2,1
"30949","d5c674542a04c60cca8d6f6fadd05c9b",201,76,80,17.5875,201,0,3,3
"30950","d5c73890a2c7210a99b912fb6dd89d9e",12,12,0,12,12,0,1,2
"30951","d5c8fc84be43abb8328888e19bbc36d9",88,58,41,15.0243902439024,88,0,2,3
"30952","d5ca2c545ce435580b58bce08f378912",46,46,0,46,46,0,1,2
"30953","d5caa7fc94f5df40cc13653547039ed6",134,43,83,11.3012048192771,134,0,3,3
"30954","d5cafbe21843ee3eb307f37fea3d3f59",88,45,68,9.05882352941177,88,0,2,3
"30955","d5cb1c3b18b672592c56ef314e965e9d",16,16,0,16,0,16,1,2
"30956","d5cd2ac71d75fead67434ff8b9e47438",15,15,0,15,15,0,1,2
"30957","d5ce76ed46b34207cd4bbbe221274ba5",47,47,0,47,47,0,1,2
"30958","d5d0509bd748203a8cab5b27fb65be5e",31,31,0,31,31,0,1,2
"30959","d5d0b3d1eb6bdaadb8968391eaa14c9d",22,22,0,22,22,0,1,2
"30960","d5d101f397f9cf5e343a5ed3ac13b714",29,29,0,29,29,0,1,2
"30961","d5d32a33ee2ccb92b9c79188e8244b07",88,68,46,13.3913043478261,64,24,2,1
"30962","d5d39d02e786f054cfbff84df04fdac1",18,18,0,18,18,0,1,2
"30963","d5d960abcbb6b884c52397a56a76a49e",75,57,75,7,75,0,2,3
"30964","d5daaf4866afb484993e191a75c6295a",45,45,0,45,45,0,1,2
"30965","d5db4c68c33c13d6cc3f5e6818affee6",146,86,63,16.2222222222222,91,55,3,3
"30966","d5df82ab83a93731dc92ef6ca836f89d",98,80,21,32.6666666666667,98,0,3,3
"30967","d5e424bc0283270103520a86fbb1d358",33,33,0,33,33,0,1,2
"30968","d5e4264693378be934325ecfb7d83bf8",46,46,0,46,46,0,1,2
"30969","d5e72978c8967e4ffbeab12bf6b08fd2",70,53,24,20.4166666666667,70,0,2,1
"30970","d5e770443d450dbe0bae559fd7d30ca4",34,34,0,34,34,0,1,2
"30971","d5e89173732508bc8a3fd9cf799ff042",95,76,83,8.01204819277108,95,0,2,3
"30972","d5e8f63098855fb9a387373d04091a86",174,89,60,20.3,174,0,3,3
"30973","d5edc2b3d22b1e376300407f0ccc1acf",165,111,61,18.9344262295082,165,0,3,3
"30974","d5efc3f46e51df372dcf745e6055a928",18,18,0,18,18,0,1,2
"30975","d5f56794118a36a161898fe470794f8f",24,24,0,24,0,24,1,2
"30976","d5f8fa3de8299aea97dfc7b0f15e7768",16,16,0,16,16,0,1,2
"30977","d5f9976807ebad9b8e8d6dfbabd066c4",61,58,8,53.375,61,0,1,2
"30978","d5fcf803aa62b688a75c39a3ba381100",122,82,41,20.8292682926829,122,0,3,3
"30979","d5ffd3737c20d686c70954a26dc2049e",21,21,0,21,21,0,1,2
"30980","d601a6d66612abf74700056a4eb0c3c8",95,60,72,9.23611111111111,95,0,2,3
"30981","d604669f0ca25a529312731984425c6d",211,99,57,25.9122807017544,211,0,3,3
"30982","d605e92aebfb466dd1b1230e70c7668f",41,41,0,41,41,0,1,2
"30983","d60a4796e2a7dd5bfc268deb89cf8180",71,61,41,12.1219512195122,71,0,2,3
"30984","d60a7a38ea7d322a27e112c9e75ac247",38,38,0,38,0,38,1,2
"30985","d60b06c6393e5e5b27e2f48385ced578",15,15,0,15,15,0,1,2
"30986","d60ce0a61f55b55ae8acf8912e70aa32",54,22,75,5.04,54,0,2,1
"30987","d60ec5ad28588c6731ebb371f4ecfde2",50,45,7,50,50,0,1,2
"30988","d6106363fa246765d80f182fd6ab3592",23,23,0,23,23,0,1,2
"30989","d610b18f49d6428ee68fd6655a999d7c",13,13,0,13,13,0,1,2
"30990","d6127b02edbb509470296ed455b570c9",121,53,56,15.125,75,46,3,3
"30991","d61791c736fd5c61bedecadee59de372",12,11,2,42,12,0,1,2
"30992","d6192214ee8f93c9311cf8eabbaa9423",54,44,78,4.84615384615385,54,0,2,1
"30993","d6197429243c0c35fc8c16b7d1078e3f",22,15,20,7.7,22,0,1,1
"30994","d61a4d6446d85e8aae2123d8b1ae96b8",18,18,0,18,18,0,1,2
"30995","d61cd4b92f14686b85693f84b3ef01c9",36,36,0,36,36,0,1,2
"30996","d61d1e9d6dcffccd0018403ac42cd438",12,12,0,12,0,12,1,2
"30997","d61db578691544d7fd7a0d1e9e43b323",12,12,0,12,12,0,1,2
"30998","d61e959138e0b33d105707cdd2802c8e",13,12,3,30.3333333333333,13,0,1,2
"30999","d61fddac72892297aee958d869245afd",63,32,60,7.35,42,21,2,1
"31000","d620d1648dc02af642b65ce1ba1bb476",134,60,65,14.4307692307692,114,20,3,1
"31001","d620fafca0b487c700122f16d2da38f9",21,21,0,21,21,0,1,2
"31002","d621b85a9f2528171c25c1a717b6cdbe",60,47,31,13.5483870967742,32,28,2,1
"31003","d62a6e3f61fd691499c3b1607548c790",135,103,59,16.0169491525424,135,0,3,3
"31004","d62ace115b125c5d75e8dfbafd8ee480",19,19,0,19,19,0,1,2
"31005","d62b222ccf35f971fb66e9d2f591e981",64,57,46,9.73913043478261,64,0,2,3
"31006","d62bc0d8a599e8bdbc58f4556e324f8c",43,25,84,3.58333333333333,32,11,2,1
"31007","d6304080db41aca07ea1f9ac487bfc34",64,46,40,11.2,64,0,2,1
"31008","d63178a5d7b1c1f6bb4c3e9457a83b99",114,33,62,12.8709677419355,88,26,2,1
"31009","d631aa21f444d8133edddfa73a9ffc39",71,64,77,6.45454545454545,71,0,2,3
"31010","d63501c75a05245977d2b46ed4f4af92",35,35,0,35,35,0,1,2
"31011","d63744f15e5dbf4567617826e1fe814a",20,20,0,20,0,20,1,2
"31012","d63a0ba41eba5fa2992f238a61f2bc9c",93,74,58,11.2241379310345,93,0,2,3
"31013","d63c1a97e54784a85b91f7daf9eeb87d",42,42,0,42,42,0,1,2
"31014","d63cd0e5bb6b75b5e4abf80580d27c71",32,32,0,32,32,0,1,2
"31015","d63dad8beb7cabe7d79408ecf4cc25a7",26,26,0,26,26,0,1,2
"31016","d641e06d8a77969f8e55253beb72b87e",202,138,77,18.3636363636364,164,38,3,3
"31017","d64e9e8290fb182cd4592f18ea6030c1",30,30,0,30,0,30,1,2
"31018","d64f4df5b8317a5d8f7682e965fff7ac",80,60,74,7.56756756756757,53,27,2,1
"31019","d650d6326eb509604a72a4380c55ab35",14,14,0,14,14,0,1,2
"31020","d651a06c7010e412576b03d054c531a7",186,127,73,17.8356164383562,157,29,3,3
"31021","d65451406fab58faceade7091eb103ba",23,11,62,2.59677419354839,19,4,2,1
"31022","d65da6c35ae2171b5b1f093fc8e74466",32,23,58,3.86206896551724,32,0,2,1
"31023","d660e00500dbe74c9220407c9d9f5fc0",13,13,0,13,13,0,1,2
"31024","d6625e7c85dd1542c2a938b399bc368c",41,41,0,41,0,41,1,2
"31025","d664b43edd1799aed55ad47284106e17",8,6,42,1.33333333333333,8,0,2,1
"31026","d666f7a34fe65d7cc148ba755bee8c56",90,52,66,9.54545454545454,90,0,2,3
"31027","d66898c420faa61b7e82f30f7936d439",53,53,0,53,53,0,1,2
"31028","d668b77ba197bb26093c75c23dd28e0e",38,38,0,38,38,0,1,2
"31029","d6694f48de6cd9a844e4a3a8c44c9244",46,31,20,16.1,46,0,1,1
"31030","d669d9becb99d7b3f97ab43c47dce4e0",105,65,56,13.125,105,0,3,3
"31031","d66a6a5264b5f84bf8b955839e3190e3",107,64,62,12.0806451612903,107,0,3,3
"31032","d66b54c1d242b823878cd6e92bb45157",60,39,35,12,60,0,2,1
"31033","d66b7d5ebaae4ce1bfccbeafbf973961",106,95,64,11.59375,106,0,3,3
"31034","d66bba6d6c68f9baf64b449aecab1660",120,87,43,19.5348837209302,80,40,3,3
"31035","d66c36d40d74c3f670e6ec96c4d088aa",60,47,36,11.6666666666667,60,0,2,1
"31036","d66c4df5138a9c3091ad58c617c7e4e7",19,15,47,2.82978723404255,19,0,2,1
"31037","d66cf43eeb89ec553f00b713f82c32b1",76,64,19,28,76,0,1,2
"31038","d66dfe18ced7aed15ef8cde2c229b49b",24,24,0,24,24,0,1,2
"31039","d66ec7fc2d85e2992e92bf684201f65a",39,39,0,39,39,0,1,2
"31040","d66fc72db8366abbe59365fe01a96f88",86,61,69,8.72463768115942,65,21,2,1
"31041","d6701e59210d77b5be8c75743222887e",69,62,64,7.546875,69,0,2,3
"31042","d670d10c938168845fdc7987091040b7",20,20,0,20,20,0,1,2
"31043","d67266a49365a0a73b8f2e23f29831bf",16,16,0,16,16,0,1,2
"31044","d673f8383501de658475253f55adc0f5",108,87,63,12,108,0,3,3
"31045","d674b4275a2545ed4a007f77e59fe2d9",12,12,0,12,12,0,1,2
"31046","d674d0d62744832bf151ad038ffe95b6",88,74,39,15.7948717948718,63,25,2,1
"31047","d67a65ebea49ca89d5d62066338627e2",16,16,0,16,16,0,1,2
"31048","d67bfddf33d9b18fd2d3b0d1abb8ff24",181,108,83,15.2650602409639,181,0,3,3
"31049","d67cef4636e3cc189139a032fa8161e6",30,30,0,30,30,0,1,2
"31050","d67d7ae8602feb069e2b2919b3331819",54,54,0,54,54,0,1,2
"31051","d680507271d728d506cb81bd71954e73",71,52,32,15.53125,71,0,2,1
"31052","d68433df72d77a35c8c0c731dcfe75a7",56,44,51,7.68627450980392,56,0,2,1
"31053","d6876d754a79459edddc6c8027cd1ed5",61,60,9,47.4444444444444,61,0,1,2
"31054","d68799b485f5016d112643a9a8767cf4",168,74,82,14.3414634146341,141,27,3,3
"31055","d68833b9ad067cf60533d292e5b8daca",114,74,62,12.8709677419355,114,0,3,3
"31056","d68aa4504b9d554347cbe48daafe5776",36,36,0,36,0,36,1,2
"31057","d68ad444ba99da2b9f6a877cb61bbbf0",57,22,55,7.25454545454545,57,0,2,1
"31058","d68caa1963919fe7985642db2352c050",244,108,84,20.3333333333333,198,46,3,3
"31059","d68d38eca8e971f8ce79b35ba64b51a7",11,11,0,11,0,11,1,2
"31060","d68df9bd0c5f742fd9fd336b447a64d4",69,46,66,7.31818181818182,69,0,2,3
"31061","d68f35ac71e387b9a894d1d034b48227",34,34,0,34,34,0,1,2
"31062","d68fda571eba7b58216c46b67b8b6955",199,77,63,22.1111111111111,199,0,3,3
"31063","d6957c6f73ac33b5a87fabf76c81ca2d",28,12,40,4.9,18,10,2,1
"31064","d695a6ccbb8aaecc182c298fbd72f22d",30,30,0,30,30,0,1,2
"31065","d69ac2895fa571179734a91e32cc449e",148,110,81,12.7901234567901,123,25,3,3
"31066","d69b3d06863d302a3414485cc2d56201",80,58,53,10.5660377358491,80,0,2,3
"31067","d69b438c86adc09259e29d46052724db",85,65,67,8.88059701492537,85,0,2,3
"31068","d6a18d1ac3f3797d1e9929fdf54996a9",12,12,0,12,0,12,1,2
"31069","d6a4fbd0e75c159e13694fa7f4a4eda3",51,27,54,6.61111111111111,36,15,2,1
"31070","d6a6250d87a05332ec80a8132e34fb7e",12,12,40,2.1,9,3,2,1
"31071","d6a6df6a15ac1cea14d5ea98be3f10c1",71,55,54,9.2037037037037,71,0,2,3
"31072","d6a825984ca6e5206b19b10c3185b6e4",38,38,0,38,38,0,1,2
"31073","d6aa438d340a715a38845a03fa9f2f65",206,114,55,26.2181818181818,206,0,3,3
"31074","d6adb5c2aa675decb77d6a5b72d19241",16,16,0,16,0,16,1,2
"31075","d6ae4ae3ddfa5f4d4813016639ddb450",190,106,62,21.4516129032258,190,0,3,3
"31076","d6b00bc8606562a4d4d5b1bbad2b9518",52,37,59,6.16949152542373,32,20,2,1
"31077","d6b23af31502d212026676e80920288d",48,41,42,8,48,0,2,1
"31078","d6b25cccefe2d45010a74a7734378d44",32,32,0,32,32,0,1,2
"31079","d6b35dc7746f5f72c663bd5f93d2b905",24,16,60,2.8,24,0,2,1
"31080","d6b3a3937e136913f367b3e53090b31c",45,45,0,45,45,0,1,2
"31081","d6b3bd5c5eaeeeb4311423e8444c0e52",79,68,79,7,79,0,2,3
"31082","d6b5b36a8ba999de15ee09f73b8eb270",55,55,0,55,55,0,1,2
"31083","d6b5cc05f8562a8c25a21c8625a6e228",148,51,76,13.6315789473684,148,0,3,3
"31084","d6b81b306e86b8e42075255c0d946a03",101,60,39,18.1282051282051,101,0,2,3
"31085","d6b89102355e794ef9ed9c2f54996030",55,37,47,8.19148936170213,55,0,2,1
"31086","d6b8c0e6956e8834af4075683ce685d6",113,69,69,11.463768115942,113,0,3,3
"31087","d6b9ef50a36f4be3cfa1007ff4b37cce",105,61,68,10.8088235294118,64,41,2,3
"31088","d6be38eed9f387d3a6ab654dbe3b56ca",29,29,0,29,29,0,1,2
"31089","d6beef0f4e4a2624fc9afb4bb5148fe0",228,72,61,26.1639344262295,210,18,3,3
"31090","d6c38f10e9511b8f000aa160d92f755d",93,60,52,12.5192307692308,93,0,2,3
"31091","d6c7a909207eb1de8fb04dfd4b08d626",101,85,87,8.1264367816092,58,43,3,3
"31092","d6c8884574c7697dfdf3d167e8ac5226",34,34,0,34,34,0,1,2
"31093","d6c97dffc72c229d69fc2be89267053d",112,74,30,26.1333333333333,76,36,3,3
"31094","d6cbc000f8ee1131f1ee3a6ad784e8a6",79,60,85,6.50588235294118,64,15,2,1
"31095","d6cd1a0ba5d8b62b14aa66d016ffdf3b",57,45,34,11.7352941176471,57,0,2,1
"31096","d6cef0fb78cdb3d9324fa972b8e0994a",50,44,35,10,0,50,2,1
"31097","d6cf2dea848b1b3bb6ca8ed5b2ef447c",118,76,74,11.1621621621622,70,48,3,3
"31098","d6d0fb41c7e887afff7711bb1777d1ed",18,18,0,18,0,18,1,2
"31099","d6d2024a1d9dbbdc5e02e0f2f6d51683",35,30,14,17.5,35,0,1,1
"31100","d6d276cb1d2ef991655b1e30c94d2701",42,39,27,10.8888888888889,42,0,2,1
"31101","d6d41499ddcf50592e2ebdcfd460d4f4",3,3,0,3,3,0,1,2
"31102","d6d7b23aa5f852617593a4bd55dd57ec",89,76,17,36.6470588235294,89,0,1,2
"31103","d6d7dfe869179e5bd93eba51bc8f335e",157,123,66,16.6515151515152,106,51,3,3
"31104","d6dac323a0a6f45db200adfb937d843a",23,23,0,23,0,23,1,2
"31105","d6dcd019fe3c884a22f3aa84eb68f715",110,72,68,11.3235294117647,110,0,3,3
"31106","d6dd4f378840971038b5170a6dd4aedc",46,46,0,46,46,0,1,2
"31107","d6df9c55de8c0f0b61a849b2b0cc1e30",27,27,0,27,0,27,1,2
"31108","d6e3f33ff7df564291974b8654bd0eeb",35,35,0,35,35,0,1,2
"31109","d6e78263f3a1fc109b7af7834dadb50f",152,85,60,17.7333333333333,99,53,3,3
"31110","d6e849a1802a7e83c505b52153075183",57,48,48,8.3125,57,0,2,1
"31111","d6e9373bc9ee9ad208cdc86adf282843",35,35,0,35,35,0,1,2
"31112","d6ea4da2869604f434c2ff54ea81bb88",65,47,68,6.69117647058824,65,0,2,1
"31113","d6f0a7b036655a4631346a9fd352f19b",73,61,77,6.63636363636364,73,0,2,3
"31114","d6f5d7d01005c44a405bdb82b27d2b82",32,32,0,32,32,0,1,2
"31115","d6fc6a14db0c7fc3ce85ad52554f86c2",49,49,0,49,49,0,1,2
"31116","d6fe0d8040f82c9169d83e36fecdb84b",153,88,43,24.906976744186,153,0,3,3
"31117","d7006a3e18e11a440170edcdbf6bd2d9",158,87,44,25.1363636363636,128,30,3,3
"31118","d701b92343f7817d5b90ae0028861950",53,46,62,5.98387096774194,53,0,2,1
"31119","d70238db1387e76be9354daecda368dd",114,56,78,10.2307692307692,93,21,2,1
"31120","d704cb84cb4ecf2ad9ecf6bb223e1eb3",186,123,77,16.9090909090909,186,0,3,3
"31121","d7050d7aad8d623c37ba59eccf04e6e6",49,49,0,49,49,0,1,2
"31122","d7073b6e54e5d0e3ebe151208e753b61",55,48,13,29.6153846153846,17,38,1,1
"31123","d7084fba2ea2b0acb25880d4bfebdbe5",61,48,19,22.4736842105263,61,0,1,1
"31124","d708ac0a58ecf6ee7129fa9c6bdd194f",41,41,0,41,41,0,1,2
"31125","d70a2ac59d5d2711fd581c52c99301eb",32,32,0,32,32,0,1,2
"31126","d70a32d7ed2d7e2017d83b8cf4ffe663",74,54,63,8.22222222222222,74,0,2,3
"31127","d70ac9ce999ea69de710e59c3b0ff1b1",124,71,38,22.8421052631579,88,36,3,3
"31128","d70b94222230e692f05ba52bc4a507c0",2,2,0,2,2,0,1,2
"31129","d710ca9cadb5bb3ee2334f389f14ec57",43,41,33,9.12121212121212,43,0,2,1
"31130","d714d28407e3be62ffaf605e4c22f2fe",35,35,0,35,35,0,1,2
"31131","d71537265e72848619090ecb8bf451af",12,12,0,12,12,0,1,2
"31132","d717b3589059da8c637af07ed9e0618d",20,18,39,3.58974358974359,20,0,2,1
"31133","d719282a12341f9e11a50b97c94611f3",35,35,0,35,35,0,1,2
"31134","d71b10eee35bd15ea3dbbf94e4578abf",41,41,0,41,41,0,1,2
"31135","d71d12a00fdcf3bd055ba5eb6ee944ee",22,22,0,22,22,0,1,2
"31136","d71ddfd16affca305cb197e795b16566",157,88,76,14.4605263157895,157,0,3,3
"31137","d71eab0520a241b5c5f9a82a1e566234",16,16,0,16,0,16,1,2
"31138","d721ebeedb338aff349cf6660aab6f23",22,22,0,22,22,0,1,2
"31139","d723bb2220777837576ae56a63040ba1",37,37,0,37,37,0,1,2
"31140","d723fc2caa8b071b490b9e6ee18a551a",6,6,0,6,6,0,1,2
"31141","d7256963d4923df251e87b730e1a87cb",11,11,0,11,11,0,1,2
"31142","d726f80bf9a5ff5281055100948bfb91",56,48,20,19.6,56,0,1,1
"31143","d72720ebc65747fc91c5dfc501b77442",9,9,0,9,9,0,1,2
"31144","d7285772f919199b2ef295b8cc4d7b72",46,32,15,21.4666666666667,46,0,1,1
"31145","d72b7b5bf8c9d63fc3fed9795599b3bc",36,36,0,36,36,0,1,2
"31146","d72d165efa4e2528fc401802e6326bf9",4,4,0,4,4,0,1,2
"31147","d72dcc846e64caba28e883825e36b8ca",28,28,0,28,28,0,1,2
"31148","d72ddb07d4be0aad5ff68e10a4e1ccf3",19,19,0,19,19,0,1,2
"31149","d732b0a0d6a244c5d711689610cbe3d1",40,40,0,40,40,0,1,2
"31150","d736b150690e4987dfe3331f996d8108",36,28,58,4.3448275862069,36,0,2,1
"31151","d73750107bb74d5d4134a3f67c3e4854",28,28,23,8.52173913043478,13,15,2,1
"31152","d73ccdae80c4597c4bbe45057263547b",88,66,62,9.93548387096774,88,0,2,3
"31153","d7410dd79991b3bdbf913ae3f0d4f224",9,9,0,9,9,0,1,2
"31154","d741decb46ffbad513f9719c91165cda",35,35,0,35,35,0,1,2
"31155","d742210801c0fb18dbde112e112f017b",17,17,0,17,17,0,1,2
"31156","d744c6a55ecbdb1956db65422bcafc7b",29,29,0,29,29,0,1,2
"31157","d749bad3186be95e729ff0ca51c2f6e0",7,7,0,7,7,0,1,2
"31158","d74a1a9cfe4aa2cfbac1c6838ae43b8f",25,18,39,4.48717948717949,25,0,2,1
"31159","d74bbfb463e31dfd3feefff9e88abf90",55,43,32,12.03125,30,25,2,1
"31160","d74e232ca4922ec1003bd9c2bdfbd234",153,89,70,15.3,153,0,3,3
"31161","d75158f7ebab53a9976c957085c8ae21",79,43,68,8.13235294117647,54,25,2,1
"31162","d75b33d1e65382849d8c48a74859ad7c",11,11,0,11,11,0,1,2
"31163","d75cf30a7163240d1288e0026418f4b6",14,14,0,14,14,0,1,2
"31164","d75f48667502c60479250a8dbdf5dbb7",54,39,39,9.69230769230769,54,0,2,1
"31165","d761e399d5b6fb2be7f4231f54619bff",21,21,0,21,21,0,1,2
"31166","d762476087eebe171f2680462dde5fb0",25,22,31,5.64516129032258,25,0,2,1
"31167","d76484e6b2f74b46b8ad1eebcb1fb075",53,53,0,53,53,0,1,2
"31168","d76586473971bce9bc3289752cc6115e",61,53,14,30.5,61,0,1,2
"31169","d765dda313307f94716926bb63770c10",15,15,0,15,15,0,1,2
"31170","d76638d9a06990f6f48f57283be82fce",127,82,70,12.7,96,31,3,1
"31171","d7674f3c69703ac348ac66ad680e6903",13,13,0,13,0,13,1,2
"31172","d76838a3bd28709907eaf0e554760da0",130,76,56,16.25,130,0,3,3
"31173","d76ea1af00a1532499d3c07efd4dff3e",1,1,0,1,1,0,1,2
"31174","d76ef4028f0109bdf483af3096b819c4",41,41,0,41,41,0,1,2
"31175","d770c36826472fe5d901a11b34f37fff",156,102,68,16.0588235294118,156,0,3,3
"31176","d774e14085dd9fcb81dbcb91fbcb1843",151,108,77,13.7272727272727,151,0,3,3
"31177","d777caf3db5f330652c122d50bd410da",213,118,63,23.6666666666667,213,0,3,3
"31178","d779817580cc4a98dbe87c751990aea7",204,126,72,19.8333333333333,167,37,3,3
"31179","d78294d90f86262656650ae558ed6df9",209,75,90,16.2555555555556,209,0,3,3
"31180","d782f0f0775cf7dfea5cfd9c104f7254",9,7,3,21,2,7,1,2
"31181","d7851d449ce5f51cecb0778e5941f5c2",44,42,23,13.3913043478261,44,0,2,1
"31182","d786b6d34cf44e44db68feee8d29dd2e",22,21,3,51.3333333333333,22,0,1,2
"31183","d7887520442ceccdb975458ff6fd361d",18,18,0,18,18,0,1,2
"31184","d789f392eaf3b9497f3e4cca73ea7b91",39,39,0,39,39,0,1,2
"31185","d78ab3d11f36f8b872710c3f1bde7b1b",31,31,0,31,31,0,1,2
"31186","d78f3d622deeedf72d037de5cbfa16ca",40,40,0,40,40,0,1,2
"31187","d792989e78a5ce0b101e845a58a79d25",35,35,0,35,35,0,1,2
"31188","d793a4c24921c0a095003283f27fa3c9",19,12,15,8.86666666666667,10,9,1,1
"31189","d79411976d4f4b6745d0d4cc75a345c1",74,35,64,8.09375,74,0,2,3
"31190","d794c629c424aada0e432f4cfc234fb7",40,29,74,3.78378378378378,40,0,2,1
"31191","d79818bc703c9ee3a7238f87d5d9f5c3",57,47,61,6.54098360655738,57,0,2,1
"31192","d798297e155d8db7816f326712f325d0",59,54,8,51.625,59,0,1,2
"31193","d799c6b3df381dcc873950629b86dec8",24,17,62,2.70967741935484,24,0,2,1
"31194","d79ab45087a4f99419e238ddaafa7167",117,83,66,12.4090909090909,69,48,3,3
"31195","d79eb789330676e4f6bd0ed2631339dd",124,66,78,11.1282051282051,124,0,3,3
"31196","d7a1af4e630a022654165522ec35bd22",57,50,47,8.48936170212766,57,0,2,1
"31197","d7a3087274982fe5c3078a7a2e7a5879",4,3,28,1,4,0,2,1
"31198","d7a4135c4bcfb3404dd7aa0950d0c8a5",30,30,0,30,0,30,1,2
"31199","d7a5c8946c0feeaa6fd1a17462bf20f8",7,6,2,24.5,1,6,1,2
"31200","d7a69439b8f0f92fc34f4dd923871d91",65,53,80,5.6875,65,0,2,3
"31201","d7a83f01f531c2b1b8a0e8a017569478",11,11,0,11,11,0,1,2
"31202","d7aba1b0dd0ba7f3544432633ebfcb65",47,32,54,6.09259259259259,33,14,2,1
"31203","d7ac5ab573e6e6d85865b1c315000152",233,117,66,24.7121212121212,198,35,3,3
"31204","d7ada5d794b39b55de06ba83da21badb",65,55,42,10.8333333333333,65,0,2,3
"31205","d7aede7d154c0ffd5a2c24dd64cb3f05",13,9,50,1.82,13,0,2,1
"31206","d7b495a1d819bc96600d2f42123a7580",34,34,0,34,0,34,1,2
"31207","d7b53a845398a4cac6982a6f6d3af40c",84,53,41,14.3414634146341,84,0,2,3
"31208","d7b5513d5a4f2588a7e3ad4faccf45e8",39,39,0,39,39,0,1,2
"31209","d7b63976252ab5c531da6d925470be55",6,6,7,6,6,0,1,2
"31210","d7b730298baf8e60ad00c95a9a61ea80",74,55,23,22.5217391304348,74,0,2,1
"31211","d7b882bb6f5255c345050fc93fc2cf77",179,103,62,20.2096774193548,179,0,3,3
"31212","d7b8fc72cadd6c7e26fd5797d69a3ce6",13,11,21,4.33333333333333,13,0,1,1
"31213","d7b901a07f39985c4596e3fb2495a1ae",43,38,12,25.0833333333333,43,0,1,1
"31214","d7b9b42354adf23ddaf3dbff58f1908f",58,57,23,17.6521739130435,31,27,2,1
"31215","d7ba75c33780409a1bba113d9d57533d",9,9,0,9,9,0,1,2
"31216","d7bae080e35fec30720125236aaa40db",58,43,15,27.0666666666667,58,0,1,1
"31217","d7be0ccbdbe45fa36421672682211788",151,81,42,25.1666666666667,151,0,3,3
"31218","d7be3cb5c840a67380084c8403af437e",36,36,0,36,36,0,1,2
"31219","d7bea64cfb845b0a4edfc0856537f8ae",1,1,0,1,1,0,1,2
"31220","d7bf92f4c8e77a871494ad7ddbfe42f8",43,43,0,43,43,0,1,2
"31221","d7bfbe471d3b6b1f569095a33d5ccaed",42,42,0,42,42,0,1,2
"31222","d7c12db7ad9d76252c06c51187098f40",54,51,53,7.13207547169811,54,0,2,1
"31223","d7c2f67a82d6f1e00d258565725bc52e",140,93,69,14.2028985507246,140,0,3,3
"31224","d7c318b2e07caf8a807f1aac6fa5c9b4",3,3,0,3,3,0,1,2
"31225","d7c67a3792d08f881486640f25831b1b",80,60,57,9.82456140350877,80,0,2,3
"31226","d7c67d14d5f86b62ce80df5748e1e019",86,48,63,9.55555555555556,86,0,2,3
"31227","d7cc3d906703f6312280e07c837cffa8",63,47,24,18.375,31,32,2,1
"31228","d7cd304b772265377c0ff56d478bf0ad",42,31,48,6.125,42,0,2,1
"31229","d7cf6d8ac2827f1c2ad61eb3a39e3fca",110,63,85,9.05882352941176,75,35,2,1
"31230","d7cfa2aa38f56b8aed15821914c2aaad",17,17,51,2.33333333333333,17,0,2,1
"31231","d7cfc3e31b17ddc3bab336741041a4bf",27,27,0,27,27,0,1,2
"31232","d7d13f2dc2c7826bf0d414deadd82356",19,19,0,19,19,0,1,2
"31233","d7d2c9044924b54d93e97bbba4964358",90,66,32,19.6875,90,0,2,3
"31234","d7d2d21f4a89a45e3088b40289202c45",60,48,23,18.2608695652174,60,0,2,1
"31235","d7d37f9568b8f1a65067961458aafb22",174,78,81,15.037037037037,127,47,3,3
"31236","d7d717413b3f7c09d9f5f5c18f1b4425",50,36,35,10,50,0,2,1
"31237","d7d7683a0626bea95664b4b6d1feea11",12,12,0,12,12,0,1,2
"31238","d7db48409b9b4e10e1d191523f9cb845",24,20,43,3.90697674418605,24,0,2,1
"31239","d7db8b8903b7adf4f6cad6905e27bea4",26,26,0,26,0,26,1,2
"31240","d7dcc5defcebd2b875c08ec1eb7e2c91",13,13,0,13,13,0,1,2
"31241","d7dfc8beac247e1ee6e1755c492da8c5",183,88,66,19.4090909090909,183,0,3,3
"31242","d7dfe659f087958f297d4202cb703737",65,55,28,16.25,65,0,2,1
"31243","d7e06decbbd57f60aafd915302fbdb5a",2,2,0,2,2,0,1,2
"31244","d7e0729aadd9edb2db95b3d4172af0f5",137,69,69,13.8985507246377,137,0,3,3
"31245","d7e33c7cfd95a29c366fec710bc7b9f7",63,46,27,16.3333333333333,63,0,2,1
"31246","d7e561f49a2c07a678acc825f15d15b9",65,41,57,7.98245614035088,65,0,2,1
"31247","d7e5e5b4458e648f2bd6a35aff317cf8",23,23,0,23,0,23,1,2
"31248","d7e8c2e1963d7e601dd5fc59f21e3b3c",58,32,36,11.2777777777778,47,11,2,1
"31249","d7ea8d76952ed007f0fb3a42a011ffc6",8,8,0,8,0,8,1,2
"31250","d7eb2e2a17de243ec13f4a014b0d9320",76,57,23,23.1304347826087,43,33,2,1
"31251","d7ed052082e0245b5b339cec52733701",28,28,0,28,28,0,1,2
"31252","d7ee8ba28f1da785f3c6ff2bcad746ce",28,28,0,28,0,28,1,2
"31253","d7ef2a021b0917ce4b13ba0e78d090d3",146,82,59,17.3220338983051,146,0,3,3
"31254","d7f24e4dd4fdbc76351a311578f876cf",18,18,0,18,0,18,1,2
"31255","d7f4a58d4ed00328942f8084ec7e03b6",16,16,0,16,16,0,1,2
"31256","d7f81eebd97ecf098c6f46f766a07d0c",107,57,71,10.5492957746479,107,0,2,3
"31257","d7f9939b15fa690bd13ed9d206f6463f",46,36,50,6.44,46,0,2,1
"31258","d7fa2fe776491a768b3c18abf534ed5e",155,79,76,14.2763157894737,155,0,3,3
"31259","d7fd6754820cc6c9a2df476cd3e3f09e",49,39,30,11.4333333333333,49,0,2,1
"31260","d8014c4a5e67d6bb2af6f03f44e21724",29,29,0,29,29,0,1,2
"31261","d8026fd4ec9d9ce3a020d44487fdb0b0",111,61,35,22.2,75,36,3,3
"31262","d804b0009d0b0af00515bf885f467bcb",85,58,66,9.01515151515152,46,39,2,1
"31263","d806d1e032cc8038e92f25896592b46a",20,20,0,20,20,0,1,2
"31264","d80711a257f85d3d1400572676b76601",125,80,64,13.671875,94,31,3,1
"31265","d80aaf286e30827b910701d1f4357b5e",28,26,38,5.15789473684211,11,17,2,1
"31266","d80b8f3b7282b94c7096f7ed507c3497",31,31,0,31,31,0,1,2
"31267","d80dd604707e5a8e61bb14c7482cb40b",22,22,0,22,0,22,1,2
"31268","d80ea821df7c53fd8eb90f1204baf0b6",64,52,61,7.34426229508197,45,19,2,1
"31269","d80f1e1f8ad0561482aef09b589023a6",81,60,48,11.8125,81,0,2,3
"31270","d815b20475d9c760d83a4d497014d6f4",18,18,0,18,18,0,1,2
"31271","d81c480245e389baf7a08539c945db14",13,13,0,13,13,0,1,2
"31272","d81d386e51ddb2d59a15c2254e1b72e4",98,67,75,9.14666666666667,79,19,2,1
"31273","d81eb47a685937351b6e9efbf21d3903",37,26,35,7.4,37,0,2,1
"31274","d81f0ccf3f7ff1d46b13aedf4c3da975",47,26,47,7,47,0,2,1
"31275","d82086c71ac591405b9b40f13cd3a3d6",43,43,0,43,43,0,1,2
"31276","d820a8fcb7b4385ff32d29b952e453a4",61,52,19,22.4736842105263,61,0,1,1
"31277","d820dce9554129223eca4ded07519622",78,61,19,28.7368421052632,49,29,1,1
"31278","d824135738144d8f1fd2157fe8f402b6",36,23,44,5.72727272727273,36,0,2,1
"31279","d82686bbd75191249bed778275e9e16c",1,1,0,1,1,0,1,2
"31280","d827c87c6dc1c03251b2206d31385f8e",24,24,0,24,0,24,1,2
"31281","d82863556fc04e1df7dccf6613719510",19,19,0,19,19,0,1,2
"31282","d829ba8e579cb832dde5284e4ccd8ac8",115,46,55,14.6363636363636,77,38,2,1
"31283","d831a9f5059c7d851ec11db75ddd56b0",22,22,0,22,0,22,1,2
"31284","d832557c11c15ad120990ccba4b93431",10,10,0,10,0,10,1,2
"31285","d833eb2e4d4e0afa69dff9215a31061a",23,23,0,23,23,0,1,2
"31286","d834a78c96bd59a99d6f6eceb022d61e",62,17,82,5.29268292682927,56,6,2,1
"31287","d8370c04d50665d27a9f1ba46ae4a493",6,6,0,6,6,0,1,2
"31288","d838196818a8eb233a6a1ef72d20f52a",13,13,0,13,0,13,1,2
"31289","d8399dc25b51fd104980069469a24553",37,37,0,37,37,0,1,2
"31290","d83a5472035b8adda4b77f0ee095ed66",37,31,62,4.17741935483871,37,0,2,1
"31291","d83b3395da824090b5df0fe8ea5f64fb",41,41,67,4.28358208955224,11,30,2,1
"31292","d83bdac6e771f6143b29f0eb74cb99eb",97,56,67,10.134328358209,79,18,2,1
"31293","d83c33be701e4bf84216c931ef8cf0bc",72,45,31,16.258064516129,72,0,2,1
"31294","d83d37b127df7dd9376502b926bd1d53",23,23,0,23,23,0,1,2
"31295","d83d5822c1414abcbf92518aef74f95c",6,6,0,6,6,0,1,2
"31296","d83d9ad60e8771fbfea19ec26576c2a0",120,100,31,27.0967741935484,102,18,3,3
"31297","d83eedb55e692f568839d0c14f4c083a",27,27,0,27,27,0,1,2
"31298","d84058c5b515f2f9024e66291a5583bf",40,36,43,6.51162790697674,40,0,2,1
"31299","d841bcfff80a1de923b43c0b8959509a",72,63,28,18,72,0,2,1
"31300","d8424dfda0ccf8f5786589f7ef32378a",28,28,0,28,0,28,1,2
"31301","d843c537cd80a31cb51c3570c2dddebc",26,26,0,26,26,0,1,2
"31302","d846e56993862c3d7a7e9d8322b03eb5",1,1,0,1,1,0,1,2
"31303","d846e7689e5b890bba19c28e9f80b1aa",35,35,0,35,35,0,1,2
"31304","d84d396d3ec89e89717ff40988459f96",55,47,39,9.87179487179487,55,0,2,1
"31305","d84fcc204dd17f8894d45d7eb5fb76e2",121,65,56,15.125,121,0,3,3
"31306","d84fe5e44ac987118a0713c00c7c36bd",158,104,71,15.5774647887324,158,0,3,3
"31307","d850a1f72d57135627befb18b350ccf8",41,41,0,41,41,0,1,2
"31308","d8513f838363507783d0d70aed5530d2",47,43,32,10.28125,11,36,2,1
"31309","d8517b27e41242c465a9ec707f45c81b",16,16,0,16,16,0,1,2
"31310","d8541626377a01b01b27efa6861ed816",45,45,0,45,45,0,1,2
"31311","d8547a4f835333faea4a3066368419ad",76,55,21,25.3333333333333,76,0,1,2
"31312","d858fcb82b1a7872efe1ba0758d8fef1",97,69,41,16.5609756097561,97,0,2,3
"31313","d85b8536a4b188504860d4356efef482",29,29,0,29,0,29,1,2
"31314","d85cf2e81df94eb099e94c003597bb97",88,75,47,13.1063829787234,88,0,2,3
"31315","d85f9ed57ea42144b5e02b1aa1ecd67d",67,43,45,10.4222222222222,57,10,2,1
"31316","d861439d112e64179bd3efabd154d8b4",34,34,0,34,0,34,1,2
"31317","d8629e46bd730307222bdde15940013d",55,55,0,55,0,55,1,2
"31318","d868d4ea9fb64860b8128e41caf1fd0d",27,27,0,27,27,0,1,2
"31319","d86bd4473932268f8c5346a64cb39a05",20,17,58,2.41379310344828,20,0,2,1
"31320","d86bf93d36484fa9ed7e7c98ff21f5df",55,55,0,55,55,0,1,2
"31321","d86ca6aa82038aaaeaa3f6f4488592c0",111,69,57,13.6315789473684,111,0,3,3
"31322","d8713e7827ffdf2a37fa7ae338d02c3f",27,21,63,3,27,0,2,1
"31323","d872a90656c1180242f44ddeb9b35066",21,21,0,21,0,21,1,2
"31324","d874e2397ce8ba7ac4dd11a3e5656722",214,122,68,22.0294117647059,214,0,3,3
"31325","d876c1a45a88e5b7097591d57c6f27ea",35,35,0,35,35,0,1,2
"31326","d878617ebf9c452c2234c83033cf56b5",23,23,0,23,0,23,1,2
"31327","d879c5b72b24a203dd24facff7bcfc9a",51,51,0,51,51,0,1,2
"31328","d880a075fc4289b3c3cf10deaa6e8415",138,104,79,12.2278481012658,92,46,3,3
"31329","d885b02eecdaa06714cd92a1c19650f0",17,17,0,17,0,17,1,2
"31330","d885c675afcc024b90a73d7c167c62de",29,29,0,29,0,29,1,2
"31331","d88849f2f27a9e07818eea5bcbf2149f",102,57,54,13.2222222222222,102,0,2,3
"31332","d888a6d8cbc667685607af557190f0fd",18,18,0,18,18,0,1,2
"31333","d8892ace9e9852a8450df6810c3e59c8",31,31,0,31,0,31,1,2
"31334","d88996ff2bfb917feadd66b7fd6f4d55",75,62,28,18.75,75,0,2,1
"31335","d88ae1247d1c5dd3f70f48e13a2da099",43,16,90,3.34444444444444,37,6,2,1
"31336","d88f2c5538de7fd00ef148abeecd9592",80,50,59,9.49152542372881,59,21,2,1
"31337","d88f37abe654170fac1f9c6511d2b0c1",50,50,0,50,50,0,1,2
"31338","d89070871461cd08841f93a34c10afab",44,44,0,44,44,0,1,2
"31339","d890f502a2e72ba3fce8a4a21e81d0d6",46,46,0,46,46,0,1,2
"31340","d8925f007ed9abf5f75c99184841761c",99,56,60,11.55,99,0,2,3
"31341","d892cc1c2e6383c9e97c41f37b8a6f52",18,18,0,18,18,0,1,2
"31342","d8945f9695ef83ae79af50993342c9de",24,24,0,24,24,0,1,2
"31343","d896ea0173de51ad8aca9c6161e9499d",123,80,69,12.4782608695652,123,0,3,3
"31344","d898bdf03c6e695d148b43bcdfd37041",23,10,65,2.47692307692308,23,0,2,1
"31345","d89d5660a58d9f5c1f009dcb5080c78b",101,39,79,8.94936708860759,101,0,2,3
"31346","d8a4ecdec5f67d7e533867b92aa0ed60",1,1,0,1,1,0,1,2
"31347","d8a5fd98dc1e4df9dbd434b23652091c",87,63,63,9.66666666666667,87,0,2,3
"31348","d8a747ffee16450007172fd5bb64ce07",145,90,83,12.2289156626506,145,0,3,3
"31349","d8a811f09445ee491970391cad09f501",102,67,44,16.2272727272727,63,39,2,3
"31350","d8a8a639788ce81563f16adaf00526eb",38,38,0,38,38,0,1,2
"31351","d8a8fa6a3d2f336d35b5164a047f8484",16,16,0,16,0,16,1,2
"31352","d8a9db9c44b2c41387b2688b4ba49534",55,55,0,55,55,0,1,2
"31353","d8aa89e58748a07ea4f5ad1de44bbbed",36,36,0,36,36,0,1,2
"31354","d8aab0cfcdae593f82ea85c386e0d4b6",41,33,14,20.5,0,41,1,1
"31355","d8aabc6e68548a6516740b3019f4c1a5",92,61,59,10.9152542372881,70,22,2,1
"31356","d8ac07b531ca1df934fe2d003b44aa5b",45,25,31,10.1612903225806,22,23,2,1
"31357","d8b08653333d0f141604aef36d80c3b3",24,14,51,3.29411764705882,24,0,2,1
"31358","d8b0bcbe4e765b7b0afd23c5dd265276",3,2,3,7,1,2,1,2
"31359","d8b2b1b7d0f65d2932e0c2a20da899ac",9,9,0,9,9,0,1,2
"31360","d8b6bffcf97d13e508ee1260a0699be6",23,23,0,23,23,0,1,2
"31361","d8b7febd4d065d5de33ee6bed34a8d46",146,59,77,13.2727272727273,146,0,3,3
"31362","d8b99164b7bef02cf9d14a41314c08fa",85,58,57,10.4385964912281,70,15,2,1
"31363","d8b9ce3b497293aeb7f02ed9edc7ac23",33,33,0,33,33,0,1,2
"31364","d8be828cb286cde00942f12428354dbb",22,22,0,22,22,0,1,2
"31365","d8bf6d0e67143842d3d713b727405740",103,82,73,9.87671232876712,103,0,3,3
"31366","d8bf9be0861f4b25f898baa4d71e1109",4,4,0,4,4,0,1,2
"31367","d8bfe0f75b35e9817fae622370a63038",35,29,32,7.65625,14,21,2,1
"31368","d8c774a0ff2e6ba0fce6282fed5c4f14",45,34,20,15.75,45,0,1,1
"31369","d8ca0b6908a20362ce172df14173cc3e",32,32,0,32,32,0,1,2
"31370","d8cc7550832cf7ab72ff242ad2e972e7",39,39,0,39,0,39,1,2
"31371","d8cd34634dde831b91f915431877d600",25,25,0,25,25,0,1,2
"31372","d8ceb140d2fc36526f085284f0535485",70,50,24,20.4166666666667,33,37,2,1
"31373","d8cf11cfb1167dc8456483144db3c576",30,30,0,30,30,0,1,2
"31374","d8d093a7906e78bc49f974aef60230ab",43,40,38,7.92105263157895,43,0,2,1
"31375","d8d0e216b22a4288e93847277f151452",90,82,77,8.18181818181818,90,0,2,3
"31376","d8d44431e9a279da8e423e28419bfe0f",119,83,56,14.875,102,17,3,1
"31377","d8d6eac407a76d9600bb316bde061ae7",31,31,0,31,31,0,1,2
"31378","d8d7cb47364d6a06456b181dc41bedc6",125,70,79,11.0759493670886,125,0,3,3
"31379","d8d8b10d37ff8ba61ef329d08c3ebdda",39,29,43,6.34883720930233,39,0,2,1
"31380","d8d8eb8715249ebfff80178a37e7dd19",56,56,0,56,56,0,1,2
"31381","d8da553dad85fadddc6ccefec107c0d3",13,13,0,13,13,0,1,2
"31382","d8dba939db6507b5f3883849917efdc2",27,27,0,27,27,0,1,2
"31383","d8dbaff42408a6d88b4d1bdd68e58596",7,7,0,7,7,0,1,2
"31384","d8dd4dcd499c3975828d0c28ed3a0950",120,102,69,12.1739130434783,120,0,3,3
"31385","d8dff9c0978161a3eacad6f2c40b654a",74,62,14,37,74,0,1,2
"31386","d8e07fd376e541b3366d5833580c8d06",238,114,60,27.7666666666667,192,46,3,3
"31387","d8e14cf47f15aafc29d37d03c0925256",6,5,10,4.2,6,0,1,1
"31388","d8e3dc58cf6a0e3486a5e66e55e6098e",27,27,0,27,27,0,1,2
"31389","d8e5eaa695d9a6ec8c9e39667c77a731",43,41,53,5.67924528301887,43,0,2,1
"31390","d8e6e60c17a3ee10a9b10c718b426d00",22,22,0,22,22,0,1,2
"31391","d8ea63cf2891d80faa35be690846b1ee",31,31,0,31,31,0,1,2
"31392","d8eb06e59f9f4f3333b715c9d676c303",75,66,54,9.72222222222222,75,0,2,3
"31393","d8eb52fc0183238c6f7f53593fc8556f",114,82,50,15.96,114,0,3,3
"31394","d8ecc0f54c622c6f8ae62007acfe3769",24,17,83,2.02409638554217,18,6,2,1
"31395","d8eef725e6d3a583c9c404cf2b483050",32,22,70,3.2,32,0,2,1
"31396","d8f0929a041e1051a18fd850927ce106",7,7,0,7,7,0,1,2
"31397","d8f274cd0aba8f767574b7182e9549b2",160,90,89,12.5842696629213,160,0,3,3
"31398","d8f2b22f05cc0478b3df67cd1052dc49",88,77,56,11,88,0,2,3
"31399","d8f407058f5e1afd1575faa9660a645a",2,2,0,2,2,0,1,2
"31400","d8f67185ff6a22a86548022bcededc59",68,49,56,8.5,68,0,2,1
"31401","d8f97d7365ca067fb624aca82ac44e8f",45,45,0,45,45,0,1,2
"31402","d8f9cd5c2733e6e4d84cc5bd0d5e524e",23,23,0,23,0,23,1,2
"31403","d8fb0dba3126b95bd4694e1b37d45e74",64,53,29,15.448275862069,64,0,2,1
"31404","d8fbd9d34f1f5793193c3e8db7ff72f5",9,9,0,9,9,0,1,2
"31405","d8fc2ce5cd60ea5984ff5180fe64bf75",3,3,0,3,3,0,1,2
"31406","d8fc85e198ea8aee0754865a7feb85d1",52,52,0,52,52,0,1,2
"31407","d8fc99c2d6414e957b47a36c39e8d05e",44,44,0,44,44,0,1,2
"31408","d8fe21cde562b7c125a0e95a18fc01ed",24,23,79,2.12658227848101,16,8,2,1
"31409","d902d678f05012381eb5171e64d4c971",61,45,54,7.90740740740741,61,0,2,1
"31410","d9034d7d851719b098d206416f4d0392",8,8,0,8,0,8,1,2
"31411","d903f89f07f505b6fe292fc7e57db4ea",35,35,0,35,35,0,1,2
"31412","d904f99dd41562ba8430a9d4c97bc16e",29,29,0,29,29,0,1,2
"31413","d90a0294a8eda131172d272ef34b76b4",59,47,78,5.29487179487179,48,11,2,1
"31414","d90ab906d3dd94224582cf9565379a64",17,17,0,17,0,17,1,2
"31415","d91004c099cb4eee6b4eb153f589b95c",68,55,40,11.9,40,28,2,1
"31416","d9105c5edf59103a5c09070846926012",192,105,89,15.1011235955056,176,16,3,3
"31417","d913c41fb0bd63b2ad828195d9d891a4",65,48,71,6.40845070422535,65,0,2,3
"31418","d91405de80c29ba3148be16860392b1b",23,23,0,23,23,0,1,2
"31419","d9156e3b13ff673455482694c66636cc",1,1,0,1,1,0,1,2
"31420","d9171d0c986a365a74d19c0456c2db27",52,52,0,52,52,0,1,2
"31421","d919b361363e9cb58fbdd0edee0c25d9",7,7,0,7,7,0,1,2
"31422","d91b5b3613d2ce2c37b266c00e57be82",26,26,0,26,26,0,1,2
"31423","d91ce2630d91f88b817835a307f5a591",18,18,0,18,18,0,1,2
"31424","d91dee159fdd6366aeed53c4d0044842",57,45,30,13.3,24,33,2,1
"31425","d91e1c553bdbf5c7e0a48fa1ce05bb6a",75,61,17,30.8823529411765,75,0,1,2
"31426","d91f13629b67d050141632a1747527f0",23,23,0,23,23,0,1,2
"31427","d9253caf8043fdf0ef61277a99848ffa",16,16,0,16,0,16,1,2
"31428","d92b12b843c3f5bf3e8497406838c85d",34,34,0,34,0,34,1,2
"31429","d92b7d37aa807037526afe58a0f020fd",37,37,0,37,37,0,1,2
"31430","d92c08bc2ed0f8f3968643767e9015d2",19,19,0,19,19,0,1,2
"31431","d9309fd295582c29a7e4e872819caf01",61,45,56,7.625,51,10,2,1
"31432","d9314b353d86ac3d7bb5d0b286117bbb",194,103,51,26.6274509803922,194,0,3,3
"31433","d931548e8b63ec7d14ac06db5f5150f3",29,29,0,29,29,0,1,2
"31434","d9351ea250f4990362acf5e9f80eef5c",208,107,76,19.1578947368421,174,34,3,3
"31435","d9382aef1b458e52d85813dcffea8bb7",22,22,0,22,22,0,1,2
"31436","d93978ac78424a2f4c3fc604926ef8a7",95,86,56,11.875,45,50,2,3
"31437","d93ebfa371e85b6e9778ffed879e1ce2",67,48,29,16.1724137931034,28,39,2,1
"31438","d93f4438fcff239a2261f72e498ee177",43,37,51,5.90196078431373,24,19,2,1
"31439","d93f86ccd9e173d0e8ddd90e7c9e4b22",23,23,0,23,23,0,1,2
"31440","d940de9a54a1e9d13f164a6a30befeb8",30,30,0,30,0,30,1,2
"31441","d9414af33e0d552a72c376fc2ff8e78f",13,12,3,30.3333333333333,13,0,1,2
"31442","d9441055e2aac0d93d8debd92d3d8342",31,31,0,31,31,0,1,2
"31443","d947f136f7d9b1f4dcef3f7d0fdb6d16",52,44,25,14.56,27,25,2,1
"31444","d948bd98b4140a67e4892820ced88268",27,27,0,27,27,0,1,2
"31445","d9498a40d1867908930526fe598e199e",25,13,82,2.13414634146341,23,2,2,1
"31446","d94bcb2a6faa0666b00d47dfa1a90026",24,24,0,24,24,0,1,2
"31447","d94c44215a843fd07f0f28d29bfe0e4e",108,78,56,13.5,108,0,3,3
"31448","d94d470a976caef0a8b5f436e47b9d43",28,28,0,28,28,0,1,2
"31449","d94d71c5580164d0f97423086d3470d4",56,48,18,21.7777777777778,56,0,1,1
"31450","d9533567b74151b50c32bf0f9d5ab6a7",187,75,64,20.453125,187,0,3,3
"31451","d9537f072869ce882865faa8801abef3",14,13,44,2.22727272727273,14,0,2,1
"31452","d9547fa9d7df311355d038987db0dbc4",172,78,62,19.4193548387097,172,0,3,3
"31453","d95569080530a2305451f4169e10a0d9",127,86,76,11.6973684210526,127,0,3,3
"31454","d957b1025040530c92ca84580eaa113b",217,95,79,19.2278481012658,176,41,3,3
"31455","d9593a8a6f556cbbb2dc9cc5b19a6c95",39,35,57,4.78947368421053,18,21,2,1
"31456","d95ac215cfdae0b13c81a563b6f082de",18,18,0,18,18,0,1,2
"31457","d95b7378b161dbc4c12cbdd6dae3982f",230,119,84,19.1666666666667,212,18,3,3
"31458","d95d52d4b25a805055033a5773d4d96c",89,66,51,12.2156862745098,89,0,2,3
"31459","d95ec1f8152bd0fb18b3144d8b70688f",39,39,0,39,39,0,1,2
"31460","d96135c5f279677a3d42abc1871f099f",19,19,0,19,19,0,1,2
"31461","d963cbde732cc73b4fe4ce5891823536",35,35,0,35,35,0,1,2
"31462","d967d2dc30dfe17e989fbb974d6a5061",35,35,0,35,35,0,1,2
"31463","d96805460fdb05aff1c43d29c6f67ee8",39,37,6,45.5,39,0,1,2
"31464","d96842b28ba0becfd832cd1ee7b34805",29,29,0,29,0,29,1,2
"31465","d9689bce60e1bcf035d5f9f605d54672",15,15,0,15,15,0,1,2
"31466","d96b6877a5fbb4954c17310a658f3e81",11,11,0,11,0,11,1,2
"31467","d96c2addbe77078b4d631ef89d397f6c",62,51,11,39.4545454545455,62,0,1,2
"31468","d96d852e9212bd172b90ba00e2e4b4bf",28,28,0,28,28,0,1,2
"31469","d97097c29565f2491d0e2fefed02ab01",92,70,71,9.07042253521127,92,0,2,3
"31470","d971e72b855207c7f20f37aa663fd13f",155,74,52,20.8653846153846,155,0,3,3
"31471","d9728ea065a5a5a4e9a1a22914e70c26",41,37,56,5.125,41,0,2,1
"31472","d9763bb5c8a4d15b77929b4a32ee1b7c",35,35,0,35,0,35,1,2
"31473","d977f665d79bd9bc1fa9086ce3a1e4bc",10,10,0,10,10,0,1,2
"31474","d9782dee462bc8aa3864abac7e8bacaf",21,21,0,21,21,0,1,2
"31475","d9795080f2ba152c07853d3c509c1ce5",183,92,79,16.2151898734177,153,30,3,3
"31476","d97b99f6d0b68bc6978860a0b847db75",51,51,0,51,51,0,1,2
"31477","d97c9489c47f1688eeb3e68cccca7e0c",154,93,82,13.1463414634146,154,0,3,3
"31478","d97df1f8d597dc1d6a411733f487262f",136,115,61,15.6065573770492,136,0,3,3
"31479","d98114649b640af06c15856a7095ea8b",5,5,0,5,5,0,1,2
"31480","d98181216d70a9c92b89457707139005",35,35,0,35,0,35,1,2
"31481","d988a3b48b6b43fd593be339f01e0cd3",69,33,65,7.43076923076923,55,14,2,1
"31482","d988de83fa429cfc4aa973dbca6bb1c2",164,104,57,20.140350877193,164,0,3,3
"31483","d9898648ef51de9013bc20047a75e6f1",106,78,37,20.0540540540541,106,0,3,3
"31484","d98aed730c926c4a8bb95858595d8544",168,119,56,21,168,0,3,3
"31485","d98b77768086d310e1ced7378bb16583",53,47,27,13.7407407407407,53,0,2,1
"31486","d98c633e093944986449b90039526879",38,38,0,38,38,0,1,2
"31487","d98e1f984fe879503fec03316e6a0a53",13,13,0,13,13,0,1,2
"31488","d9900c6aa1846bcfb087b5d8902cb849",27,27,0,27,0,27,1,2
"31489","d9913b112058d3d96a998a8001bda078",105,73,61,12.0491803278689,76,29,3,1
"31490","d99223f29ac312f23e66e1a0a8bf693b",157,76,72,15.2638888888889,141,16,3,3
"31491","d993f93d49ab3c8cdd09f161c9a2f6c7",48,35,28,12,48,0,2,1
"31492","d9950b530138eab75977a74805cae3b3",34,34,0,34,34,0,1,2
"31493","d996eaf2f025e6ca96b9b65bf79228f7",47,41,15,21.9333333333333,47,0,1,1
"31494","d997f7174f36f79bd05a5caa89fe1ddd",21,21,0,21,21,0,1,2
"31495","d9988e8686cbb1efd2d9565dba237e4b",52,42,36,10.1111111111111,52,0,2,1
"31496","d99985821328855ba864848e2acc6c0c",137,108,49,19.5714285714286,86,51,3,3
"31497","d999975d0b47b6e4aa2e48c7b7d0b76c",95,65,64,10.390625,66,29,2,1
"31498","d99be318a07322f7889be38e1476e99f",129,79,56,16.125,98,31,3,1
"31499","d9a2e7e2ff298f294883ffb1c0366445",23,23,0,23,23,0,1,2
"31500","d9a48f267bec7642f1e385355261ca83",82,56,58,9.89655172413793,82,0,2,3
"31501","d9a4a0a433911109757ac6ec98f63bf3",57,42,64,6.234375,57,0,2,1
"31502","d9a6c7f86a4fa0a133554c23847d533f",23,23,0,23,23,0,1,2
"31503","d9a76f9a83f22c943e704b5ef6e3fbe7",109,70,76,10.0394736842105,109,0,3,3
"31504","d9a78f7903be8ceade78a792eae8b166",26,23,33,5.51515151515151,26,0,2,1
"31505","d9a857a3bbf9715709b9785da55f457f",180,113,25,50.4,180,0,3,3
"31506","d9ac7990d8bcfe9e2f3fe0da3be1c257",70,45,41,11.9512195121951,36,34,2,1
"31507","d9b23e1f46782162bed27226535d31de",22,22,0,22,0,22,1,2
"31508","d9b66c42dcc0bab412c205729005d87d",67,36,52,9.01923076923077,52,15,2,1
"31509","d9b6cc822242678678d75e9d59c57340",23,23,0,23,23,0,1,2
"31510","d9b94fa716db78c2b54b462c780124b2",112,82,27,29.037037037037,87,25,3,3
"31511","d9ba16adc3043ba104ae96a0b48127f3",22,22,0,22,22,0,1,2
"31512","d9ba228bc32110058cafb198cc89251a",11,11,0,11,11,0,1,2
"31513","d9bd1ac4eebf2430bf060e74e5b6b030",23,23,0,23,23,0,1,2
"31514","d9becd82fc03caa8de8a1c9c999f16e5",73,56,14,36.5,73,0,1,2
"31515","d9c1eaab830b77aa14a73a0dca9503ad",18,18,0,18,18,0,1,2
"31516","d9c2abaaca89203bb7ed70960984a72e",33,33,0,33,33,0,1,2
"31517","d9c3c5e8de5147b9388eb17600a9c968",198,95,56,24.75,198,0,3,3
"31518","d9c48acb3039efd89f52b5cc8cb92293",87,62,74,8.22972972972973,64,23,2,1
"31519","d9c5b42687419720aeb8f3059df1d83c",37,28,44,5.88636363636364,37,0,2,1
"31520","d9c83760297c7acdaf8cd35c5d88c784",37,37,0,37,37,0,1,2
"31521","d9cd313ce6266a30f80bb17468866245",99,83,46,15.0652173913043,49,50,3,3
"31522","d9d29b5df369e743662f7c2916629d85",52,52,0,52,52,0,1,2
"31523","d9d4353b8be6979cac67378c993c3ad5",22,22,0,22,22,0,1,2
"31524","d9d48b84aaac1827396dca05cc31fd8d",31,31,0,31,31,0,1,2
"31525","d9d552557f4e93eb045351bff46a2ba4",20,20,0,20,20,0,1,2
"31526","d9d64e7362797b90c8012f93e7730ce4",20,20,0,20,20,0,1,2
"31527","d9d66eea2d8a90d7327f47a9d86e6308",12,12,0,12,12,0,1,2
"31528","d9da7edeee01cf227ffc4b7047bb47c4",35,26,68,3.60294117647059,21,14,2,1
"31529","d9dca74b053df972b02cbd6097c1209a",23,23,0,23,23,0,1,2
"31530","d9dd06b6e555729fbfdef8b8bfec7cfd",50,50,0,50,0,50,1,2
"31531","d9ddc5cd2ffcb2783469a71521210e2a",160,109,64,17.5,113,47,3,3
"31532","d9e099247b6385c371d7c4d4012acda8",204,94,54,26.4444444444444,204,0,3,3
"31533","d9e25edf779179268ee10b7d419b62b7",11,11,0,11,11,0,1,2
"31534","d9e406e937296dc6eb0b154ff1b97c52",166,79,66,17.6060606060606,120,46,3,3
"31535","d9e5f99a701b611e1439046451f7e42c",66,37,71,6.50704225352113,66,0,2,1
"31536","d9e719e6b710ec6a6807aa34328c8b32",32,32,0,32,32,0,1,2
"31537","d9e8320cabfaa7ce2c8157b6d2a61bdb",69,47,41,11.780487804878,69,0,2,3
"31538","d9e8b0e85c620848242aa389e0fae50f",28,28,0,28,0,28,1,2
"31539","d9eb096abcedea75665e4f9cdbe2048d",38,38,0,38,38,0,1,2
"31540","d9eeb805b3f29192e15da6ce90296073",117,84,24,34.125,73,44,3,3
"31541","d9eef420e665d8c615fa4488140fb47f",126,93,78,11.3076923076923,82,44,3,3
"31542","d9ef1b91a16fdf0afabd6de1f23f4583",102,51,72,9.91666666666667,50,52,2,3
"31543","d9eff551dfa62985c25ad415caf4f100",68,62,34,14,68,0,2,3
"31544","d9f1d46f5dcdbe661a656ea43ea36459",180,67,57,22.1052631578947,180,0,3,3
"31545","d9f6d0e1c66e6189e889d543cb787516",84,71,14,42,84,0,1,2
"31546","d9fe8b99dfa4e1dc74e685f7cc30c303",17,17,0,17,17,0,1,2
"31547","d9feae8fcb864d99fb61c2cbbbf7225a",26,26,0,26,26,0,1,2
"31548","da014337fb2bd12465e20dc2be97bbf2",20,20,0,20,20,0,1,2
"31549","da02783422a6d577f7a165b4fc0a79d7",21,21,0,21,21,0,1,2
"31550","da0441ccdde61eba4fb5abd61a8774ae",110,62,71,10.8450704225352,110,0,3,3
"31551","da0525349f6b1829ea5c2db8432f755f",26,22,44,4.13636363636364,26,0,2,1
"31552","da0581ce279acb35a63c43f0ce871c65",18,12,56,2.25,18,0,2,1
"31553","da071e72b7b775131e72182dc10f08db",110,74,68,11.3235294117647,110,0,3,3
"31554","da0735073894c9e6655fbde3e8324cee",42,42,0,42,42,0,1,2
"31555","da0944e139ea94554b1231cd974f43ef",46,46,0,46,46,0,1,2
"31556","da0c0bb51776d943b9016ba35922930e",48,45,44,7.63636363636364,48,0,2,1
"31557","da0cc6e8484ce28adf551e06881e12e6",16,16,0,16,16,0,1,2
"31558","da0eaa6b417da05b54b85cbd63ddbdc3",195,88,64,21.328125,195,0,3,3
"31559","da1014c23f30a1e5ccae7a219bacc28f",29,28,9,22.5555555555556,29,0,1,2
"31560","da10eae90def64687f754eecad3ffeef",164,86,49,23.4285714285714,118,46,3,3
"31561","da13836cb07e2e4d28cc4eeabb90c6c8",21,21,0,21,0,21,1,2
"31562","da138b2a24f57c91ee0125b1659c3b4c",48,45,52,6.46153846153846,48,0,2,1
"31563","da14b704fad1b43cba39bd6cedbc2f55",80,40,58,9.6551724137931,47,33,2,1
"31564","da16a11a1221a6b503afc80e838aa896",18,18,0,18,18,0,1,2
"31565","da1801f043daeee41b460ca7b3f3d6e1",1,1,0,1,1,0,1,2
"31566","da1823551edbe7052d99c494ffb1ea35",12,9,31,2.70967741935484,12,0,2,1
"31567","da1ad0293867b154373cca70845d5066",18,18,0,18,18,0,1,2
"31568","da1cde57d232dcf0aaf0f5c9eda75521",69,53,49,9.85714285714286,69,0,2,3
"31569","da1d49cb1e94ae2acc33267f25b57b7a",164,116,71,16.169014084507,145,19,3,3
"31570","da1d5f1455d4e1858f9bb948f4f7fe76",34,34,0,34,34,0,1,2
"31571","da1e4dc4a34c1b4ef9b8e4bfe1918493",179,95,70,17.9,179,0,3,3
"31572","da1f6b1d5e2634267b96aeed0150ca87",7,7,0,7,7,0,1,2
"31573","da20a87e71c0162838d1849f7fb5e69b",19,19,0,19,19,0,1,2
"31574","da22b8a7f123128453c3b7a6c9d95b7a",19,19,0,19,19,0,1,2
"31575","da233aab458f545a27e5c0760b1f6f10",111,83,24,32.375,60,51,3,3
"31576","da24d93d4b026a86df8121593597b13e",44,40,25,12.32,14,30,2,1
"31577","da24e42ca2ae9a4331932b68035c2ca2",54,54,0,54,54,0,1,2
"31578","da282f5073bb404e0d94483b950ecc04",32,25,37,6.05405405405405,18,14,2,1
"31579","da2e1f8d4858e6cd7bbc5ab1ee3701e4",4,4,0,4,4,0,1,2
"31580","da35080b85e1ec33317aa4da8e7601cc",18,18,23,5.47826086956522,10,8,2,1
"31581","da363dfcc76338f7d6768de20a2e83c5",66,63,60,7.7,66,0,2,3
"31582","da38e3557665141969b58b0e33333da1",27,27,0,27,27,0,1,2
"31583","da414eccfca4de05e1a585b1fc86046b",27,27,0,27,27,0,1,2
"31584","da444f03f8fb4944740aa2f48bbe5ebf",42,42,0,42,42,0,1,2
"31585","da44dec697b2988514b866e9454249d7",32,32,0,32,32,0,1,2
"31586","da4635449d42430e6419bbce53b122a3",64,58,27,16.5925925925926,64,0,2,1
"31587","da463c7cd0976c8a16358b5a8cf6999d",12,10,13,6.46153846153846,12,0,1,1
"31588","da4822e3b427341e21839aaee86dbdf6",20,19,22,6.36363636363636,5,15,2,1
"31589","da49318e122f3e411540cfc24212de49",167,76,70,16.7,130,37,3,3
"31590","da4c453b841d8d0773f009e9cb3a8f4b",39,39,0,39,39,0,1,2
"31591","da4e2e9909547665d9c4ed60401b31ec",80,47,84,6.66666666666667,80,0,2,3
"31592","da4e45fcd2a0e450d48c02d462e0e5c0",90,66,56,11.25,90,0,2,3
"31593","da4efb39633e53b4af0402b5127fe022",29,29,0,29,29,0,1,2
"31594","da4f288650c8352d7a10a51f5a8834f4",16,16,0,16,16,0,1,2
"31595","da501c5a670f19d07bb18f363395718c",226,65,89,17.7752808988764,193,33,3,3
"31596","da502a78cb8aa79d3d8a522040a334e1",99,79,47,14.7446808510638,99,0,3,3
"31597","da50bda50fa9d2861e7e6abd694c607c",155,84,38,28.5526315789474,112,43,3,3
"31598","da529df348d96c5abf0cacf4436bd9fd",93,56,63,10.3333333333333,93,0,2,3
"31599","da57b6f704ea67bedf3f232b340246e6",137,84,18,53.2777777777778,137,0,3,3
"31600","da58843753c5a2a6ce83ace177689343",16,16,0,16,16,0,1,2
"31601","da5b8a15e395ae3121fa321c85ce5cc5",31,31,0,31,0,31,1,2
"31602","da5e198ea864e286745d989912c1f886",125,96,28,31.25,125,0,3,3
"31603","da5f0ff00f210f079d612e01e61abfe8",13,13,0,13,13,0,1,2
"31604","da620e34fd9a83dbf163f5181eb0e022",29,25,37,5.48648648648649,29,0,2,1
"31605","da63ec36db68bfd62e7304df3016585c",99,61,71,9.76056338028169,99,0,2,3
"31606","da64d7eef53e152d25b1ad67f82783bb",19,14,0,19,19,0,1,2
"31607","da674a2ca41610f74b846a0b2d4973a8",43,43,0,43,43,0,1,2
"31608","da69004616fbcbf2c05b92689a838c47",41,41,0,41,41,0,1,2
"31609","da6cb146df4900fa7353b3e2d995d964",68,60,31,15.3548387096774,68,0,2,1
"31610","da70864caf871d4a64743c8e017318f3",47,41,29,11.3448275862069,23,24,2,1
"31611","da719ccbf973fee7c1da6efbfa9668a0",87,66,53,11.4905660377358,87,0,2,3
"31612","da722ff7687e25b818810769ba9c4b9d",2,2,0,2,2,0,1,2
"31613","da7351f2ed898b834dcfa1260f06cf86",25,25,0,25,25,0,1,2
"31614","da74d74eb2f8d9aa173d8f098371cce0",135,82,56,16.875,116,19,3,3
"31615","da76ceddf10c420a165633f266fa01a9",23,23,0,23,23,0,1,2
"31616","da777a9a23cf92b18e57b43362a8a4ff",38,38,0,38,38,0,1,2
"31617","da788cdc7dfa4af03d798a5c82df3600",51,39,14,25.5,51,0,1,1
"31618","da7e559bcd50fdf88ad00a1f5d4851b0",43,36,11,27.3636363636364,21,22,1,2
"31619","da7e71aeeeb87b31664ed6a28da1a446",4,4,0,4,0,4,1,2
"31620","da80e20faa75b2728e213c1acf5e963f",28,28,0,28,28,0,1,2
"31621","da80ea30500ccfa7531e7da7d6231744",22,22,0,22,22,0,1,2
"31622","da81a806b4d2a1e7cf2bd484483652e9",5,5,0,5,5,0,1,2
"31623","da83b0aa563d1c50ddf81c66eb53554c",153,104,68,15.75,135,18,3,3
"31624","da87341afa15f6892077027f1b37d349",133,75,75,12.4133333333333,133,0,3,3
"31625","da88a411ff7fddcc42ba24cb46f0e423",3,3,0,3,3,0,1,2
"31626","da88db0213b2cb70ab786eb2115b0506",34,34,0,34,34,0,1,2
"31627","da88e4fb4c7b10f1b82129da78e82c65",31,31,0,31,31,0,1,2
"31628","da893655690de9e07720010d7068904e",40,33,41,6.82926829268293,40,0,2,1
"31629","da894e15724c985317b59a5b183e8d65",131,67,85,10.7882352941176,131,0,3,3
"31630","da8ab5b514faecb7c970058bd960b5fd",193,102,78,17.3205128205128,153,40,3,3
"31631","da908c583f32829fc4d1f9c9dc7b56a9",35,35,0,35,35,0,1,2
"31632","da936f0d6966b30b829b9acda9d5eee2",97,75,63,10.7777777777778,97,0,2,3
"31633","da97eec080b03779636c0b6c1bbc6218",22,22,0,22,0,22,1,2
"31634","da98aee74f1e54e83e1ccde9912acdcc",88,61,70,8.8,88,0,2,3
"31635","da99c2c89c7fc5b56055baa363d62610",107,72,18,41.6111111111111,107,0,3,3
"31636","da99e26c6e99371aa7e6a4735349c396",39,38,19,14.3684210526316,13,26,2,1
"31637","da9ab72f3837aa5fb03dd637f04902cc",22,22,0,22,22,0,1,2
"31638","da9cb2e07d68f4b5798ea45ba8936cbf",28,28,0,28,28,0,1,2
"31639","da9dcc08029749f246856c4a032c77a5",177,102,68,18.2205882352941,177,0,3,3
"31640","da9de8c718a3b5ae5e78ef8efa18e72b",1,1,0,1,1,0,1,2
"31641","da9f122002422273b1b75f6312db83fd",122,77,63,13.5555555555556,122,0,3,3
"31642","daa074965ff3aaeb7d9868a5dba8d759",84,60,64,9.1875,84,0,2,3
"31643","daa0d4fa9507521c3f960dfb1662f597",97,74,57,11.9122807017544,97,0,2,3
"31644","daa1a4c529e136864e91c9dbffa37446",16,16,0,16,16,0,1,2
"31645","daa23eff8ac69266a8dbdfd56793eee9",70,48,42,11.6666666666667,70,0,2,3
"31646","daa65336f89efefa49bd48e8973a9c4d",18,18,0,18,18,0,1,2
"31647","daa694a2176b38aba06d183a70275dfa",28,28,0,28,28,0,1,2
"31648","daa6e8566a62de4871dd47c141f305c0",162,79,56,20.25,112,50,3,3
"31649","daa7e69c3c280ab2662a09f39139653f",201,97,75,18.76,201,0,3,3
"31650","daa85479fa680e3d1d962b09cdb7af35",85,66,49,12.1428571428571,85,0,2,3
"31651","daae88f29b8b91f186c087308e836ea8",39,39,0,39,39,0,1,2
"31652","dab1bf8d4f313b1d19cdb39dae57259a",26,26,0,26,26,0,1,2
"31653","dab24672bc52ab108bab71799b52c829",39,39,0,39,39,0,1,2
"31654","dab265dab092a862a603f5a8cd4f6c01",204,114,80,17.85,204,0,3,3
"31655","dab346af779da00a7ad0119d0d165243",92,64,47,13.7021276595745,57,35,2,3
"31656","dab3671a49f76bf657ee41b9a5c77192",44,44,0,44,44,0,1,2
"31657","dab759be10ca9dacd821dcf949c2545e",90,77,22,28.6363636363636,90,0,3,3
"31658","dab82e04f7fb6d6b0f55df04e31ac3b5",34,34,0,34,34,0,1,2
"31659","dab8752108399e79426665be7167c983",211,121,70,21.1,211,0,3,3
"31660","dab8c87bfe0fac8ceb10b95a9b7f4f92",47,14,43,7.65116279069767,47,0,2,1
"31661","dab9d84e46b39a7e13884826dcf4dd58",10,10,0,10,10,0,1,2
"31662","dabb54b764a26342c538dda6312e0c25",21,21,0,21,21,0,1,2
"31663","dabbc4e911354cd252192cab212e3436",14,10,19,5.15789473684211,14,0,1,1
"31664","dabe2619f4a5b0896313d516c22bb202",50,40,52,6.73076923076923,28,22,2,1
"31665","dac2cdd645730e1347c74d73e5a688e4",27,27,0,27,27,0,1,2
"31666","dacb5057c3004c8b55573f5ccba7a722",52,47,70,5.2,36,16,2,1
"31667","dacd48be14ceeff5cac6885ad9e768c5",142,106,42,23.6666666666667,95,47,3,3
"31668","dacd667c5465fb8a61639592ed725b88",15,7,56,1.875,15,0,2,1
"31669","dace895b9c2b406354c84a01c9684225",30,28,35,6,30,0,2,1
"31670","dacf2e6df4edf6aa3f81e3f1a5143c40",81,54,29,19.551724137931,81,0,2,1
"31671","dacfbe32cd46b769196a6496362afa99",76,67,28,19,76,0,2,1
"31672","dacfbeaee51ce7e28ed493e8ca225ce8",49,49,0,49,49,0,1,2
"31673","dacfe1c02ce964d7f25bd15f23feb185",25,25,0,25,25,0,1,2
"31674","dad2cee731ea0760bbfe03b7107e625f",38,38,0,38,38,0,1,2
"31675","dad5ee4ce5deed82f3636f8a755b3bed",95,75,31,21.4516129032258,40,55,2,3
"31676","dad60b89c1a4a2943c628ec2b9280218",223,107,77,20.2727272727273,194,29,3,3
"31677","dad61c3f8ec07b27f42ae8c8deefa389",9,9,0,9,9,0,1,2
"31678","dad64e568d4dbb7ab97689ca50cfed83",31,31,0,31,0,31,1,2
"31679","dad8d63e250c9e5ee1786eb366520721",58,45,50,8.12,32,26,2,1
"31680","dad8e018cffda3efcea697c13c076bab",32,32,0,32,32,0,1,2
"31681","dadb83a1f591e40c75ba817d95cd118d",127,89,59,15.0677966101695,77,50,3,3
"31682","dadd9eddcabbeeeeb70defcd4a40498e",60,56,16,26.25,29,31,1,1
"31683","dade69f0ae73888084e28383c81881a0",12,12,0,12,12,0,1,2
"31684","dae046581cc3385fcfc4617bff58629c",40,40,0,40,0,40,1,2
"31685","dae04bab1f67814f8fa81154cc5e3a56",16,16,0,16,16,0,1,2
"31686","dae05b592eba9eaa15d076fa6bbe1c56",49,49,0,49,49,0,1,2
"31687","dae076190ced22796b7e3a7e263b823c",43,43,0,43,43,0,1,2
"31688","dae07b666250186c01c0eafc5e9023b1",48,48,0,48,48,0,1,2
"31689","dae29d5e523980719754fa31a98a86f3",110,82,52,14.8076923076923,110,0,3,3
"31690","dae42b51b054ecac43d309eef24cfe7d",38,30,39,6.82051282051282,38,0,2,1
"31691","dae75f6d8ba51b6baeea5e751934889a",35,35,0,35,35,0,1,2
"31692","dae7f11b3082262ccb426a21d0a947a2",42,42,0,42,42,0,1,2
"31693","dae883aa81edf90c87a59e7822d312ad",125,95,83,10.5421686746988,106,19,3,3
"31694","dae974b8bdc0fcdb2cea2d16f3506722",34,34,0,34,34,0,1,2
"31695","daecf790ff5f8cf222ace4e1bde23fc3",2,2,0,2,2,0,1,2
"31696","daed170a8dbb040df1dd486d6cbdb49d",207,110,70,20.7,207,0,3,3
"31697","daee58b4033b546b567410ef719113c8",127,91,32,27.78125,86,41,3,3
"31698","daeed5b48b1abd86bde218b748d422b6",9,9,0,9,9,0,1,2
"31699","daeedd9b611c3acc15d499fde24f9e8a",180,120,62,20.3225806451613,180,0,3,3
"31700","daf1c1ce83cb96e27ed2ecd1aa222cfc",30,30,0,30,30,0,1,2
"31701","daf2e78328d006cb6813f79d03e61c16",37,37,0,37,37,0,1,2
"31702","daf2ead71303dbe9e1f6e1e8839b765b",170,91,77,15.4545454545455,146,24,3,3
"31703","daf4eeb3e135048aab39e67e9334470f",59,46,23,17.9565217391304,59,0,2,1
"31704","daf672309328eca462e3fe62f8700c71",54,38,56,6.75,54,0,2,1
"31705","daf75e2d017017aa13bdb6747b41f0bf",131,64,74,12.3918918918919,105,26,3,3
"31706","daf79ce8b445602f1c7ecd6bb2e30d45",64,45,26,17.2307692307692,29,35,2,1
"31707","daf8a41529d8fc1dfb0acd086e6319cf",1,1,0,1,1,0,1,2
"31708","daf90873981f8899a236b4f985ccb0dd",110,79,51,15.0980392156863,110,0,3,3
"31709","daf93d8e7f8534b2a50f532ff3bf067a",17,17,0,17,17,0,1,2
"31710","dafc818498e0799e5c23e7c5333e2eb0",12,12,0,12,12,0,1,2
"31711","dafe0f13fab9a28c3c3cb179c2961733",54,42,41,9.21951219512195,54,0,2,1
"31712","db0118a038a841ce2a351f85153ed0e2",27,25,4,47.25,27,0,1,2
"31713","db019af8ef7397f3e025d72443ae7271",73,53,66,7.74242424242424,73,0,2,3
"31714","db036476e82eaad973c5a581f2cdbb7b",18,18,0,18,0,18,1,2
"31715","db0367bae317742fc8b40812f0962a8d",140,84,38,25.7894736842105,140,0,3,3
"31716","db065eb1026b96a03f7c78ccc170eaf6",33,26,44,5.25,33,0,2,1
"31717","db0ad35a67945aa0839a70a042f678e9",21,21,0,21,21,0,1,2
"31718","db0b237a8e5a5446dc781043e0c75b9d",34,27,16,14.875,18,16,1,1
"31719","db0baaf3a2d026ad05725f449b6eca1b",79,62,19,29.1052631578947,79,0,1,2
"31720","db0bdef9470e725c4701fdc10016beff",62,49,43,10.093023255814,62,0,2,3
"31721","db0d747770fd685e6f6f45f4c19dd645",216,91,63,24,216,0,3,3
"31722","db0ed47b59b9463522f50694646ca0e0",77,50,76,7.09210526315789,57,20,2,1
"31723","db101bebecd93c733586bebedb615216",57,41,16,24.9375,34,23,1,2
"31724","db12701465829561e60ad83c45806ede",181,89,63,20.1111111111111,181,0,3,3
"31725","db1347c6e71e3d8253f7b946508fe0b2",47,41,30,10.9666666666667,16,31,2,1
"31726","db149da9e92a250b65f7543af49fbff8",18,18,0,18,18,0,1,2
"31727","db14b544829beae5fbc6ae259f914de9",70,41,62,7.90322580645161,47,23,2,1
"31728","db17a48562f7678c9a7f8f25b672d742",41,41,0,41,41,0,1,2
"31729","db17a7cccc7657066a0eca8d7001c496",59,32,62,6.66129032258065,59,0,2,1
"31730","db19118cbbb327bc70ce0b0827ecc2dd",79,47,60,9.21666666666667,79,0,2,3
"31731","db1c896720c7658a03b7bc65de3596a1",27,19,49,3.85714285714286,27,0,2,1
"31732","db23259a65e765dfe2b0024a24ba6775",37,37,0,37,0,37,1,2
"31733","db23ca49d930d7420ba6cc1936231a42",156,50,83,13.1566265060241,156,0,3,3
"31734","db2494f47e632d951bd7da98eb24d766",78,49,40,13.65,39,39,2,1
"31735","db263a58ff8544a64a69dee4861d487e",172,120,24,50.1666666666667,172,0,3,3
"31736","db2d37e4617c7085a6d9e3bb425d6508",10,10,0,10,10,0,1,2
"31737","db2f85e42924c5a1c654cb27054bb0ff",18,18,0,18,0,18,1,2
"31738","db2f892fccc5d604084c9c2c850b17cd",32,32,0,32,32,0,1,2
"31739","db315b28fbaae75f6094ac34d88cffe0",19,19,0,19,19,0,1,2
"31740","db318f3282bdf297054fd801610a190c",68,59,18,26.4444444444444,42,26,1,1
"31741","db32079945ed03eba8ca70732efd50bb",79,65,34,16.2647058823529,79,0,2,3
"31742","db33cc76270e634b71c73c609c83e504",29,29,0,29,29,0,1,2
"31743","db36498d4734ab85ba9335d33ba6bbf6",26,26,0,26,26,0,1,2
"31744","db37b90471456682d6921047bc7efd2e",132,86,81,11.4074074074074,110,22,3,3
"31745","db38ae58fc2f422199063f95458a0232",56,41,40,9.8,26,30,2,1
"31746","db395e49d09721adc3ca28c5c416133f",17,17,0,17,17,0,1,2
"31747","db3adb3efcee240490ee1cda963d9653",3,3,0,3,3,0,1,2
"31748","db3b8a896632eb2c5cad70ff022371bc",18,18,0,18,18,0,1,2
"31749","db3d9b8cb9d7804a5d5a9c97d5eb3e21",5,5,0,5,5,0,1,2
"31750","db402eef441b9eb1c81aeb9a60933ef6",56,56,0,56,56,0,1,2
"31751","db4112d5ab4beb89641861f74a537146",88,75,41,15.0243902439024,88,0,2,3
"31752","db453b35163a475ad5abaab70f898022",175,126,84,14.5833333333333,175,0,3,3
"31753","db45b15e1f56f191e7ef07349fa2d6a0",214,85,83,18.0481927710843,214,0,3,3
"31754","db4650320ca59c0935721590c64e6f61",87,67,23,26.4782608695652,40,47,2,3
"31755","db4762dd69f63007e4f1fd3fca435699",114,77,74,10.7837837837838,74,40,3,3
"31756","db484f5eb75586dba7172eec6fc66ae1",163,111,39,29.2564102564103,163,0,3,3
"31757","db4857a05dacf39480cb3bae016b931f",21,21,0,21,0,21,1,2
"31758","db4b8273d037d7d12fbc2bc7586b83d3",170,105,70,17,170,0,3,3
"31759","db4d7efdca0de676772bf6788e998f21",25,23,25,7,25,0,2,1
"31760","db4f0fbe5994e83b9d55b7f971996660",194,88,87,15.6091954022988,194,0,3,3
"31761","db516aa9bb7095cf0ab2891332cc7a37",20,20,0,20,0,20,1,2
"31762","db52e6db25ff154293e01d7432aa5b94",15,15,0,15,15,0,1,2
"31763","db5365012aec4a0ebc3caf2c9cca5577",18,18,0,18,18,0,1,2
"31764","db54da6a4bd1ceb68ed07a1eb858ee35",23,23,0,23,23,0,1,2
"31765","db55d76f323447d08aa18e8344118a40",43,40,43,7,43,0,2,1
"31766","db56cb19d08e1efa61984ac884f0451a",27,27,0,27,27,0,1,2
"31767","db57c3ffa76d7cf828c4db6b44c98d2f",12,12,0,12,12,0,1,2
"31768","db57c60eb0e66dcfcc1b7da76541f170",120,91,70,12,85,35,3,3
"31769","db5957e7b4e36c3f3028d618ba282e3e",130,69,38,23.9473684210526,86,44,3,3
"31770","db5bccb1ecce5f425e3e012612f59157",15,15,0,15,15,0,1,2
"31771","db60b5ac46939258b97e7fb66253f68f",22,22,0,22,22,0,1,2
"31772","db60c407099abfd6ae58119ee4fe654a",58,34,78,5.20512820512821,58,0,2,1
"31773","db6274b9dbd9884e8e0ac2e1515c191d",37,28,34,7.61764705882353,37,0,2,1
"31774","db640a02ae6955e8a8b9166be1d82ff4",184,121,50,25.76,184,0,3,3
"31775","db65119bd42fbdecd482242ef4b446cc",70,62,32,15.3125,34,36,2,1
"31776","db67e0099c4251f82e692ebb2dd6b935",98,67,48,14.2916666666667,98,0,2,3
"31777","db68f8e31c56acad3163dc1fb70d9561",42,31,25,11.76,42,0,2,1
"31778","db6c0cc3ae2ad6167a06d21277db84ee",14,14,0,14,14,0,1,2
"31779","db6f3e479fff64dab42636434271851c",28,28,0,28,28,0,1,2
"31780","db6f60c959c3dd04875c18f17b53854d",124,80,77,11.2727272727273,124,0,3,3
"31781","db705f105e49b7e2bd2a54efc86d7414",59,45,15,27.5333333333333,59,0,1,1
"31782","db70e4a2cafb3ec0f130ad11d341429a",16,16,0,16,16,0,1,2
"31783","db71a02f592b9bf384a178548045bceb",23,23,0,23,23,0,1,2
"31784","db725cbedd68534874c0cab01e16c84b",80,48,63,8.88888888888889,80,0,2,3
"31785","db72f4390d29765f663b538277936914",91,46,73,8.72602739726027,91,0,2,3
"31786","db735afaa8e8d3712262f47ed73fbdff",66,47,63,7.33333333333333,66,0,2,3
"31787","db75f8b69e2a9eb9d578d5cfc14e106c",55,47,21,18.3333333333333,55,0,2,1
"31788","db80a2e6239ac035f5c52ffa38753db2",35,35,0,35,35,0,1,2
"31789","db8369da64f34e9f7acc77b7a8fb111d",74,62,16,32.375,29,45,1,1
"31790","db864a439a37fbfe0b96273cd2176ada",139,103,48,20.2708333333333,139,0,3,3
"31791","db87145e13f55502bdec282dce95df7d",96,54,63,10.6666666666667,96,0,2,3
"31792","db8749c9e787473a3dedfa5e296834fd",66,53,41,11.2682926829268,22,44,2,1
"31793","db8a9294331989ad59b76824f4eeae8b",105,62,52,14.1346153846154,105,0,2,3
"31794","db8da18d07f24fb4fe1cd917014a5116",201,113,68,20.6911764705882,201,0,3,3
"31795","db8f1a40a15f7a69e224e48e7613722c",28,28,0,28,28,0,1,2
"31796","db92efbf7c01fc8d5cc57f73042270a5",30,30,0,30,30,0,1,2
"31797","db93fb83664d24ca955c3bef24664b7d",32,32,0,32,0,32,1,2
"31798","db94b088aad770eabab65c471c557cdf",36,36,0,36,0,36,1,2
"31799","db955c83a0b6b2c0d7cc5abfbb6cb56c",1,1,0,1,0,1,1,2
"31800","db976ee97c3b112e9707637de6a162a8",185,108,90,14.3888888888889,185,0,3,3
"31801","db9a99751f09d23f52bcaa2ea3961eb2",37,37,0,37,37,0,1,2
"31802","db9b70986abfeb715b00fa391655c136",46,41,36,8.94444444444444,46,0,2,1
"31803","dbabd129e55101e283594a62b1160ff7",61,49,26,16.4230769230769,61,0,2,1
"31804","dbad922413407faed7eed0fa943b64c2",48,43,9,37.3333333333333,48,0,1,2
"31805","dbae5b815718304d65a3cd4af0e23281",124,91,63,13.7777777777778,124,0,3,3
"31806","dbb0cbbae3c34f3f360232deff9f7fae",96,41,70,9.6,72,24,2,1
"31807","dbb58cd59bdfd3469a233692902ddfd1",44,34,25,12.32,44,0,2,1
"31808","dbb63be4a4090a212dcb3a1291a1f518",9,9,0,9,9,0,1,2
"31809","dbb71608751bd085fd31aa4b29efacf2",162,71,88,12.8863636363636,132,30,3,3
"31810","dbb95806e3fcfe2d7e595c3552364898",47,39,17,19.3529411764706,47,0,1,1
"31811","dbb9bc140498264a710e9d1367a085b5",49,49,0,49,49,0,1,2
"31812","dbbae19080973356b7bf9f7c7ebc2343",10,8,35,2,10,0,2,1
"31813","dbbb1d1743b7346c759039f66f9fd476",45,36,54,5.83333333333333,45,0,2,1
"31814","dbbd208dd15d6ec8c8ebf6b2c4402712",183,87,77,16.6363636363636,183,0,3,3
"31815","dbc10ffabe352216d9ee6962a510f0b9",39,39,0,39,39,0,1,2
"31816","dbc149ab657b3c0ab093252e4ae52c46",20,20,0,20,20,0,1,2
"31817","dbc192eebaadc2671279f7e2725e4f84",10,10,0,10,10,0,1,2
"31818","dbc2ed4fef878c1ecdabbb96f9692626",35,35,0,35,0,35,1,2
"31819","dbc74169b4603691bab4672816201334",36,34,45,5.6,36,0,2,1
"31820","dbcf7a920f458096d022f38337fbc3c4",27,27,0,27,27,0,1,2
"31821","dbcfeac72040e9e52328c98059f7dd91",28,28,0,28,28,0,1,2
"31822","dbd1475b817f76abf19a4d711a3a91a5",172,95,47,25.6170212765957,124,48,3,3
"31823","dbd2baa2ea9f3fc4c6fed112dcc4658a",37,35,21,12.3333333333333,37,0,2,1
"31824","dbd6ef2a20c251928a1a6710823a6aec",31,26,21,10.3333333333333,0,31,2,1
"31825","dbd88094d8ba08116b6fca0843318680",61,34,56,7.625,61,0,2,1
"31826","dbd8f002a7f7027ab408b22d7a6a2f16",38,38,0,38,38,0,1,2
"31827","dbd9c1d589b4ece2ce78a0c7199e3835",72,68,25,20.16,72,0,2,1
"31828","dbd9cfabc7c9ca95c85b682356d5d23d",111,87,65,11.9538461538462,111,0,3,3
"31829","dbdaafdcb7bc7e093763b24e02fc57e9",48,44,20,16.8,48,0,1,1
"31830","dbdcc3081c733ba7c0f629e5b176f7a1",48,48,0,48,48,0,1,2
"31831","dbdd9577435b89d9749de98776d5a7b9",53,41,69,5.3768115942029,36,17,2,1
"31832","dbe25e287aa43e8f3943faa943555268",69,55,44,10.9772727272727,69,0,2,3
"31833","dbe2fb6d02a13b07fce67f440e062cee",2,2,0,2,2,0,1,2
"31834","dbe33710a956f08374f4cf9f6813860a",32,32,0,32,32,0,1,2
"31835","dbe41c10a8e4611daca1c8a8cbb09060",36,36,0,36,36,0,1,2
"31836","dbe4a8b0302eda3dea33bd2bd49fe71d",141,119,70,14.1,141,0,3,3
"31837","dbe89f45af4c7202858c772c49faf22f",47,47,0,47,0,47,1,2
"31838","dbea0dc923b0745236f1203f85d9c58d",235,80,77,21.3636363636364,183,52,3,3
"31839","dbeaa5e3419419cbbb2d63cb9178e9e9",45,39,41,7.68292682926829,45,0,2,1
"31840","dbee3e8140ddb21d7dc109231c1a1202",21,19,55,2.67272727272727,21,0,2,1
"31841","dbf86cda13638ca86c942cfb639fe37b",32,32,0,32,32,0,1,2
"31842","dbfa88a0042cc438a92963e5cc8b49e6",19,19,0,19,0,19,1,2
"31843","dbfdc289a2bd1d6c0acd96daa49c9c64",20,20,0,20,20,0,1,2
"31844","dbfdf16670c084a25641d7f7881df014",117,51,83,9.86746987951807,117,0,3,3
"31845","dc01902da2c239245621339a4c033c15",32,31,4,56,32,0,1,2
"31846","dc01ef022ce33a788babc4f51c3792e6",19,19,0,19,19,0,1,2
"31847","dc041dbf7db478f092643b0a3b9c9cca",38,27,27,9.85185185185185,38,0,2,1
"31848","dc05524d79ad79939727b6b7579539cd",148,101,62,16.7096774193548,148,0,3,3
"31849","dc07f026a5357be0ed79ab4b1e008d34",264,141,81,22.8148148148148,215,49,3,3
"31850","dc0b88750181d105f6599e9cd0721562",39,31,35,7.8,39,0,2,1
"31851","dc0b91af29c5a3ebe3bf4ccfbcf4e553",59,43,25,16.52,42,17,2,1
"31852","dc1097a7bf2d67ec3c3b55eee338f085",13,13,0,13,13,0,1,2
"31853","dc15ccbcc2f74bb40a254940f865febd",69,60,86,5.61627906976744,38,31,2,1
"31854","dc168c9c7193b43a3201744f5b9f518a",49,44,85,4.03529411764706,49,0,2,1
"31855","dc1690722dede64fff80f3a7563b3ea9",48,39,29,11.5862068965517,48,0,2,1
"31856","dc1a5c3814f9ddbddca2f7afbef18f86",33,33,0,33,33,0,1,2
"31857","dc1b8b2566c183d995fae550abf1e601",94,63,36,18.2777777777778,94,0,2,3
"31858","dc1bc37b864b990bd7c225a653606639",145,84,81,12.5308641975309,145,0,3,3
"31859","dc1c01a730aebe3b5438b3716108f958",32,32,0,32,32,0,1,2
"31860","dc1cc414745bf8e5fe27a2b05d75c3f1",9,9,34,1.85294117647059,9,0,2,1
"31861","dc1d6a5ea8a08c958ceda03a2fefc83e",35,35,0,35,35,0,1,2
"31862","dc201a3699da50d047d2bde9360cf158",55,55,0,55,55,0,1,2
"31863","dc2095c369b21a027de94d57e398cdf6",46,46,0,46,46,0,1,2
"31864","dc21a45273ed282ff515c3db878c4531",101,78,38,18.6052631578947,101,0,3,3
"31865","dc21f9b87f64cf237093bd32334de063",18,18,0,18,18,0,1,2
"31866","dc233512782923bfe98c1da45eb53ba2",96,54,75,8.96,96,0,2,3
"31867","dc2406f5773fb133aed82bba9f523cb1",15,15,0,15,0,15,1,2
"31868","dc24548d8271da90c950ed83b16659be",24,24,0,24,24,0,1,2
"31869","dc245e2990ba316635af8975f61ed8b2",4,4,0,4,4,0,1,2
"31870","dc254ece445761b355a3d8397325669e",37,37,0,37,37,0,1,2
"31871","dc26ed56d81e2010e9f9f117535b22aa",109,81,54,14.1296296296296,109,0,3,3
"31872","dc2769fa845e2c0d8a3630f9da873de0",8,7,50,1.12,8,0,2,1
"31873","dc27dfe613c84a5fbac014a37e258234",51,46,14,25.5,51,0,1,1
"31874","dc28144e74b1c21ac6b64d86bc56c5a6",136,99,49,19.4285714285714,136,0,3,3
"31875","dc2ae1ec7742bf34f5585044c5db273f",51,51,0,51,51,0,1,2
"31876","dc2e0937a62b65647f6be97d3b2b7199",23,23,0,23,0,23,1,2
"31877","dc2e7bdbcf148fc017b203386d293740",178,63,75,16.6133333333333,147,31,3,3
"31878","dc3075c0cf5f52cbf1d1b18699c2e945",71,54,30,16.5666666666667,71,0,2,1
"31879","dc308b5a0a2a8f2d61724dbfcd5210c8",21,21,0,21,21,0,1,2
"31880","dc30dcba43285b2096a8d69fa7fa3343",222,104,79,19.6708860759494,169,53,3,3
"31881","dc343c02f90293416825fcbccfa6031f",144,72,70,14.4,144,0,3,3
"31882","dc373ac7ecf512a436627de3222b0a11",122,75,83,10.289156626506,122,0,3,3
"31883","dc3f0c7f1d0008492515fd5433804392",27,27,0,27,27,0,1,2
"31884","dc40080cdd0eac577af8a5ffe7be6b54",18,18,0,18,18,0,1,2
"31885","dc4041990cc4b77f7c5e4694dd04c551",34,34,0,34,34,0,1,2
"31886","dc40a3a67dc787ae05f4a06029b2b362",152,96,76,14,152,0,3,3
"31887","dc45bce62aa5d9f18222e36345a43c0a",36,32,63,4,36,0,2,1
"31888","dc461482667a656979e66616e8dbd91d",44,34,44,7,44,0,2,1
"31889","dc4680a784f397b6ddb2c2094cad2aa7",180,85,84,15,180,0,3,3
"31890","dc49cb4acaa69fc78ee559b45d39f57c",127,75,57,15.5964912280702,105,22,3,1
"31891","dc4a83b889f5c5691287925696acf20a",110,58,72,10.6944444444444,94,16,2,1
"31892","dc4ad3dbd3629c864492b6a926549498",18,18,0,18,18,0,1,2
"31893","dc4d1bfeeb69a82b13248940b06115a4",21,17,42,3.5,21,0,2,1
"31894","dc502b2d15d535e9d16b40ad05d3d8cc",217,64,76,19.9868421052632,217,0,3,3
"31895","dc53c78bc63b1320fc2913ffd31148d2",14,14,0,14,14,0,1,2
"31896","dc58da1d1029ba679526c6013b73d991",36,20,58,4.3448275862069,36,0,2,1
"31897","dc5da6d37ba0ad9b104b6e3b31d18141",24,24,0,24,24,0,1,2
"31898","dc5e04af4b39af4c3861d0bffed553ce",75,53,28,18.75,75,0,2,1
"31899","dc615adb079050a9aad52de8c29750cb",181,95,70,18.1,181,0,3,3
"31900","dc62b68b3812cf6820310f667f1d62f0",96,70,44,15.2727272727273,96,0,2,3
"31901","dc6533171e27f07bdf99dbdb0eaf095d",46,43,14,23,46,0,1,1
"31902","dc67ac2529831553bb98a86297bc5a6c",18,18,0,18,18,0,1,2
"31903","dc68cb7e2aba23911d417a9b9e483471",144,93,83,12.144578313253,144,0,3,3
"31904","dc68d33fb378660b28c4252e3513ecdb",53,53,0,53,53,0,1,2
"31905","dc6f8f7c501b2f93b49c871c7cb5715f",33,33,0,33,33,0,1,2
"31906","dc7122fa1130d2cd019c9fbdff4d323f",29,18,62,3.2741935483871,29,0,2,1
"31907","dc719b2ed143e3df3edb9672c75cf564",52,52,0,52,52,0,1,2
"31908","dc755b5a6be52948b2698029ceb20400",70,52,40,12.25,70,0,2,3
"31909","dc7916ea74ce4f72ffa04f5cd335aea1",29,29,0,29,29,0,1,2
"31910","dc81e91400c76a6454c97cca0a12395b",46,46,0,46,46,0,1,2
"31911","dc831daf898f057329bdd1676d347fc2",54,41,26,14.5384615384615,23,31,2,1
"31912","dc86bd930696b1bc4b873bb47cfba06a",29,29,0,29,0,29,1,2
"31913","dc8908efe20cd7ce3a952f3d3fd9d787",142,64,82,12.1219512195122,142,0,3,3
"31914","dc895fae52837348a26f08fa0e8db1d0",6,6,0,6,6,0,1,2
"31915","dc89831c818f442c4f0cf715d62a5e28",20,20,0,20,20,0,1,2
"31916","dc8a16db26762473c357bc3e33c0f473",77,57,75,7.18666666666667,77,0,2,3
"31917","dc8b187bbbdb3b735ecbf7f2ea503f03",23,23,0,23,23,0,1,2
"31918","dc8d7076e4e8ba59ba092e1d553228f5",27,27,0,27,27,0,1,2
"31919","dc8e21f925a213acb393b60d0e02a59b",71,46,73,6.80821917808219,71,0,2,3
"31920","dc8ffa5ae716ad6abb79e3e1fd17f174",13,13,0,13,13,0,1,2
"31921","dc92291051c4882c4a728d880d38dc41",64,56,35,12.8,64,0,2,3
"31922","dc956fee6e15278f6b75f3e692241b8b",183,90,63,20.3333333333333,150,33,3,3
"31923","dc9606c4227ac07eefb3cade0408c900",15,15,0,15,15,0,1,2
"31924","dc98fe0140ea353873a63c8aa2bb6bc3",208,111,83,17.5421686746988,154,54,3,3
"31925","dc9ae350b47bcb0212eedf899266985d",27,27,0,27,27,0,1,2
"31926","dc9caefd421eb27554a2aabb518b427f",44,42,82,3.75609756097561,9,35,2,1
"31927","dc9cd33af766549d0ec1276e26ec5dad",37,34,33,7.84848484848485,16,21,2,1
"31928","dc9e5c55b305d7dd31beb06d7ffb4a94",11,6,62,1.24193548387097,11,0,2,1
"31929","dca017401d76bb166716355e4ba96fe9",32,15,62,3.61290322580645,32,0,2,1
"31930","dca0428baa6a31f404502cb1b428bca6",53,37,39,9.51282051282051,25,28,2,1
"31931","dca05d27025187853524d1a5fca6cf1c",49,49,0,49,49,0,1,2
"31932","dca06872d2e50cb478f18acc0c7c8eeb",100,62,70,10,64,36,2,3
"31933","dca16fe6a86b0283d9f5d2428f5e6c5b",188,66,76,17.3157894736842,154,34,3,3
"31934","dca34e75bfeb5e54b4ce4984524fdfeb",31,31,0,31,31,0,1,2
"31935","dca375a41c932bc2912d86e89639d53b",52,36,74,4.91891891891892,35,17,2,1
"31936","dca3c945ea168e8de156e7c69d2b6f37",130,52,86,10.5813953488372,79,51,3,3
"31937","dca5dbdb16e1b7ee58a0fa63c2156659",93,72,21,31,93,0,3,3
"31938","dca779b760e335d9a7eabb45e63890da",66,51,50,9.24,66,0,2,3
"31939","dca87f97fbb5db67b12882d76efd9888",73,50,68,7.51470588235294,73,0,2,3
"31940","dca9445852554688cfda429f6f665030",82,67,50,11.48,82,0,2,3
"31941","dca96857d7ba707396bc88fd38731a52",20,20,0,20,20,0,1,2
"31942","dcabd447ef11ec7520a7734cb41c14d3",23,23,0,23,23,0,1,2
"31943","dcacfeede4f907a7cbe3de62a661c126",56,52,14,28,56,0,1,1
"31944","dcae948832193baa30ffc52b5adec68c",29,29,0,29,29,0,1,2
"31945","dcb111163e0dcbdaee5656b9003ea82c",32,30,6,37.3333333333333,32,0,1,2
"31946","dcb64a4b31ddf86bd4af53ef5a418608",119,75,36,23.1388888888889,119,0,3,3
"31947","dcb65119ccc8e1310ecce22e25233909",23,23,0,23,23,0,1,2
"31948","dcb855c418b0cc0c4474101b3c2f8dc2",50,50,0,50,50,0,1,2
"31949","dcb8bb3a6683c6031c338e29d0562bff",65,58,54,8.42592592592593,65,0,2,3
"31950","dcbc02ea0e5e063026fa727c97aa9470",46,44,43,7.48837209302326,16,30,2,1
"31951","dcc0689bdf9ca0f63dd0255368c04597",95,66,30,22.1666666666667,43,52,2,1
"31952","dcc4f046079415e82bd5a81044da11f4",22,22,0,22,22,0,1,2
"31953","dcc91db87e8d457ec08a118701944fe6",51,51,0,51,51,0,1,2
"31954","dcc9da5cc806aa1eb14c55eef56394aa",31,31,0,31,31,0,1,2
"31955","dccba2348d72cccc87c7f30073059e69",58,40,16,25.375,58,0,1,1
"31956","dccdd016cea25edc38b40475040de068",31,31,0,31,0,31,1,2
"31957","dcd174539e18a5e91bc8ef53c334758d",38,32,10,26.6,38,0,1,2
"31958","dcd20df72de5d71b49b30390198e8564",33,33,0,33,33,0,1,2
"31959","dcd551c62cc1b6b0c392e49bac791e97",47,20,81,4.06172839506173,47,0,2,1
"31960","dcd5593be681722d97e61e45c75aceb0",33,28,38,6.07894736842105,23,10,2,1
"31961","dcd8616d4346aaa3c9850efed7979764",28,28,0,28,28,0,1,2
"31962","dcda34117166713913b5c29a3869662b",80,65,31,18.0645161290323,80,0,2,3
"31963","dcda7c8015976b7b698b8d34e54af6d7",62,48,17,25.5294117647059,38,24,1,1
"31964","dcdca816b4761e78113529bc101f2886",15,15,0,15,15,0,1,2
"31965","dcdfef864ccbc289fe9e6e6abd4d2035",29,29,0,29,29,0,1,2
"31966","dce18d1756214122ac7d75646b819e59",42,42,0,42,42,0,1,2
"31967","dce24d438798efda33a4370a7c1d24f7",49,49,0,49,49,0,1,2
"31968","dceebcfa572382c6eec7aa83320a8c54",42,42,0,42,42,0,1,2
"31969","dceed96695b20431740a107bdcbab6e0",20,20,0,20,20,0,1,2
"31970","dcf12011dea98c3b30ca8a0a0a993c60",36,25,62,4.06451612903226,33,3,2,1
"31971","dcf1c408ec10f14e87f63d3bfd68c8de",8,6,76,0.736842105263158,8,0,2,1
"31972","dcf1e31ca66301a83cd9f3ffd68f8032",65,56,71,6.40845070422535,65,0,2,3
"31973","dcf43794428453ec6ea6ce33bc9770bf",30,30,0,30,30,0,1,2
"31974","dcf49f66fec11473096b06e8a493dbe7",48,48,0,48,48,0,1,2
"31975","dcf67ca00d064e8659d8345d0a6e63a4",222,148,62,25.0645161290323,177,45,3,3
"31976","dcf9aa06242c871f49ab4108ea87712e",27,27,0,27,27,0,1,2
"31977","dcfa1dfcd36266d3b7c1e70573212e59",47,28,56,5.875,47,0,2,1
"31978","dcff4a5d99303858218154cbd4fb54d7",82,57,63,9.11111111111111,49,33,2,1
"31979","dd001fd65c14442e2f2a79a0bdaac6c1",20,20,0,20,20,0,1,2
"31980","dd0586ce8b193d9c60055472755612c4",15,11,62,1.69354838709677,15,0,2,1
"31981","dd077728e1ce5455b8dc9b25f5676594",50,49,26,13.4615384615385,16,34,2,1
"31982","dd087d94fadca5ac19671e5d693476b4",28,28,0,28,28,0,1,2
"31983","dd0e205f96d6f128339ef9eebec5ae78",194,131,77,17.6363636363636,153,41,3,3
"31984","dd10097eaad9e9954cef89a6d5a3dfc4",153,89,61,17.5573770491803,153,0,3,3
"31985","dd10cb78389b9e49880d819fd56ef623",86,61,49,12.2857142857143,86,0,2,3
"31986","dd10d57ade267ed48068154c96ee2aaf",86,64,72,8.36111111111111,58,28,2,1
"31987","dd12da0b963bd96d02297d715768a994",147,86,58,17.7413793103448,106,41,3,3
"31988","dd13702a6c97cf1ffa4e9a3d0be50d14",51,51,0,51,51,0,1,2
"31989","dd13f137551262ec8846044515874482",31,31,0,31,0,31,1,2
"31990","dd151a3c5021fe10fd678466f239b333",12,12,0,12,12,0,1,2
"31991","dd179f1f4d9f8df48b5b2242f4ee1690",219,103,83,18.4698795180723,170,49,3,3
"31992","dd18d946b2258905f46aedb5d60ffc6d",194,120,70,19.4,194,0,3,3
"31993","dd1a44e4ded54e8d98c0b2670199f9a5",17,17,0,17,0,17,1,2
"31994","dd1d74058936658e26bbabc07a2048f9",40,40,0,40,40,0,1,2
"31995","dd1e4e0ad5c6ffd3224020b72a54df87",5,5,0,5,5,0,1,2
"31996","dd1ed0837b6c6fd6e840696c17059975",173,86,80,15.1375,160,13,3,3
"31997","dd21a294344c94db1549250288b0bcc1",23,23,0,23,0,23,1,2
"31998","dd22f0c2485e3152a74f1417c3585762",43,43,0,43,43,0,1,2
"31999","dd2670b6d44b0c937812bcdf3e5db0fc",7,7,0,7,7,0,1,2
"32000","dd268a049c60922db3eb2dd131b439be",26,26,0,26,26,0,1,2
"32001","dd2b2568e4be6e3101f6ff7fb88ac43a",9,9,0,9,9,0,1,2
"32002","dd2b8993fc405681ac5985afca901e5e",34,34,0,34,34,0,1,2
"32003","dd2ca394cfcf8fc6cc106482daceb6df",70,50,34,14.4117647058824,70,0,2,1
"32004","dd2e5fcc1a9611393aaa6fe7704d310d",7,7,0,7,7,0,1,2
"32005","dd32b88f44fff12f866088df46036eaf",66,49,60,7.7,66,0,2,3
"32006","dd33cb276af520085b47f766d64f24f8",28,28,0,28,0,28,1,2
"32007","dd341d5a99f46c4a8f2158afa3859ec9",24,24,0,24,0,24,1,2
"32008","dd36149164065092a206ca63136c8c29",22,22,0,22,0,22,1,2
"32009","dd38eb2125d9b36d8b79527da4da78d4",30,30,0,30,0,30,1,2
"32010","dd3c234af039b0028de1b964aed5b4b0",24,24,58,2.89655172413793,24,0,2,1
"32011","dd3e6d8ef75c44675d8b2b09342e92a8",36,36,0,36,0,36,1,2
"32012","dd401865ddf539318294e3a2e8102a5d",40,40,0,40,40,0,1,2
"32013","dd4103fc45e1af1dc6a09c03df830834",27,21,6,31.5,27,0,1,2
"32014","dd445bbffabb19faa7ba703dd5d33ba4",37,37,0,37,37,0,1,2
"32015","dd44cb5bd049ffa2dc5d169d8a5c7f28",32,32,0,32,32,0,1,2
"32016","dd45c8cb47a744743cbf82bc3de43d2b",39,39,0,39,39,0,1,2
"32017","dd46bfd498e2db2ae8e60606aba8f134",20,20,0,20,20,0,1,2
"32018","dd49c134dd8b233e625f8088de19ee43",101,62,61,11.5901639344262,101,0,2,3
"32019","dd4a6717da30e673b43941d49c8376de",89,67,71,8.77464788732394,89,0,2,3
"32020","dd4bc3f99bb89c1283200b31bd199705",63,56,61,7.22950819672131,20,43,2,1
"32021","dd4c64c3d8f4770b16d9ab19c1ec9e29",19,19,0,19,19,0,1,2
"32022","dd4cad2a0567374b2479fb930ae3720a",132,60,74,12.4864864864865,101,31,3,1
"32023","dd4d081dc5bde86f59593dd69d44bff9",21,21,0,21,0,21,1,2
"32024","dd4db0a32254511b7c49cd4f37b800d3",76,56,49,10.8571428571429,76,0,2,3
"32025","dd4efb8d08e400cab46ec8f6a9278ab0",45,44,35,9,45,0,2,1
"32026","dd50c4ed277169c81183d75e9d1e6451",75,50,42,12.5,75,0,2,3
"32027","dd5230be996f55af772f59790f37146b",52,48,15,24.2666666666667,20,32,1,1
"32028","dd5286b90720ec59dd79304d07190459",74,56,54,9.59259259259259,74,0,2,3
"32029","dd5364bedb376927eee82522996a8e94",101,80,14,50.5,101,0,3,2
"32030","dd546532f15c6cb5434c5102a58fd497",14,14,0,14,0,14,1,2
"32031","dd593065410adf3396ad3627e953d500",63,46,23,19.1739130434783,63,0,2,1
"32032","dd599781e219d4880e1bf5536843ef22",34,34,0,34,34,0,1,2
"32033","dd59cd1d3f7457f5dd9c0e11e78c35ad",196,108,56,24.5,196,0,3,3
"32034","dd5be0922b8cd587a1d435504f9018ee",48,42,35,9.6,48,0,2,1
"32035","dd62040c4a0ffca4f33dca4c85fc1d97",22,22,0,22,0,22,1,2
"32036","dd666c88804e9adbea9bcced7ff048f1",36,34,21,12,0,36,2,1
"32037","dd68067f135e21ab74cb7d8fcaaaff29",159,91,50,22.26,108,51,3,3
"32038","dd685dad37abc4352c9b251430c02ba1",48,32,51,6.58823529411765,48,0,2,1
"32039","dd6f854d04722e5bdf7c386cd1bbb433",27,24,31,6.09677419354839,27,0,2,1
"32040","dd70178d10717ba4f66a04f51dad4d3e",56,56,0,56,56,0,1,2
"32041","dd7103f89599801365bfa2070c3d63d6",149,97,59,17.6779661016949,149,0,3,3
"32042","dd71e26f6a3677494fc189dbe78d9bcf",22,22,0,22,22,0,1,2
"32043","dd728a8439b11fd5998da6807937f15d",114,67,51,15.6470588235294,114,0,3,3
"32044","dd74d2ccdbd164c9af11db7ec5ba9de0",123,94,63,13.6666666666667,123,0,3,3
"32045","dd75960116bcac743cf9961f0bbf475e",38,28,24,11.0833333333333,38,0,2,1
"32046","dd7756550376bb2a9a1edc58abff5739",26,22,21,8.66666666666667,26,0,1,1
"32047","dd77c8702c2584d25e9713d185d85031",85,64,28,21.25,85,0,2,3
"32048","dd78710bad81664a1c4908ff34cc6c9b",3,3,0,3,3,0,1,2
"32049","dd7a69566a0372a35c96efe6c23b291d",10,9,29,2.41379310344828,10,0,2,1
"32050","dd7a890926fbaaa2a2eba50cf505de11",21,21,0,21,21,0,1,2
"32051","dd7bf4ebd945fc733c1b5b970b8d593e",230,75,71,22.6760563380282,191,39,3,3
"32052","dd7dae6b0668be3bada3c9e0dccaa923",116,85,68,11.9411764705882,116,0,3,3
"32053","dd7f8eaa3360d94d333af3928678a6d5",16,16,0,16,16,0,1,2
"32054","dd80f4b2d65cffb356d6d0a467da0216",11,11,0,11,11,0,1,2
"32055","dd81caf5ff1110f68e75b958cfd5fac9",76,58,74,7.18918918918919,54,22,2,1
"32056","dd83c3ada1e5db7865a3f2997e226679",41,41,0,41,41,0,1,2
"32057","dd88116f933b60fa71bfda1a8cb38c1c",43,43,0,43,43,0,1,2
"32058","dd892125698a170d31c2a54188c7ddac",164,98,82,14,164,0,3,3
"32059","dd8d958b1ef2221f875d59b91dc9c756",93,73,32,20.34375,93,0,2,3
"32060","dd92217c17530dde03329f88f24b78ef",45,45,0,45,45,0,1,2
"32061","dd9572f3f8847f23c6170b3faeeccdd7",113,84,28,28.25,85,28,3,3
"32062","dd9608d3b423171201b5886bc00c75b9",31,31,0,31,31,0,1,2
"32063","dd966c4d68b46e01bb58d80e470e9309",37,36,5,51.8,2,35,1,2
"32064","dd9774592fd1071b21bca91164b1cccb",190,115,62,21.4516129032258,190,0,3,3
"32065","dd98960621531f2cc01545b8c5930c4e",165,84,77,15,165,0,3,3
"32066","dd98ea1057b9d1a2b434c8631e594a4f",21,21,0,21,21,0,1,2
"32067","dd9aa0d416cb4fa22861bb8421cc0ea0",66,61,82,5.63414634146342,66,0,2,3
"32068","dd9d2e5d30a5706ff55b0c9d9f9f7b78",63,54,14,31.5,63,0,1,2
"32069","dd9dca26e0e9d9ebca7970a3542722b1",28,28,0,28,0,28,1,2
"32070","dd9eef9ad481fb93b02849bfc6cfd4d0",34,33,6,39.6666666666667,34,0,1,2
"32071","dda2fc8e8f6a229d2d0b362c8f997e8e",36,34,6,42,36,0,1,2
"32072","dda55e1f39463d61f486a3112229dcfc",210,81,70,21,210,0,3,3
"32073","dda5ba67a2c031fcc6753606341cf509",18,18,0,18,18,0,1,2
"32074","dda75a342d583ad48f98837d582d9998",65,46,21,21.6666666666667,65,0,1,1
"32075","dda8320a8d9976f371bc4d58988f5e3a",87,53,65,9.36923076923077,87,0,2,3
"32076","dda94d0208841a6025ed5aece9ad9a86",35,25,73,3.35616438356164,27,8,2,1
"32077","ddaa0bb02d0ae8d8a7e9159b4ddf326d",14,14,0,14,14,0,1,2
"32078","ddaa5767ba17d85ca961de001caf7e67",29,27,4,50.75,29,0,1,2
"32079","ddada3d4cb50dc794c4c6ad616da3cf8",39,39,0,39,39,0,1,2
"32080","ddaf4038412dd16e95807ac3c7e518de",132,97,49,18.8571428571429,83,49,3,3
"32081","ddafb5ac3cc3a2f1a9d432efa307273e",54,48,56,6.75,54,0,2,1
"32082","ddb03ca93a22648d76c12fdea3ba5d1a",152,84,69,15.4202898550725,152,0,3,3
"32083","ddb2569dfa994e4e09f9fcee53f29002",25,22,25,7,13,12,2,1
"32084","ddb57fe67b33941f70d78c0fc06e0212",39,32,21,13,39,0,1,1
"32085","ddb6ec511f0329725213cd890a87d480",6,6,0,6,6,0,1,2
"32086","ddb9966d3d949abf553623600f267cad",3,3,0,3,0,3,1,2
"32087","ddbbe12141dfb87e73e1d2516cf11ba4",40,39,26,10.7692307692308,40,0,2,1
"32088","ddbc33e6eda5493a2533583b25fa08b2",9,9,0,9,0,9,1,2
"32089","ddbcfa0195636a6807e710befbc83adf",3,3,36,0.583333333333333,3,0,2,1
"32090","ddbec8fcb6eade53914b0b30bec2f9ee",72,52,21,24,72,0,1,1
"32091","ddbf637dae658175b2a8b9a9c5094404",131,101,61,15.0327868852459,120,11,3,3
"32092","ddc064c6901b52d54b0f042ab26aae80",44,44,0,44,44,0,1,2
"32093","ddc442456ce1fa1cb86d42ddcf3dfa65",20,20,0,20,20,0,1,2
"32094","ddc4d444abfcf8df49dfe6dd7a91b9cc",196,77,83,16.5301204819277,196,0,3,3
"32095","ddc4feb9eaf2fed54ebdff9c20283246",12,12,0,12,12,0,1,2
"32096","ddc5e93948f174acbba8dd1c86d7b716",60,44,35,12,60,0,2,1
"32097","ddc5f130e4ca3f6a6b42b82508c5e622",85,57,62,9.59677419354839,85,0,2,3
"32098","ddc9d55a0cefd878321d4ccde95718f9",108,97,75,10.08,108,0,3,3
"32099","ddca4650846157ede0cfd6e27c707223",210,143,55,26.7272727272727,210,0,3,3
"32100","ddcdfa07f877e0ac7c0a25804ee1b867",95,77,13,51.1538461538462,95,0,1,2
"32101","ddce0db4b1b2f9780ada7a7826a9488e",13,13,0,13,13,0,1,2
"32102","ddcf330d2e95bf376d9b793eae837dc5",99,88,22,31.5,99,0,3,3
"32103","ddd299e08ef07cb9ef30c380d41165ca",28,20,26,7.53846153846154,15,13,2,1
"32104","ddd4bd397a595086f0658314e271946d",23,23,0,23,23,0,1,2
"32105","ddd4c2351558f13acc6c83091cbbcb58",77,55,31,17.3870967741935,77,0,2,1
"32106","ddd50ebe406882cfb6c9ec11d1d19fc1",41,41,0,41,41,0,1,2
"32107","ddd6a0008fcf4676ab8edce697600913",175,102,78,15.7051282051282,148,27,3,3
"32108","ddd75985225e029e929de3b69935d2e0",42,42,0,42,42,0,1,2
"32109","ddd932d0928aedc2d76f54893a57f86a",27,27,0,27,27,0,1,2
"32110","ddd95bbe8ba1e167049cc1698117aaba",2,2,0,2,2,0,1,2
"32111","dddae0ed9a0bdbffff848bd51b91a61e",152,111,68,15.6470588235294,152,0,3,3
"32112","dddd6731cb7e2aeb5c8587d336714ddb",114,76,29,27.5172413793103,114,0,3,3
"32113","dddfc424046b1d8531efb64fc8fd5530",115,82,62,12.9838709677419,99,16,3,1
"32114","dde0ea17838ffbeceaedef5cf82215fc",26,26,0,26,0,26,1,2
"32115","dde11f0a1eb80c4e66ccd7f8de6a2b6b",12,12,0,12,12,0,1,2
"32116","dde12003184174314f2a609154c4872e",251,145,78,22.525641025641,203,48,3,3
"32117","dde18b351994543550f954f1c4ae9bd9",229,120,82,19.5487804878049,185,44,3,3
"32118","ddea59eb81abbb26e6b030b036158626",192,87,61,22.0327868852459,141,51,3,3
"32119","ddeca60326dd8e80a6da76aefaeebb61",47,47,0,47,0,47,1,2
"32120","ddef52df17d6f558676bf4abb302c3d8",1,1,0,1,1,0,1,2
"32121","ddef8be6f18e88f805e6afcd4808350c",32,23,42,5.33333333333333,32,0,2,1
"32122","ddf048c59c790e6e2edf92836e0268fa",42,42,0,42,42,0,1,2
"32123","ddf08ad638eee8f6ed06860fb9d03976",60,49,57,7.36842105263158,28,32,2,1
"32124","ddf3917198112a95834a2031c39c2642",36,36,0,36,36,0,1,2
"32125","ddf71958d67a3ea354e2a8c511ea9653",111,90,44,17.6590909090909,111,0,3,3
"32126","ddf7f2431ff248ecb4c728a9acd82a03",24,21,12,14,15,9,1,1
"32127","ddf92431296e882105870c5d457028b4",9,9,0,9,9,0,1,2
"32128","ddfded9a89f88b2c5365d009c1e4c0a7",23,22,6,26.8333333333333,23,0,1,2
"32129","de00aaf92e79712022e410ac9360a27d",184,92,59,21.8305084745763,184,0,3,3
"32130","de0229707128a61adfc4158bde7ae1cc",81,61,59,9.61016949152542,81,0,2,3
"32131","de026d35ea067a7f32a8600b92abc921",10,10,0,10,10,0,1,2
"32132","de0338dba73377ee391badc1f3800c43",19,19,0,19,19,0,1,2
"32133","de03c283df97d1e78e0983196062f7c1",68,54,68,7,42,26,2,1
"32134","de0553e3885daade3e0108629d79dced",94,65,29,22.6896551724138,51,43,2,3
"32135","de05627c4f46f58e949feec4c4ab3148",57,44,42,9.5,57,0,2,1
"32136","de05eb3a2d80ff92f1100bc543269344",28,28,0,28,28,0,1,2
"32137","de079f54478cc424450c0fb528065fe4",51,51,0,51,51,0,1,2
"32138","de082f368288808313b3c5a969758562",30,20,66,3.18181818181818,30,0,2,1
"32139","de0ad4b37609a2c051a67c1b5e35ac5b",81,73,23,24.6521739130435,81,0,2,3
"32140","de0c8fedaec194deea5b736039082493",93,26,84,7.75,93,0,2,1
"32141","de1846b5c8d93a50e644b985eb02a859",81,49,57,9.94736842105263,81,0,2,3
"32142","de1a806bf2665b3f0ff01cf3d710b72b",4,4,0,4,4,0,1,2
"32143","de1cfbcc945fb7e5705bf84381975205",15,15,0,15,15,0,1,2
"32144","de1f768b03d45d2feeb637e9cd85b4fc",5,5,0,5,5,0,1,2
"32145","de232c9ada14eed355a02b60c8a67698",41,41,0,41,0,41,1,2
"32146","de2391019baaf4b3dd199f8af7d73a15",32,29,72,3.11111111111111,15,17,2,1
"32147","de259b41b7649f82271cc03f2b677285",2,2,0,2,2,0,1,2
"32148","de2683994a8d59d79e676e3c90da5127",84,62,18,32.6666666666667,84,0,1,2
"32149","de27ac802cb09e88c01de8e8f5079f91",82,56,51,11.2549019607843,82,0,2,3
"32150","de280d94839280bbd9556841de32a2f8",74,54,31,16.7096774193548,74,0,2,1
"32151","de28a0e8d223d33762e42b871589ec8b",88,57,27,22.8148148148148,88,0,2,3
"32152","de28fa637e99c24aa26d8fd6481aeb6f",26,26,0,26,26,0,1,2
"32153","de2df45fe7420ec3ee1da08863911c35",55,55,0,55,55,0,1,2
"32154","de33045b6df21e2f102fcbdcac721203",44,44,0,44,0,44,1,2
"32155","de35923a57fce240bb5e87f4efb8e761",117,86,70,11.7,117,0,3,3
"32156","de36694ec5dcfc05618b4da3a5b288ec",50,40,39,8.97435897435897,32,18,2,1
"32157","de369d97e9e249d85a32b792bccf2745",14,14,0,14,0,14,1,2
"32158","de3a02b9aa5683a392c11b2b15f89474",18,18,0,18,18,0,1,2
"32159","de3a27ebba85d99afaa6cd60b046e0bd",33,33,0,33,0,33,1,2
"32160","de3b0f3622d734d9e336fb2235a92a75",203,95,82,17.3292682926829,184,19,3,3
"32161","de3b9ad0bc4b17c4247b696101abd5f1",95,64,89,7.47191011235955,95,0,2,3
"32162","de3bdac1a826ce7002071dd0027b1d03",54,42,27,14,23,31,2,1
"32163","de3c83adcb20875505e847bfa2783e6c",95,60,67,9.92537313432836,59,36,2,3
"32164","de407a972212de16af797ca568087fa7",151,86,61,17.327868852459,111,40,3,3
"32165","de40ea1676397585790454ac66ce36c4",174,123,50,24.36,174,0,3,3
"32166","de44f9674507bc2fe5bcada4a0131fd9",44,32,33,9.33333333333333,44,0,2,1
"32167","de46d3d031cded1e0e7671226e834c83",80,55,48,11.6666666666667,80,0,2,3
"32168","de48ebf37a104c646d0457e72bfa0f0b",98,74,43,15.953488372093,98,0,3,3
"32169","de4b49290cbc7f051a7e579fdd173bbf",7,7,0,7,7,0,1,2
"32170","de51601b879be7bf26739073aca95483",59,46,44,9.38636363636364,59,0,2,1
"32171","de52c85249fbb924d5dece595b7db945",47,47,0,47,47,0,1,2
"32172","de5682d89f477de04b239e673c65dd5d",13,13,0,13,13,0,1,2
"32173","de577896db27178e2a5e03c7db6c0adf",16,16,0,16,16,0,1,2
"32174","de579e08d24228c5a1f36b7a460ed47c",65,37,56,8.125,65,0,2,1
"32175","de5cde37da3234e174ed2c5a938b8828",116,77,26,31.2307692307692,116,0,3,3
"32176","de609df6b89e6ee0b0381801a33e7962",80,64,14,40,80,0,1,2
"32177","de61a892f8c1a10bad31f45d06d3f923",85,64,48,12.3958333333333,57,28,2,1
"32178","de61ee5fa48a7d6dfc6725923573fe75",29,29,0,29,0,29,1,2
"32179","de620911ff51de5c9e28633d79dc5da0",77,55,40,13.475,57,20,2,1
"32180","de623f04b73b80d38b0c5b88a22f335a",44,30,25,12.32,24,20,2,1
"32181","de6433a3d6a82ce6c6eb1578b12b7c03",168,80,62,18.9677419354839,168,0,3,3
"32182","de6981c43b417cd7aa4ef7a4635bcee0",13,12,21,4.33333333333333,13,0,1,1
"32183","de6b57bd8cc5a78a897548a829238082",23,23,0,23,23,0,1,2
"32184","de6bb96e9b2888b97147073423853015",22,22,0,22,22,0,1,2
"32185","de6de896efff63662ba1b736a24dfc4a",90,51,62,10.1612903225806,90,0,2,3
"32186","de6eb56c62621d1d480aa145e7ad9764",84,57,58,10.1379310344828,84,0,2,3
"32187","de6eb5d3ac13d89b31201bf9cafc9b2c",116,70,22,36.9090909090909,116,0,3,3
"32188","de71dd81befe8964ec0f8a61bac9ac5f",153,105,70,15.3,153,0,3,3
"32189","de723677ed6e4a10d730de59a82cbe29",1,1,0,1,0,1,1,2
"32190","de76113c34d38de299fb6f0dc97d887d",43,36,11,27.3636363636364,43,0,1,1
"32191","de771237345363d7db2482900035a056",35,35,0,35,35,0,1,2
"32192","de78ef994a5be1767359ed93e53fb550",29,29,0,29,29,0,1,2
"32193","de78f0c9cc5e92461ff100a83c9d8ffc",106,83,23,32.2608695652174,106,0,3,3
"32194","de79ec140a35fc905c560da9a216222a",40,40,0,40,40,0,1,2
"32195","de807ff37329232e45ec6e7f4a646b4e",37,19,83,3.12048192771084,37,0,2,1
"32196","de81ff176ec5226052bf9dcfb4b4f5d0",35,35,0,35,0,35,1,2
"32197","de82c089de13931d22dd0386772ff1d6",30,30,0,30,0,30,1,2
"32198","de8305e2cc8a2016a60df5b0ffbcea76",79,58,64,8.640625,79,0,2,3
"32199","de85761e9fd2bb241653e514ff9955c8",157,120,55,19.9818181818182,157,0,3,3
"32200","de85d81447efd3b3adbaae7570a3691d",78,68,15,36.4,78,0,1,2
"32201","de88413cc84f258a0bcc3fc59d96481d",1,1,0,1,1,0,1,2
"32202","de890f7218a6aeca7a4ee6975e6d28a2",89,72,28,22.25,89,0,2,3
"32203","de895866b90e27d6733ce491f55cc67e",16,16,0,16,16,0,1,2
"32204","de8f18106e136eb8e7f267a15cadd0ec",20,20,0,20,0,20,1,2
"32205","de90caaa158a4bd27b6ab9e2e1749c23",30,30,0,30,30,0,1,2
"32206","de93fadf6bb840ec75d9188bbe324f55",73,53,52,9.82692307692308,73,0,2,3
"32207","de967b7d6e7e282d3868b70fce1589ef",51,51,0,51,51,0,1,2
"32208","de98439b4afba8b92faa45f03fe76f9a",21,18,17,8.64705882352941,21,0,1,1
"32209","de9919f4fa21e1d7d0f83f0af9f4b1d3",164,92,69,16.6376811594203,164,0,3,3
"32210","de9b3599e332486220ba57779d2aa4a5",29,29,0,29,29,0,1,2
"32211","de9d0a619b6caa671abb0c001f8016ab",49,49,0,49,49,0,1,2
"32212","de9f2229bfc3db06aeb91d835db0b6e7",60,52,70,6,60,0,2,3
"32213","de9fff87b4ca1038809e5e4b1294eb48",8,4,63,0.888888888888889,8,0,2,1
"32214","dea131d302fdc5149efaa5b3e8191745",12,8,40,2.1,12,0,2,1
"32215","dea47b353e643c983912cac528dfd026",10,10,0,10,10,0,1,2
"32216","dea7f8d0cb979fc116cdbb9863365c26",8,8,0,8,8,0,1,2
"32217","dea835e8ba4eff43eb6423876490f22c",42,42,0,42,42,0,1,2
"32218","dea93120e98a61ff0d79a1fdce7f9208",27,27,0,27,27,0,1,2
"32219","dea95e929382309982e27e50f988be24",54,45,55,6.87272727272727,54,0,2,1
"32220","deaa8f26b8c7c3830327011dd96092cd",21,21,0,21,21,0,1,2
"32221","deaefa57cc5ab82e0d5e9e51078c0d60",44,44,0,44,44,0,1,2
"32222","deb4eae179d57235ba633139b0fd72d5",8,8,0,8,8,0,1,2
"32223","deb612cc711071a01b0217c897132e2c",20,19,7,20,20,0,1,2
"32224","deb6e951170a0b2fca46db43ae857c15",113,79,65,12.1692307692308,113,0,3,3
"32225","deb862141e3a1845c9dd144f82b749e8",132,112,61,15.1475409836066,77,55,3,3
"32226","deba3c0776105b27a28bf478b0e0cb48",84,65,59,9.96610169491525,53,31,2,1
"32227","debb0aedfeb11b08a0e2c0b255e1c3f2",43,43,0,43,43,0,1,2
"32228","debc8038539ebcd70e0895548d41a5d5",77,44,49,11,77,0,2,3
"32229","dec3e4f29d51171b7edcc31abe68cc5f",175,87,70,17.5,175,0,3,3
"32230","dec47bef498e1d5611d7f34c641a4bf0",7,7,22,2.22727272727273,7,0,1,1
"32231","dec540ee7b0401d9e884fe7dbbb00cb7",33,33,0,33,33,0,1,2
"32232","dec6164779d5f23e25622f93be7a0cc3",79,58,30,18.4333333333333,36,43,2,1
"32233","dec6d663a03127abc3796b6366530c56",44,44,0,44,44,0,1,2
"32234","dec74e12bb3248257d11100a660a147f",86,78,63,9.55555555555556,86,0,2,3
"32235","decb1883a8159f34b9f54f227012c0b7",85,52,63,9.44444444444444,85,0,2,3
"32236","decb8a40b2211336434050b03d5a17a5",196,61,83,16.5301204819277,196,0,3,3
"32237","decc30b2ceaee8b705bba62493093f9c",166,89,55,21.1272727272727,133,33,3,3
"32238","decee14b6bc7b8dda5313d71580bb1a2",104,64,67,10.865671641791,56,48,2,3
"32239","decfb3e160195deaca4503a8fdb1c2ee",32,32,0,32,32,0,1,2
"32240","ded3129220ea559a02358614cc2a1e44",190,115,54,24.6296296296296,190,0,3,3
"32241","ded3bb339f7e036f81189d53ff64706a",27,27,0,27,27,0,1,2
"32242","dedbc30e174055b1322b2c6a96a6a1ab",25,25,0,25,25,0,1,2
"32243","dedc69178a7228b751f5e7a10fa0ac00",56,38,70,5.6,56,0,2,1
"32244","dedd7d7beb920afd852fee0d61420dc0",39,39,0,39,39,0,1,2
"32245","dedf620b1af8e4e8934b8e3dbe4e32e8",215,84,85,17.7058823529412,196,19,3,3
"32246","dee0f1f295e47f9e51f73f645538244f",45,26,58,5.43103448275862,16,29,2,1
"32247","dee29c43e2fadafe1d5909f0410e241b",75,62,17,30.8823529411765,33,42,1,1
"32248","dee2c88d063022849400c528585191c9",129,93,69,13.0869565217391,129,0,3,3
"32249","dee4ffaa9aa745595807cd0b483ac578",14,14,0,14,14,0,1,2
"32250","dee605fbf2a12312a79de0be3363e05e",101,85,17,41.5882352941177,52,49,3,3
"32251","dee65cff545f997601126821ee96e8c9",12,12,0,12,12,0,1,2
"32252","dee65f5dca818d2bb0e9e63847cd0c0e",117,86,77,10.6363636363636,117,0,3,3
"32253","dee6b0a6c2f07729eb2950bf502e40ab",12,12,0,12,12,0,1,2
"32254","dee715071d1f221fe176b724a5e639d8",24,24,0,24,24,0,1,2
"32255","deea16e661c21bb8fcf1fc14bf26b003",156,88,58,18.8275862068966,114,42,3,3
"32256","deeb26f8aabda002e6b5266a25e70c33",121,51,76,11.1447368421053,121,0,3,3
"32257","deed7c97a4190585e0f3872b04617a56",83,62,65,8.93846153846154,83,0,2,3
"32258","deeee33114a375cef1ab32824576d100",45,45,0,45,0,45,1,2
"32259","deeefb5b3f4f0843b7eff56da10b3423",64,62,23,19.4782608695652,47,17,2,1
"32260","def405862d3a09c911fb207bcb31d4e1",52,38,58,6.27586206896552,36,16,2,1
"32261","def535f46c45322a48084b5129712784",119,85,76,10.9605263157895,119,0,3,3
"32262","def789a410a66a7fe8065c27f1241039",34,34,0,34,34,0,1,2
"32263","def7ebd24bb3e300217dfed8aa0fea3d",34,25,70,3.4,34,0,2,1
"32264","def9234c96ce67d4112ece1919d1973c",119,79,25,33.32,71,48,3,3
"32265","defaf7a4d81feab45a1bbf19f6193f37",25,25,0,25,25,0,1,2
"32266","defb5fe7a213d4a9fa15fec7c9b54c23",90,69,78,8.07692307692308,90,0,2,3
"32267","defc9c05ef99a3813a10743c2153f6ae",177,86,78,15.8846153846154,177,0,3,3
"32268","defe8f05a5d1947c4e00fd31434d229b",31,31,0,31,31,0,1,2
"32269","defefdf5d592cc9decc43675b468068b",41,39,6,47.8333333333333,41,0,1,2
"32270","df02a3c5e45d41368088e5d1e2e83366",23,23,0,23,23,0,1,2
"32271","df034a23449f113cf179b929dd448f97",112,62,69,11.3623188405797,112,0,3,3
"32272","df06f4f0cb5c88c7dfcbeca7afb47f11",163,93,62,18.4032258064516,163,0,3,3
"32273","df09d35c85015ac02fac683f5bf03af4",32,26,27,8.2962962962963,32,0,2,1
"32274","df0b756a3b2e136bf3c73fa441b97826",14,14,0,14,14,0,1,2
"32275","df0c4b6f7d7072fdfbfff3a955c50714",84,61,76,7.73684210526316,84,0,2,3
"32276","df11f61fa654c9d18cc5ea1073f0c7d7",17,17,0,17,0,17,1,2
"32277","df13d5c4c2a00b111370d956430a4865",55,55,0,55,55,0,1,2
"32278","df1679580ef193257ef038ed69d9bb91",42,42,0,42,42,0,1,2
"32279","df194eb96b2dc939e1d1b4cf30d275bd",16,16,0,16,0,16,1,2
"32280","df19a913dac861fb9841ea451cc047d9",51,51,0,51,51,0,1,2
"32281","df1e290a02b7eeba63d5ba6d9bedfc07",61,41,64,6.671875,61,0,2,1
"32282","df1e4227d32110125bdb6947db174666",31,31,0,31,31,0,1,2
"32283","df1f1da5ba7c61d8000f00d5a3bf3d2f",16,16,0,16,16,0,1,2
"32284","df1f6b86102619a030476a9fd6be7287",22,18,57,2.70175438596491,22,0,2,1
"32285","df239e99e160996b800c07e10a2b86bd",29,29,0,29,29,0,1,2
"32286","df24339acc49320367ca9214f6b571b0",58,44,31,13.0967741935484,58,0,2,1
"32287","df243e7601d3d2e09bdd1b57d909a7a8",21,21,0,21,21,0,1,2
"32288","df24662fca326339379de5008c9e8ec7",127,62,59,15.0677966101695,127,0,3,3
"32289","df27989209061061b23760e53021e0f9",16,16,30,3.73333333333333,16,0,2,1
"32290","df2bcecbdeb8c491aafb41fd58d4628e",103,74,77,9.36363636363636,103,0,3,3
"32291","df2c6bc8b21c96411dde952629894d0b",33,33,0,33,0,33,1,2
"32292","df31812ca322fc901123766c5b361a2d",167,69,76,15.3815789473684,118,49,3,3
"32293","df33c5fda799623cf19dde3bba0ad517",19,19,0,19,0,19,1,2
"32294","df34670703aab577c65898a28eb0ebee",99,57,75,9.24,49,50,2,3
"32295","df35313877afc3f23d956ffa8b4e50a2",44,39,20,15.4,44,0,1,1
"32296","df36f782947197c7625dba4ef0a9c8c5",73,53,67,7.62686567164179,73,0,2,3
"32297","df370c39d6ecd6616f5b63bdde8dfa4d",97,65,37,18.3513513513514,97,0,2,3
"32298","df377b78b857f16bffd73722279f7aa2",63,55,22,20.0454545454545,63,0,2,1
"32299","df37e76670f99a11f100ed8dc68843fd",39,27,54,5.05555555555556,39,0,2,1
"32300","df383fc8887227bd2cafc4800c3e2cad",30,23,66,3.18181818181818,30,0,2,1
"32301","df3fde1fb614b19f20c0b7d16f548d80",48,42,20,16.8,18,30,2,1
"32302","df401c7dc48e79a848dd2bc7682ecfc4",110,97,46,16.7391304347826,110,0,3,3
"32303","df439669cab315c9ff392986861c6631",60,56,66,6.36363636363636,15,45,2,1
"32304","df43f1764fb324f6772d36002188f660",42,42,0,42,42,0,1,2
"32305","df450298f6b41a35a07afac1f157910b",74,51,38,13.6315789473684,74,0,2,1
"32306","df45ac060df4e2914d3978d12bbf0363",30,30,0,30,0,30,1,2
"32307","df4802f32973d94f1ae830cd40172ebe",29,29,0,29,29,0,1,2
"32308","df48af231416a50c51f1fa6215f88364",98,70,74,9.27027027027027,98,0,2,3
"32309","df49cf16fb07c4c84c1accda4bfc9742",36,36,0,36,36,0,1,2
"32310","df4a016673c7130f00a5a8fc034cf6da",60,50,42,10,60,0,2,1
"32311","df4b64d832b75646a292e4ecd6e76b59",160,103,60,18.6666666666667,160,0,3,3
"32312","df4c744da24e92905aa8056d36933fd9",21,21,0,21,21,0,1,2
"32313","df512ba11d67f0d3e8ddad70f0f68351",196,137,70,19.6,196,0,3,3
"32314","df517c27e087b49237d95ee3fc293ab5",119,89,79,10.5443037974684,102,17,3,3
"32315","df529215d9e02e04d31b183f7663a2eb",24,24,0,24,24,0,1,2
"32316","df537758b3a520d9e21bd6130f7d56e7",16,16,0,16,16,0,1,2
"32317","df56dac9b23ee1e0042550a69ee4ef38",30,30,0,30,30,0,1,2
"32318","df5c7eb7729d8bf39c1d09e4bceba39e",54,45,33,11.4545454545455,54,0,2,1
"32319","df62010daa0e0277ce2ade0a8a306a6c",17,17,0,17,17,0,1,2
"32320","df64e5897ac268a58c58c54fe6434103",44,44,0,44,44,0,1,2
"32321","df663b810bdd0553207dfeda02b2bf31",20,20,0,20,20,0,1,2
"32322","df66de8739b47a4faa86af9fcb1095e5",130,84,77,11.8181818181818,130,0,3,3
"32323","df66eb420a2be1a99d01e703f81dbde9",49,49,0,49,49,0,1,2
"32324","df6716df4ccb1cca9ae0742a3c78b80e",52,38,30,12.1333333333333,52,0,2,1
"32325","df6ad7b2496f044eb5b28b411cc825fe",29,29,0,29,29,0,1,2
"32326","df6b267455b25e2a2cd8b5f06e43dcdf",22,22,0,22,22,0,1,2
"32327","df6eee9475407d3b1bb6d51413fd593d",66,48,26,17.7692307692308,66,0,2,1
"32328","df6ff46c5c1a371bf8cbb0fd015de5d9",35,34,42,5.83333333333333,35,0,2,1
"32329","df71e3528a5f69be3a3b2ee6459c08e9",43,33,16,18.8125,13,30,1,1
"32330","df72023ec812e0ec782a9d7ea4bee1cd",69,57,27,17.8888888888889,69,0,2,1
"32331","df731063f675401ba2a43e0544eab2e7",111,109,65,11.9538461538462,103,8,3,3
"32332","df7471632c9674034e46eea9ee591bdd",78,54,23,23.7391304347826,47,31,2,1
"32333","df74ea6276d5afe7d81dc684988901a8",164,108,64,17.9375,164,0,3,3
"32334","df762fe731acebdae70a6cee1a8fdd41",85,58,14,42.5,85,0,1,2
"32335","df76da6cbc5e640b8de30bcafdcaf1a7",8,4,70,0.8,8,0,2,1
"32336","df794a19c3183ed4f4656a83d47b4a0b",41,41,0,41,41,0,1,2
"32337","df7aa02df6b9661ce6f6632688c24180",44,44,0,44,44,0,1,2
"32338","df7b4156fe8931b7acaab709a72fdd11",46,35,37,8.7027027027027,46,0,2,1
"32339","df7b8523e05e927f4440edaccbced102",8,7,20,2.8,5,3,1,1
"32340","df7bbb012deab661640fe3d505d5a281",21,21,0,21,21,0,1,2
"32341","df7c06e0e7087febacfb037423e6bcfc",24,22,74,2.27027027027027,24,0,2,1
"32342","df81c0e760e5e87c94dff224a76c653d",27,27,0,27,27,0,1,2
"32343","df84b5680531d3f07e580fadabb4154e",85,64,72,8.26388888888889,50,35,2,3
"32344","df85124a7e11302754cf808f0adb55e6",46,46,0,46,46,0,1,2
"32345","df86d903919f0c824377c99f917652c0",44,44,0,44,0,44,1,2
"32346","df87b844cbeffdbea5444cb152c6936a",199,127,55,25.3272727272727,199,0,3,3
"32347","df8888105fc8e7e0e24e2ece2bd003d7",25,25,0,25,25,0,1,2
"32348","df8ac30f8ec7ebf2aa601a336b6a6312",2,2,0,2,2,0,1,2
"32349","df8bbfddd61594727161251e9b685ef7",10,10,22,3.18181818181818,10,0,1,1
"32350","df8cb7f34310fc5b8ac57c29f18e07a1",41,37,28,10.25,0,41,2,1
"32351","df8d32d886b7c7ab81e7d8a636e81c9e",160,97,57,19.6491228070175,160,0,3,3
"32352","df8edbfabdee0f8ecac74874863ad169",106,55,77,9.63636363636364,106,0,2,3
"32353","df91bae826c84fbabb966afc05ebfc2e",63,53,42,10.5,63,0,2,3
"32354","df91cd6ad427f793f7bedd6b0cdba8dd",49,42,61,5.62295081967213,49,0,2,1
"32355","df924d986bfdc792dc32e8033c045d0f",158,90,84,13.1666666666667,158,0,3,3
"32356","df95fef7e736b2aa60b489a63f929c78",21,18,29,5.06896551724138,21,0,2,1
"32357","df96f52e17d808b37fc847a2d7d1a19f",123,84,71,12.1267605633803,123,0,3,3
"32358","df993ea32f9922b4dce82bbbe36cad06",22,22,0,22,0,22,1,2
"32359","df9b349692ffff7a978fedf03cea2b00",48,48,0,48,48,0,1,2
"32360","df9c3b11337a93bddfeb55b0b8e0b353",142,123,60,16.5666666666667,142,0,3,3
"32361","df9c50869af1140a7442aefd58610fc2",26,17,60,3.03333333333333,26,0,2,1
"32362","df9d236fa748f8da4c171e2a233a5ad0",41,41,0,41,41,0,1,2
"32363","df9dfdf9d0c901cce80249d5f4039ad3",182,108,63,20.2222222222222,182,0,3,3
"32364","df9f8373da4edc3b375b063ad5989a48",75,65,51,10.2941176470588,75,0,2,3
"32365","df9ff85e681aaba417739c3c8ca15b8c",23,23,0,23,0,23,1,2
"32366","dfa2097ea5261f0c124163c31bba18d6",28,28,0,28,28,0,1,2
"32367","dfa5b28564572d380ded29a10fe13dcc",13,13,0,13,13,0,1,2
"32368","dfa5ee77ec357706e2baee1b6c2b031b",129,76,50,18.06,96,33,3,3
"32369","dfa8808209227c796747b7f0a3c74b1f",175,103,76,16.1184210526316,175,0,3,3
"32370","dfa90fa33530b730cd738f2230e48754",107,75,43,17.4186046511628,107,0,3,3
"32371","dfaf01b836ae9b82ab82132c594820bf",92,79,63,10.2222222222222,92,0,2,3
"32372","dfb231dcf721e7f1c873ca4949e0ad25",106,89,71,10.4507042253521,106,0,3,3
"32373","dfb62be33a07ea78cab4e97f2899703f",50,50,0,50,50,0,1,2
"32374","dfb75eb0397b41aef9dd2b8650295c7c",26,26,0,26,26,0,1,2
"32375","dfb7f829581692dff14d0c975adb1cbe",9,9,0,9,9,0,1,2
"32376","dfb84c02795bc06fca9b419ad07753b9",61,50,55,7.76363636363636,61,0,2,1
"32377","dfb8d37557609ce25c42c66efa85f11c",1,1,0,1,1,0,1,2
"32378","dfb9776c807b9542d2669d1218711b07",3,3,0,3,3,0,1,2
"32379","dfbae2006c5001c34f9b2bb88b0f3f67",20,20,0,20,20,0,1,2
"32380","dfbc59c1b67d0a03e54848f2efe931cf",151,100,26,40.6538461538462,151,0,3,3
"32381","dfbd9b707fb0493af1ae0dc83fa47834",30,30,0,30,30,0,1,2
"32382","dfbe093bf57611f6b8e81e2a859a7f80",146,89,64,15.96875,146,0,3,3
"32383","dfbea8ac7c74ff9c6672aee92092b203",32,32,0,32,32,0,1,2
"32384","dfbfae83f69febc970adaee30ed69c46",24,24,0,24,24,0,1,2
"32385","dfbfaedf18d4e6d40580de15d3011f6b",28,28,0,28,28,0,1,2
"32386","dfc39ab2bf3e8c9bc939f93fe600450e",86,63,31,19.4193548387097,86,0,2,3
"32387","dfc5b2090de73b212272bbf8dd95796b",4,4,0,4,4,0,1,2
"32388","dfca2c2914eebf8f696ffda2af63eedb",29,29,0,29,29,0,1,2
"32389","dfcb7a4f3809c9acd1f7be82accad5a7",111,92,26,29.8846153846154,59,52,3,3
"32390","dfcb980514324bd0c07bbd10f71768c8",136,92,75,12.6933333333333,136,0,3,3
"32391","dfcde96af4e7767669bf7845d681b939",65,38,43,10.5813953488372,65,0,2,1
"32392","dfcf76048b712658b7853292f016526f",34,34,0,34,34,0,1,2
"32393","dfd019da5dd4f9462a8e2f5d13f44005",20,20,0,20,20,0,1,2
"32394","dfd34448270024b935fd8fe6bf684c3b",144,87,65,15.5076923076923,144,0,3,3
"32395","dfd442313e1643aeac6487d8a9e54052",65,56,19,23.9473684210526,37,28,1,1
"32396","dfd5cc2a17ebf16a2fda80d90ddc7191",109,86,75,10.1733333333333,96,13,3,1
"32397","dfda77214ffff61ab6d5ca71e752e5d0",23,23,0,23,23,0,1,2
"32398","dfdabd077b019ecb2956e5d5ac9dee0a",27,27,0,27,27,0,1,2
"32399","dfe07d2434785f90b7d8ec7194863828",18,18,0,18,18,0,1,2
"32400","dfe1f0f0e617c8a568f217a799c2d226",38,38,0,38,0,38,1,2
"32401","dfe51a3a1ffc228a0fbe08fa8436a000",62,55,65,6.67692307692308,62,0,2,3
"32402","dfe52eb8cfd701aba659b219e47301c7",7,7,0,7,7,0,1,2
"32403","dfe5d33494b0ce0dd5a0f5d2342d146d",9,9,0,9,9,0,1,2
"32404","dfe5e618a29341b6f727beff3701476b",145,67,73,13.9041095890411,115,30,3,3
"32405","dfe8152f78155eb842b80693d4f8bee0",61,46,76,5.61842105263158,61,0,2,1
"32406","dfe9a77342a647ee9c411c5bc4ec5c27",19,19,0,19,19,0,1,2
"32407","dfea41e5f54eca4d8744544a1627120e",168,87,70,16.8,152,16,3,3
"32408","dfea9744ca92d04eebf9a05a1abe1322",11,11,0,11,11,0,1,2
"32409","dfebb61b0543ce76af1df164b94c4189",32,27,60,3.73333333333333,32,0,2,1
"32410","dfec45b72e4056271bee25f8084011b5",103,85,46,15.6739130434783,103,0,3,3
"32411","dfed9759baab8ac8f45ee1db1377428b",14,13,6,16.3333333333333,14,0,1,2
"32412","dff54ed560387ddbda785e0b4500a456",19,19,0,19,19,0,1,2
"32413","dff6e24c94642b5b3948afaae1087c12",29,29,0,29,29,0,1,2
"32414","dff8603b9a58d7e765b79cffea2e1049",123,50,71,12.1267605633803,123,0,3,3
"32415","dffb5584cb59b7c11eef656deb22a898",182,119,68,18.7352941176471,151,31,3,3
"32416","dffd1e0af13bef0de03fb552492916ca",45,36,35,9,0,45,2,1
"32417","dffd30107bc9f65e3b328f65c13edcd4",49,44,34,10.0882352941176,49,0,2,1
"32418","dffe6fceb22e1689a8a4e95e36c134c2",180,79,89,14.1573033707865,152,28,3,3
"32419","dfff7bed0836b06b4b59fef05314aca2",103,68,42,17.1666666666667,103,0,3,3
"32420","e0008950acaec500798018033c60a2a5",244,102,77,22.1818181818182,202,42,3,3
"32421","e0026223a230c823f0b6a12fc31d70e7",91,53,57,11.1754385964912,91,0,2,3
"32422","e0047da7e1d1a0eb195e15b53c5038d3",141,98,42,23.5,141,0,3,3
"32423","e00681a445badc63141411f6ccce0cbd",51,51,0,51,0,51,1,2
"32424","e007462cab7043010cfc673b5da783b2",66,58,64,7.21875,66,0,2,3
"32425","e0079b990693dbbf21f463b5a0aef5bf",166,84,79,14.7088607594937,166,0,3,3
"32426","e007b90c4261e2b911c3a96c6de5da74",44,44,0,44,44,0,1,2
"32427","e00b1b1ba7e5859f7876fbe5122c60bf",49,41,16,21.4375,49,0,1,1
"32428","e00b4a618e13dd893a316d86e0ac3ca7",80,43,58,9.6551724137931,80,0,2,3
"32429","e00bd17f240bb6dd67f51205a8bb49e4",55,46,55,7,55,0,2,1
"32430","e00c2648d34d2348caf4991d527fe3de",109,65,60,12.7166666666667,109,0,3,3
"32431","e00e5291c1dbbbea0a0360f0c7340f97",37,34,39,6.64102564102564,37,0,2,1
"32432","e00f8535a94a3f3822195327f2c50e2a",41,37,28,10.25,41,0,2,1
"32433","e0113eacceee5e338c3fd2be01ba0b05",47,40,21,15.6666666666667,47,0,1,1
"32434","e011f2b03bff03a02b0e6b8960cc1fa5",88,71,30,20.5333333333333,88,0,2,3
"32435","e012a4a9f251963c08425fa9f44eefd7",22,22,0,22,22,0,1,2
"32436","e012e76682e148d3895c0481cb34b2d6",80,61,61,9.18032786885246,80,0,2,3
"32437","e0153682f72125550b8102b62aabd826",14,14,0,14,14,0,1,2
"32438","e015b37201341344adb5bb650648873d",33,33,0,33,33,0,1,2
"32439","e01718616a726cee5ed21d8a806dbaf8",58,39,71,5.71830985915493,36,22,2,1
"32440","e0178fb6acf1c6f10d3becbdcbdd22ab",70,60,13,37.6923076923077,39,31,1,2
"32441","e01e28226e5ac1e857565da60c53844f",23,23,0,23,23,0,1,2
"32442","e01f5c9a59a870384ac9e23cc2c405a6",10,10,0,10,10,0,1,2
"32443","e01faaf8722ef8d272bc39b1d1ec333a",95,69,59,11.271186440678,55,40,2,3
"32444","e01feecaf064b54a9bbf4c524323a72d",38,38,0,38,38,0,1,2
"32445","e022cacfdf536351a7b96bbaea969e8a",20,20,0,20,20,0,1,2
"32446","e02870a066a0f1970f6aacfd07f1940f",103,50,62,11.6290322580645,103,0,2,3
"32447","e029684c267786365e97dd9d3ed6a173",5,5,0,5,5,0,1,2
"32448","e029b73420eebc2f20d3809c0946aaa7",32,32,0,32,32,0,1,2
"32449","e02b2114a3ebb4d0bd9e831cdd6e033b",41,34,52,5.51923076923077,16,25,2,1
"32450","e02b8e0f8088e51331dcd0000f978ec3",28,28,0,28,0,28,1,2
"32451","e02b93bf5f95a5210e025e57aa4c6089",19,19,0,19,0,19,1,2
"32452","e02d344177ac6ef65a27a244a00f1541",51,51,0,51,0,51,1,2
"32453","e03021a653d2a1b09dbc8cfc73731601",20,20,0,20,0,20,1,2
"32454","e0318c7e44dde9181f5154cf62184fd7",31,31,0,31,31,0,1,2
"32455","e032ee4097717216cfd89d3a88b69158",30,23,9,23.3333333333333,30,0,1,2
"32456","e035d6f2105883e158efe8f9d9db87e8",65,48,53,8.58490566037736,65,0,2,1
"32457","e039636ba07c5a33d4151704fe21a927",23,23,0,23,23,0,1,2
"32458","e03a95370e11548255afa03a72643206",53,41,44,8.43181818181818,16,37,2,1
"32459","e03b52c39952c08b484106ee7c107b43",14,12,3,32.6666666666667,14,0,1,2
"32460","e03c981462d6e08197ab21053dfe8a0d",10,10,0,10,10,0,1,2
"32461","e03cf6c77cc86dd91c6ae8ef169e09d1",27,27,0,27,27,0,1,2
"32462","e03d45215237d31696a59215d20bbe44",5,5,0,5,5,0,1,2
"32463","e03eb4240dfd15d0ab79d1cc41b89884",32,32,0,32,32,0,1,2
"32464","e04095b789786bd9d83ae677242b25d0",18,9,76,1.65789473684211,18,0,2,1
"32465","e0417157d39b9fa784a079ce8003d616",17,17,0,17,17,0,1,2
"32466","e04180da5e700ead471a6eca014a8732",10,10,0,10,10,0,1,2
"32467","e041d2ed4221d35d56c29d89c7fe84a6",18,18,0,18,0,18,1,2
"32468","e042a14cffe063fc367c2143fa10b423",96,54,56,12,96,0,2,3
"32469","e04668d88b8e65b0b0bcb2bc671e4021",29,29,0,29,29,0,1,2
"32470","e048eb5345ad1d5b366994e3303730de",56,43,28,14,56,0,2,1
"32471","e0495b8f410d74fa47e2f90dde05c1a0",15,10,53,1.9811320754717,15,0,2,1
"32472","e049d82e68bfd1f91583910c7aafd33d",24,24,7,24,24,0,1,2
"32473","e049daeb64bb1f5470ec56a2b445cf4c",110,89,31,24.8387096774194,110,0,3,3
"32474","e049fc46eba5a1cd2c5ee6cce9533c20",21,21,0,21,21,0,1,2
"32475","e04adacba3bc2e6830b801c4db352154",116,99,61,13.3114754098361,116,0,3,3
"32476","e04b60d1004203465df5789a30539e8b",47,46,18,18.2777777777778,47,0,1,1
"32477","e050b4c97544c7e5e294da8ef0017eac",98,67,35,19.6,98,0,2,3
"32478","e0593b0ea7d615281024f9254291808c",56,37,41,9.5609756097561,56,0,2,1
"32479","e05966bc4f2afca064c4f3abea6b6bb6",68,49,36,13.2222222222222,29,39,2,1
"32480","e05b985809c74b2b372fdd1a65f8ba4f",106,62,60,12.3666666666667,106,0,2,3
"32481","e05e95555cda27aaf3bf98e82d46a86a",3,3,0,3,3,0,1,2
"32482","e05ea2d54f860bae03ede664a0b3e55e",17,17,0,17,17,0,1,2
"32483","e0676676be2b1e427fa29af9d08ec1a1",106,82,52,14.2692307692308,106,0,3,3
"32484","e067d648093433bd00fc0f36252488fa",87,71,78,7.80769230769231,40,47,2,3
"32485","e06ebf16cb755fcad60ebee33f2d338f",23,22,7,23,23,0,1,2
"32486","e06f27fb0e99243a1d70c52ccb6d2108",20,20,0,20,0,20,1,2
"32487","e074e1af39f1b83a7a7f8caa69ff69f5",21,15,51,2.88235294117647,21,0,2,1
"32488","e0754529efa2f92cb31141f5004dcc89",93,73,71,9.16901408450704,59,34,2,3
"32489","e076a57e467c9039a63c18f4129a6185",72,50,56,9,72,0,2,3
"32490","e07911457b7b3bb778126a496574352f",16,12,38,2.94736842105263,16,0,2,1
"32491","e07d83f443dd2bedbd83517b70cc2fb5",215,99,87,17.2988505747126,199,16,3,3
"32492","e08125550f9554afc4411d8ff8f2b310",83,65,67,8.67164179104478,48,35,2,1
"32493","e0836e59575deded58d1e6886800bfda",37,35,27,9.59259259259259,24,13,2,1
"32494","e0846e0b11cef5726711a57b4bbb3711",84,58,43,13.6744186046512,72,12,2,1
"32495","e085c6b89805dc768fab3b53c608fbc3",62,43,50,8.68,62,0,2,1
"32496","e0860b8131c112296dfb23848a18665e",27,27,0,27,27,0,1,2
"32497","e08841327ba3bbc418343e110fc7ae38",8,8,0,8,8,0,1,2
"32498","e0886dc4b4666aa2e1b194e30e4f55e6",53,38,77,4.81818181818182,53,0,2,1
"32499","e08b99f862a14152f12b61867c161159",28,28,0,28,28,0,1,2
"32500","e08de48a7ec99e2960bfd07f75da4774",18,18,0,18,18,0,1,2
"32501","e093145d2751f50ff1d34b6b36a28b05",20,20,0,20,20,0,1,2
"32502","e09579a0e97896a5bf2c52907a3c1810",43,43,0,43,43,0,1,2
"32503","e0984690076dc6f1e7e36469d61079a8",29,29,0,29,0,29,1,2
"32504","e098cc5b51e8348f3989e61f6f62770a",14,14,0,14,14,0,1,2
"32505","e099e15538bf887e55dd51040dac7e06",28,28,36,5.44444444444444,28,0,2,1
"32506","e0a001fb5b1fa51da076b02a04da1985",24,24,26,6.46153846153846,13,11,2,1
"32507","e0a0c74e0ee901ce0610a0f074a96bef",92,72,78,8.25641025641026,92,0,2,3
"32508","e0a1015540dd013f5cc0d46d94975bfd",36,27,60,4.2,36,0,2,1
"32509","e0a20b15da2b3d07465f5b73078c4a24",68,51,31,15.3548387096774,34,34,2,1
"32510","e0a2c8a0ce3eb0e615bb14f253ba6048",10,10,0,10,10,0,1,2
"32511","e0a30bb2fe5baec7f7534cf9d9514421",22,22,0,22,22,0,1,2
"32512","e0a74f474850d7acb6f772d43ce42759",121,94,49,17.2857142857143,121,0,3,3
"32513","e0a7b4d031d895ef4ea05e21762e87eb",23,23,0,23,23,0,1,2
"32514","e0aade10d2a411b73b1a96b785aa58ed",5,5,0,5,5,0,1,2
"32515","e0aeffed9570c40d3e58c3977fd17b5c",39,39,0,39,39,0,1,2
"32516","e0af856b1e2a79f9e779e8cb22b06239",22,7,84,1.83333333333333,16,6,2,1
"32517","e0b15538afabbab43d2be4dc67517960",23,18,48,3.35416666666667,23,0,2,1
"32518","e0b2d425daa197b3f4b0e7afb478d949",24,24,0,24,24,0,1,2
"32519","e0b3ea07f524214f5b03f04914bbc01f",48,48,0,48,48,0,1,2
"32520","e0b57281b7afec50a2eabc67c44cc4c6",94,60,35,18.8,75,19,2,1
"32521","e0b7a1026e6290a1a5914755f738837c",9,9,0,9,9,0,1,2
"32522","e0b7ed801403d59eea717190c1a60327",15,15,0,15,15,0,1,2
"32523","e0b82424b0a9fb59eedec9018bbd5456",46,46,0,46,46,0,1,2
"32524","e0b89a1af186a17aa316b3d7f2b24efe",59,45,27,15.2962962962963,59,0,2,1
"32525","e0b986124c090dbe31ade99734416759",17,17,0,17,0,17,1,2
"32526","e0bbf0d36ee15ef2e14c9334364a3c93",9,9,0,9,9,0,1,2
"32527","e0bd44d8dddaf315225141f7037190ed",53,37,44,8.43181818181818,33,20,2,1
"32528","e0c804560e0d4a757131755c6aa4f474",26,26,0,26,26,0,1,2
"32529","e0cc7f138e52c3c557d327ac1fa048f5",16,16,0,16,16,0,1,2
"32530","e0cd4bf3435b02ffd1001cd980afd7f1",156,124,77,14.1818181818182,115,41,3,3
"32531","e0cddf4a8cf47203912d6e3e0044c2ed",36,36,0,36,36,0,1,2
"32532","e0ce1009485eae8353f95293e40280d2",72,52,44,11.4545454545455,28,44,2,1
"32533","e0ce355c5a57956bf282eb7a38ca2969",133,61,67,13.8955223880597,130,3,3,3
"32534","e0d0a09c9b91b7fd16ac39cd07ec1cb7",82,55,37,15.5135135135135,60,22,2,1
"32535","e0d1da2c29a32d396ee56b6851a3772a",23,23,0,23,23,0,1,2
"32536","e0d3286106ec8ade71dbc30b4d9829d9",37,37,0,37,0,37,1,2
"32537","e0d39abf2d6838863183c613cf26775e",132,86,90,10.2666666666667,99,33,3,3
"32538","e0d508eb17a72f93bd20c4c0203c8633",27,27,0,27,27,0,1,2
"32539","e0d5584c05a1614f506cd5b055a45b9b",15,15,0,15,15,0,1,2
"32540","e0d91a535e46eea2a2c033e29bdf9c0d",66,53,65,7.10769230769231,66,0,2,3
"32541","e0da0645fa137b1586d41ac2e89e69d5",31,31,0,31,31,0,1,2
"32542","e0dd95faee5c7e5afcb890aad679a928",43,31,78,3.85897435897436,43,0,2,1
"32543","e0de6c557bf6e26dfbaea5c138a9c67a",43,41,11,27.3636363636364,43,0,1,1
"32544","e0deb6195cf124e98b3fdf745734f32d",51,51,0,51,51,0,1,2
"32545","e0e3f07d78e600b7376ee821ed4f2076",32,32,0,32,32,0,1,2
"32546","e0e4252d0185039a51772138031ca6b5",27,27,0,27,27,0,1,2
"32547","e0e4d1ea35739ff7202771a7497e27df",116,38,82,9.90243902439024,116,0,2,3
"32548","e0e5ebbe61109fa407a53e2fe0429c66",7,7,0,7,7,0,1,2
"32549","e0e6350cb1afb2a9e34b4a38229e0d17",12,12,0,12,12,0,1,2
"32550","e0e8546502c14576f0a1d1c9925eba8e",76,62,47,11.3191489361702,29,47,2,1
"32551","e0e90abebc6b06a8b8ba585d360503ce",25,25,0,25,25,0,1,2
"32552","e0ea41ab2aba90af3e6675920c8ab87a",3,3,0,3,3,0,1,2
"32553","e0ed5d21deae00dc2270817de4ce56d0",2,2,0,2,2,0,1,2
"32554","e0ef587fa4f238ac2c0462f0014a6014",97,78,34,19.9705882352941,97,0,3,3
"32555","e0f0ac857dcb5c06493d29ee42de8ef1",41,41,0,41,41,0,1,2
"32556","e0f10c43c0c0a7acf3d4fc7e6c8437d0",24,24,0,24,24,0,1,2
"32557","e0f3ab538e94006f7f461d4319b5445b",46,46,0,46,46,0,1,2
"32558","e0f515d79c06313c656020dbe96106bd",47,32,13,25.3076923076923,47,0,1,1
"32559","e0f849ed271b00d0cfd3e951fab46de2",138,71,85,11.3647058823529,138,0,3,3
"32560","e0fa2f9d9607bb3ac677fa1e055dc059",45,35,85,3.70588235294118,45,0,2,1
"32561","e0fbfe18ee7608b6cb207ed200ded93d",30,30,0,30,30,0,1,2
"32562","e0fc3dbf42a656ce92f8e061690436c8",30,30,0,30,30,0,1,2
"32563","e0fd06411e505b1e736cf5e2d28210a7",18,18,0,18,0,18,1,2
"32564","e0fdfc66959f318f376b7585a4ff89fc",40,40,0,40,40,0,1,2
"32565","e0fe0c7fecc1c4c45878b737a12efb52",33,33,0,33,0,33,1,2
"32566","e10227a6d8b761eeb5637cc90c04babe",147,60,70,14.7,147,0,3,3
"32567","e10285bde73098d87088f46f3f990059",27,27,0,27,27,0,1,2
"32568","e10651d4a864c590a6a92beb50dc9ab9",69,55,53,9.11320754716981,69,0,2,3
"32569","e108dac219e9b6f21d3a28d4597dceff",14,14,0,14,14,0,1,2
"32570","e1092df92196d0cdab389cf5b44d1340",50,39,39,8.97435897435897,45,5,2,1
"32571","e10933b92d4b4e1562bcb0c16c338e45",73,58,19,26.8947368421053,73,0,1,2
"32572","e10b3f445cc7d79ff6ec1e92ed207530",98,61,63,10.8888888888889,98,0,2,3
"32573","e10c207a1c0237067c29ee0d9b44102e",28,28,0,28,28,0,1,2
"32574","e10d5df659408738098acc9c2b909269",55,55,0,55,0,55,1,2
"32575","e10e98876e725395683ca865d34c6ab1",24,23,32,5.25,24,0,2,1
"32576","e1100847dfe270f4a7809d14564a463b",27,27,0,27,27,0,1,2
"32577","e1123b34bd839e4310656d1863bf86b1",75,62,42,12.5,75,0,2,3
"32578","e115e07784b9b4a9c9a1f1c67a0467c9",47,47,0,47,47,0,1,2
"32579","e1179701763b5ab0b2de63b8bedd911b",52,45,61,5.9672131147541,52,0,2,1
"32580","e119b0f53b73d75eea56b45034b69674",91,77,48,13.2708333333333,91,0,2,3
"32581","e11cb880844b2bbb8da92057c5fd4889",93,73,31,21,93,0,2,3
"32582","e11ee3a59c038ac6f33f7b262e24ad08",98,49,65,10.5538461538462,71,27,2,1
"32583","e11f83bdf1ca1a005f23bd16ecabff3f",14,14,0,14,14,0,1,2
"32584","e120f8fcae177a4048bc4f10c0a8cc5c",12,12,0,12,12,0,1,2
"32585","e125789f02c03e66f6b664a7188e391e",28,28,0,28,28,0,1,2
"32586","e125cecb7dd21e5584c375d0da64d5d4",129,78,76,11.8815789473684,99,30,3,1
"32587","e12b1e611955bd1503f3d7975644c31e",27,27,0,27,27,0,1,2
"32588","e12b73b24d9e2277a7d82898aa7c78b0",109,56,88,8.67045454545454,109,0,2,3
"32589","e12f05ca0ab05b273a567812ec4d6fe8",66,49,51,9.05882352941176,30,36,2,1
"32590","e13065704961deb9ef9e61167d012c6c",60,48,69,6.08695652173913,26,34,2,1
"32591","e1340b9747b88defb0694bbafc8f1a7d",42,33,32,9.1875,17,25,2,1
"32592","e13676f09ff2433f047c3a259847839d",28,28,0,28,28,0,1,2
"32593","e139f196cdfd1b4ddfc96ca8814e4940",86,50,79,7.62025316455696,61,25,2,1
"32594","e13adf7984695756a561e7499fabb534",101,75,30,23.5666666666667,101,0,3,3
"32595","e13b70a65e99c6f0c0e250f2da6722d8",126,84,85,10.3764705882353,93,33,3,3
"32596","e13f9e4df6acd4199ba5d54a035be80c",81,46,43,13.1860465116279,81,0,2,3
"32597","e1428aafce53e686db2297fa9a97c806",84,49,80,7.35,84,0,2,3
"32598","e14331b47c3bfa96af5dfb69ff0c9cc2",49,42,53,6.47169811320755,28,21,2,1
"32599","e143f42f950ce8f8152d72943e8d13ea",123,104,70,12.3,123,0,3,3
"32600","e144f27b4f0736b9770652e7b16ed130",29,29,0,29,29,0,1,2
"32601","e145302599da21d2944414b7177ad45d",12,9,53,1.58490566037736,12,0,2,1
"32602","e14cec20ecbe9136df476d4eb3b7f648",19,19,0,19,19,0,1,2
"32603","e14d7eae0c722c720199d910ac43e5a2",25,25,0,25,0,25,1,2
"32604","e14dba7264599aa087716b7844593228",55,48,7,55,0,55,1,2
"32605","e14e944f0b27c803b3628331d4f6e7aa",30,30,0,30,30,0,1,2
"32606","e14ec620c1b734c4f8859dae568ea380",17,17,0,17,17,0,1,2
"32607","e14ef6f6a8e7e37e942e3046bd55ec6b",39,39,0,39,39,0,1,2
"32608","e14fd3a87adb1ec44c9cc3eb25bcdea9",160,100,61,18.3606557377049,105,55,3,3
"32609","e15113950f98cd82b5d2157bc2b8c748",24,24,0,24,24,0,1,2
"32610","e151839325a0b550905bcdd1642b5b8b",50,50,0,50,50,0,1,2
"32611","e1539d911a03490759ada462dce99b24",27,27,0,27,27,0,1,2
"32612","e156614564335924d2b8b7c660ce5650",66,57,20,23.1,66,0,1,1
"32613","e1594648bb30f74401ac1a09dc178238",79,53,29,19.0689655172414,69,10,2,1
"32614","e15af62e3215df1c66109d7d0ad1690e",72,53,55,9.16363636363636,51,21,2,1
"32615","e15be4bc1161204e65ac099627971ac6",209,121,56,26.125,209,0,3,3
"32616","e15e330c6fa38340bc652999644b3c2d",51,36,63,5.66666666666667,16,35,2,1
"32617","e15f5b145a901968ee7cb853714249f8",16,16,0,16,16,0,1,2
"32618","e1600dd095648182be8fd001bc5a16c1",29,29,0,29,29,0,1,2
"32619","e160a36e173f4ce711feaafa5903a957",42,42,0,42,42,0,1,2
"32620","e1629fc2ab0f28d65d30c197d966131d",1,1,0,1,1,0,1,2
"32621","e162ae43553e1cc1002103f8935c7875",26,26,0,26,26,0,1,2
"32622","e1652e57d21737102e8014eb0dfc4268",29,29,0,29,29,0,1,2
"32623","e168b8c17bfff7040f157e7c5b5107f5",39,36,17,16.0588235294118,16,23,1,1
"32624","e16eb79dbfad124d1a077afb9824ef98",100,63,35,20,62,38,2,3
"32625","e16ed81419f41c86a83b2b7b713b3899",66,56,47,9.82978723404255,22,44,2,1
"32626","e1708b9791a6e151084814d34832d096",44,44,0,44,44,0,1,2
"32627","e1718fcfa631974f82479e53b8188909",39,39,0,39,39,0,1,2
"32628","e1726bbc3440a1871b5fe3e5cf74fc60",56,47,42,9.33333333333333,56,0,2,1
"32629","e1729d48adde46ba4d577084609ecd8c",27,27,0,27,27,0,1,2
"32630","e173b8736fa1142ff8def29cae82dee2",26,26,0,26,26,0,1,2
"32631","e1751efcad22fd354865bca9540d21a6",148,58,88,11.7727272727273,148,0,3,3
"32632","e1767e739f46ef81698fd005a66460e8",92,64,41,15.7073170731707,92,0,2,3
"32633","e17730d16d9ab3b981da48286a0c28e9",111,79,64,12.140625,111,0,3,3
"32634","e1786750d90d175ca2421293bbba0f60",22,16,30,5.13333333333333,22,0,2,1
"32635","e17902da82550a41d0a390d4c46d04d7",81,63,69,8.21739130434783,60,21,2,1
"32636","e17a16da02bf6a34319d079d65637ccc",27,24,24,7.875,27,0,2,1
"32637","e17c4710b7e980662d0e2ea5432a5358",30,30,0,30,30,0,1,2
"32638","e17c923a1d858ae77d84ffec53f0e77f",8,8,0,8,0,8,1,2
"32639","e17e3ad22be047dd983c9d5adda910e3",121,70,60,14.1166666666667,84,37,3,3
"32640","e17e5a2396e514dbcb9ba51ddb00b0d9",84,79,15,39.2,37,47,1,3
"32641","e18016abe5eaeecf7ff05044f21f07d1",45,44,29,10.8620689655172,2,43,2,1
"32642","e1823887c042ed6083319ade6bcf8e36",14,14,0,14,0,14,1,2
"32643","e1844acdaec147b73ef82430206caffd",85,72,51,11.6666666666667,43,42,2,3
"32644","e185cb34955e652e37a99dcdeaf0a683",84,61,43,13.6744186046512,84,0,2,3
"32645","e186060a8f193936079e733df6c11338",149,107,68,15.3382352941176,109,40,3,3
"32646","e18629586ac9918787c2ebd59684cefc",34,34,0,34,34,0,1,2
"32647","e188c08b6f4de1849967121ad8daa9ab",34,34,0,34,34,0,1,2
"32648","e18b9e299242a1052dd78f751ed55406",156,103,84,13,156,0,3,3
"32649","e18ee7351f280c2359a095b47845bf44",25,25,0,25,25,0,1,2
"32650","e1911460d99945933722532163de4a8a",168,87,64,18.375,168,0,3,3
"32651","e19171de6291c8ea93435b7f222c5dda",16,16,0,16,16,0,1,2
"32652","e1929540fce48295955b77806781f18d",17,17,0,17,0,17,1,2
"32653","e194d42f7c34f57e8be4858734e58d6f",47,47,0,47,47,0,1,2
"32654","e1959478dfb7938a2063a2bb432ccfb4",33,33,0,33,0,33,1,2
"32655","e195efd4a070dd6ad3b720f2e3975a99",157,120,41,26.8048780487805,157,0,3,3
"32656","e1996f24bce165faa6bbe5138fda3c74",100,86,39,17.9487179487179,100,0,3,3
"32657","e19afe24eba738f61e7b4a09dd29863b",119,78,62,13.4354838709677,119,0,3,3
"32658","e19d79b5b52feb6af710897450b15e48",99,74,73,9.49315068493151,99,0,3,3
"32659","e19f661995737d538582cd43269c5d82",35,35,0,35,0,35,1,2
"32660","e19ffece086f2df96c6c3130911f445b",36,36,0,36,36,0,1,2
"32661","e1a10c7037017fe4118fbe0af1b23249",13,13,0,13,13,0,1,2
"32662","e1a37d4263cba8b8bce5a75e5321be53",48,38,35,9.6,48,0,2,1
"32663","e1a5429cf8653b2cdde8bace7ac69b68",21,21,0,21,21,0,1,2
"32664","e1a5ab52b4c1d435b9187ef3861e7aae",27,27,0,27,27,0,1,2
"32665","e1a633c4b2d08ea6fb052a648d00606b",82,68,55,10.4363636363636,82,0,2,3
"32666","e1a91e83469bc8831ec15b76f1a99c8f",73,45,46,11.1086956521739,73,0,2,3
"32667","e1a9799ad50eb77e0491be9a247a7d57",50,50,0,50,50,0,1,2
"32668","e1abda0ab3c79a9b0694c36d7b88b226",140,69,62,15.8064516129032,140,0,3,3
"32669","e1ac0ec58ea2e5ddd1e3f604b86f3993",29,29,0,29,29,0,1,2
"32670","e1ae2ac224363160d2bb227a22c08539",32,32,0,32,32,0,1,2
"32671","e1b076127c364a6e92712a8f0d8985bc",48,47,18,18.6666666666667,48,0,1,1
"32672","e1b1096570962a6edee57f344daf349d",82,67,47,12.2127659574468,82,0,2,3
"32673","e1b1f3713d878959e47064fb772bccb1",121,104,53,15.9811320754717,121,0,3,3
"32674","e1b20fb218df9d738b782d03938a0dc4",133,63,68,13.6911764705882,133,0,3,3
"32675","e1b478caf3e605562fc9497f9713e094",71,58,19,26.1578947368421,28,43,1,1
"32676","e1b6aceef91b59918fe3e783e9349af7",14,14,0,14,14,0,1,2
"32677","e1b9065f4bb3c48e8d07af684e4eb49d",7,7,0,7,7,0,1,2
"32678","e1b97212fdff25bad50f8137df62849c",97,82,25,27.16,97,0,3,3
"32679","e1bc98e6285f32fe7e0ff12d4f2972a0",52,46,57,6.3859649122807,29,23,2,1
"32680","e1bd891e7e6c4e0b27d9ae92ec9e5239",218,149,67,22.7761194029851,218,0,3,3
"32681","e1be4d50e7a8004c26bbefe13d628cab",125,86,42,20.8333333333333,71,54,3,3
"32682","e1c54961c9a23cad1a0be2d8b8a02bee",31,31,0,31,31,0,1,2
"32683","e1c763dd5e427f8c71ce344af32b57af",119,95,77,10.8181818181818,119,0,3,3
"32684","e1c8ac0c655decfcf80a20dcc683d9d9",41,34,63,4.55555555555556,41,0,2,1
"32685","e1c95e8236eff661160be59a32d3456e",10,10,0,10,0,10,1,2
"32686","e1c9f05035d4501cedbd476b23cf3299",63,59,20,22.05,63,0,1,1
"32687","e1cec67e6bb62a3ab0d145bbcc5b6d70",97,64,57,11.9122807017544,97,0,2,3
"32688","e1cf9a3db79979cc1c71fcbb396fcabe",102,48,49,14.5714285714286,102,0,2,3
"32689","e1d3ff2570d070ebe3b89878ef5fa213",42,42,0,42,42,0,1,2
"32690","e1d456a7a0d46a06f99ba91d4ed3c9d9",23,23,0,23,23,0,1,2
"32691","e1d58650d40a750848dc8223358e8c00",26,26,0,26,26,0,1,2
"32692","e1dabaf11edca5ac904a0be8fad0e3f0",43,43,0,43,43,0,1,2
"32693","e1daccd1c1ab5cd3ffdf0ef6abe9b47d",4,3,5,5.6,4,0,1,2
"32694","e1dfe0c437a13d21bd714bd4acf8d75e",23,23,0,23,23,0,1,2
"32695","e1dffbc341018e6f7cf25324983d5397",48,48,0,48,48,0,1,2
"32696","e1e2f4cf2c6d2f91733425aff34cde29",42,42,0,42,42,0,1,2
"32697","e1e38378b5ca3fc2ca0cbf535329aa60",12,12,0,12,12,0,1,2
"32698","e1e6b86e1f0301c19aa93acb31d6e096",12,12,0,12,0,12,1,2
"32699","e1eda74c5518e8aacefddbed5b8e7c04",52,42,63,5.77777777777778,52,0,2,1
"32700","e1ee191e5a71bbceb2305f1cdde8c729",73,50,72,7.09722222222222,55,18,2,1
"32701","e1efb576e0c07e806bada00d9ecfe846",11,11,0,11,11,0,1,2
"32702","e1f0c4dc740b59dc2c176167b241108b",37,37,0,37,37,0,1,2
"32703","e1f124b568d7236287437a2c0c1367de",34,34,0,34,34,0,1,2
"32704","e1f1394a620cc82e9aec664c09997bf6",15,15,0,15,15,0,1,2
"32705","e1f29f6d5ff41006fa8c4d680acaf156",35,29,12,20.4166666666667,35,0,1,1
"32706","e1f3479ff158d1b3eb141d9b74fce669",75,62,60,8.75,58,17,2,1
"32707","e1f441c9a7bbb274cd30fae07ef8c2d3",89,64,51,12.2156862745098,89,0,2,3
"32708","e1f75b90f6080e7f3aa3f087795a489d",17,17,0,17,17,0,1,2
"32709","e1fa37a62f9bb0c384c4b9af6e84f5d6",92,44,63,10.2222222222222,92,0,2,3
"32710","e1fd1f149eed65fc73892103635e6848",18,18,0,18,18,0,1,2
"32711","e1fd6369f740590aedd679daecb47c35",28,28,0,28,28,0,1,2
"32712","e1fe94339a0a42f319215adc3d83c380",68,45,49,9.71428571428571,68,0,2,3
"32713","e201fcbb0c1bb23256c4aefde1fa0ae6",60,48,27,15.5555555555556,28,32,2,1
"32714","e2020a7e31bdfda5bd1fb1f157221331",150,82,88,11.9318181818182,98,52,3,3
"32715","e2027372cd84402e267c21eaec895a13",59,51,83,4.97590361445783,59,0,2,3
"32716","e204b4da96a4ab2ed4be18234c6f6c15",16,16,0,16,16,0,1,2
"32717","e20663a5ccd29fe59e26dc48008ff571",54,54,0,54,54,0,1,2
"32718","e208d18dd789089ab2e249ab23d46d98",62,40,57,7.6140350877193,62,0,2,1
"32719","e20bd555037ba2e60279c6f7fe9003df",124,65,73,11.8904109589041,80,44,3,3
"32720","e20c3f5a40a42cdbffb2de37723a450a",2,1,41,0.341463414634146,2,0,2,1
"32721","e20c494ced87af16383db8a43beae084",61,53,21,20.3333333333333,61,0,2,1
"32722","e20caa26886062c03a36546c8c53d477",29,29,0,29,29,0,1,2
"32723","e20e76c65fe9b539c23e3f6a79a04ebb",33,33,0,33,0,33,1,2
"32724","e2115f71d1358505457f41f3b1778a3b",8,7,3,18.6666666666667,8,0,1,2
"32725","e21567d96dceeac372092bd8adfad30e",14,10,37,2.64864864864865,8,6,2,1
"32726","e2156faff725bc00825f662d696583e0",75,60,55,9.54545454545455,75,0,2,3
"32727","e2158fd0fcad5c370481dd179d540d43",48,48,0,48,48,0,1,2
"32728","e217fbd50824073620a04db6572897ff",178,40,86,14.4883720930233,124,54,3,3
"32729","e218b861b3f3b2b743f5c8a547ab10d0",5,5,0,5,5,0,1,2
"32730","e218c2700bb23fa79985c80cf488bafb",32,29,54,4.14814814814815,15,17,2,1
"32731","e21bb3fe0dea04c144f99c98daeafe11",36,36,0,36,36,0,1,2
"32732","e21dd2067c6e55be4457e41a0ed49f8e",215,104,62,24.2741935483871,215,0,3,3
"32733","e21e0fe6f58139e31fcb70c2216b2c9f",7,5,32,1.53125,3,4,2,1
"32734","e21e5acfb4ece35371745c11bd1a4c40",14,14,0,14,14,0,1,2
"32735","e220245d51af1b7d498c51c853083832",27,27,0,27,27,0,1,2
"32736","e223cb6251c04ca9180834e30f633fca",159,86,82,13.5731707317073,159,0,3,3
"32737","e2242c701e727c5b7bc436033a9d2d8e",38,38,0,38,0,38,1,2
"32738","e2249df5e0787c7005a48ff013a6a088",3,3,0,3,3,0,1,2
"32739","e2294bda04a4f24d7ae8c3d70ff5bdb4",16,11,35,3.2,16,0,2,1
"32740","e22afac13b3b052c5fe42c3b9e472141",35,35,0,35,35,0,1,2
"32741","e22c10abfee59bbe76baa0491c600fab",52,45,32,11.375,52,0,2,1
"32742","e2312b28a79876d18592f1d27e2a775c",35,35,0,35,35,0,1,2
"32743","e23539558ebaff0a13e4a1a121c0b59e",19,19,0,19,19,0,1,2
"32744","e236068d269054c7f5506567795b8420",168,72,82,14.3414634146341,134,34,3,3
"32745","e23816d44d4366a3fdcbd9f2c9555f99",58,40,67,6.05970149253731,58,0,2,1
"32746","e2389b0ec863567431b84f1acd0c552d",150,75,71,14.7887323943662,150,0,3,3
"32747","e23f0865e72744c025ba3fb049b968bb",148,86,73,14.1917808219178,148,0,3,3
"32748","e243497a7fa1eb0573ef295749a39a10",36,36,0,36,36,0,1,2
"32749","e244b7401945013cd6c87eb7280ab579",126,88,71,12.4225352112676,126,0,3,3
"32750","e244d1562adb34b7a18023baaae23c31",104,65,25,29.12,54,50,2,3
"32751","e24550249c4dec95aeb23735c7079a9d",51,29,68,5.25,51,0,2,1
"32752","e24581c9f1f0534a7128a333da75b78b",26,26,0,26,26,0,1,2
"32753","e245dd2ef08d6705922fc403088ebb76",17,17,0,17,17,0,1,2
"32754","e246f12a202f57c261be877ba0d6caed",99,68,56,12.375,99,0,2,3
"32755","e24787a19d7fbb512ebf2e1fb4902b7a",104,93,63,11.5555555555556,104,0,3,3
"32756","e247acf815002e6b799dd60d9e93328f",23,19,24,6.70833333333333,23,0,2,1
"32757","e24df92dffb58e70d79d5e7ab209ff58",10,10,0,10,10,0,1,2
"32758","e24eeee3f7aa74e56f837423c4c2bb94",63,45,35,12.6,63,0,2,1
"32759","e2511818ed58d6413698468a5c255c12",25,20,77,2.27272727272727,25,0,2,1
"32760","e254a2289410e5a8731493690d1078a4",10,10,0,10,10,0,1,2
"32761","e2573c93b18088cc7c7a6d3761b006cb",13,13,0,13,13,0,1,2
"32762","e2576bdf31fd6222c81935cfbf72a016",173,78,62,19.5322580645161,173,0,3,3
"32763","e25b4e62f5039bae46a16c53a44fca37",139,78,67,14.5223880597015,139,0,3,3
"32764","e25bfe758c381841376801ba11d7787a",130,90,74,12.2972972972973,93,37,3,3
"32765","e262addfeb178204424fe076f08ff849",106,74,73,10.1643835616438,106,0,3,3
"32766","e2642c6807e9f2eaa1eeea8e157f125b",47,37,45,7.31111111111111,21,26,2,1
"32767","e264cffae4d9d0f01248420c7b535bf8",12,8,78,1.07692307692308,12,0,2,1
"32768","e2670983c68df535f27ce012b85733fb",71,51,35,14.2,71,0,2,1
"32769","e26a1ec2ca5f83734c1fd5a95ec4bc72",30,30,0,30,30,0,1,2
"32770","e26a79b27e07b55e18cb996ccd485d81",122,77,60,14.2333333333333,122,0,3,3
"32771","e26cab7996bd0cfbc651cc6c2c4ad17b",255,105,79,22.5949367088608,206,49,3,3
"32772","e26cb9b73e77d012fb87f4db168a5ebe",5,5,0,5,5,0,1,2
"32773","e26f9f73efb0260dd8115f7e4816b130",31,31,0,31,31,0,1,2
"32774","e2702b634c69091d5c40b4177326c2bc",115,72,52,15.4807692307692,77,38,3,3
"32775","e270902ad7681f60665704b74f9924b0",18,18,0,18,18,0,1,2
"32776","e270c868fe78795cc715c3b382698b21",5,5,0,5,5,0,1,2
"32777","e271eb61eaff24dbe36394f21b08d6f8",50,50,0,50,50,0,1,2
"32778","e273f7a95a0d0fc03f91d19c829a121c",97,76,28,24.25,97,0,3,3
"32779","e27669b6ff0abbeab8fdb94a84081200",96,81,65,10.3384615384615,54,42,2,3
"32780","e276a93e6a62a24a560b60d04ced42cb",175,78,74,16.5540540540541,175,0,3,3
"32781","e2775037256963b970122b651db323d9",13,13,0,13,13,0,1,2
"32782","e27c64a4678e7e6ab6c23f1821466966",31,17,60,3.61666666666667,23,8,2,1
"32783","e27ceb0a1576648212c4325fdf7d8002",42,42,0,42,0,42,1,2
"32784","e27ec0b6f417efcf067746f1647eb02b",31,25,57,3.80701754385965,31,0,2,1
"32785","e280645c05362be45f4848fb8d353d2a",29,29,0,29,29,0,1,2
"32786","e280f39ce2aa55b9d110f2c139d0985a",120,79,70,12,120,0,3,3
"32787","e280f83ef49d3ff663c35d877f596c97",11,11,0,11,11,0,1,2
"32788","e281575acde65b80c0acefa61f597fae",90,66,36,17.5,90,0,2,3
"32789","e281d3f2ad3b37b39832aedfd8247dd0",1,1,0,1,1,0,1,2
"32790","e2820ad10a21d6398337862d8d0ebd45",95,68,72,9.23611111111111,95,0,2,3
"32791","e2834461b80de543698a029961452a9d",123,69,29,29.6896551724138,123,0,3,3
"32792","e284343fac0436d4ed4a064eb7949864",86,62,69,8.72463768115942,86,0,2,3
"32793","e2852eb147fde95c8b50d707f2c934e1",23,23,0,23,23,0,1,2
"32794","e286193c7be88509b2b0921ed781377a",107,70,51,14.6862745098039,107,0,3,3
"32795","e2870d0af10f494debed26bd48eb3b1c",101,65,61,11.5901639344262,101,0,2,3
"32796","e288ec377ac4feba9cba0d2a485c109c",80,66,58,9.6551724137931,80,0,2,3
"32797","e289658952d28004c1ae55865837810f",44,29,42,7.33333333333333,44,0,2,1
"32798","e28ce7cf133289f89ef69b4340857c88",144,88,60,16.8,144,0,3,3
"32799","e28d5582884d4f0771be5545aa381f92",93,51,87,7.48275862068965,81,12,2,1
"32800","e28f85f0d981b05d959f8e213607d568",38,33,49,5.42857142857143,38,0,2,1
"32801","e290b16877f20c7eb0c262289b92482f",57,40,47,8.48936170212766,26,31,2,1
"32802","e2921b2496ff11192972a92564158cfa",169,99,65,18.2,168,1,3,3
"32803","e2924550a31839d1c0f8d349f01ec95d",17,17,0,17,17,0,1,2
"32804","e29368921b9abe8ce88e263ec157bd5a",129,73,61,14.8032786885246,91,38,3,3
"32805","e293ed3a365f0e254139f5fdef19fa78",202,99,79,17.8987341772152,202,0,3,3
"32806","e295a49896c2298138ffb5ca3d32899c",12,12,0,12,12,0,1,2
"32807","e29861d198a332fd6c74a000e8137ea2",102,81,68,10.5,65,37,3,3
"32808","e2990074287f06ad47a4cdf4dc0c47d9",30,30,0,30,30,0,1,2
"32809","e29c236a0c68fc453ef6fb37738eeab5",22,22,0,22,0,22,1,2
"32810","e29fc3c1fca7e22c37780cd8c00dbc24",5,5,0,5,5,0,1,2
"32811","e2a11a740ef3141c31dc84ff4048f275",108,89,38,19.8947368421053,108,0,3,3
"32812","e2a133b6aec563c3336c6fe5701be4c3",45,24,84,3.75,45,0,2,1
"32813","e2a163b479d0e972605cb96be3463584",85,67,59,10.0847457627119,85,0,2,3
"32814","e2a305c035a506be4536d4b0e0caae76",14,14,0,14,14,0,1,2
"32815","e2a50d5c36e16db3ea65ae045c75524c",7,7,0,7,7,0,1,2
"32816","e2a76443c298ef175316e79276eddd57",53,39,19,19.5263157894737,53,0,1,1
"32817","e2ab2d6776d033a3cacf487c5037dd98",125,50,71,12.3239436619718,125,0,3,3
"32818","e2acd0faef7677fc104f8f3f6dc48546",195,118,76,17.9605263157895,195,0,3,3
"32819","e2b05a3d565180546ec91051c7291da2",171,136,60,19.95,142,29,3,3
"32820","e2b1a3803fc50fa2e4071b88120cf003",47,47,0,47,47,0,1,2
"32821","e2b4e5ae8afa1992a96d8f7b9c793cbd",1,1,0,1,1,0,1,2
"32822","e2b6ef98d087d13e6cceb8aa2ca678f7",23,23,0,23,23,0,1,2
"32823","e2b745f5aa02a8b4d949e6869a786657",67,50,14,33.5,67,0,1,2
"32824","e2ba7d809182c76dd306d5d6a91e9f7f",28,28,9,21.7777777777778,28,0,1,2
"32825","e2bb6a11fa11d5e23d5df1e98424a3df",74,62,55,9.41818181818182,74,0,2,3
"32826","e2bbd4115d76cd4276558fd10ee305bb",15,15,0,15,15,0,1,2
"32827","e2bcdf5e7691b6539e6fd1ee293ad506",81,55,39,14.5384615384615,81,0,2,1
"32828","e2c042022fbe5601972f2e2b08ffa678",36,36,0,36,0,36,1,2
"32829","e2c3435daaabc9808a1bd4151b74d36e",66,51,23,20.0869565217391,66,0,2,1
"32830","e2c35846c4a554e542cb58849f5fb8ee",41,30,52,5.51923076923077,20,21,2,1
"32831","e2c389589e01f7d1b7b46aaddb4580b1",80,64,39,14.3589743589744,80,0,2,3
"32832","e2cb77fcb5e89dfe41e390e652f23805",21,21,0,21,0,21,1,2
"32833","e2cc92386aadcfb64a9cce632248a701",38,33,46,5.78260869565217,38,0,2,1
"32834","e2ce54d1b8120d2706fd670b05ba2a28",21,20,28,5.25,21,0,2,1
"32835","e2d181d75927051e8a4dd5368f5c2eaa",37,37,0,37,37,0,1,2
"32836","e2d7814fbf69fc6eda3d7e572a41db36",34,34,0,34,34,0,1,2
"32837","e2d9680b479d5921c9da0d99151f7872",154,72,70,15.4,154,0,3,3
"32838","e2ddfb08b00353e4ce45386fb2aedc46",52,52,0,52,52,0,1,2
"32839","e2dedb4adc2999696bbae1e6ab671f37",85,58,46,12.9347826086957,85,0,2,3
"32840","e2df250d944a97eb92413b16c5b61593",157,78,43,25.5581395348837,157,0,3,3
"32841","e2df943dada63e43eca3b6f83d5c7647",35,35,0,35,35,0,1,2
"32842","e2e0ae0ca41994031ed515a1715a9319",40,40,0,40,40,0,1,2
"32843","e2e442c42dca5f7205c387e61e8abcc2",41,41,0,41,0,41,1,2
"32844","e2e99b44ccf888e9c7bd5e2b885175b4",32,32,0,32,32,0,1,2
"32845","e2e9de870021f669be5ae250232ba4e9",113,72,81,9.76543209876543,113,0,3,3
"32846","e2eb68ec07208fda031f0175dac8e1cd",54,45,32,11.8125,25,29,2,1
"32847","e2eed1c47c7fefb52bf444a42cbae43f",144,88,50,20.16,114,30,3,3
"32848","e2f0d4123493758a417e893fccdb1f1f",89,58,49,12.7142857142857,89,0,2,3
"32849","e2f16f06630edc98ab3ebf54d053ff00",112,85,77,10.1818181818182,74,38,3,3
"32850","e2f1de58efd881990c6f0992542de22f",89,50,75,8.30666666666667,89,0,2,3
"32851","e2f321780b8cc61292031fa06951b799",96,64,28,24,96,0,2,3
"32852","e2f3346e6d5c33f5143381d3577fc689",15,15,0,15,15,0,1,2
"32853","e2f33ec010376a1c3f6aec0924b48520",7,7,0,7,7,0,1,2
"32854","e2f395cc83b18e529efaff865e6f2ef2",30,30,0,30,30,0,1,2
"32855","e2f3b26589fdbbebb279376bc7068d2d",147,98,76,13.5394736842105,147,0,3,3
"32856","e2f45fed31bf589c9ef76743bb8d3d17",23,23,0,23,23,0,1,2
"32857","e2f496efc2035f531e988850a53b2e67",93,52,72,9.04166666666667,93,0,2,3
"32858","e2f61c77ae49f4ac0b8ca0fc20465f44",18,18,0,18,0,18,1,2
"32859","e2f6a05c5fcab0d75dbc723d3aa0e794",15,15,0,15,15,0,1,2
"32860","e2f72f44de44e1e8a58af60ebc834147",13,12,4,22.75,1,12,1,2
"32861","e2f7c59cc296113d08fe24e65de0aa75",58,44,35,11.6,58,0,2,1
"32862","e2f7db542dd02231c451f7c8cd4f17be",47,45,6,54.8333333333333,47,0,1,2
"32863","e2fa3353c89990564dd7826b38da0a44",1,1,0,1,1,0,1,2
"32864","e2fa3c8473499c68812282d34d261edf",1,1,0,1,1,0,1,2
"32865","e2fd4df743d28e1ede195b3660058d8d",68,51,36,13.2222222222222,35,33,2,1
"32866","e2fff76c200d963cd64fe6c2c097be6d",48,48,0,48,48,0,1,2
"32867","e3010b91a0b653b10510db6d402b3443",93,48,63,10.3333333333333,62,31,2,1
"32868","e3011d4ce1e28f272bf7ce54ba1c1cb8",46,28,69,4.66666666666667,46,0,2,1
"32869","e302ebd5e23d3dc10c5ffd6bc610b229",17,17,0,17,0,17,1,2
"32870","e3039db7d5a67274e3e5dc49f93536b9",53,21,56,6.625,0,53,2,1
"32871","e30967591f04bd9c39e0b1fe7059410b",24,24,0,24,0,24,1,2
"32872","e30996dd65c4fbeca40823ca870626f8",24,14,82,2.04878048780488,15,9,2,1
"32873","e30a8acf0d9d47116ea78330e5be8464",48,42,48,7,48,0,2,1
"32874","e30b63a99c98df8eaa0c7c8e80895fc1",49,37,42,8.16666666666667,49,0,2,1
"32875","e30bc8b07e7fdb49dc5ec537c6e6a26e",36,34,6,42,36,0,1,2
"32876","e30c55c2c318bd683c485783ee6ce5cc",20,20,32,4.375,11,9,2,1
"32877","e312893d2aa66c6bfe77a62ded2d5182",14,14,0,14,14,0,1,2
"32878","e312aa7e24f3bab9cbdaa5369042a89b",127,73,84,10.5833333333333,127,0,3,3
"32879","e312eeb21d939ea529140790daf7903a",48,41,21,16,48,0,2,1
"32880","e314637372078d99441d0c2efb5feb60",45,45,0,45,45,0,1,2
"32881","e315a7e75a6183269ee046992b5e6f50",49,49,0,49,49,0,1,2
"32882","e31a74562610d97e49429b51ef4c7715",207,101,59,24.5593220338983,207,0,3,3
"32883","e31ad8b00c3cf165dfa62c07ee4fb372",34,34,0,34,34,0,1,2
"32884","e31b67e68d7a5442452ad80971ea107c",37,37,0,37,0,37,1,2
"32885","e31d4341e1b7c83cf2c28b0f5ccbd1f3",75,56,42,12.5,75,0,2,3
"32886","e3208161862e5518754c982de640a19f",49,47,19,18.0526315789474,49,0,1,1
"32887","e320e94bae4868b5f00502095dc935a9",39,39,0,39,39,0,1,2
"32888","e3230d755334302cec8e9d0150670640",3,3,0,3,3,0,1,2
"32889","e323374b3150344da17c1be15ecbd178",23,23,0,23,23,0,1,2
"32890","e32538b34fd9cdff28159a6ec5be2087",203,85,67,21.2089552238806,203,0,3,3
"32891","e325f12e253d9000061331a14093d289",11,11,0,11,11,0,1,2
"32892","e3283046bf27e5a1cbd3ab6167e776ae",140,79,60,16.3333333333333,140,0,3,3
"32893","e32846e900dbf65a02ac34ba00b9da5a",31,31,0,31,31,0,1,2
"32894","e32a6570318d4f729174c4a37c3c07c6",48,48,0,48,48,0,1,2
"32895","e32af0a606441ea14da3ab38f253a461",81,73,33,17.1818181818182,81,0,2,3
"32896","e32d08a2816e3438fc580e709fd08f71",52,47,25,14.56,26,26,2,1
"32897","e32dd2c2d40514109a262143723c37fd",240,104,75,22.4,213,27,3,3
"32898","e32e1153b765d0e9c20ed018cfa1d7e9",36,36,0,36,36,0,1,2
"32899","e32f17bbf54a5e378e153a0295dfea1f",41,41,0,41,41,0,1,2
"32900","e32ff36e297488bf9b49d7818e6b7e55",145,80,74,13.7162162162162,113,32,3,3
"32901","e3310cf2975c34a4e867eaeda37eaf69",58,50,23,17.6521739130435,58,0,2,1
"32902","e331eca58b3627e0a7ee67b5da0259e5",1,1,0,1,1,0,1,2
"32903","e337c8c296a9bf52186db21988ace2d2",145,105,61,16.6393442622951,145,0,3,3
"32904","e33891b3e3b255291369aa580738ad8a",163,100,82,13.9146341463415,112,51,3,3
"32905","e339440fda4cf2798719cbd83cea10ca",107,91,85,8.81176470588235,107,0,3,3
"32906","e33b8c909faaf626124c288b013dae0f",47,43,26,12.6538461538462,47,0,2,1
"32907","e340535299fa1e39b7cd8cce9422466d",93,48,79,8.24050632911392,71,22,2,1
"32908","e340ca1d0bb1be9608239469663a77ee",24,24,0,24,24,0,1,2
"32909","e340d5fb6c26f510808d9b9627d5f080",51,49,14,25.5,51,0,1,1
"32910","e340f612bcf299691b9727ce1cc73470",57,49,75,5.32,57,0,2,1
"32911","e341549a9d8caf30368ea4dd730fdd1c",10,7,62,1.12903225806452,10,0,2,1
"32912","e34214c89a97030bd6f10ffacb360107",15,15,0,15,15,0,1,2
"32913","e342c51fa8b7f53614a48a06a95d5c83",34,34,0,34,34,0,1,2
"32914","e342edb50c30214e007911cefe98d1c9",26,25,30,6.06666666666667,26,0,2,1
"32915","e343788790d4ed9699620d756f60434a",72,55,55,9.16363636363636,72,0,2,3
"32916","e345fd1d015d29ee58ac799047499e12",126,78,59,14.9491525423729,126,0,3,3
"32917","e347a13222c6c8f98a1ead92c0edbc0b",211,96,76,19.4342105263158,211,0,3,3
"32918","e347e26fb002ced7fb05e757eb4ff961",13,13,0,13,0,13,1,2
"32919","e34b1d62f5671208d81cc7df02140b4f",27,27,0,27,0,27,1,2
"32920","e34ea69a72e3ab83f54ceabee72b4854",23,23,0,23,23,0,1,2
"32921","e34f4768430ef34d298cb42493002e7f",155,119,64,16.953125,106,49,3,3
"32922","e350e0e88a603a39de032041a7449d38",59,39,41,10.0731707317073,59,0,2,1
"32923","e3511126dc27c9ef1f871adc5e8e4d8a",75,54,42,12.5,75,0,2,3
"32924","e3511c0e9a99e0bba241418c581edfc2",147,75,69,14.9130434782609,147,0,3,3
"32925","e354785a598eac46e4d141f710dfb92e",59,56,49,8.42857142857143,59,0,2,3
"32926","e3564d68d1ca815a6d84d1151673b84c",55,44,61,6.31147540983607,55,0,2,1
"32927","e35974cf7a7725f417bfc24a48b7ca52",99,56,71,9.76056338028169,99,0,2,3
"32928","e35ac1f7fe2b302819dd89b00416dd87",191,95,84,15.9166666666667,158,33,3,3
"32929","e35b2b16629bc00a9967391d2cc08912",23,23,0,23,23,0,1,2
"32930","e35bb26db63bdc29e275246c3cd570b3",46,46,0,46,0,46,1,2
"32931","e35cd8a728fe22f3b988451bc67444de",4,4,0,4,4,0,1,2
"32932","e35d7922cfbc7d7e5c5e6026bf051f3d",11,11,0,11,11,0,1,2
"32933","e35d811b8a52104432974cadd314d4f6",24,24,0,24,24,0,1,2
"32934","e360e474b326e1ba8ecacb782bee89f5",190,76,84,15.8333333333333,190,0,3,3
"32935","e361598b52cc7a80ced0d6025a02bb69",105,60,31,23.7096774193548,105,0,3,3
"32936","e362a89f14f45da3168367feae183c98",24,17,48,3.5,24,0,2,1
"32937","e36b21be59a097e4689c6f09fcca4831",92,48,50,12.88,92,0,2,3
"32938","e3703c72ec381bae06e5b10df4c6ea0f",17,17,0,17,17,0,1,2
"32939","e37185855a400339a7cdb936c139f631",145,93,62,16.3709677419355,145,0,3,3
"32940","e373c09e0532b567e142f328e6b032c7",23,23,75,2.14666666666667,23,0,2,1
"32941","e3751fc791bd34e366b84632d59d53da",101,47,48,14.7291666666667,101,0,2,3
"32942","e376cbff8c48808fa52da8e674f4a10a",29,29,0,29,29,0,1,2
"32943","e37829218917f84e308effc844b0af1f",135,95,63,15,135,0,3,3
"32944","e37abeea1791dd64954fc88d85967b70",66,53,37,12.4864864864865,66,0,2,3
"32945","e37b430e4489ac4d50de6f0f4511dec6",15,15,0,15,15,0,1,2
"32946","e37d215df04a09a650e6c79fced2b2f4",158,85,71,15.5774647887324,158,0,3,3
"32947","e37e637b103fd18d77f66ddf50f3676c",45,43,32,9.84375,45,0,2,1
"32948","e37fb6212212e77a26ed1c8d626af5bd",8,8,0,8,8,0,1,2
"32949","e381be3d5379e6f2f95c3100eea39903",24,24,0,24,24,0,1,2
"32950","e3825ab7ef32a89a6eb4ec4f993ce018",27,23,56,3.375,27,0,2,1
"32951","e38353d2a698b616acd995ecacd691be",118,77,67,12.3283582089552,118,0,3,3
"32952","e3868043df9ef0914c45c20fe6460a87",117,87,45,18.2,117,0,3,3
"32953","e3873da4bcf85c480fd27d4a144f2076",93,65,23,28.304347826087,57,36,2,1
"32954","e38904b3afa6237640fb0f6cb7fc402d",114,48,78,10.2307692307692,114,0,2,3
"32955","e38b01abafba2bd1fb730f6e4cef8ca8",41,41,0,41,41,0,1,2
"32956","e38c5215224b0410492912bb7139a593",8,8,0,8,8,0,1,2
"32957","e38d02ac7560ce6a954ab7fd11fd18d9",34,34,0,34,34,0,1,2
"32958","e38d93514e6045b18abfeacbcb9e8532",187,103,73,17.9315068493151,152,35,3,3
"32959","e38eea606ff554665ba514000b423b76",54,46,16,23.625,26,28,1,1
"32960","e38facf9360102fddf7f275d65e83fb0",110,91,83,9.27710843373494,110,0,3,3
"32961","e3906851ef6bc54a3234c7a00db0368f",19,17,24,5.54166666666667,19,0,2,1
"32962","e3910d55c33641943ced03defbe9de77",1,1,0,1,1,0,1,2
"32963","e393125413638ac30ffca92e98ffa2f1",149,121,57,18.2982456140351,109,40,3,3
"32964","e3966855c9a356615ab63e4e283b8d8f",9,9,0,9,9,0,1,2
"32965","e3966fb8d6d0672e9fe79d8c26be1a6d",56,56,0,56,56,0,1,2
"32966","e39742c59bc945ec2733a4d6f9846ffa",79,65,70,7.9,79,0,2,3
"32967","e397ee79562d8d0492e2382948913b61",44,44,0,44,44,0,1,2
"32968","e39a25341de5f0f6f54e3207996f4d1c",45,31,56,5.625,45,0,2,1
"32969","e39c7a560100f573924e0aff201ccc40",23,23,0,23,23,0,1,2
"32970","e39e3d78800fad473cab5047d1f11d44",47,38,60,5.48333333333333,34,13,2,1
"32971","e3a1ef0ea1ba80c38f8ac7100ad1b29a",89,72,25,24.92,45,44,2,3
"32972","e3aa0e4d44bba3b61c46451634886154",15,15,0,15,0,15,1,2
"32973","e3ab5de3e290e419ce86b5bc70a5a23f",156,111,42,26,156,0,3,3
"32974","e3ac8cd257518aa1d60c1f55e3831610",26,20,79,2.30379746835443,26,0,2,1
"32975","e3ac8e1b70104ded0cfb4c07c5313ed2",40,40,0,40,40,0,1,2
"32976","e3ad11c4b9624b636faee304127f4659",3,3,0,3,3,0,1,2
"32977","e3b13a65db7032fc66f8e8cbedcd248d",99,51,45,15.4,99,0,2,3
"32978","e3b19c56248a87b7b9c392e85d455628",69,42,45,10.7333333333333,69,0,2,3
"32979","e3b54a2d51c5df1d025796bb084e364c",36,24,14,18,36,0,1,1
"32980","e3b66354c14d0090e4ceb9124f494635",61,41,79,5.40506329113924,23,38,2,1
"32981","e3b75dad173281140b7495ab7039fc14",143,87,69,14.5072463768116,143,0,3,3
"32982","e3ba1701bb3749601f22249184a3f6c6",72,59,41,12.2926829268293,72,0,2,3
"32983","e3bb4a9ecc7fc936b1958dfedaf28116",32,32,0,32,32,0,1,2
"32984","e3bb98a3553e218ff9d268680e8d0c8c",16,16,0,16,16,0,1,2
"32985","e3bd10f6151a5705b55a3b3979cc4407",111,76,78,9.96153846153846,111,0,3,3
"32986","e3be9d75b285eb618543810acfa9e7d1",27,27,0,27,27,0,1,2
"32987","e3bf2f2b2e89adc18d31be3b6e942535",31,31,0,31,31,0,1,2
"32988","e3bf6ca48431f5423862754726ca013e",19,19,0,19,19,0,1,2
"32989","e3bfbe86026bc87b0e65cd83cb286a7c",54,54,0,54,0,54,1,2
"32990","e3c130a11690d4a0b5daf4787b2c1578",37,37,0,37,37,0,1,2
"32991","e3c1f233b94d2ada84553b61b844ad26",77,75,38,14.1842105263158,77,0,2,3
"32992","e3c2cd41492ce63ffd1175d00998b800",30,30,0,30,0,30,1,2
"32993","e3c499b44a0a8e7b92996215f613a17f",66,49,37,12.4864864864865,66,0,2,1
"32994","e3c76587d131e723523818077640fb06",10,10,0,10,10,0,1,2
"32995","e3c80cc723a6f2895ac3e8f3cc2fedad",68,42,68,7,36,32,2,1
"32996","e3ca24a17bcb86375b5673a998f3dcf6",57,52,13,30.6923076923077,18,39,1,1
"32997","e3cc662abccaefa2cf0a611e08ead870",88,72,54,11.4074074074074,68,20,2,1
"32998","e3cf7d5dca787aea40d6453c2c891328",196,66,77,17.8181818181818,196,0,3,3
"32999","e3d2b25db6e5eb0cb7727e4bed2ede33",42,42,0,42,42,0,1,2
"33000","e3d477ad1c79b45eb712a3916cd4f363",38,38,0,38,38,0,1,2
"33001","e3d4f91e3c6ff35801e10027ee8d7840",15,10,30,3.5,8,7,2,1
"33002","e3d7931ca20ede78f21ad7db0ec83511",89,64,61,10.2131147540984,49,40,2,1
"33003","e3e030732ca814149f3dafd360efe7b8",4,4,0,4,4,0,1,2
"33004","e3e115d2893cf00887e2712bf5a1905b",73,59,29,17.6206896551724,73,0,2,1
"33005","e3e16361d970defb9d3d25d9b3b4cc18",23,20,44,3.65909090909091,23,0,2,1
"33006","e3e1be944880bcbd505ac301259c9008",35,21,75,3.26666666666667,35,0,2,1
"33007","e3e24fb9c93502faff72d2538e676806",4,4,0,4,4,0,1,2
"33008","e3e2eb6fcd17bad51d4fb0d58a61929c",30,30,0,30,30,0,1,2
"33009","e3e475e1a0c75f93cbfd2a352a8a33aa",149,94,82,12.719512195122,117,32,3,3
"33010","e3e532b5a5a9efa0ec65bfec8ff80b4f",66,62,37,12.4864864864865,39,27,2,1
"33011","e3e715bcd35959cdc6c4f3f211a905ad",34,27,44,5.40909090909091,18,16,2,1
"33012","e3eaeeb061121f7b6e9ae7527912281f",8,8,0,8,8,0,1,2
"33013","e3ec046bdf0fb05e7c5f62a69c0a0749",57,47,43,9.27906976744186,57,0,2,1
"33014","e3efa1a774a21a50d5c429c6c6da5498",185,117,69,18.768115942029,185,0,3,3
"33015","e3f0003c864e817e2051c5659c032f60",96,84,30,22.4,42,54,3,3
"33016","e3f2965b4671080fba8aaf78553f6255",93,70,72,9.04166666666667,93,0,2,3
"33017","e3f4dfe04ebe3d4431c04f6f3fb3137d",203,99,80,17.7625,176,27,3,3
"33018","e3f594261131ce34ac198a91572173d8",13,13,0,13,13,0,1,2
"33019","e3f63fa3f58874800b602eb0fac30f36",27,27,0,27,27,0,1,2
"33020","e3f6bfac31d727c920b06a923b6f6a8b",79,56,59,9.3728813559322,43,36,2,1
"33021","e3fdc99c8606ed04ce6fe2c1ff51aa3f",70,56,14,35,17,53,1,3
"33022","e3ffbde240adb97f8ccac3c1f37b59c0",121,74,59,14.3559322033898,73,48,3,3
"33023","e4001be3e73cbecab3ac1a59e8bb7527",11,11,0,11,11,0,1,2
"33024","e4016a85ce235590959cc7ec472012b9",43,43,0,43,0,43,1,2
"33025","e401b72283435b43bc239b42eabac220",18,14,69,1.82608695652174,18,0,2,1
"33026","e4054cbddbea624a718686d926ba0614",213,115,81,18.4074074074074,165,48,3,3
"33027","e407a32e64d7c3c5fcb1da4515f16819",14,14,0,14,14,0,1,2
"33028","e4090f41f016db106f98ca9a0b502cc9",38,38,0,38,38,0,1,2
"33029","e40a620f3a88b5295f5589fb3a92edcd",166,126,69,16.8405797101449,153,13,3,3
"33030","e40a8cfcb1ada1d5e805d870e5d7360d",181,79,69,18.3623188405797,136,45,3,3
"33031","e40cc5b06665da8eda40294ef0249dba",213,94,80,18.6375,176,37,3,3
"33032","e40d0c4d74987a8b1a2a04623e4496a0",23,23,0,23,23,0,1,2
"33033","e40d5b6049cdf842015f5fdfcb4e82e4",91,46,61,10.4426229508197,91,0,2,3
"33034","e40f6cebbd76edc09118c5b00cf67f1c",5,5,0,5,5,0,1,2
"33035","e412dd1f16bf5c999b637ac1567a227b",7,7,0,7,0,7,1,2
"33036","e41368dede3cebfcc93ec9bf24aabf58",39,39,0,39,39,0,1,2
"33037","e4143f5e02d3d97ffde500f8d31af1d7",48,33,39,8.61538461538461,48,0,2,1
"33038","e41ae1af671992d75d36591ed3400d45",29,25,14,14.5,0,29,1,1
"33039","e41c8dec94089155a57a06ca1d1cd9ad",42,42,0,42,42,0,1,2
"33040","e420ad61051bf4b5795d4ad4f94d476a",1,1,0,1,1,0,1,2
"33041","e42259bd8cf204e76eac915abd29d9d7",51,49,7,51,51,0,1,2
"33042","e424b5117490fbbbd60114f4ef1ef006",17,17,0,17,17,0,1,2
"33043","e4255b4241d0dd7007e09eb900213bf4",22,22,0,22,22,0,1,2
"33044","e4260dada97e72687eeb36e91bcd7424",25,25,0,25,25,0,1,2
"33045","e426f5caba2cbe829def845e88bd76d7",8,8,0,8,8,0,1,2
"33046","e42ad22c9fc9c15c2a68a29b34b7b762",42,42,0,42,42,0,1,2
"33047","e42d7c9ae89ab2b9e3ec7c3d31d97e4e",153,63,72,14.875,103,50,3,3
"33048","e42dc28c954d6ab29ebec8885c1b347b",32,31,19,11.7894736842105,32,0,1,1
"33049","e42f8a931e9466aaaa2d65707f6c1bb2",19,19,0,19,19,0,1,2
"33050","e42ffcbb3eb35abf777dbfc7851cfc10",29,29,0,29,29,0,1,2
"33051","e430431d96dec3314e9149b8ccc325a3",122,72,71,12.0281690140845,78,44,3,3
"33052","e430914c238da787102c2fa01668a922",101,73,63,11.2222222222222,101,0,3,3
"33053","e4325d040c69e869e2fe86a1af863723",24,24,0,24,24,0,1,2
"33054","e43261c5e1f48b8249c9493a5326ee5e",35,35,0,35,35,0,1,2
"33055","e433f5c04d0c02aa95ae489caea51198",176,109,75,16.4266666666667,132,44,3,3
"33056","e434d125ea12a5c75f859f8dd49e6fe7",44,44,0,44,44,0,1,2
"33057","e436d319d92ca476cca3cd115e3a8a2d",54,48,29,13.0344827586207,54,0,2,1
"33058","e4376612ca12151746aabd4a8846fa3b",48,45,12,28,35,13,1,2
"33059","e43a2851f4a9a35d72631fa505558f0e",59,43,70,5.9,59,0,2,1
"33060","e43bdfbc54de6890cbbc83b1f582e908",48,42,63,5.33333333333333,48,0,2,1
"33061","e43be2e4b87102782147446cec700424",69,54,63,7.66666666666667,69,0,2,3
"33062","e43cbf85a4e7571ab253d303862e9b87",51,49,13,27.4615384615385,51,0,1,1
"33063","e43d60855b21c74c1aaf7aa381c497a5",37,31,29,8.93103448275862,37,0,2,1
"33064","e43d8ceda0a0c309b058ace3dec300b8",80,52,45,12.4444444444444,29,51,2,1
"33065","e43dad296c47ac2005bd1d6cb3fb3fb7",15,15,0,15,15,0,1,2
"33066","e43e4b4789434ad015d50b60805c9d91",28,23,14,14,28,0,1,1
"33067","e440e236536b6cfd800efda4aba22fbd",40,37,16,17.5,17,23,1,1
"33068","e4435555f2f49f0164e6194112c3e8ae",20,18,40,3.5,20,0,2,1
"33069","e44750793c2a49d1f38516f17a8bd0a8",89,49,58,10.7413793103448,64,25,2,1
"33070","e44783a07fb563caecd21a8adbfc5b18",79,56,35,15.8,79,0,2,1
"33071","e448cb0145fa72d9c13ab36407a86577",27,23,30,6.3,27,0,2,1
"33072","e44a7707b0c72f5c0aa420a65bef4340",34,34,0,34,34,0,1,2
"33073","e44a85a160a1d0f1801f6baad3223c01",35,35,0,35,0,35,1,2
"33074","e44b90dadd992d026e1eea0233adc42c",53,53,0,53,53,0,1,2
"33075","e44bb3976c212d60f3cd5757c56dee6b",197,91,67,20.5820895522388,197,0,3,3
"33076","e44d40692f133e88b3b108a61d62ee5d",46,43,77,4.18181818181818,46,0,2,1
"33077","e44db964fc2304e0af14178225456d46",135,88,78,12.1153846153846,92,43,3,3
"33078","e4501b31c3c5bfc809e29a201b719473",36,22,32,7.875,36,0,2,1
"33079","e450685bf4ed901c56c3f1f5167ea67f",69,50,25,19.32,69,0,2,1
"33080","e450e3a0dbacb6f202b4512ff294a089",43,43,0,43,43,0,1,2
"33081","e4534d71ee15b7ab5109973a647c14a2",29,29,0,29,0,29,1,2
"33082","e4543e6ebd46ad74ebce9d5206fb3cd6",26,26,0,26,26,0,1,2
"33083","e454d87b6c8f915d6a9e8479b94dfa50",38,38,0,38,38,0,1,2
"33084","e4570e10d54bc8396540dc8ae77d9bd5",11,11,0,11,11,0,1,2
"33085","e458a3c036f9761e880022e04da6e5e8",80,57,49,11.4285714285714,80,0,2,3
"33086","e45914396c8659b94db94083d32e1658",51,51,0,51,0,51,1,2
"33087","e45968025215c33f052380767a8ca119",96,76,14,48,96,0,1,2
"33088","e45e80abf0afe64b37ef50bb9eb9bfd4",130,91,54,16.8518518518519,101,29,3,3
"33089","e45ef2a3bc669a0183041b4f94d70f44",193,94,76,17.7763157894737,193,0,3,3
"33090","e4603f8c58e5922e685dfd32a17091fd",31,31,0,31,31,0,1,2
"33091","e460c2b9f1f555199561a34805610986",75,53,23,22.8260869565217,75,0,2,1
"33092","e4610106d142750459563ecd5f700941",54,54,0,54,0,54,1,2
"33093","e461882ccb7a7144e584c8c370b44d05",106,77,56,13.25,106,0,3,3
"33094","e461d1eec7d80a4774fc58ae6df1ea97",249,117,77,22.6363636363636,210,39,3,3
"33095","e46203ec985df2fef59bb1f0cc69eb66",30,30,0,30,0,30,1,2
"33096","e4643587d0a1d74eeb0ccedb393fbc59",94,70,31,21.2258064516129,94,0,2,3
"33097","e465248994fe05d7bd29333d2acf7ff2",169,93,64,18.484375,123,46,3,3
"33098","e466572cabb9a9cc921443effbe63ccd",21,21,0,21,21,0,1,2
"33099","e46d4e45259d49fca44ccc47dc66ea77",20,20,0,20,20,0,1,2
"33100","e46f5b95b17ab31c043ac52d6e294e25",43,43,0,43,0,43,1,2
"33101","e47074e1f4c35baaa65f6a099447eede",126,66,71,12.4225352112676,81,45,3,3
"33102","e4725f6bfaf98e752e8bb2b65a074481",9,7,27,2.33333333333333,9,0,2,1
"33103","e4730ae0d90ffff22eecc6f6ef70eaba",84,69,40,14.7,31,53,2,1
"33104","e473f547669bede159f5c1ea4ea8e35b",23,23,0,23,23,0,1,2
"33105","e474a8c5b8df4459ffd25352c2210717",19,19,0,19,19,0,1,2
"33106","e475f5b47e802803118ab7c64f1025c8",19,19,0,19,0,19,1,2
"33107","e47812dca1a12a85bb09aa920377ab76",17,17,0,17,17,0,1,2
"33108","e47882abf8eeea6ae9b58c1499b8fcec",120,79,63,13.3333333333333,89,31,3,1
"33109","e47a61f1834869f84b936cf6a8e196a2",19,19,0,19,19,0,1,2
"33110","e47abc1a347958198c006556564e7b23",138,98,55,17.5636363636364,138,0,3,3
"33111","e47bc7f0b88a5fd89ced885efb788d92",12,12,0,12,12,0,1,2
"33112","e47ef6c016abc4751a09a53eb5048b1c",138,79,58,16.6551724137931,89,49,3,3
"33113","e480fab39ee73c3eec39d8b8cc081be4",41,32,25,11.48,41,0,2,1
"33114","e4820d6dba00c56c9fa3ce0cce22796b",78,64,62,8.80645161290323,78,0,2,3
"33115","e4820e59fd04cbe3f5bab1da36932ec7",32,20,75,2.98666666666667,19,13,2,1
"33116","e486daf5bddc8dadc1d68aa0e2253145",24,24,0,24,24,0,1,2
"33117","e48816a62fce6e11795401987bb1bf88",152,117,50,21.28,152,0,3,3
"33118","e488d2b8b799286a2adfa29bdda46a71",46,42,7,46,46,0,1,2
"33119","e488dab03b76535215a63710c9548415",49,44,47,7.29787234042553,23,26,2,1
"33120","e491359a11b146681c65ee70c9566522",25,25,0,25,0,25,1,2
"33121","e49191ba1fcaca460c050ea6c5ea362a",48,48,0,48,48,0,1,2
"33122","e493f4df42842936191cff5b93808f6e",51,51,0,51,51,0,1,2
"33123","e49402dff4d1210604952a3977c38847",48,48,0,48,48,0,1,2
"33124","e49679bb9f6a3786e4ab99980f346cb4",46,35,72,4.47222222222222,46,0,2,1
"33125","e49683ceb55797c146a523f28354e85d",7,7,0,7,7,0,1,2
"33126","e49827d6d01db1225e98ba53dd76992e",22,22,0,22,22,0,1,2
"33127","e4a5c7946491c32a70838c31588c8dd5",61,43,33,12.9393939393939,61,0,2,1
"33128","e4a7a532770ca46cb5c72e28cad6af7b",46,37,57,5.64912280701754,46,0,2,1
"33129","e4a94fa9bb2ee2565d404b30b88bfe5e",2,2,0,2,2,0,1,2
"33130","e4ac43556f0d575e75947a972083ecbc",197,78,76,18.1447368421053,197,0,3,3
"33131","e4ae6ce964f2291b63009fb544b2d54d",207,94,73,19.8493150684932,169,38,3,3
"33132","e4af94dbd5a84fd6225eb51c3662c539",17,13,50,2.38,17,0,2,1
"33133","e4afac2ee330664bef164b5e4574979e",12,12,0,12,12,0,1,2
"33134","e4afc0f89f501650bc1581a3c1a4dea5",58,45,42,9.66666666666667,58,0,2,1
"33135","e4b0922d1ef6d2418a661c38ce026c2d",78,49,60,9.1,50,28,2,1
"33136","e4b152222ca788a9b601c1d602214530",75,49,36,14.5833333333333,40,35,2,1
"33137","e4b27b11dc2a92757c24ade37196171b",19,19,17,7.82352941176471,19,0,1,1
"33138","e4b592a01f0edcd8fb7efa061803acfd",28,28,0,28,28,0,1,2
"33139","e4b7a1362b134154b8e272507a3a6cca",102,70,53,13.4716981132075,102,0,3,3
"33140","e4bb2c2daec70316c3b6688fa206be10",122,68,76,11.2368421052632,93,29,3,1
"33141","e4bc9724280ac42d715a86ce056cbc06",102,73,78,9.15384615384616,102,0,3,3
"33142","e4c1b3d7e1ab3bd4758bd56a44aa9e59",30,30,0,30,0,30,1,2
"33143","e4c4cb8dff051488e71b5bb932358ec9",81,56,55,10.3090909090909,81,0,2,3
"33144","e4c5b71be1b3983e59bc059b4e8527a7",29,29,0,29,29,0,1,2
"33145","e4c6819a8f33bbe6f3d79a53893e7d42",17,17,0,17,17,0,1,2
"33146","e4c77f346c72c7f5ef8572a0831889c6",16,16,0,16,16,0,1,2
"33147","e4c860f300c6a10102bab7bc8335ba20",17,17,0,17,0,17,1,2
"33148","e4ca3600b3f05727a6c4a594440fb168",109,79,76,10.0394736842105,109,0,3,3
"33149","e4cb512f9868b43489658ff26ede9847",137,83,64,14.984375,137,0,3,3
"33150","e4cc98438c0c01e52186fc5e8b147acd",53,53,0,53,53,0,1,2
"33151","e4cd729a8ae1c2a8b75702b48053a92e",14,14,0,14,14,0,1,2
"33152","e4cf62740c2259992cac9846299d40a5",35,35,0,35,0,35,1,2
"33153","e4cfb9f18496975f75d34235755a90a7",78,61,29,18.8275862068966,78,0,2,1
"33154","e4cfcea31d3c85214549c7c66d0208ea",27,27,0,27,27,0,1,2
"33155","e4cfd96a42af3d00573773aae9b35909",90,69,43,14.6511627906977,90,0,2,3
"33156","e4d36495fd4c2c77849331153787c79f",68,44,61,7.80327868852459,68,0,2,3
"33157","e4d42a52e866b5c70e85fcf1aa0b1bef",125,98,60,14.5833333333333,88,37,3,3
"33158","e4d4fc5b0f17d664e403170715c925af",5,4,5,7,4,1,1,2
"33159","e4d6757c00267c939969e9026d1f2fba",1,1,0,1,1,0,1,2
"33160","e4d72b5bcfbdd79871a0725d680bfca1",16,16,0,16,16,0,1,2
"33161","e4daf17f2e962b5376cc56b2591c8a24",29,29,0,29,29,0,1,2
"33162","e4e48ef5da14ef5e4987001523b2ba0e",69,54,53,9.11320754716981,69,0,2,3
"33163","e4e4a204f02eb935ffe6529e31b41430",37,37,0,37,37,0,1,2
"33164","e4e4f89ee351fcd11d70d78e1f53e3a8",28,28,0,28,0,28,1,2
"33165","e4e58537d4057562c5935d3a2bfa2b21",110,74,78,9.87179487179487,82,28,3,1
"33166","e4e65ffd934deaa33447eff9dd1b23f7",40,40,0,40,0,40,1,2
"33167","e4e711d14408dbf844c67b36025f5d0b",43,43,0,43,43,0,1,2
"33168","e4e793353d3086933feaee26481d1cab",207,58,77,18.8181818181818,207,0,3,3
"33169","e4eec248bcba1d09935364980705f733",12,12,0,12,12,0,1,2
"33170","e4ef7608d28430b58336734d93da0845",36,36,0,36,36,0,1,2
"33171","e4f1b534eb74c1e6761361b4bac0a541",66,46,62,7.45161290322581,66,0,2,3
"33172","e4f24e579d0946942381a002fbdc5c16",71,41,60,8.28333333333333,71,0,2,1
"33173","e4f3574dbdc3334ba0a61be57e25a9d6",8,8,0,8,8,0,1,2
"33174","e4f44538d3f4db89e1981a7cad38f4b6",37,37,0,37,37,0,1,2
"33175","e4f621c68eb3da6840bda33ca4ead771",116,59,65,12.4923076923077,116,0,3,3
"33176","e4f64b4f05944611dfdf24a76b9b1d75",240,98,79,21.2658227848101,193,47,3,3
"33177","e4f9891fe8f7a70ab635fa6902cbc782",13,13,0,13,13,0,1,2
"33178","e4fb16ec8b0854c379401b2e4e0f22dc",72,47,54,9.33333333333333,72,0,2,3
"33179","e4fd660cf6a6632c10485e76ceb227be",20,20,0,20,20,0,1,2
"33180","e4fe1dee36c7d4618fc56a41ae5899fa",35,35,0,35,35,0,1,2
"33181","e4ff9383ac280514fb9e090a832a1306",62,45,67,6.47761194029851,57,5,2,1
"33182","e5007bc36d345f755f7091d4a6651719",86,74,77,7.81818181818182,86,0,2,3
"33183","e5037529753033f1868d4afd88510a68",17,17,0,17,17,0,1,2
"33184","e503afe9a7873f840ad7b17be38b6cea",33,33,0,33,33,0,1,2
"33185","e504b2f4a5dfd57489fe59390b8578dd",33,29,25,9.24,33,0,2,1
"33186","e50500f15c188177f1da400bde601b76",13,12,2,45.5,1,12,1,2
"33187","e5097dc238ddcfec6bdffb4327fba927",105,78,54,13.6111111111111,105,0,3,3
"33188","e50e42520ee75ef91d82d14f8375d09b",128,96,80,11.2,89,39,3,3
"33189","e51024b974c448c50f20b1048a5ed793",32,32,0,32,0,32,1,2
"33190","e51164003e86de2a3c04a554b97414e5",156,87,78,14,156,0,3,3
"33191","e513ceeb8cc9a8be89e2792d2afb07d6",41,41,0,41,41,0,1,2
"33192","e519828d13b87c718b068cd416497fe4",19,19,0,19,19,0,1,2
"33193","e51f5642d198ec2d3dd61ad0ac3a37dc",9,9,0,9,0,9,1,2
"33194","e520b3d5a21d5ad41f81f3d642ad386d",139,101,35,27.8,139,0,3,3
"33195","e5210f7cc70fa4513d43eb6ba033e49a",61,40,84,5.08333333333333,61,0,2,1
"33196","e522c462a273e207556e5d70b9301cd9",22,22,0,22,22,0,1,2
"33197","e527ade4052616930f1dacad6f0c27f8",31,31,0,31,31,0,1,2
"33198","e529521f9b502a1666c4ffbc6c698743",80,62,40,14,80,0,2,3
"33199","e52b88235d64f2ddfa08f00693559d49",130,96,30,30.3333333333333,130,0,3,3
"33200","e52c2bfce41a25e6a8e56ae66709d3f8",48,48,0,48,48,0,1,2
"33201","e52d2e43adae00375343338c5b18be86",25,25,0,25,25,0,1,2
"33202","e52e05e41c0b65492a759823b567a5ee",31,31,0,31,31,0,1,2
"33203","e531add7b30d032b275b1e4f954c612d",54,47,18,21,54,0,1,1
"33204","e53245a6642b71cf545a97f07efe3bef",36,36,0,36,36,0,1,2
"33205","e533ad674d0fe801750a50c62e8965ca",53,53,0,53,53,0,1,2
"33206","e5344004c2e846b1b8a681faeae75f34",113,78,47,16.8297872340426,113,0,3,3
"33207","e53647741954c604199ed2ed2b447116",36,36,0,36,36,0,1,2
"33208","e5377b87f44f406c3e9bc242d508cf42",37,32,51,5.07843137254902,37,0,2,1
"33209","e53c677035be3177513145291d08b4c6",52,45,51,7.13725490196078,52,0,2,1
"33210","e53d3768a0627b9c9fe130b90785ebcc",42,42,12,24.5,22,20,1,2
"33211","e53d4d59864b564e2e85ed5a7f1f6960",11,11,0,11,11,0,1,2
"33212","e53e0fb417726e07068900a84dd23670",30,30,0,30,30,0,1,2
"33213","e53f7987013536fa91f9523ea62d8e5b",1,1,0,1,1,0,1,2
"33214","e5404d8bdada7a35c0e49f398a6ece38",14,14,0,14,14,0,1,2
"33215","e5413e3e67ae23388329c83389e72ce4",66,48,36,12.8333333333333,48,18,2,1
"33216","e5428bcf122441c67f80f3a3b1949684",73,57,19,26.8947368421053,73,0,1,2
"33217","e545318b51e0592adad0643a12c1a48a",104,77,35,20.8,104,0,3,3
"33218","e54785fe343516fd4c721ab198228b0a",56,43,49,8,56,0,2,1
"33219","e54bc9d883f8673751a736f734102239",37,32,7,37,37,0,1,2
"33220","e55110e7fad881353534bf35359a76f8",109,77,77,9.90909090909091,109,0,3,3
"33221","e551c7c26fadae94a9305a806220486f",50,43,63,5.55555555555556,50,0,2,1
"33222","e5549a6e23c540fdbb899382a7d597fe",46,46,0,46,46,0,1,2
"33223","e555ab8303bce0c91e892efbe28f84fa",49,49,0,49,49,0,1,2
"33224","e556fe29c3fa475f49bd89fc5db80cc1",78,51,67,8.14925373134328,78,0,2,3
"33225","e557aa24ae897516b202b19131982f23",135,41,73,12.9452054794521,135,0,3,3
"33226","e55d7ad322266767e5f49849b2af782a",35,35,0,35,0,35,1,2
"33227","e55ddd92a73f134e60bace3c9621b781",39,36,40,6.825,10,29,2,1
"33228","e562b359adb06b35c4411f30affe8d28",51,41,57,6.26315789473684,51,0,2,1
"33229","e5641654a46dd72b5bc01142f0feaed7",78,68,22,24.8181818181818,78,0,2,2
"33230","e566c5411c194ea40691334ea57a03ab",15,15,0,15,15,0,1,2
"33231","e5674c7f9262fffe1846386bee986af2",21,21,0,21,21,0,1,2
"33232","e56942c624417a699c0f66fdcb5be7da",67,56,38,12.3421052631579,67,0,2,3
"33233","e5699722991173bf7172c9a7b68ae77d",65,53,24,18.9583333333333,65,0,2,1
"33234","e56b732b33e2063f31aa28a6b69f8e66",108,68,48,15.75,108,0,3,3
"33235","e56d3b5064311b2faf75a4d8dc721f7d",28,28,0,28,28,0,1,2
"33236","e56f89c410df6eed6b28a6c78fa4cce4",42,42,0,42,42,0,1,2
"33237","e570768f60a493edf38a17d6414fee2d",51,34,53,6.73584905660377,51,0,2,1
"33238","e5717589b70fef10f34a3937346b80d8",260,113,73,24.9315068493151,212,48,3,3
"33239","e5733850b304f73e5e0226ba38e503e5",16,16,0,16,16,0,1,2
"33240","e5737dc6917dbb6bf4ea300d994c6f5c",18,18,0,18,18,0,1,2
"33241","e576361827183977c4fa8e568ec802e2",52,44,72,5.05555555555556,52,0,2,1
"33242","e579c2fdc5cfdc0aa26d7facfa346cd2",104,73,60,12.1333333333333,59,45,2,3
"33243","e57ccfb2d118be0839d39c8fdb78c5ef",123,54,82,10.5,123,0,3,3
"33244","e57df717b7f9393da2970b13f0ae4db8",35,35,0,35,0,35,1,2
"33245","e57e44ee7cf66f78c8eb288ea8be6aa1",25,25,0,25,25,0,1,2
"33246","e584dcc43d93f52b493980a95dddc7cf",40,40,0,40,0,40,1,2
"33247","e584fa81f11c54f2b67f3e6bf98042a6",45,28,64,4.921875,45,0,2,1
"33248","e5856be0babdb28dd2763f5338e22fc3",216,135,73,20.7123287671233,216,0,3,3
"33249","e588215033e74ab6ec5d4cedd68e2494",75,69,48,10.9375,48,27,2,1
"33250","e588d4d0e432636acaffefbcb7fa59c9",118,84,59,14,118,0,3,3
"33251","e58a31d2de9aa285fe9c8a7d48b61439",23,23,0,23,23,0,1,2
"33252","e58f7b431b69dbb20fc03f5da8de6cfe",139,96,71,13.7042253521127,139,0,3,3
"33253","e59015be1f0a1b15d267f8d82c4b5279",44,27,75,4.10666666666667,33,11,2,1
"33254","e590962eb2ca927f1d1a04d63b39908f",47,47,0,47,47,0,1,2
"33255","e594fa9089ac3e5014d741bacfcee156",31,31,0,31,31,0,1,2
"33256","e597dcbe38b2f9bb0d644bfb9b8e63ce",21,21,0,21,21,0,1,2
"33257","e598a2a0877900ef354bb0597b3a2d5a",162,92,53,21.3962264150943,162,0,3,3
"33258","e59967846ef5e59b6175c68d888222a3",196,116,61,22.4918032786885,196,0,3,3
"33259","e599b05d4c227bba1cddaec7ce240ff2",98,56,61,11.2459016393443,98,0,2,3
"33260","e59a545dbbeeda3310de14f94d88a55e",12,12,0,12,12,0,1,2
"33261","e59f82ccb2e2b2e211ebf22396a3bcb7",42,37,49,6,14,28,2,1
"33262","e59ff1d5a3fd6f1997e507101cbce799",82,71,46,12.4782608695652,82,0,2,3
"33263","e5a29648ce43ea70ff08be3b1ee69dcf",56,33,33,11.8787878787879,56,0,2,1
"33264","e5a2d96b99b994995b14272316b49d70",34,34,0,34,34,0,1,2
"33265","e5a47fd7ef7c4b514e5746ad52eb7f37",54,47,24,15.75,28,26,2,1
"33266","e5a6911a2efe5700e87b2f809a9d858b",22,17,49,3.14285714285714,22,0,2,1
"33267","e5a695383c25886769d0fd5f78315fd4",63,32,67,6.58208955223881,63,0,2,1
"33268","e5a6cd79aa322ae676560f37ed8ba238",74,63,20,25.9,74,0,1,2
"33269","e5a75176a171ae0d3752d5f303917e15",94,84,26,25.3076923076923,94,0,3,3
"33270","e5a954116dce2c59fb7b50354b2ae079",37,37,0,37,37,0,1,2
"33271","e5aa08fe8d2e27a1aabdb05d72211b33",33,18,54,4.27777777777778,33,0,2,1
"33272","e5aac4ae92418865670e726304f00c75",21,21,0,21,21,0,1,2
"33273","e5ace720d9c53051fa1b938893087f7f",131,59,85,10.7882352941176,131,0,3,3
"33274","e5ad50019e23effa1d2ca402a0c5454d",59,49,49,8.42857142857143,59,0,2,1
"33275","e5b016e44f2e25b8b88ad5dccba49934",92,72,21,30.6666666666667,92,0,3,3
"33276","e5b21c77d09246117943c137d49be208",18,16,3,42,18,0,1,2
"33277","e5b2817d305f4a9e831814d0dbfebbb6",38,38,0,38,38,0,1,2
"33278","e5b2cea838d64062b6bbcd1f3f7428af",30,30,0,30,30,0,1,2
"33279","e5b5d73d17af900cf5dce9764fb6a7b6",127,75,60,14.8166666666667,127,0,3,3
"33280","e5b7cabff14dd7f3294914a47f74dc49",42,42,0,42,42,0,1,2
"33281","e5bb71d1a320e282ca3ae514f18a6f93",95,79,66,10.0757575757576,95,0,3,3
"33282","e5bb7ac5d5b6b94417f6ec74d7ac53ff",135,103,56,16.875,135,0,3,3
"33283","e5bc3070c07043c8415c32d496b6cfe7",61,42,84,5.08333333333333,12,49,2,1
"33284","e5bc92e40c2fb3b10cd19c1ff4690489",41,37,54,5.31481481481481,41,0,2,1
"33285","e5bcc6d5b66cd4db3997ecec3be5a731",12,12,0,12,12,0,1,2
"33286","e5c29d255aa6d7588c90a7032d8040d9",3,3,0,3,3,0,1,2
"33287","e5c2cdea46b0433f6a401b7f8d99f7c6",20,20,0,20,0,20,1,2
"33288","e5c2f90c1314d9bf1766f4f2f35570da",40,31,20,14,40,0,1,1
"33289","e5c7f52fdd39087237b1d1b212b85abc",10,10,0,10,10,0,1,2
"33290","e5c84f42ffe4310a51df9e350c250e59",80,65,27,20.7407407407407,42,38,2,1
"33291","e5ced8791b9d2e3d82006861a214c9c7",99,85,67,10.3432835820896,99,0,3,3
"33292","e5cf8bbd195759e75ca79e0875d66101",15,10,33,3.18181818181818,8,7,2,1
"33293","e5cfebd69e96688082c02300a3e9df74",25,25,0,25,25,0,1,2
"33294","e5d285d3fb6d12ee46ef90ae7c8261f8",17,14,13,9.15384615384615,17,0,1,1
"33295","e5d549cfe97e730f15d8465133f6e046",9,9,0,9,9,0,1,2
"33296","e5d608b396f06766fa661e7ee554fe71",58,51,77,5.27272727272727,58,0,2,3
"33297","e5d7547bdb59886b8ba976550c58fd92",204,75,80,17.85,171,33,3,3
"33298","e5d937be88758703882127292e98c1d8",86,73,18,33.4444444444444,86,0,1,2
"33299","e5d9a906aac8f9ca4182ff9ced304fc2",69,49,42,11.5,69,0,2,3
"33300","e5da676f6668d435ed8ff2a9858703ab",28,28,0,28,0,28,1,2
"33301","e5db6a9d749d6fc2835c3464071b7b50",7,7,0,7,7,0,1,2
"33302","e5dba117f7af018a16db43e9efa942bf",65,63,77,5.90909090909091,65,0,2,3
"33303","e5ddc1322134c28df65596771b5b825d",12,12,0,12,12,0,1,2
"33304","e5df93451422bd94cc6248acbf8bc5a3",102,65,72,9.91666666666667,102,0,2,3
"33305","e5df97ff15ab7b28adbc0113e0ed9164",69,62,32,15.09375,69,0,2,1
"33306","e5dfa29badff14ecbaae930db18e3603",41,30,79,3.63291139240506,41,0,2,1
"33307","e5e02eb058b8b336d37e4c02cfb33496",67,52,44,10.6590909090909,67,0,2,3
"33308","e5e056db5afb3b6167879503775b19d4",37,37,0,37,0,37,1,2
"33309","e5e165730f7ccb75b09168933b965688",24,24,0,24,24,0,1,2
"33310","e5e50cd58c6fefb3b5cd3adec9f3e645",3,3,0,3,3,0,1,2
"33311","e5e8412a5fe06ea1da8504b0b2bea55e",102,74,52,13.7307692307692,73,29,2,1
"33312","e5e986209ed77a6e6122442e92d94aab",40,33,67,4.17910447761194,30,10,2,1
"33313","e5e9bbfdddd22131ad78a39a17547202",12,12,0,12,12,0,1,2
"33314","e5ed56a32858222854c662d626ea705b",16,15,8,14,16,0,1,2
"33315","e5eee75c6175e646bdc95a2752467d56",1,1,0,1,1,0,1,2
"33316","e5ef5187692418045e884628bd98a609",124,85,38,22.8421052631579,89,35,3,3
"33317","e5efd031d1c01e50cf62b1d92b55a85f",114,53,89,8.96629213483146,114,0,3,3
"33318","e5f25e2af3db6c23db57a151e427bfb3",214,95,79,18.9620253164557,214,0,3,3
"33319","e5f425f56709b426acfd61b4de239a22",11,11,0,11,0,11,1,2
"33320","e5f444a2bed82ff0b9253372374e5c11",86,64,17,35.4117647058824,36,50,1,3
"33321","e5f489bd298a1a5ae11a4f025e6d7ace",39,39,0,39,0,39,1,2
"33322","e5fd6fde43dedb7785792ea158986320",22,22,0,22,22,0,1,2
"33323","e602924325437613a11777708ce4658f",66,42,56,8.25,66,0,2,1
"33324","e603259c0366120c350920a63d3886b5",60,55,40,10.5,60,0,2,3
"33325","e60449e5b6fd468e4538af034a92e6d1",81,60,61,9.29508196721312,81,0,2,3
"33326","e6044d2a342b3ccd48e3a736fc172f27",46,39,69,4.66666666666667,46,0,2,1
"33327","e6056abd4dcfc1e157e223b7e9540c3f",14,14,0,14,14,0,1,2
"33328","e60597766e24927bca55ae9fc9c80488",35,32,41,5.97560975609756,7,28,2,1
"33329","e605d228c0605f6a31c9b88228cc462b",155,108,56,19.375,155,0,3,3
"33330","e6072f878c47c49868025cc3fa2169d0",70,56,16,30.625,70,0,1,2
"33331","e6079c576a558b1c0a7401c75f7764b8",194,126,54,25.1481481481481,194,0,3,3
"33332","e60f576788894e724a0f2662ba6e7a27",47,47,0,47,0,47,1,2
"33333","e60fa9a05333703f86805e8e84655a07",32,32,0,32,32,0,1,2
"33334","e61065980d44a73db65ddacb1fd0a64c",5,3,28,1.25,5,0,2,1
"33335","e610b19d945b9b7ddf349809c33c4754",77,58,30,17.9666666666667,33,44,2,1
"33336","e6122c851942a1469069793414851417",14,14,0,14,14,0,1,2
"33337","e612d153f506d42a304bb0beb2dfe522",27,27,0,27,27,0,1,2
"33338","e6130bd013a9af864fad186940d6840b",22,22,0,22,22,0,1,2
"33339","e61386894dcf20f95beb52012d5b2ffd",13,13,0,13,13,0,1,2
"33340","e61474a6b46cfaafe249a27e319fe85b",53,47,73,5.08219178082192,18,35,2,1
"33341","e616c09f898d1a950f461666e9795025",42,37,31,9.48387096774193,42,0,2,1
"33342","e617508fb0f763af3c64e05c175ee46a",63,53,17,25.9411764705882,22,41,1,1
"33343","e617853c34c2ba194aa51c4fa23a6c8f",29,26,63,3.22222222222222,29,0,2,1
"33344","e619635070e844eb1c816c39cdc9ee55",11,11,0,11,0,11,1,2
"33345","e619a5e5c80d0e83dbdbe6d6aeae74d1",16,16,0,16,16,0,1,2
"33346","e61a7e7680e4e9cfb3b1f3ae265415f3",63,42,56,7.875,63,0,2,1
"33347","e61d10ec84eeb722babe1cfc39993f07",30,30,0,30,30,0,1,2
"33348","e61d5c7f5e6db32191a67280a8137a34",42,39,60,4.9,19,23,2,1
"33349","e61ee4bdf5215fa88f8e48a1b5f1b51b",183,110,82,15.6219512195122,131,52,3,3
"33350","e61f7a5b6ca8289b21b6f0d2919a5c0b",33,22,63,3.66666666666667,33,0,2,1
"33351","e6228cc58e097ed3f25fae4962f6bc14",34,34,0,34,34,0,1,2
"33352","e62445152603f6d396b492c1c38fb845",78,65,12,45.5,78,0,1,2
"33353","e626478b11c644839b6fb7a246c70d84",3,3,0,3,3,0,1,2
"33354","e626eb3e2d25e94db418041ff8265799",10,10,0,10,10,0,1,2
"33355","e6279113f9f3e01ed0b1ab601bb96d4e",36,36,0,36,36,0,1,2
"33356","e62800656edc936f9e69e14b16f84f63",130,77,78,11.6666666666667,102,28,3,3
"33357","e62b51e6dd31896afb9d657718d9d9b0",135,46,67,14.1044776119403,135,0,3,3
"33358","e62f60cec0568c91e3d970f6bdff381f",32,32,0,32,0,32,1,2
"33359","e62febb78e266aff099f6540d97e3f0a",141,102,55,17.9454545454545,114,27,3,3
"33360","e6325d10ab388a041c32c6337d3c6ef8",13,13,4,22.75,13,0,1,2
"33361","e635586e53523cd5a4017a73bfd09bb3",90,80,26,24.2307692307692,90,0,3,3
"33362","e635ac86aa9b3b7503aacde7b06ea4c5",23,23,0,23,23,0,1,2
"33363","e635b34290334284340ce93574fa727b",41,29,36,7.97222222222222,41,0,2,1
"33364","e635dd1bbb0fb6119e8a52f3381d0b2e",97,69,56,12.125,97,0,2,3
"33365","e636b95cc6aedc039a65092549bbd96a",53,53,0,53,53,0,1,2
"33366","e636da0c2c8653e9e1932fe865602a21",147,87,49,21,147,0,3,3
"33367","e63aabbf8d7299b755aefc20ad1d83ae",67,62,9,52.1111111111111,35,32,1,2
"33368","e63bb52c7423290ce909ecd3b51b4847",23,23,0,23,23,0,1,2
"33369","e63d7367da248061da0bd0dbdcbf7003",248,108,65,26.7076923076923,203,45,3,3
"33370","e63d85dd4cd49f4b935b902cfab7f060",169,100,70,16.9,169,0,3,3
"33371","e6417ed9e1c594ec56bce7fd4c1e12fb",84,67,80,7.35,84,0,2,3
"33372","e64191425716b452655d60b1137fc10f",41,41,0,41,0,41,1,2
"33373","e6429e4ac9a350428488b911e0ededad",27,27,0,27,27,0,1,2
"33374","e642f3ae8f95342978cb3c293ea10016",82,56,30,19.1333333333333,82,0,2,1
"33375","e64346d3b7dc5350a74cb9c87b68b03a",1,1,0,1,1,0,1,2
"33376","e6440753ed2b6a18fee9efb2521f8206",110,85,79,9.74683544303797,110,0,3,3
"33377","e6456dd6625c6d598a032f12e63bf400",101,62,79,8.94936708860759,101,0,2,3
"33378","e647172b0afb2b317858a884a705effa",144,80,65,15.5076923076923,124,20,3,3
"33379","e647bb262f20e2cd5101f796d0294bf7",46,46,0,46,46,0,1,2
"33380","e648e56c904c1f982ac0fcb9fdcacf1b",65,58,45,10.1111111111111,65,0,2,3
"33381","e64d7509e1ee74dc4178ad91c85d4221",50,34,63,5.55555555555556,50,0,2,1
"33382","e64f52e58b1ccc62ff31d60e0630be77",32,32,0,32,32,0,1,2
"33383","e6544c3f8af9ae96a4c33536dc8576f6",29,29,0,29,29,0,1,2
"33384","e6545304770fd6593e30283ce3bba0d4",92,78,28,23,92,0,3,3
"33385","e655f8a93abbe68d4ba8499a2cf4c1fc",61,50,47,9.08510638297872,61,0,2,1
"33386","e657c1b497134e841080efd625f8330f",53,48,28,13.25,53,0,2,1
"33387","e65835bd3223551a28249200a18c9f3a",71,66,10,49.7,40,31,1,2
"33388","e65eafc0210cbc770cfd114222d25e62",177,111,64,19.359375,177,0,3,3
"33389","e65f3dec87ebc594f93bb7b3b3914888",144,85,72,14,144,0,3,3
"33390","e65fe90b66ae35c4bf1b7662eacb06bd",74,38,76,6.81578947368421,74,0,2,1
"33391","e6614d4cf851ec17a4092d2ff7509f6a",9,9,0,9,9,0,1,2
"33392","e66265b9e000eb693b655e8f1e18a315",41,33,20,14.35,41,0,1,1
"33393","e665052fd7222e795248286fea428a8f",30,30,0,30,30,0,1,2
"33394","e6665af67af1776d41e8443b67f56ec0",34,34,0,34,34,0,1,2
"33395","e668a8ff6353c9d332fdc9a02cf3c52a",66,56,56,8.25,66,0,2,3
"33396","e66ae9268ef47fae6dcb716a5108acb4",68,41,48,9.91666666666667,68,0,2,3
"33397","e66be21ed7cb5167c2d91fdd6856815a",50,50,0,50,0,50,1,2
"33398","e67061916c2ac3deb12c0f9221741281",34,34,0,34,34,0,1,2
"33399","e67133d45a50418a97f58537e807a7ac",29,29,0,29,29,0,1,2
"33400","e67273b8080ccc0ecbaea4256f3e45a2",13,13,0,13,0,13,1,2
"33401","e67321fb757d1f760d43bbe5fc86a505",170,90,83,14.3373493975904,170,0,3,3
"33402","e67325dc7e5f24ed7867b83fa91a99e0",99,75,58,11.948275862069,64,35,2,3
"33403","e675af3c32efb222498ef1a6e59cf27d",114,66,52,15.3461538461538,78,36,3,3
"33404","e679cc3204e3dea45b01159f82a82d6e",115,61,84,9.58333333333333,73,42,3,3
"33405","e67aa5565543fc583c4c203c12e00025",17,17,0,17,17,0,1,2
"33406","e67ab1ec821b4fbfa15fd69c2c95869c",35,35,0,35,0,35,1,2
"33407","e67ab91e0fb4014adaac3c60c129c78b",27,27,0,27,27,0,1,2
"33408","e67cf2d265b1ca4561647d97cc7237fa",16,16,0,16,16,0,1,2
"33409","e67e5a009859090f482456085b8c906c",99,72,42,16.5,99,0,3,3
"33410","e67f961caf2828988ebdb86fd8d999b2",109,78,60,12.7166666666667,93,16,3,1
"33411","e681a3f15dc71a567f4722a8d01c77c8",24,24,0,24,24,0,1,2
"33412","e681df1cf42df09de93adcdb526006bb",82,66,18,31.8888888888889,79,3,1,2
"33413","e6871d43ce8354a40da9b69b30ecd9b2",121,64,79,10.7215189873418,121,0,3,3
"33414","e68a1411bc30e6084533a21798cbe60e",29,26,14,14.5,0,29,1,1
"33415","e68cd0f5633ab84a4bd2dd3520180fc2",26,24,77,2.36363636363636,26,0,2,1
"33416","e68df71eff46f55b1a39a646dabf3292",10,7,28,2.5,0,10,2,1
"33417","e68e26db0270235e9c8bec529fe6661a",76,67,61,8.72131147540984,59,17,2,1
"33418","e68ef686395f01920ca7f3da660678c5",34,34,0,34,34,0,1,2
"33419","e68fdcb95eb5e7554b9cfd0c67845eb2",28,22,57,3.43859649122807,28,0,2,1
"33420","e691de880b5f1b6d64c24c3aa7cd8022",25,13,67,2.61194029850746,25,0,2,1
"33421","e6924c7c0986aa170c5ddcc8fc6fa235",66,60,84,5.5,11,55,2,3
"33422","e69330dd611aa41bec407e4a19139c69",103,71,42,17.1666666666667,103,0,3,3
"33423","e697ecadfcccb60c31b2dd385847e296",122,59,62,13.7741935483871,85,37,3,3
"33424","e6985816cc0e35c4250522386b88e4cc",9,4,47,1.34042553191489,9,0,2,1
"33425","e6985a750298d617a8b0b22a3f31513a",199,78,63,22.1111111111111,199,0,3,3
"33426","e698de99e4f0c59ffb2770f63d33b311",21,16,4,36.75,21,0,1,2
"33427","e69b093d09a652298fb4ba242559b4f0",66,54,60,7.7,66,0,2,3
"33428","e69fa0d1e3b94a2c2f497c60ccb431e5",23,23,0,23,23,0,1,2
"33429","e6a029740c3427b40c0b428c2979b931",79,68,36,15.3611111111111,79,0,2,3
"33430","e6a08c2e1f864558143d3cc7d7ea8617",104,86,39,18.6666666666667,61,43,3,3
"33431","e6a38def6d34314e15433fa32e59b3c6",72,62,49,10.2857142857143,72,0,2,3
"33432","e6a72b3266627c4296b77d9970bf80cf",152,87,70,15.2,116,36,3,3
"33433","e6a7e8d49b95da534787cb0009d4d04d",97,67,41,16.5609756097561,97,0,2,3
"33434","e6aa3abafb1a6e5085985fe4958c9ad3",37,23,68,3.80882352941176,17,20,2,1
"33435","e6ad141aeae80e63d71493fa6df2bdc9",177,99,70,17.7,177,0,3,3
"33436","e6af054af1c8e05f359d3ebfe8e56d74",164,113,53,21.6603773584906,138,26,3,3
"33437","e6b312240bd5c65b3b23c92aff76628d",62,51,15,28.9333333333333,62,0,1,2
"33438","e6b3f60221b685df67db0a0be5aee5f5",1,1,0,1,1,0,1,2
"33439","e6b51aabcdb919cfdb6227c20e2c54e1",6,6,0,6,6,0,1,2
"33440","e6b675c4105c2caf9e5d08bab5d5d7a1",7,7,0,7,7,0,1,2
"33441","e6b82ac0fcd22fc18337423d62801cdc",110,78,58,13.2758620689655,110,0,3,3
"33442","e6b9c8779feb54335e812533caab6ddf",45,45,0,45,45,0,1,2
"33443","e6bb5f8e58de75bf3cc637ef3cc7cbb3",128,120,53,16.9056603773585,128,0,3,3
"33444","e6bd1148539c33eeec0d67f45452767a",117,76,81,10.1111111111111,117,0,3,3
"33445","e6bf49f3e0b1afce51256cbb4caee7d6",47,47,0,47,47,0,1,2
"33446","e6bfbbd0f2996ec436ad728be9180eef",12,12,0,12,12,0,1,2
"33447","e6c1ddef44dd550fa887c7ed56da0a5f",132,66,62,14.9032258064516,132,0,3,3
"33448","e6c40e37a8d98788add755b2e927baaf",5,5,0,5,5,0,1,2
"33449","e6c425e64b16b3ae9c11b1146396948d",78,44,28,19.5,78,0,2,1
"33450","e6c87e287b37894951b407335725e999",14,14,0,14,14,0,1,2
"33451","e6c94f99e6ceccd6beb31f1942f2492c",22,22,0,22,22,0,1,2
"33452","e6cc6138b37c0fd2e9c04ab9ec552a03",36,36,0,36,36,0,1,2
"33453","e6ccf004534b653d36027a1228a332b4",68,56,26,18.3076923076923,31,37,2,1
"33454","e6cd2c3bdaeb32b3ace1d62136174051",8,8,0,8,8,0,1,2
"33455","e6d1062441a087e467ab5bde2876dd54",46,38,56,5.75,46,0,2,1
"33456","e6d1dd21cf2f2b4477fa276e2f587d96",67,51,55,8.52727272727273,67,0,2,1
"33457","e6d3c0c0044468d9dfbfd70339431700",25,23,40,4.375,25,0,2,1
"33458","e6d995cabf47258f4b2cb0e900959416",24,24,4,42,24,0,1,2
"33459","e6da0eab22aeae835284652e87ad7c82",34,34,0,34,34,0,1,2
"33460","e6da82abeef1000928e221363b042818",218,92,88,17.3409090909091,218,0,3,3
"33461","e6db449140da2f6004b26ad71bce6515",87,65,57,10.6842105263158,87,0,2,3
"33462","e6dba7bcd3586a9f195ac0e47d068c66",21,21,0,21,21,0,1,2
"33463","e6dbd75892f61ec779bb8d0208048a3f",40,29,85,3.29411764705882,32,8,2,1
"33464","e6e01f7d4f5636bd3e4fa299f9e34fea",100,81,78,8.97435897435897,100,0,3,3
"33465","e6e2373a6fc8be06be89259903da28f2",39,39,0,39,39,0,1,2
"33466","e6e25494a180625623dd69991da105bb",69,61,33,14.6363636363636,69,0,2,3
"33467","e6e28f456ac827513fbe6618da7c5ff6",25,25,0,25,25,0,1,2
"33468","e6e4517f509c130639fd654d2d670c56",2,2,0,2,2,0,1,2
"33469","e6e72e38347bf5a89a0c6b1d67832298",49,23,82,4.18292682926829,49,0,2,1
"33470","e6ea1aa14bcde2809aac579bc7128861",74,57,81,6.39506172839506,74,0,2,3
"33471","e6eb939fea3ae986a5369149d51868e7",127,89,44,20.2045454545455,86,41,3,3
"33472","e6ebbe585b23d60956ad44dafc7447eb",1,1,0,1,1,0,1,2
"33473","e6ef43799cf9ba887a9af8d5f9f4686f",27,27,0,27,0,27,1,2
"33474","e6f19f890b70dce499d7d728005bd49b",136,63,75,12.6933333333333,136,0,3,3
"33475","e6f21888672a2d65834f5b13b799220b",44,33,65,4.73846153846154,31,13,2,1
"33476","e6f25d47892711c79b04df98689299d9",3,3,0,3,0,3,1,2
"33477","e6f8392231ed6fae282207b913630ee7",54,38,57,6.63157894736842,54,0,2,1
"33478","e6f9374631ca8edc53c218a54e440886",25,25,0,25,25,0,1,2
"33479","e6f9718f2dbbb85b02b547923e4557f8",26,26,0,26,26,0,1,2
"33480","e6fab94cbb46827b02a2d1e2f3f90ab6",45,36,64,4.921875,45,0,2,1
"33481","e7040a64f4e35e21868b0993d4aeb231",10,10,0,10,10,0,1,2
"33482","e70507b8cd703b2f177ed0c97c3f4ecd",113,83,19,41.6315789473684,113,0,3,3
"33483","e7057c21bbfcc7b07112d3067687dfad",63,45,39,11.3076923076923,17,46,2,1
"33484","e7079d419d02dd9735b5fcb0d6c2df34",48,48,0,48,48,0,1,2
"33485","e7083e3fa27748fb2b0f4915e9cd2495",59,38,62,6.66129032258065,59,0,2,1
"33486","e7095181f5b680635e3ee566f97cf1f1",15,15,0,15,15,0,1,2
"33487","e70aa816b8ea5509cb0f3385309f37c4",41,41,0,41,41,0,1,2
"33488","e70b63ee086b5b1db76bc29994508990",105,97,47,15.6382978723404,58,47,3,3
"33489","e70e2763c6b29e8454bb66aef094e57f",5,4,41,0.853658536585366,5,0,2,1
"33490","e71109ac366cccb843cbcd1122dbd1ba",104,87,21,34.6666666666667,104,0,3,3
"33491","e712c96b0adb1242c8f8e825f5389945",51,51,0,51,0,51,1,2
"33492","e713ed2f47518075677339a29198b730",248,98,70,24.8,213,35,3,3
"33493","e7143ba49a6c357fef8f225779ff0f16",205,118,63,22.7777777777778,205,0,3,3
"33494","e71576500b2d3ee4ba2ebb7ac7d21f20",71,64,25,19.88,48,23,2,1
"33495","e716054967eaf1f9693a8f598429291d",6,6,0,6,6,0,1,2
"33496","e7186660061e2b5394c2da8a2ce3f5fb",16,16,0,16,0,16,1,2
"33497","e71ae955768a2b0c16facce8d7b1a188",79,49,75,7.37333333333333,59,20,2,1
"33498","e71b20635255d6236275ef4a93e4c06c",30,30,0,30,30,0,1,2
"33499","e71bcf90317760e7f1cfd47463722bdb",69,52,44,10.9772727272727,69,0,2,3
"33500","e71ccf4f42b2741ce32fd73d735216ad",135,73,41,23.0487804878049,135,0,3,3
"33501","e71d8e8f72d1e2a2311a6a4025eaa87f",37,34,30,8.63333333333333,37,0,2,1
"33502","e72004e14ed5abbea871fb75e9a601f4",96,74,55,12.2181818181818,96,0,2,3
"33503","e721a9de705a5810536729d19aec0897",16,16,0,16,16,0,1,2
"33504","e7251c3616f748ed94e41c116f0f6935",188,105,74,17.7837837837838,154,34,3,3
"33505","e727c4c218304691e4a24e05cdfc0977",76,65,46,11.5652173913043,76,0,2,3
"33506","e72a0f1437e14531e8c6ec4393c57298",10,8,23,3.04347826086957,4,6,2,1
"33507","e72c371c48c839513510698458d5008a",93,63,74,8.7972972972973,93,0,2,3
"33508","e72d5da4af0445f6f34b2573bb06902c",177,87,36,34.4166666666667,177,0,3,3
"33509","e73437353bc427fa438b86b786cfd994",79,64,43,12.8604651162791,43,36,2,3
"33510","e7354a6646a37747974ad3c10885748d",29,27,6,33.8333333333333,29,0,1,2
"33511","e7364972beb0efa9600a1dc72870c776",55,55,0,55,55,0,1,2
"33512","e73a9fdf07e07cf6bb11683382d079f8",33,33,0,33,33,0,1,2
"33513","e73b30da881897a34ddf03c45fac0cd0",47,41,23,14.304347826087,47,0,2,1
"33514","e73c418c8d8d1a4a527c616c078f6092",208,105,63,23.1111111111111,208,0,3,3
"33515","e73e0ee3adce6f3085d5e17367fa785e",34,29,49,4.85714285714286,34,0,2,1
"33516","e73e7e37d5daeb2b17ba4d1659d23a1d",1,1,0,1,1,0,1,2
"33517","e741c09abd87fa362ac8729e2905dea6",47,47,0,47,0,47,1,2
"33518","e741fb2f618efd42e9a14bdfd80accdf",16,16,14,8,16,0,1,1
"33519","e742a4a68bf18223fd2292ba6a097994",73,65,58,8.81034482758621,73,0,2,3
"33520","e749068906ffac5ba608ef5f64fa8477",43,43,0,43,43,0,1,2
"33521","e749151efead4146a0deb849f2262ec1",19,19,0,19,19,0,1,2
"33522","e7494cc7c5cb71a9059b24f8b465d088",14,14,0,14,14,0,1,2
"33523","e74ddc090bb4d9391ceaba4d03a9574f",75,49,26,20.1923076923077,41,34,2,1
"33524","e750e5b31e620c9f65e20a5d5bc36a3f",79,44,76,7.27631578947368,51,28,2,1
"33525","e7547722311bf9ce48e02936eea31d3e",48,46,14,24,48,0,1,1
"33526","e754b23b2765464cff145b53f66c7e12",43,42,67,4.49253731343284,22,21,2,1
"33527","e755c96113bd5984da12e625fd04b7fc",126,78,72,12.25,126,0,3,3
"33528","e757b482509690886a89e514d9d20e3b",32,32,0,32,32,0,1,2
"33529","e7597510dbae055739d3dfe486cc50f6",37,34,28,9.25,35,2,2,1
"33530","e75c693bd793d1af750dba3fb5a8a71b",43,43,0,43,43,0,1,2
"33531","e75dfff91851c444205ac9eeb4047e73",19,19,0,19,19,0,1,2
"33532","e7623f42e35d59ef788d20a61b6c880c",15,15,0,15,0,15,1,2
"33533","e763dfcb09ae789a79a3ff5ea4421624",55,50,27,14.2592592592593,35,20,2,1
"33534","e7642c08720c70b4dfefa5164d1783c4",94,70,57,11.5438596491228,78,16,2,1
"33535","e764445e57fd0592fceb722f561e90bc",26,26,0,26,26,0,1,2
"33536","e764c5aff0dd050a4f3cceceec3a52bd",31,31,0,31,31,0,1,2
"33537","e764fe4daa3f156953e98c15672664ea",28,28,0,28,28,0,1,2
"33538","e765bf839480f476889af9f5199daa0d",38,38,0,38,38,0,1,2
"33539","e76768d2424e6af927f85be74dbbc587",18,18,0,18,18,0,1,2
"33540","e768315e950cbaab3e91c27ff0537379",16,15,2,56,16,0,1,2
"33541","e769dabfd4eed0d6c30352312052c29d",91,66,51,12.4901960784314,65,26,2,1
"33542","e76ce52bb54de37d84319b7330564d79",108,55,56,13.5,108,0,2,3
"33543","e76e0c007ea40fd75c18d67ad3cc6b27",73,41,83,6.1566265060241,54,19,2,1
"33544","e76e9c8d95b2ff7bae2636ce619b01ad",23,23,0,23,0,23,1,2
"33545","e76f4be9eaf40ef01c63b882a437000a",64,50,28,16,64,0,2,1
"33546","e77295f97cec36f05c9dd64192687ccf",45,45,0,45,45,0,1,2
"33547","e773217f370cd1e503db01007dbd1e91",65,52,57,7.98245614035088,32,33,2,1
"33548","e77346905b5e59580d845612d2ae5ba0",70,67,34,14.4117647058824,70,0,2,3
"33549","e77396af69cb4b240d8cb6667532a0cb",25,21,41,4.26829268292683,25,0,2,1
"33550","e773ba1af7f673e667bbd56cbead46da",16,16,0,16,16,0,1,2
"33551","e7768f008eaa2350d8613436c660ec24",66,50,64,7.21875,42,24,2,1
"33552","e776e2ef0ab8d2c1fee79ac321bac711",59,54,8,51.625,59,0,1,2
"33553","e779993620dcab1e8c0fb9420cfb8d25",75,57,69,7.60869565217391,75,0,2,3
"33554","e77a32bb9e80feb399586f7fb38865aa",64,52,27,16.5925925925926,64,0,2,1
"33555","e77d0c2511552e38c80553f3445e3102",72,59,39,12.9230769230769,72,0,2,3
"33556","e77e0b229e83caf5916e64a3e4a6fcde",46,40,20,16.1,46,0,1,1
"33557","e77fa371cd0f694661411480f2be07c2",27,27,0,27,0,27,1,2
"33558","e7839cd32ad3794fb843179277352670",36,30,35,7.2,36,0,2,1
"33559","e787bd9c0feb86d326552273d76099d1",10,10,0,10,10,0,1,2
"33560","e788ecac605b3ab6af5a98990291f794",99,81,68,10.1911764705882,48,51,2,3
"33561","e7899db61688234c931a402650882823",53,43,27,13.7407407407407,53,0,2,1
"33562","e78ac9a38283d4cbebb0bc91e1fd85f7",68,53,36,13.2222222222222,33,35,2,1
"33563","e78da12c3b81aa0e89b662919b1baa7c",109,65,50,15.26,70,39,2,3
"33564","e78f1ac54273ae8e018a98f366226601",40,33,14,20,40,0,1,1
"33565","e790fb614fb1d955e53424a5fbc674a5",28,25,45,4.35555555555556,28,0,2,1
"33566","e79230e06b057e900618ba0cc896f10e",27,27,0,27,27,0,1,2
"33567","e792c47e33fee6fd2d2cad0e6a3e15c3",95,63,34,19.5588235294118,95,0,2,3
"33568","e793e31e91276069dcf32cddcd12f4bd",218,76,52,29.3461538461538,218,0,3,3
"33569","e793f17862706fa4fd23c8c5c16cdc05",30,30,0,30,30,0,1,2
"33570","e7959de75c190251a0c052f7251b0664",71,67,76,6.53947368421053,71,0,2,3
"33571","e795da49628650b3a85fa8d6da0d7818",106,78,30,24.7333333333333,106,0,3,3
"33572","e7988de4e47193a48a830ad522b1d8f1",35,22,68,3.60294117647059,35,0,2,1
"33573","e798f9ab087e72240b01c56163649cd9",53,53,0,53,53,0,1,2
"33574","e79c7f2c5a4554f6700b5dc19de7b04f",25,25,0,25,25,0,1,2
"33575","e79d231cf4f076f643211a6110f23be6",29,29,0,29,29,0,1,2
"33576","e79e9927b0e3469fc20b651a7d2ef003",41,41,0,41,41,0,1,2
"33577","e79ede845e17c77a334b32cf5f7c0b65",52,45,11,33.0909090909091,52,0,1,2
"33578","e79ef4d5bb1454ce4964aa2d587d931d",9,7,50,1.26,9,0,2,1
"33579","e7a08173b96ded5485e6f3b696352974",23,23,0,23,23,0,1,2
"33580","e7a0e639d8c253014d6cae23b1e1eea3",32,18,55,4.07272727272727,32,0,2,1
"33581","e7a7225e7929aae31e98d87028a5ead6",22,22,0,22,22,0,1,2
"33582","e7a8172f566b918549f3c1041d2602de",39,28,67,4.07462686567164,25,14,2,1
"33583","e7a8ed02eee29de926707ec1552c17e1",23,23,0,23,23,0,1,2
"33584","e7a9616c86405d0e8683bd47b6241001",117,73,84,9.75,87,30,3,3
"33585","e7ab4e7d3885a086db941c5ae2d0074b",33,33,0,33,0,33,1,2
"33586","e7abb89a7b08c7f4f2516b3b58ba866c",17,13,20,5.95,17,0,1,1
"33587","e7aed1e65b631b5766a8bc638aa229b7",25,25,0,25,25,0,1,2
"33588","e7b0636f47127c5deb213cd35c3f4d48",68,43,18,26.4444444444444,68,0,1,1
"33589","e7b47ecb804b4120c3d8b33cc579cc56",30,21,81,2.59259259259259,23,7,2,1
"33590","e7b601b87a1bd85b4f03a0395dc00a87",85,77,57,10.4385964912281,85,0,2,3
"33591","e7bd7ac667a1c9c896fda4466dc10e35",117,74,60,13.65,117,0,3,3
"33592","e7be0f8a1bf2b9eae04bc8a0d4aaa19b",7,7,0,7,7,0,1,2
"33593","e7c1d314a28fe91a50cc54a5e22823d3",87,60,22,27.6818181818182,87,0,2,2
"33594","e7c65288bdb4a2f058c5f8c301de3ee9",19,19,0,19,19,0,1,2
"33595","e7c6eaa7f94fd6d9279b195bab3af86c",19,19,0,19,0,19,1,2
"33596","e7c83b7ce98f03812774fa1233be70d2",45,38,52,6.05769230769231,45,0,2,1
"33597","e7cc2d206a549e2e2ab5230c00ddbc43",106,58,42,17.6666666666667,70,36,2,3
"33598","e7cd38833381ddbf483cd36d6c2f5b7c",18,18,0,18,0,18,1,2
"33599","e7cdb21ae47a7d55e5bcc5eeeddb000f",109,67,55,13.8727272727273,70,39,2,3
"33600","e7cf2c8ff3eb87ce29830029fbf76e4f",76,58,65,8.18461538461538,76,0,2,3
"33601","e7d0c831ebe3835c0c51825459b8324d",27,27,0,27,27,0,1,2
"33602","e7dc9be6dd4f5df89c0d1e4f188749d1",169,127,73,16.2054794520548,169,0,3,3
"33603","e7dcac1b91ea6a8fc8b905d3481ae5bc",54,38,35,10.8,54,0,2,1
"33604","e7dd0212f8c59dde093faaa2a7c1859f",33,33,0,33,0,33,1,2
"33605","e7e1385998433165ea0c2863a8e7ddf6",29,29,0,29,29,0,1,2
"33606","e7e5b74c6479cc5aea7f299acba72579",2,2,0,2,2,0,1,2
"33607","e7e6328ef0c0b8f722c1094f85e51e95",105,72,40,18.375,105,0,3,3
"33608","e7ef37ed2a43f14d1a020e41396d129f",27,18,46,4.10869565217391,27,0,2,1
"33609","e7f119be066de667368503d86e54f06f",99,54,47,14.7446808510638,99,0,2,3
"33610","e7f65e91ca63b37d19b7aa93070ae752",22,22,0,22,22,0,1,2
"33611","e7f75c9b678babe614affd06bfdfb065",26,26,0,26,26,0,1,2
"33612","e7fcd46a0c3d1c7f775d59d0519dfea7",25,17,40,4.375,25,0,2,1
"33613","e7fce8edc75fefef9be45a14f21d7cbc",41,41,0,41,41,0,1,2
"33614","e7fe47f91697873400b4e34c9dd633f7",57,48,44,9.06818181818182,57,0,2,1
"33615","e7ff41450eae6052f76b9513d8d8e3ea",27,25,23,8.21739130434783,18,9,2,1
"33616","e7ffd5292f3a1b0ea4f4d024f6ee38fe",19,19,0,19,19,0,1,2
"33617","e800c1ebddf413b12ad9f64234e79a6b",126,93,70,12.6,77,49,3,3
"33618","e800f2f3d1e77e76f9c4b20e613f735c",98,84,30,22.8666666666667,58,40,3,3
"33619","e8012f41c0d1fa510170efe15a125c0d",104,85,53,13.7358490566038,80,24,3,1
"33620","e8024b93eb71aced2c79c486ab4b06de",82,49,81,7.08641975308642,82,0,2,3
"33621","e8026c32f6c8521dd3768aa43a6a7f82",68,50,79,6.0253164556962,48,20,2,1
"33622","e803a1a81760c425d4c57e8245348b3c",81,60,61,9.29508196721312,81,0,2,3
"33623","e806884c3617c46b77c1dceea965008f",155,121,44,24.6590909090909,155,0,3,3
"33624","e80b554a3a1b31eddce6f13cb6b3b473",12,12,0,12,0,12,1,2
"33625","e80de583532b594fbf49beb7551c7022",36,36,0,36,36,0,1,2
"33626","e81471a99823a44a5c718d6b2c2636f7",141,105,44,22.4318181818182,141,0,3,3
"33627","e814fae5fbe46a54468147d148a18ff7",35,32,21,11.6666666666667,0,35,2,1
"33628","e8181caf8e3280636a0fde38246a6860",41,41,0,41,41,0,1,2
"33629","e818e0183b46e62c550082d1b173b998",18,18,0,18,18,0,1,2
"33630","e81b048a3e5ad604f4a6d7aec64232e1",18,18,0,18,18,0,1,2
"33631","e81b9336676cd9bf525a53b09f91da27",22,22,0,22,22,0,1,2
"33632","e822912f94fc918af5b40ed587394885",111,41,68,11.4264705882353,111,0,2,3
"33633","e8242fe5fd5d463c867a95d1608b9f45",128,84,56,16,128,0,3,3
"33634","e8287770a5edba0f106478eb97951a13",56,44,40,9.8,27,29,2,1
"33635","e82b3c2bbe588564be222782cc0f09a8",102,36,77,9.27272727272727,102,0,2,3
"33636","e82be9eff1852e8d4db91042ae6d7f96",25,25,0,25,25,0,1,2
"33637","e82e274ac6b1a51445db79d3f591cf9d",41,32,27,10.6296296296296,19,22,2,1
"33638","e82e360c2c79fa0b9c121313a49245a0",3,3,0,3,3,0,1,2
"33639","e837cad66e5d75792cd519ad3c31688c",80,54,79,7.08860759493671,80,0,2,3
"33640","e838745ca579ec9f41ba0c0eb1301c36",121,94,82,10.3292682926829,121,0,3,3
"33641","e83887fefdbd77cdd4df2f71816ec5ce",44,44,0,44,44,0,1,2
"33642","e83c61ba9d1ba88097a01922f8f909fc",53,39,64,5.796875,53,0,2,1
"33643","e83df64b52194b2632b752c97e8ed493",150,86,84,12.5,150,0,3,3
"33644","e83eb958a014875d89a77ff51821e787",13,13,0,13,13,0,1,2
"33645","e83ec36716709b22a61ff6c86a5533d7",46,29,78,4.12820512820513,28,18,2,1
"33646","e83ecfccebd4bf03fd6820ad137e5c7f",51,46,14,25.5,51,0,1,1
"33647","e841b8470ad2e6db6c71b4fde10f06df",31,30,48,4.52083333333333,31,0,2,1
"33648","e841ddf3d7696d22bfa8983d552fb324",67,62,35,13.4,67,0,2,3
"33649","e84366e1768c890cb8be77dfe8693689",44,44,0,44,44,0,1,2
"33650","e8444ea70758e47df061ac49c38f310a",53,37,66,5.62121212121212,1,52,2,1
"33651","e8474d1df6723df5704983cf269c9640",225,125,81,19.4444444444444,183,42,3,3
"33652","e848bb5f5bc77787fc695b93daf42e1c",97,78,48,14.1458333333333,97,0,3,3
"33653","e84a543544322eacd8f6141e1b86d449",119,85,68,12.25,119,0,3,3
"33654","e84d77ef811841155824ec15f577755f",13,13,0,13,13,0,1,2
"33655","e850209e72da78adbaf186e4e7bd19ba",233,85,76,21.4605263157895,202,31,3,3
"33656","e8507540058df8b666ef640920b0d87b",197,127,82,16.8170731707317,150,47,3,3
"33657","e8513d6f98bc5ef0de529f7245104559",51,46,20,17.85,51,0,1,1
"33658","e856ac4fcbb25bb6ded330a8c398b3ed",13,13,0,13,13,0,1,2
"33659","e857bdc36c7aaf7f7de04f562bf02c42",60,44,55,7.63636363636364,60,0,2,1
"33660","e85b28155ac33d5a197e9f3a24d65db3",2,2,0,2,2,0,1,2
"33661","e85b4af99bd9aa027d0cab98f4242995",47,47,0,47,0,47,1,2
"33662","e85b5077538d6735249a02ab12d82451",182,71,72,17.6944444444444,149,33,3,3
"33663","e85d59fbd55d1733b7ce932ffc044da9",160,98,47,23.8297872340426,160,0,3,3
"33664","e85eca61bb4558faef1feace696d7cc4",51,51,0,51,51,0,1,2
"33665","e85edcf549e62185713cd0139e6b92d6",33,33,0,33,33,0,1,2
"33666","e85f192ec38c71e717d9400342f4d7aa",9,6,48,1.3125,9,0,2,1
"33667","e86082d20f565466366e54596511bc67",36,24,56,4.5,13,23,2,1
"33668","e860d2c84a9b388c9199e2c89503654f",10,7,63,1.11111111111111,10,0,2,1
"33669","e8625fbf00d853b811462725e12bfad1",204,104,82,17.4146341463415,169,35,3,3
"33670","e862d3caa2c0aa3d3dbb40e32e148ec7",103,62,28,25.75,82,21,2,1
"33671","e864d340fd0b3c8ccbcbca0f4425f2d0",83,42,74,7.85135135135135,83,0,2,3
"33672","e868e7aef5130b9c83a477b303229cdb",17,17,0,17,17,0,1,2
"33673","e86e077242958cb53128f09ec1a118f1",201,101,38,37.0263157894737,201,0,3,3
"33674","e86e4423a35084fe4956e5ad8196bc3b",29,23,49,4.14285714285714,29,0,2,1
"33675","e86e6053261ea5edab8bb428ff04d1b8",26,26,0,26,26,0,1,2
"33676","e876778ee9a279742c81f0d3b981b671",10,10,0,10,10,0,1,2
"33677","e87a82fbb5f6593f347a823866220400",5,5,0,5,5,0,1,2
"33678","e880fce0959cb3b81bb815f31b551e7e",14,9,36,2.72222222222222,14,0,2,1
"33679","e88391c4063175223b37ce655b3042e8",99,69,56,12.375,99,0,2,3
"33680","e8871128631283ace5d649a731100bf4",17,17,0,17,17,0,1,2
"33681","e88766350f05ad568f0d7244a1f4b3f9",43,33,41,7.34146341463415,43,0,2,1
"33682","e88855f4bdecb7e97354ca9f6877b8ec",27,27,4,47.25,16,11,1,2
"33683","e88e94664eb1d66741718fc048aa879c",31,31,0,31,31,0,1,2
"33684","e890251364ff0a2ed92dc21e30fd13cd",170,92,76,15.6578947368421,170,0,3,3
"33685","e8908eca6905096eef6e96051bad0b94",10,10,0,10,10,0,1,2
"33686","e8933d30f1d99a0551221ccb777eade2",35,35,0,35,35,0,1,2
"33687","e895e09124c176427438114794a87727",32,32,0,32,0,32,1,2
"33688","e896c969f5087b5b3de6e760bcae1a28",165,103,78,14.8076923076923,165,0,3,3
"33689","e899bcf72d7ff8e9941f46a0cdcfb361",29,29,0,29,29,0,1,2
"33690","e89a2fca09d6f4e22eb6192cd6a2fa8e",9,9,0,9,9,0,1,2
"33691","e89b1a21c5ecdc518f22b2f3595a98da",12,7,39,2.15384615384615,12,0,2,1
"33692","e89d029ab13009eadbb09e1012805bfc",159,65,69,16.1304347826087,159,0,3,3
"33693","e89d8543e1e65577268f9f92d1d06820",250,137,86,20.3488372093023,215,35,3,3
"33694","e89e2bac736e181a2130ede815bb6753",20,20,0,20,20,0,1,2
"33695","e8a08505c99a8608845fb273e6fd9f6b",46,46,0,46,46,0,1,2
"33696","e8a0f12037f5dc9900105e65c8869dc3",38,38,0,38,38,0,1,2
"33697","e8a1016c3facee91fdf30f5a7f0583d3",116,71,65,12.4923076923077,95,21,3,1
"33698","e8a1d59718652b283ca28d3eec36f435",10,10,0,10,10,0,1,2
"33699","e8a343de71fae7267eeb68f276e85094",4,4,0,4,4,0,1,2
"33700","e8a4ad5b483bcc84f7fd1585d9ce0b12",218,104,58,26.3103448275862,187,31,3,3
"33701","e8a53130e9ec9075850fcf38d6b58067",222,114,82,18.9512195121951,200,22,3,3
"33702","e8a933210040e01eec3875a5e8a14f84",52,45,50,7.28,52,0,2,1
"33703","e8a95ec3fdc1398effc6cbf2f84f1d3a",17,14,62,1.91935483870968,17,0,2,1
"33704","e8a9c11ca189b8b2e36f110a576a9964",30,29,75,2.8,9,21,2,1
"33705","e8ab559ba2b0ecca98ddd115dbf14c96",25,25,58,3.01724137931034,6,19,2,1
"33706","e8b002727a79055cd435a77d91a91282",35,34,14,17.5,35,0,1,1
"33707","e8bea2085b9d30ed844be64b1c1a802e",83,75,42,13.8333333333333,83,0,2,3
"33708","e8c0b2f05f93f31f48d582c17befe390",11,11,0,11,0,11,1,2
"33709","e8c22f5f1d2d3de29ed91f5bc335ff86",27,27,0,27,27,0,1,2
"33710","e8c27745005e2a84e15c865eacf43474",28,28,0,28,28,0,1,2
"33711","e8c27c52eebd75a8458be13e5ec61c71",17,17,0,17,17,0,1,2
"33712","e8c29dcb7e4dfd87b4a4dce29da2d3e3",155,91,71,15.2816901408451,155,0,3,3
"33713","e8c2a5b47db98e6cd5913434fc4c3542",85,77,12,49.5833333333333,85,0,1,2
"33714","e8c54915d64b3da278e3ce03d4077b3d",83,58,35,16.6,83,0,2,1
"33715","e8c6bfc227cf254b13f41e287638169e",32,32,0,32,32,0,1,2
"33716","e8c7c90f7029fce6d34111b662ecc2cc",256,129,79,22.6835443037975,218,38,3,3
"33717","e8cd1cd0fff8cdb7edb278d605151a60",28,24,47,4.17021276595745,13,15,2,1
"33718","e8cdbe3a93f36d888675fff907affbcf",96,72,42,16,96,0,2,3
"33719","e8ce59a111a9475d7c3733b749c44104",62,54,49,8.85714285714286,62,0,2,3
"33720","e8d05cfcd3f53cd29b908c654113aeb3",52,48,39,9.33333333333333,52,0,2,1
"33721","e8d1fff5a3ac25c0a7621527d290bc60",28,28,0,28,28,0,1,2
"33722","e8d2b70d24409863b539ec00e81cdeca",176,90,68,18.1176470588235,176,0,3,3
"33723","e8d2bf2f81181d88af9c00636b078cb7",40,27,23,12.1739130434783,40,0,2,1
"33724","e8d65fce402fa6c65316496ce21e1a94",68,48,34,14,34,34,2,1
"33725","e8d77fdda1b48a7c14e12da08a2e74cc",41,34,13,22.0769230769231,41,0,1,1
"33726","e8d876f8022765821fed2856423d31f8",136,82,72,13.2222222222222,107,29,3,3
"33727","e8d950347aa6e61ce59efae73be200ea",37,37,0,37,37,0,1,2
"33728","e8d9a7cf435e08bb097982dbd59e1c14",108,84,56,13.5,108,0,3,3
"33729","e8d9c007594f2c646de02dd8482fd097",92,50,60,10.7333333333333,54,38,2,1
"33730","e8dc5140459aea18a9fbe6907de6f9d0",50,28,43,8.13953488372093,33,17,2,1
"33731","e8ddfe1678a3f126541e4646b86f2854",22,22,0,22,22,0,1,2
"33732","e8e31f9b3edd52e9ea0f8d9b4d195ce9",65,35,35,13,39,26,2,1
"33733","e8e4f996fae8205c100a2498002dd400",9,9,0,9,9,0,1,2
"33734","e8e9e95219395ca492e0430492a259e3",38,38,0,38,38,0,1,2
"33735","e8e9f9c2a2d17b5fd121017f8df2fcdc",127,106,38,23.3947368421053,72,55,3,3
"33736","e8ead9305fcc15a6b92783202b2907b9",39,34,6,45.5,39,0,1,2
"33737","e8eb3e2070456a6e411dfbe49a7d100b",57,48,26,15.3461538461538,22,35,2,1
"33738","e8ee1dbb260b0777cf13be423577c806",17,17,0,17,17,0,1,2
"33739","e8ee4fc70518e89e6aff57a09582809a",146,77,75,13.6266666666667,146,0,3,3
"33740","e8f2fbb5fb08cda8ac18b5ef985116b0",34,34,0,34,0,34,1,2
"33741","e8f5d02804885be8a6c15ecd7780bc8d",126,78,70,12.6,82,44,3,3
"33742","e8f6462c299575c8a45a4466afcf265e",230,129,80,20.125,194,36,3,3
"33743","e8f71f6ba611a3f1f490d9a5d22804e5",47,43,59,5.57627118644068,18,29,2,1
"33744","e8f7c3863f7fc16d46f6247ad4c80e13",52,46,9,40.4444444444444,52,0,1,2
"33745","e8f9b8326edc6794db296346e188af1b",88,51,52,11.8461538461538,34,54,2,1
"33746","e8fa34ba0a614b5242502e45ea4d27e1",20,20,0,20,0,20,1,2
"33747","e8fc3d3f0254d7b02c1c02a7e23d2142",17,17,0,17,17,0,1,2
"33748","e8fd6e58000f4a90dd55f3fd1be5fec6",190,88,81,16.4197530864198,190,0,3,3
"33749","e8ff144abbd403e94bbaeedfab4231d4",35,35,0,35,35,0,1,2
"33750","e9006648099bd333b14f37835f488c3b",25,16,58,3.01724137931034,17,8,2,1
"33751","e900b7899f9fb4151c16360152885eff",14,14,0,14,0,14,1,2
"33752","e900ed8c29034c0d31d237198e83047a",8,6,28,2,8,0,2,1
"33753","e903aef1717a34e5657e13f6a8cfbb25",38,20,65,4.09230769230769,27,11,2,1
"33754","e904078eb9aa33d98af380f569677d44",90,77,72,8.75,90,0,2,3
"33755","e904a456c755cab99a929396fedb7c00",38,38,0,38,38,0,1,2
"33756","e9053bd8523aad0bcbc6c11bb5e44c6c",93,42,56,11.625,93,0,2,3
"33757","e90c744141ef07ab2f9fddf37fdbd85f",76,55,29,18.3448275862069,76,0,2,1
"33758","e90cf95847c9e660e18f450b3b191a76",72,46,76,6.63157894736842,72,0,2,3
"33759","e90fb32102a11a05350a0f0aa09bfc59",44,42,59,5.22033898305085,44,0,2,1
"33760","e911eff384edc98830e52c429d977bb1",42,42,0,42,42,0,1,2
"33761","e91260f9dd2a6ce0601434990a84af95",1,1,0,1,0,1,1,2
"33762","e9159d3131890c7676065556665a0613",24,24,0,24,24,0,1,2
"33763","e91a4150487e9813afb8655678f17ff8",27,27,0,27,27,0,1,2
"33764","e91a438aabfc1721e26083d149faa49a",132,87,56,16.5,132,0,3,3
"33765","e91a846294b54f407293c46ea703f3b9",124,67,36,24.1111111111111,124,0,3,3
"33766","e91dc908c0bee46eea5cd4d3bdd9b022",65,47,40,11.375,65,0,2,1
"33767","e91f9bd4780c33b15d19df982933376d",172,109,75,16.0533333333333,117,55,3,3
"33768","e920c9b5443b7b1d92f5b78bd30d92ef",168,86,70,16.8,168,0,3,3
"33769","e9219258b8efc33f82be88ab7b454b42",24,24,0,24,24,0,1,2
"33770","e921d1202dca8110531b234e1c2809a8",73,54,11,46.4545454545455,73,0,1,2
"33771","e923d9e001a027375c2246b79843952f",25,22,21,8.33333333333333,25,0,1,1
"33772","e924bd2df96ceddcd6f39fb506ae7f68",90,72,31,20.3225806451613,90,0,2,3
"33773","e925baec7ab8d3d4721312b5dec1b3ad",6,6,0,6,6,0,1,2
"33774","e9261c3c4f1a3d39e5c1955389556563",44,44,0,44,44,0,1,2
"33775","e92852c49163656daa748e377ad23fc3",139,88,61,15.9508196721311,139,0,3,3
"33776","e92a4e8dcc2c2aa2e0aebfb5959230b9",34,33,37,6.43243243243243,34,0,2,1
"33777","e92b7e6595e3dd7ddf600c0842528335",16,16,0,16,0,16,1,2
"33778","e92dde26292c1c6547c704041e074901",44,44,0,44,0,44,1,2
"33779","e92f376b95e9110580bc207ba4bc80ef",69,48,71,6.80281690140845,69,0,2,3
"33780","e931c6df2c688e9ddbb690469bedd7b1",191,111,54,24.7592592592593,154,37,3,3
"33781","e935b3dc90b91eec8a69d9187c2a5e09",207,151,81,17.8888888888889,207,0,3,3
"33782","e93c46553207e7c6af0463594c798a59",215,68,71,21.1971830985916,215,0,3,3
"33783","e93c85871a294b9dde88ef64a86f49c6",112,78,71,11.0422535211268,112,0,3,3
"33784","e93f0a9daf3bee4189428af6458427cf",134,90,75,12.5066666666667,134,0,3,3
"33785","e93fe06b38d8db00dc61e560c6501aeb",21,21,0,21,21,0,1,2
"33786","e940ade40fd1297e1f7003c422712c47",80,56,47,11.9148936170213,30,50,2,1
"33787","e945db64aa2ec5d24ad3ddb10a931474",39,21,46,5.93478260869565,39,0,2,1
"33788","e945f99a8d71d53135ab3448a4673553",37,34,61,4.24590163934426,37,0,2,1
"33789","e948f592a54e93d829f5f59b613596a0",67,49,14,33.5,67,0,1,2
"33790","e948f98b22bb46b0acfb42a3c3c79be1",3,3,0,3,3,0,1,2
"33791","e94a271777dbf115083f9e7106d3e58e",61,41,45,9.48888888888889,61,0,2,1
"33792","e94a816171c3119d00c5e102943fbad7",66,50,85,5.43529411764706,54,12,2,1
"33793","e94c2fcd60fd98d88d757265088261ce",27,25,24,7.875,13,14,2,1
"33794","e94d8a111e902d2431e52e2cfa831a0b",13,10,29,3.13793103448276,13,0,2,1
"33795","e94ed723c4ef44d72dfd7509b455b0a2",20,20,0,20,20,0,1,2
"33796","e951583c6d4d2336e663c4ade604a9c3",120,37,72,11.6666666666667,90,30,2,1
"33797","e956a9149b94aee930b6b77c477a0ef7",11,11,0,11,0,11,1,2
"33798","e956c798b681e02b5b7d2482652eea87",23,23,0,23,0,23,1,2
"33799","e95a111ade0811c85a9c4aa63fdceb47",54,46,15,25.2,54,0,1,1
"33800","e95b48cd282f3da447cbb67d9441d063",40,40,0,40,0,40,1,2
"33801","e95b4a6a504da6cec3981359fd81ca18",145,87,60,16.9166666666667,145,0,3,3
"33802","e95b91b20b985707bf2005f101554ec2",23,23,0,23,23,0,1,2
"33803","e95c8b010c6301f6fc675571bad480f4",7,5,75,0.653333333333333,7,0,2,1
"33804","e95cb9d159864dae6ba70036226e8132",200,117,76,18.4210526315789,169,31,3,3
"33805","e9644edbb0bd90d69699f9563a056b7b",92,64,33,19.5151515151515,51,41,2,3
"33806","e96500fd55974dec06031fec30b56170",163,56,69,16.536231884058,140,23,3,3
"33807","e969612a86cce2e806518c7c65fc8e10",6,3,39,1.07692307692308,3,3,2,1
"33808","e96b9b558562c89f750186129f87c484",160,83,41,27.3170731707317,160,0,3,3
"33809","e9710831e531f564333c78e4c81cb2f9",25,25,0,25,25,0,1,2
"33810","e9715d04ded1833decc076b8a5f86826",45,39,55,5.72727272727273,45,0,2,1
"33811","e971b0ad8f90da15c37b65bab4c84d5a",9,6,76,0.828947368421053,9,0,2,1
"33812","e973755448def85f3d42804ccfc6d2f7",93,80,36,18.0833333333333,93,0,3,3
"33813","e97580934491e03e0dca44458aa52315",18,18,0,18,18,0,1,2
"33814","e9758ad0a0016108853092784543ff4f",116,72,66,12.3030303030303,80,36,3,3
"33815","e9780dbe1fff2b8ba5cb128d3e507c9f",25,18,38,4.60526315789474,13,12,2,1
"33816","e978a85c19c3e9ac9c992448a39d49bf",11,11,0,11,11,0,1,2
"33817","e97a989cb2c2699025c77dc8905fbba8",40,40,0,40,40,0,1,2
"33818","e97b234be35a1695ea5eb65fdd8db199",147,78,52,19.7884615384615,112,35,3,3
"33819","e97c82b96f1b67bb6d6e51cce8ebdd0a",34,34,0,34,34,0,1,2
"33820","e97e941900af0a030c3d785dabbbcf85",170,129,41,29.0243902439024,170,0,3,3
"33821","e97ef00b24982cca94d16202957d8915",10,10,0,10,10,0,1,2
"33822","e97f970e14b23a168959087ae0d96c59",148,68,75,13.8133333333333,148,0,3,3
"33823","e980041281e5ab4c7f35833d70e1f157",135,56,69,13.695652173913,108,27,3,3
"33824","e98227ebe81460572db4256228fe0c45",48,32,65,5.16923076923077,48,0,2,1
"33825","e9833ca5cf34e4d7bef7bf74a1f22434",13,13,0,13,13,0,1,2
"33826","e983a1b29218a6b3db736213a710a638",19,19,0,19,19,0,1,2
"33827","e98467b6924e4a716a5d16a12d09fb8c",141,99,58,17.0172413793103,141,0,3,3
"33828","e986e2eab39189fde671b744c4177ac2",14,14,0,14,14,0,1,2
"33829","e987427fb7fc2a12b83f581eca45f6c9",31,31,0,31,31,0,1,2
"33830","e98813a4be5f27f427a57cab5ff21488",108,63,63,12,108,0,3,3
"33831","e98894914fb3fa39b7fcc2ab60d34116",22,20,32,4.8125,22,0,2,1
"33832","e988eb211377c67ad7ec64d2d8e32791",58,49,30,13.5333333333333,58,0,2,1
"33833","e98aefff192e5a03715fb7b2c488eaf5",49,49,0,49,49,0,1,2
"33834","e98cdfc622a8263110acff6e1b218f96",88,76,49,12.5714285714286,88,0,2,3
"33835","e98d1beb62c542acdec2943d6d09cf48",25,25,0,25,25,0,1,2
"33836","e98f05e5c3adccb3bd9445d33ec69850",211,109,79,18.6962025316456,181,30,3,3
"33837","e98f1041a27527d082896e6d1cba001a",10,2,83,0.843373493975904,10,0,2,1
"33838","e98f853cbea1cca81ceebe9ea415c206",110,65,67,11.4925373134328,110,0,3,3
"33839","e993eb20982600bf2ae9ce6ed48ebae1",27,19,73,2.58904109589041,27,0,2,1
"33840","e9947f0a6b877bec23bdfaf6e9644119",87,70,65,9.36923076923077,68,19,2,1
"33841","e9983d287dcf2076ddfe2d80727ade9f",202,68,72,19.6388888888889,165,37,3,3
"33842","e9989edd9fa67ff2cd3596e26be29ac9",12,12,0,12,12,0,1,2
"33843","e99c5fa90aadd7150f5b3fc5bfdced03",13,13,0,13,13,0,1,2
"33844","e99c8e5ab78168bf8c9c27ad1961ed5b",93,56,78,8.34615384615385,93,0,2,3
"33845","e99d97ef958df8170ebfe8257d77ab28",63,52,42,10.5,63,0,2,3
"33846","e9a13dba84c3e8b998304e395aa65738",212,128,62,23.9354838709677,212,0,3,3
"33847","e9a622b132903a6e6e4e04ba96c36b53",21,20,19,7.73684210526316,21,0,1,1
"33848","e9a6e03c90cdc1d9a562dde3a349f824",104,75,62,11.741935483871,104,0,3,3
"33849","e9ad81c3cf92a05504bfd44476f3deb7",37,37,0,37,37,0,1,2
"33850","e9b468062eeee23dbc2c51bb325103f3",48,24,48,7,48,0,2,1
"33851","e9b5ab5cced28b7b2657244e3cfc4efd",12,12,0,12,12,0,1,2
"33852","e9b834e69f1428d61cb3ea6d6f348a43",13,13,0,13,13,0,1,2
"33853","e9b86fea53116a4804556e063dc73d41",107,61,57,13.140350877193,107,0,2,3
"33854","e9b9ed6f07b893e3c7a658c831dbfee1",16,16,0,16,16,0,1,2
"33855","e9ba22140dc210564293f3b34e6aec00",47,41,12,27.4166666666667,25,22,1,2
"33856","e9bbbd8e4ac9ec50047d4e5792761904",88,64,70,8.8,88,0,2,3
"33857","e9bc84f3b7a39f95d20f4405a99d446f",14,14,0,14,14,0,1,2
"33858","e9bdb12036698f8738c79e89961aeef5",197,125,77,17.9090909090909,197,0,3,3
"33859","e9c0d78ece0829b1b288b31e7c531d24",83,52,59,9.84745762711864,67,16,2,1
"33860","e9c3ad34546932097ef4871393a5531b",37,37,0,37,37,0,1,2
"33861","e9c401fd015546eb7d98949e6985866c",23,16,46,3.5,23,0,2,1
"33862","e9c4eeeb1efb198594a72b125c1bab24",57,52,34,11.7352941176471,57,0,2,1
"33863","e9c9137ac85eec19d627c4a1e951cc9f",14,14,0,14,14,0,1,2
"33864","e9c94af960632b9cd6774d7271d44bd3",12,12,0,12,12,0,1,2
"33865","e9ca0201206b52467a80555ed39b9bda",35,35,0,35,35,0,1,2
"33866","e9ca92e5b2048fe39e386acb3b53ec36",113,78,60,13.1833333333333,113,0,3,3
"33867","e9cb360f25c1f35471beeb7f478c9630",9,9,0,9,9,0,1,2
"33868","e9cda1ff8b3d953c16669a271971adc3",7,7,0,7,0,7,1,2
"33869","e9ce0f61482a1f7c15f217844419e9d1",22,22,0,22,22,0,1,2
"33870","e9cf9b3bff7a59113ced1059ad727904",89,74,40,15.575,89,0,2,3
"33871","e9d115bf4a63db51910036868bb8ad95",19,19,0,19,19,0,1,2
"33872","e9d15aadaeba72e56572b99495ca3535",45,45,0,45,45,0,1,2
"33873","e9d3e1c1c0deef7fc2d600d618e1540c",107,57,89,8.41573033707865,84,23,2,1
"33874","e9d4725d9f1a6b26c5f508b24ba9fce9",39,34,54,5.05555555555556,27,12,2,1
"33875","e9d73a241f78536ef11c6af512f6b587",117,85,44,18.6136363636364,74,43,3,3
"33876","e9d7ba59d618b89a61c52c2994c3b02c",112,86,70,11.2,65,47,3,3
"33877","e9d9b0493bcfe0cd8428a55c7f5f454d",44,43,35,8.8,16,28,2,1
"33878","e9ddb3023ca20a1ec61485a115c2da17",57,45,13,30.6923076923077,57,0,1,1
"33879","e9de5fcada151f9b365038a96dc218c8",144,33,84,12,144,0,3,3
"33880","e9decc05efa0b7f58a998f4216f0a1e6",51,34,61,5.85245901639344,51,0,2,1
"33881","e9df4763a8866f48e2dd12b556dd900f",56,28,60,6.53333333333333,56,0,2,1
"33882","e9df50b414a68c6004f05a030060031c",125,88,57,15.3508771929825,90,35,3,3
"33883","e9e013747d72b4d1d43f104bedaded80",11,5,46,1.67391304347826,11,0,2,1
"33884","e9e2ecf0687d50010a39d5e06687ab50",31,31,0,31,31,0,1,2
"33885","e9e4da9dbb596a85f9eacedef70d5771",79,62,28,19.75,79,0,2,1
"33886","e9e5d8eff41eff0095583ae0614b41a1",26,26,0,26,26,0,1,2
"33887","e9e924dba17d34a18ba265ee2e56eb1c",16,15,12,9.33333333333333,16,0,1,1
"33888","e9e99432d052ee863ae8d2b9296b03fa",157,109,58,18.948275862069,157,0,3,3
"33889","e9eafcfd514e2f9e1f6e0238a0c3c96a",48,48,0,48,48,0,1,2
"33890","e9ec5c8d379078dd7a6c83777f9c43e4",122,86,52,16.4230769230769,122,0,3,3
"33891","e9efa782c65307e57b0ffffc879881a6",67,56,67,7,67,0,2,3
"33892","e9efe13e3fc34b3d16bb3835c0c273a8",78,55,38,14.3684210526316,78,0,2,1
"33893","e9f056066d6ef32268eba69a5574c070",103,78,21,34.3333333333333,103,0,3,3
"33894","e9f195de3d5a7885cccb2a881d641570",135,60,77,12.2727272727273,135,0,3,3
"33895","e9f5b0bddea3ac5190a47aefa75cebbc",18,18,0,18,18,0,1,2
"33896","e9fbce1be6b9fff41e000f6f8064804c",38,31,18,14.7777777777778,18,20,1,1
"33897","e9fbe4cce6438499ca2a620e1cac5ab4",66,59,78,5.92307692307692,66,0,2,3
"33898","e9fed979d0de51b58366d734e37d5df4",194,99,61,22.2622950819672,194,0,3,3
"33899","ea016e5783ec4a20d1d4935b7207710a",123,96,47,18.3191489361702,75,48,3,3
"33900","ea01745f2ba35ab45c3f98e1ebb40298",74,47,78,6.64102564102564,74,0,2,3
"33901","ea02a384e1e73e856bcc0c2b1a1de6c5",139,102,49,19.8571428571429,139,0,3,3
"33902","ea05e37e82867774abafaa53379fc633",16,16,0,16,16,0,1,2
"33903","ea061c34fe2ce350edcb6e62fc693bba",236,109,82,20.1463414634146,208,28,3,3
"33904","ea082d0eec03f49b7683a6512511a03e",50,50,0,50,50,0,1,2
"33905","ea09c24d90745279b11dda2773feb448",133,32,71,13.112676056338,133,0,3,3
"33906","ea0bf9068094ca44e2a07b157004b571",208,100,85,17.1294117647059,208,0,3,3
"33907","ea111fd22de3c7735fedce8b0dd66a7a",117,76,46,17.804347826087,71,46,3,3
"33908","ea122ff9196ee9fd78b56f464f213d1d",151,95,42,25.1666666666667,151,0,3,3
"33909","ea153177e98300c9fdb382eb2e768d38",133,62,80,11.6375,118,15,3,1
"33910","ea15ac5fc5709967dba050210cb93d45",15,15,0,15,0,15,1,2
"33911","ea165114968b0dec7103ee0044d931e5",95,67,63,10.5555555555556,95,0,2,3
"33912","ea1722bd9564561d01a99414fa8a8547",61,53,9,47.4444444444444,61,0,1,2
"33913","ea17545814822640d074c1e1061d293e",39,30,37,7.37837837837838,39,0,2,1
"33914","ea1ad2e069050f067ca0c38a6a8f5cd4",6,6,0,6,6,0,1,2
"33915","ea1bf57afda5caaf72c70f4895478d05",22,22,0,22,22,0,1,2
"33916","ea1c627647a114f59e90442c23fdc901",191,98,69,19.3768115942029,191,0,3,3
"33917","ea1cb3aed9f89dc20cfa3188f421e198",212,149,82,18.0975609756098,212,0,3,3
"33918","ea1cdc808af0ac9ad3468195c9b5b582",99,65,63,11,99,0,2,3
"33919","ea1de6452608dab833f164352fad8e8c",8,8,0,8,8,0,1,2
"33920","ea23f79b0a84d41252f71e2f38cc8fc9",96,60,61,11.016393442623,65,31,2,1
"33921","ea2415ba222c9a7572b1a6aacc826a8f",26,26,0,26,26,0,1,2
"33922","ea242c7eb3ac9eeea68414d9572803c7",188,112,64,20.5625,143,45,3,3
"33923","ea25616e577412d30474981201f84fe2",46,42,19,16.9473684210526,46,0,1,1
"33924","ea2778510a84f05cd45cf17b7d6f9050",19,19,0,19,19,0,1,2
"33925","ea2ce03c814d8046e894650289d6d24d",47,47,0,47,47,0,1,2
"33926","ea2d279685044ff63515b8469299a217",103,76,68,10.6029411764706,103,0,3,3
"33927","ea2e625690da68cba92ff3fdb088d8ec",37,37,0,37,37,0,1,2
"33928","ea2f432464cdf47969725f421a7bafa4",145,73,77,13.1818181818182,145,0,3,3
"33929","ea3237289d448ce4e8274cf82862ad4e",99,59,78,8.88461538461539,99,0,2,3
"33930","ea327b08b16b9495c385626c9d8c9139",119,75,81,10.283950617284,119,0,3,3
"33931","ea3553eb8aea49c82d62c72d7ab2496f",135,100,36,26.25,135,0,3,3
"33932","ea38d7debc81671d20af5fde5042156b",3,3,0,3,3,0,1,2
"33933","ea3a0e1c663214579d347a4370aaebb3",32,32,0,32,32,0,1,2
"33934","ea3c028a968b3d50575d720822f68477",218,80,71,21.4929577464789,218,0,3,3
"33935","ea3c5de842c54c7ea188cc457b435c32",100,89,48,14.5833333333333,100,0,3,3
"33936","ea3e6dafe43fdc2916bb9b5c607dcb60",51,45,43,8.30232558139535,28,23,2,1
"33937","ea3eaf3ff8f8533a58fcd2def4883eec",132,101,21,44,132,0,3,3
"33938","ea4042e6d17154d1d18b81a005a044e9",31,31,0,31,31,0,1,2
"33939","ea411a44c29dee97339a6921edadf7dc",5,5,0,5,5,0,1,2
"33940","ea441920120e0ac0fce2de36360169b0",133,60,62,15.0161290322581,133,0,3,3
"33941","ea468d71d1ff21390dd82806edc44d64",14,14,0,14,14,0,1,2
"33942","ea46fc7b72f7b42c36a8d3f82e825e9d",55,43,37,10.4054054054054,55,0,2,1
"33943","ea46fcb29668786622d28c34eb21996a",108,75,43,17.5813953488372,108,0,3,3
"33944","ea48a86c4f79ee0e539110be362260d4",37,37,0,37,37,0,1,2
"33945","ea4a7f6709af40e5c625765c6f618474",9,9,0,9,9,0,1,2
"33946","ea4cc273a523a77004c120dbd8716c01",218,78,90,16.9555555555556,218,0,3,3
"33947","ea4dcc0b24bfd4a80a10ecc8e48a7db4",15,12,41,2.5609756097561,6,9,2,1
"33948","ea5490057a99d3a0b386bf705202a535",83,68,31,18.741935483871,83,0,2,3
"33949","ea565a64f1fd64a4ab75b668045fda4c",71,49,56,8.875,71,0,2,3
"33950","ea576ce7268626813a968a5ef930d5fd",16,14,22,5.09090909090909,16,0,1,1
"33951","ea5be54a06e9697df762d38eb7128342",209,70,73,20.041095890411,209,0,3,3
"33952","ea5d410daff090229c2ee03b8252808a",26,20,73,2.49315068493151,13,13,2,1
"33953","ea5f5638d57353969aa37ca93bcbeb28",26,26,0,26,26,0,1,2
"33954","ea63b3649f7212ae22b6ca110861e169",15,15,0,15,15,0,1,2
"33955","ea64f467ae19de38a9bf0dfec776ac18",94,71,34,19.3529411764706,94,0,2,3
"33956","ea65892ec3e09180fd59264ee5d94cfe",104,59,67,10.865671641791,104,0,2,3
"33957","ea69479c0a9c875033673fad0b92daa3",32,32,0,32,32,0,1,2
"33958","ea6ad6eabfd08a01dad6d60fa9b36df4",17,17,0,17,17,0,1,2
"33959","ea6b7fbb97f68f1792518dced19c0a99",142,118,22,45.1818181818182,142,0,3,3
"33960","ea6fd30fc600684110e88f15861fa90b",104,76,48,15.1666666666667,73,31,3,1
"33961","ea735ee9ff0cfcec86f2548c93fefdb7",73,60,38,13.4473684210526,73,0,2,3
"33962","ea75a6f05c161dcf79c78c223f6dda21",98,61,42,16.3333333333333,98,0,2,3
"33963","ea75ded3c8051c985bc7be4537cc0167",99,58,31,22.3548387096774,99,0,2,3
"33964","ea7700e750a5d038c380cd86d608ac9f",92,65,83,7.75903614457831,92,0,2,3
"33965","ea772df8060b65f20b1a0607814a73b7",17,17,0,17,0,17,1,2
"33966","ea7993cc17c636b9c90779ac98276bdc",11,11,0,11,11,0,1,2
"33967","ea7a493ea48aad4efe77a5cbb8f42fb3",25,25,0,25,25,0,1,2
"33968","ea7b6d31d873bd22d2264e7687b875c9",87,60,29,21,87,0,2,3
"33969","ea7ddde51b3ccaea578505d2d7f0ac57",2,2,0,2,2,0,1,2
"33970","ea80d2169fb26276f2d103b696c24c95",10,10,0,10,10,0,1,2
"33971","ea8327c629dd7247d96ae37bed94a81b",202,156,60,23.5666666666667,202,0,3,3
"33972","ea84ec7a0d093392227bf6f601c6253d",132,67,61,15.1475409836066,82,50,3,3
"33973","ea860e6f09054a97e94107a755b8a562",206,106,61,23.6393442622951,206,0,3,3
"33974","ea87129a3f89544f864fb3f58ff089a1",175,111,47,26.063829787234,175,0,3,3
"33975","ea8a9eeed02094b4cb93b51be5eec173",202,90,63,22.4444444444444,175,27,3,3
"33976","ea8b5e9c84db3a94260e1b0409bfc53f",68,39,61,7.80327868852459,55,13,2,1
"33977","ea8febe9e6ab616e400c83488a76176c",3,3,0,3,3,0,1,2
"33978","ea90f26a4400654895a82e4a6d6cd336",23,23,0,23,23,0,1,2
"33979","ea92008616e3d817ad38dbfd6be2042e",24,24,0,24,0,24,1,2
"33980","ea9377a77b7caa0fedb13bb16b3ddd2e",135,105,51,18.5294117647059,135,0,3,3
"33981","ea9bb8137497d71db7c040b4dc9fc119",21,21,0,21,21,0,1,2
"33982","ea9f62b740b35751c0b1f73241a2ee96",58,37,50,8.12,58,0,2,1
"33983","eaa30fa541d514c813ef800f5c088694",38,38,11,24.1818181818182,38,0,1,1
"33984","eaa45084c21885aaf9b842eb1b937b58",138,103,68,14.2058823529412,138,0,3,3
"33985","eaa588692a4a4ad09c81fc77bc0f2808",27,23,38,4.97368421052632,27,0,2,1
"33986","eaa5e33ad5ce7c6a6ce2c7671c5d0bf8",233,78,83,19.6506024096386,200,33,3,3
"33987","eaa5ef09e35b8d7dea881bd07f131aa4",43,37,77,3.90909090909091,43,0,2,1
"33988","eaa7224e3e10738de062437f565ac445",51,47,63,5.66666666666667,51,0,2,1
"33989","eaa9b127514946892e25119088ed9600",47,35,45,7.31111111111111,47,0,2,1
"33990","eaaaa177ba89a0b64e8a37bda7c65019",23,23,0,23,23,0,1,2
"33991","eaada7f7c2703d510509e4e39691065b",12,12,0,12,0,12,1,2
"33992","eab260e57b37d4721de9219618274cfa",75,62,38,13.8157894736842,46,29,2,1
"33993","eab591f3a5e835933de24f7901be19ae",65,50,21,21.6666666666667,65,0,1,1
"33994","eab814f34cc26dc84e0d60e63a4b9c4f",36,36,0,36,36,0,1,2
"33995","eabb5626b65bcdb82ee6af78b4045385",27,27,0,27,27,0,1,2
"33996","eabc5d98e597c01cb6bdc73d55a34207",173,79,84,14.4166666666667,129,44,3,3
"33997","eabcb9c0781e14a7b6dac90df859b8ad",46,46,0,46,46,0,1,2
"33998","eabcc13f44c4f3ac72b26c6cb87d4c57",21,21,0,21,21,0,1,2
"33999","eabcfe67db4363da7b2c38149b6f5b6e",38,34,9,29.5555555555556,19,19,1,2
"34000","eac0fc7c5d1eb80a2db275dbbf1b3bab",40,40,0,40,40,0,1,2
"34001","eac20e8a4f5c63c2a0fc06456020cdd2",134,97,83,11.3012048192771,104,30,3,3
"34002","eac3650060240f561075f7278016cae7",31,26,48,4.52083333333333,14,17,2,1
"34003","eac3b03a535095d022cfb754766b306d",18,18,0,18,18,0,1,2
"34004","eac620bcc0666a3b9b2c66d2b6d4266a",39,39,0,39,39,0,1,2
"34005","eac77ea615e693ccc120a9accdbed01e",244,110,68,25.1176470588235,201,43,3,3
"34006","eac9338b8c002c99a06c121760d1193c",31,31,0,31,31,0,1,2
"34007","eac95f3b4354856ddc998a2f602debe3",22,22,0,22,22,0,1,2
"34008","eacc25acb6d22f9fbcc0be6bd82f3d84",30,30,0,30,30,0,1,2
"34009","eacc5d4a22992429db0d8ec726a6c20b",23,23,0,23,23,0,1,2
"34010","ead42572ac0f3d23550d3ec74df3a209",35,23,66,3.71212121212121,32,3,2,1
"34011","ead47d49b026a80d50f055a202a15682",217,78,70,21.7,217,0,3,3
"34012","ead506ca8f2459ce77bba4831f46cf08",37,28,6,43.1666666666667,18,19,1,2
"34013","ead64efd6a6074d2ed18009f923640f2",134,79,70,13.4,134,0,3,3
"34014","eadaeccb65fe888d8394443f4e1c5900",6,6,0,6,6,0,1,2
"34015","eadf7f6216f4d48379877f58402fb6e9",68,54,74,6.43243243243243,68,0,2,3
"34016","eadfe2ebcc6f5d14683799590ea54a1c",6,6,0,6,6,0,1,2
"34017","eae0d4c60bd67f643ea52d6bcb5ec5b1",63,48,35,12.6,63,0,2,1
"34018","eae1f1e93c38a5ea51d462ce3a626271",124,48,88,9.86363636363636,83,41,3,3
"34019","eae34108984abde5e5a9c1164408241a",10,10,0,10,10,0,1,2
"34020","eae41ee6914d93b8bf799571255a5eb3",90,56,54,11.6666666666667,82,8,2,1
"34021","eae7530cc51b7bdee9d95651cc34bde4",79,63,21,26.3333333333333,79,0,2,2
"34022","eaeac181616f83fa1f1d4414503ce2d7",43,43,0,43,0,43,1,2
"34023","eaeb1449d9f77af29cfdc283f7873a59",28,28,0,28,0,28,1,2
"34024","eaeb2f9cba5b0dc2cd18e426e3965f63",31,31,0,31,31,0,1,2
"34025","eaf10c1519fa69c912dc138c382a63d4",40,35,7,40,0,40,1,2
"34026","eaf1cae1a93b08a7eb70f4584856640a",72,60,14,36,72,0,1,2
"34027","eaf40228b38a8cac7fdee1638a9f7c81",30,23,25,8.4,30,0,2,1
"34028","eaf4d2cf7d3867432771307242552203",42,42,0,42,42,0,1,2
"34029","eaf62814e52b4bc5f2fdf59c6c0c8136",124,95,45,19.2888888888889,124,0,3,3
"34030","eaf7b7632edce75bbba65af31dd8fa01",28,8,60,3.26666666666667,28,0,2,1
"34031","eaf85bb21023b4e895438f4fa7e34695",30,30,0,30,30,0,1,2
"34032","eb003905291bdae1906db83587191d25",14,11,53,1.84905660377358,5,9,2,1
"34033","eb034b5dbfaf0743a334885717b00d20",42,39,59,4.98305084745763,29,13,2,1
"34034","eb0371376c03322b3a2c027dce79e014",6,6,0,6,6,0,1,2
"34035","eb07da8535bbface3ed4e9a0fa82b3ab",170,46,84,14.1666666666667,159,11,3,3
"34036","eb08aa8bb5041b8fbe2207231cf344ff",79,65,15,36.8666666666667,79,0,1,2
"34037","eb095dcd4aa712be1faab4317c749d19",48,48,0,48,0,48,1,2
"34038","eb0a0dfc76e53e119921b163f9bef0c3",27,27,0,27,0,27,1,2
"34039","eb0ada05e33fd198a6914c33350773a1",29,29,0,29,29,0,1,2
"34040","eb0b57f42e1f3c4fe05c9fb8244a72c1",45,40,52,6.05769230769231,45,0,2,1
"34041","eb0dd7b7c4d6b9b6a0682901f55aea11",26,26,0,26,26,0,1,2
"34042","eb0eea45f37f2a08a9e468671f9667bc",60,50,21,20,60,0,2,1
"34043","eb10814f6dc5fc16fab63a615d814837",69,53,23,21,34,35,2,1
"34044","eb13d2da44d11c6979188991178a7105",27,19,49,3.85714285714286,27,0,2,1
"34045","eb1449570e487a8b662f5cc060613b3c",21,21,0,21,21,0,1,2
"34046","eb1625deb3a8fdf733e62311b0314b28",128,74,25,35.84,94,34,3,3
"34047","eb1ada513549bb622328380c7c6c52f0",11,11,0,11,0,11,1,2
"34048","eb1c1abffe81e45faa4767402bf758c8",39,39,0,39,39,0,1,2
"34049","eb1c618d690a39e7b23e657fc43b0229",26,26,0,26,26,0,1,2
"34050","eb1e0ca509eb6d15d0e0961e27b241e7",58,55,8,50.75,58,0,1,2
"34051","eb21a2b39519b03923bb9f34d8538734",27,27,0,27,27,0,1,2
"34052","eb22ebc4cdf12efaf243f8c6352a2e22",49,34,49,7,49,0,2,1
"34053","eb23a4ba420cf6534a464c7eb6f804c5",16,16,0,16,16,0,1,2
"34054","eb23e466044b4a0ea3de6bda703c8b91",3,3,0,3,3,0,1,2
"34055","eb2554169a9097d779435dd19f33ce7c",44,44,0,44,44,0,1,2
"34056","eb28aeb520f74a53de5f4237a1873658",34,34,0,34,34,0,1,2
"34057","eb28ce4dff22c51a1cc64a6737828ab1",7,5,67,0.73134328358209,5,2,2,1
"34058","eb2aac0a1d19b5424e29104bfbd53f4d",27,27,0,27,27,0,1,2
"34059","eb2b76cf9aad4f86d2c548e5afd99528",86,64,47,12.8085106382979,86,0,2,3
"34060","eb2c8e7cc5d29a7ef75b0496a78b1211",54,54,0,54,54,0,1,2
"34061","eb2ff7dad153fde6b6e224aa986b2fcd",56,44,39,10.0512820512821,23,33,2,1
"34062","eb379f0d1acbb88a547822ca437a5c52",142,105,38,26.1578947368421,142,0,3,3
"34063","eb3b4a0bd5af64a27ad53ee700be0e6d",41,41,0,41,41,0,1,2
"34064","eb3b779732c2ea26b87aa5c29217802d",94,54,71,9.26760563380282,70,24,2,1
"34065","eb3c51cbd3f83fd13406fb2e3f79aba7",21,21,0,21,21,0,1,2
"34066","eb3d2bc53c11d25f6f07b570aaf2111b",131,61,89,10.3033707865169,131,0,3,3
"34067","eb3e08067ff7bc279b19f9f5b69943ca",72,45,31,16.258064516129,72,0,2,1
"34068","eb3e295d7246e535abf131d9924dfd08",136,89,67,14.2089552238806,96,40,3,3
"34069","eb43f0923171465b4d786ed9c4552d43",30,30,0,30,30,0,1,2
"34070","eb4517d9a51c61ad1ccc4679d2d63269",217,115,71,21.3943661971831,193,24,3,3
"34071","eb45643ac604748fdca20d2769769ab2",29,29,0,29,29,0,1,2
"34072","eb489b1a0afc295a7207e9fc77b8e3c5",89,56,76,8.19736842105263,89,0,2,3
"34073","eb4ab944bdab7b9b103a6e16ba27da3f",66,47,88,5.25,66,0,2,3
"34074","eb4d9a4e97aed30ca8a3118455b6eedd",27,20,30,6.3,14,13,2,1
"34075","eb50b46c930152a1c5b466c08aaf6bdb",15,15,0,15,0,15,1,2
"34076","eb531bcfdcb7f7d62b66043a6f52712f",14,14,0,14,14,0,1,2
"34077","eb54ea20a8a5e4b91e4ba6d2d4e512f6",162,81,29,39.1034482758621,162,0,3,3
"34078","eb552bcd71ac838a47be42d5d1cb7562",21,21,0,21,0,21,1,2
"34079","eb5537ff43d5157f58f550a030cb7bbf",199,82,77,18.0909090909091,187,12,3,3
"34080","eb558cad307ff8962f393545e152ae6c",78,56,41,13.3170731707317,34,44,2,1
"34081","eb55e6f9fc5f6fb3654dd6f43bf9375e",15,15,0,15,15,0,1,2
"34082","eb56a4ed45e1c7183a6a5cff2cae249b",32,32,0,32,0,32,1,2
"34083","eb56be2a97defd96d92a5c470697a8cf",154,97,73,14.7671232876712,154,0,3,3
"34084","eb572bc830f00032ac7fdd9105bf1459",41,41,0,41,41,0,1,2
"34085","eb57e5b72a6c528d00d9b44aaf2d9179",52,45,59,6.16949152542373,52,0,2,1
"34086","eb58a600d7afa98fbdbd2aeeef809593",67,58,66,7.10606060606061,67,0,2,3
"34087","eb5a474fd8fa23b85edac0f0fae91f4b",10,10,0,10,10,0,1,2
"34088","eb5c955428816b18d13bdfad055dff2b",6,6,0,6,6,0,1,2
"34089","eb5eb3da7c11477963bd04c859e68282",164,76,74,15.5135135135135,164,0,3,3
"34090","eb5f57cb687be138c82cb1862622546c",178,22,84,14.8333333333333,178,0,3,3
"34091","eb6316fbac280c65712536bc10475503",17,17,0,17,17,0,1,2
"34092","eb64565c13a0b2f138962e783e11f607",20,20,0,20,20,0,1,2
"34093","eb6514505cedf5cad477f9cfa77d07f7",12,12,0,12,12,0,1,2
"34094","eb667322b84f0e6c3a90c7df1224a9cf",14,14,0,14,14,0,1,2
"34095","eb668b939a6c97d7e2feab66cbec97e6",66,54,26,17.7692307692308,32,34,2,1
"34096","eb66ad223dcabb373955afc4791a737f",47,47,0,47,47,0,1,2
"34097","eb66c961f38799663f571e32824bc689",61,44,41,10.4146341463415,61,0,2,1
"34098","eb68ad1f737584b4bfa980ca136e005a",32,32,0,32,32,0,1,2
"34099","eb6c4a17841c8abb28d56c1358c56a25",99,62,73,9.49315068493151,50,49,2,3
"34100","eb6e934dab09bee6b39237cd2f9e2a95",5,5,0,5,5,0,1,2
"34101","eb705e2c3ce5c57bb1b4d075ccc73985",42,42,0,42,42,0,1,2
"34102","eb73cd15c8b3629702f92b0214bda80c",126,38,81,10.8888888888889,126,0,3,3
"34103","eb75b39b34a498bc7ef15246c4d01ad7",35,12,82,2.98780487804878,35,0,2,1
"34104","eb76f2d97421038a3611d194d2f14352",43,39,21,14.3333333333333,43,0,2,1
"34105","eb7928428b701a31e60e303891d3f711",168,120,82,14.3414634146341,168,0,3,3
"34106","eb796a5893a8aa374aa8235f59909354",40,24,83,3.37349397590361,9,31,2,1
"34107","eb797ff21ff493ca45b47cc85ba50a96",31,31,0,31,0,31,1,2
"34108","eb79ceb46d2884410ef5f2ca0fcba401",42,36,25,11.76,42,0,2,1
"34109","eb7a5e5a59da8da6a6a0b739a42eadbd",18,18,0,18,0,18,1,2
"34110","eb7e24e60a25b1ff27a37ddea2fe5430",23,12,49,3.28571428571429,23,0,2,1
"34111","eb80ba2a42c732844667ad7b1f7edfc0",55,55,0,55,55,0,1,2
"34112","eb8366432d223bcd8be4bfff9e951af0",141,86,37,26.6756756756757,141,0,3,3
"34113","eb83ca9e85254e1e990b1e70617d6148",57,40,65,6.13846153846154,57,0,2,1
"34114","eb8540c2eeb869c79ed82648d48a3c24",94,78,33,19.9393939393939,94,0,3,3
"34115","eb8713dceec0b8140375450130620ee2",55,43,9,42.7777777777778,55,0,1,2
"34116","eb8b72ad09cb2c065982f1dc29a620dd",29,29,0,29,29,0,1,2
"34117","eb930364a4d90c1ef4be177fb9f8aa52",42,42,0,42,42,0,1,2
"34118","eb9651e77d04888eb61df821d068abb6",98,59,66,10.3939393939394,98,0,2,3
"34119","eb97c9c19beea0b3d3a56290f6acf149",41,31,28,10.25,41,0,2,1
"34120","eb99f86f4c8a873776cc7ef6cf07acb5",64,51,57,7.85964912280702,33,31,2,1
"34121","eb9dbc3c80995f90833188f32a69511f",36,36,0,36,36,0,1,2
"34122","eb9e2f668360add5429c02a58eaf90f7",28,28,0,28,28,0,1,2
"34123","eb9e7e623bbb5f2cd88bafe770630eb0",92,81,48,13.4166666666667,92,0,2,3
"34124","eba03f104d2029f23ace8f0e6befe783",200,116,69,20.2898550724638,200,0,3,3
"34125","eba4a9185ea60d67c5dbe18645496bab",5,5,0,5,5,0,1,2
"34126","eba858f5ef12451fef86d0f299886174",34,34,0,34,34,0,1,2
"34127","eba8d5427505e67b8dd26d622f35a1d3",36,27,52,4.84615384615385,36,0,2,1
"34128","ebabe51b7257c1eec85051dabb9efc15",23,23,0,23,0,23,1,2
"34129","ebac31eb4c9feb7f4595a2f873d421a5",17,17,0,17,17,0,1,2
"34130","ebade9223803b1e5213f0dfd4ed4d01c",33,33,0,33,0,33,1,2
"34131","ebae031594535b29de8059a8af2ba155",91,48,59,10.7966101694915,91,0,2,3
"34132","ebaf707aa33b7e16f2b752dff182dabd",83,56,49,11.8571428571429,31,52,2,1
"34133","ebb0607322254b3a4b463dfee433f2d4",32,32,0,32,32,0,1,2
"34134","ebb28f1b1138d1aa73dc56aa17d8c14c",1,1,0,1,1,0,1,2
"34135","ebb33cf5872fe39255599916fb4b955e",41,41,0,41,41,0,1,2
"34136","ebb50bb45666b6b0477373d6a5d4621d",47,47,0,47,47,0,1,2
"34137","ebb731890dcf105ba6250c7af239291b",33,33,0,33,33,0,1,2
"34138","ebba7813cdd95708424adca613d9d8e4",83,62,32,18.15625,55,28,2,1
"34139","ebbcef2f3f4734f5681b7f221daa92d0",47,39,47,7,47,0,2,1
"34140","ebbd7319d4ad9ddcbf81aba7933dea60",37,37,0,37,37,0,1,2
"34141","ebbd7bf1c74e1eff364018ac87a1a179",38,38,0,38,0,38,1,2
"34142","ebbe25571fab22f915180dc1f5aae42a",56,56,0,56,56,0,1,2
"34143","ebbe5fccbe01137d43dd93b9b0ea3231",55,46,63,6.11111111111111,55,0,2,1
"34144","ebbe7b4e1e142f52709778bcd3bf957f",34,34,0,34,34,0,1,2
"34145","ebc0617741a60a25d0862a462e597421",42,42,0,42,42,0,1,2
"34146","ebc0e5a960ec9cc0100b7e10b8b57d7e",24,24,0,24,24,0,1,2
"34147","ebc2231ded97622b8ea6fcb6d641a5ab",21,21,0,21,21,0,1,2
"34148","ebc4d77c4613b2e9e1c00a39e1cb7aca",16,16,0,16,0,16,1,2
"34149","ebc5b5a12a08936bdbdb71d09396ea12",70,64,39,12.5641025641026,70,0,2,3
"34150","ebc5b9005fac75fbafa97c186aa14b6c",31,30,37,5.86486486486486,31,0,2,1
"34151","ebcb886ac6390e455d649a1e52d7a873",19,19,0,19,19,0,1,2
"34152","ebce7081d40e8b109ac6911775ffa54b",7,7,0,7,7,0,1,2
"34153","ebd0771a1b7a9e705ed0cc20663ce7cf",35,35,0,35,35,0,1,2
"34154","ebd1dadb54288ddfe1a2c5641f8573a7",68,55,76,6.26315789473684,68,0,2,3
"34155","ebd3c4854893efd9a39d6cbc5378c76e",19,19,0,19,19,0,1,2
"34156","ebd555293bc2a45bee504421401f49f5",200,80,90,15.5555555555556,200,0,3,3
"34157","ebd81681da066767facf3442889f7fc1",70,54,41,11.9512195121951,70,0,2,3
"34158","ebd8a9b83b9c4facec0de4b68dab3b17",26,26,0,26,26,0,1,2
"34159","ebd9657367e5df70a8543c15fceaf060",26,26,0,26,26,0,1,2
"34160","ebda2c44e150e4f736b3a4380fb070b0",19,19,0,19,0,19,1,2
"34161","ebdd2795bb21e5b27eaa74d72800c76f",76,53,47,11.3191489361702,46,30,2,1
"34162","ebde774b559f97e024ac959ea5162b80",45,34,45,7,20,25,2,1
"34163","ebe237907d2a8902c0baa287eb81546a",21,21,0,21,0,21,1,2
"34164","ebe3e5e428bb03a985f1a06c083b2d2e",30,30,0,30,30,0,1,2
"34165","ebe4863fd67ece37957b997fa645111b",30,27,65,3.23076923076923,21,9,2,1
"34166","ebe58cb9fdfd2dd3a3090c94b84be14d",19,19,0,19,19,0,1,2
"34167","ebe602aac4bb2cf6750c3c52cdc121fb",90,73,54,11.6666666666667,90,0,2,3
"34168","ebe7b18e4885ac06190e917b28bdd8de",129,82,65,13.8923076923077,129,0,3,3
"34169","ebe7d029ede543deaa7fb8167b8287e8",26,18,10,18.2,10,16,1,2
"34170","ebea6bda6d7bec4780c3542d09b7a354",72,58,40,12.6,34,38,2,1
"34171","ebeb75aee3a3084e7b69e29b935c3218",120,96,44,19.0909090909091,120,0,3,3
"34172","ebec6c29b3455c3953b16649fad7f323",38,38,0,38,38,0,1,2
"34173","ebec9bb758d410499fee752f988c4f74",27,27,0,27,27,0,1,2
"34174","ebef203e24a7e712d22326b45bb89228",35,35,0,35,35,0,1,2
"34175","ebefc78ea67d26f8213864ced0efe065",29,29,0,29,0,29,1,2
"34176","ebf0cc271daf6a7f7f1f9e4d77f36667",35,35,0,35,35,0,1,2
"34177","ebf0d7d669f45e3bc040b862a46c36ba",33,33,0,33,33,0,1,2
"34178","ebf393306204bb590b4062c67e8f4f67",33,33,0,33,33,0,1,2
"34179","ebf4bcb158abfb2bd26e29f8d71dee6e",40,40,0,40,40,0,1,2
"34180","ebfe7b3d1ada4635a32c98bc65c0de43",24,24,0,24,24,0,1,2
"34181","ebfebf5c132b3c3f924b135c712ff171",32,32,0,32,32,0,1,2
"34182","ec014923098c23cad5e74b989c16869a",37,37,0,37,37,0,1,2
"34183","ec01d0c7b9e64f1e476507009f984291",31,25,63,3.44444444444444,31,0,2,1
"34184","ec02e5cfedd230ec9266743c11f809e0",8,3,74,0.756756756756757,4,4,2,1
"34185","ec03051c83070c5a8de5e8ce8bc21840",107,72,31,24.1612903225806,107,0,3,3
"34186","ec0313fa1dd7bcd0abf1196ca2952320",10,10,0,10,10,0,1,2
"34187","ec038bbf51691a1cecb99b77a7451247",182,107,72,17.6944444444444,160,22,3,3
"34188","ec055c35cbc760ebf964c33de9ae26f1",54,54,0,54,54,0,1,2
"34189","ec05bc906325d4a714bd21d58f073f1e",13,12,7,13,13,0,1,2
"34190","ec06857491506b45b7adbacc523a55b2",26,26,0,26,26,0,1,2
"34191","ec07dff7929bb1fdeb6e77c10e6d1cd1",39,39,0,39,0,39,1,2
"34192","ec0890f3ee297f593e1c15b3fcc88b9d",56,45,54,7.25925925925926,56,0,2,1
"34193","ec08bf8033edbf0ad01ea29054a58747",71,55,63,7.88888888888889,71,0,2,3
"34194","ec0ae622e40f16c5fcdf46a228809a30",45,45,0,45,45,0,1,2
"34195","ec0b781f151f7d077bcb76ad5fae1f33",15,15,0,15,15,0,1,2
"34196","ec0bee50dd3cc07ac824614377d37d3f",19,17,7,19,19,0,1,2
"34197","ec0e06bb37e4db5685c9b941dcd5e6d1",114,103,42,19,114,0,3,3
"34198","ec0e31d22a965ef9a509dc1fbdacb2d9",135,94,35,27,135,0,3,3
"34199","ec0e677240a2dcfb3b8c238f02797064",10,10,0,10,10,0,1,2
"34200","ec0f100492e216af4d8f7c7967988036",129,57,81,11.1481481481481,129,0,3,3
"34201","ec10ffbd62b66d500715fcb05cd31c07",50,42,21,16.6666666666667,0,50,2,1
"34202","ec14bceeb660d4aad41ee75a2f6eefd5",8,8,0,8,8,0,1,2
"34203","ec15c41473e88d8cf53828ed78d9199d",13,13,0,13,13,0,1,2
"34204","ec16216154844c0188c68a736ceee595",116,67,83,9.78313253012048,116,0,3,3
"34205","ec164013d1e070ae3b398dd1dc39da26",123,72,31,27.7741935483871,123,0,3,3
"34206","ec19a1e59fe2e97a12c34430760daaa2",43,32,42,7.16666666666667,43,0,2,1
"34207","ec1ae9959a401726b9fdf45d744c5d48",31,31,0,31,31,0,1,2
"34208","ec1b0dd613872dd31abc1ba8a9268f46",150,88,63,16.6666666666667,102,48,3,3
"34209","ec1fa301fc491d07752364584a7bdebd",22,22,0,22,22,0,1,2
"34210","ec26c8201b5f335897c558e363b527e5",32,28,10,22.4,29,3,1,2
"34211","ec26dd62947d23586626ae05cfe41c5a",18,13,57,2.21052631578947,18,0,2,1
"34212","ec27bb3edb0f87a25f7bdeac39ebd111",79,67,56,9.875,79,0,2,3
"34213","ec27ce698971af490c3894ac63102607",96,78,71,9.46478873239437,96,0,3,3
"34214","ec29b4a31bd29c365496e6c71fb34216",47,47,0,47,0,47,1,2
"34215","ec2cb81ea2653719a982d3def3463994",88,49,67,9.19402985074627,88,0,2,3
"34216","ec2d0c2e503d1ac1dc84ec7330eda3b8",11,9,30,2.56666666666667,11,0,2,1
"34217","ec2db5a904797adfd333b08396ff7f16",42,42,0,42,42,0,1,2
"34218","ec2e31766c21beaf4af82f795049ea10",136,90,84,11.3333333333333,105,31,3,3
"34219","ec2ea174ebcd9033d5811e2a4831531d",139,97,88,11.0568181818182,84,55,3,3
"34220","ec2f16c807a2a4931e11fd435b81a71f",35,35,0,35,35,0,1,2
"34221","ec31aa21fb11cfa55ec2bbc4b1f9f5a1",27,27,0,27,0,27,1,2
"34222","ec3554c4e682d00a7aeab6586256bcb9",31,31,0,31,31,0,1,2
"34223","ec3896f5ea82e314a4a815ab1b37bad7",10,10,0,10,10,0,1,2
"34224","ec3a5d1a39813db689cfb80dc52bc89c",237,102,78,21.2692307692308,210,27,3,3
"34225","ec3f2f7ea5658709c7fe5502db09906e",31,31,0,31,31,0,1,2
"34226","ec3f5fd9acb98de7a2973a2df731613f",38,28,84,3.16666666666667,38,0,2,1
"34227","ec3f60cb5eeec1f98cd54cefecdd1137",98,82,64,10.71875,98,0,3,3
"34228","ec43177791df985ee7804f9b0783080b",55,41,42,9.16666666666667,55,0,2,1
"34229","ec457c41285e2b1ae6146f83d5e98338",22,22,0,22,22,0,1,2
"34230","ec4a5e415e89ac9ddae8679e692b8586",43,43,0,43,43,0,1,2
"34231","ec4bf5f157e10a4f1bfe36595805fa27",30,30,0,30,30,0,1,2
"34232","ec4d26f98a95385cf11940c3a6415584",63,52,28,15.75,63,0,2,1
"34233","ec4d685bc518572026e473c569bc4b7f",39,29,41,6.65853658536585,26,13,2,1
"34234","ec4fcbd8f473ee46b892cd8065087549",47,47,0,47,47,0,1,2
"34235","ec50d24a18848ee3ff3c129fe47948af",1,1,0,1,1,0,1,2
"34236","ec50f651f036de7ebd3798c08009b6fa",29,29,0,29,29,0,1,2
"34237","ec5221d7833dce7562743bf3a5b2278c",140,57,78,12.5641025641026,140,0,3,3
"34238","ec567770feac6b23d3d229011d5d477e",28,28,0,28,28,0,1,2
"34239","ec5cc33a5248e918c9a3f1a8faf50d4c",68,57,31,15.3548387096774,68,0,2,1
"34240","ec60745747451d770f3311a70e2605dc",70,52,32,15.3125,45,25,2,1
"34241","ec60f9a26b907e2b3aad2e47a923c512",59,48,54,7.64814814814815,59,0,2,1
"34242","ec61086ca41923d5dc9a3548c8cb3526",34,33,6,39.6666666666667,1,33,1,2
"34243","ec624ae2a4d6bd90972d920043f51682",169,112,56,21.125,169,0,3,3
"34244","ec62da8561d6493a81ab09c5745c760a",46,40,7,46,46,0,1,2
"34245","ec66bd6c8b7aa0f557fc5174eb52d9a6",32,32,0,32,32,0,1,2
"34246","ec66ea617d9f73608f36cc1a8d42fcfe",47,47,0,47,47,0,1,2
"34247","ec6cba924b352dc8c371b91b3332d350",32,32,0,32,0,32,1,2
"34248","ec71b1c19df43a9288b994e9203c6e48",47,47,0,47,47,0,1,2
"34249","ec73a096e0e907b74228c2082e28961e",9,4,89,0.707865168539326,9,0,2,1
"34250","ec74a2043de915ea770b6e69d939bba7",34,34,0,34,0,34,1,2
"34251","ec755c7631127535cc4c2e24262241bc",20,20,0,20,20,0,1,2
"34252","ec77040bdc025bacf4272ae0af4f34d9",137,83,81,11.8395061728395,119,18,3,3
"34253","ec776816315c8088ba8c6d6cff56eb62",39,39,0,39,39,0,1,2
"34254","ec7917e527a108f56614c7a8abde9d29",14,14,0,14,0,14,1,2
"34255","ec795aacedd94d5bc3fbd291fc7540af",182,104,34,37.4705882352941,167,15,3,3
"34256","ec7b2a2c239f2b9fd594ee2bcc8caa79",8,8,0,8,8,0,1,2
"34257","ec7e689c04bfd3bcddabf82d0c1b8f01",101,74,56,12.625,101,0,3,3
"34258","ec7f2b8d8263b2dbbb45dc8318508b1f",99,78,31,22.3548387096774,56,43,3,3
"34259","ec80434aceb8aee0159c2f656507d9a8",8,8,0,8,8,0,1,2
"34260","ec83356e93448ed695eab43aad52f3cf",20,8,58,2.41379310344828,20,0,2,1
"34261","ec84d7ceb8fff18aaa088341eb0f6629",27,27,0,27,27,0,1,2
"34262","ec8615e576bbdb74e35bad84a4bc07a2",36,36,0,36,36,0,1,2
"34263","ec86710919afc01517df758d6d0741a0",80,69,14,40,80,0,1,2
"34264","ec87078a0a3038d10aaf8418a1ce7c63",41,41,0,41,41,0,1,2
"34265","ec872ca90128232c2bad80aba0d8ed8c",65,44,47,9.68085106382979,43,22,2,1
"34266","ec8870da943913ff90d950b547ae4fb6",198,133,58,23.8965517241379,198,0,3,3
"34267","ec889eaecef53ec5f268fd438b5c5bb0",30,30,0,30,0,30,1,2
"34268","ec8b81e67c899128a9e346b4ed2f92ac",18,18,0,18,0,18,1,2
"34269","ec8d4e5c91b34e55d17741f2336eaa48",142,97,72,13.8055555555556,111,31,3,3
"34270","ec8d6326ab999027d460beda83b89885",128,74,86,10.4186046511628,82,46,3,3
"34271","ec915b76b02f21d129edf4913ce13fab",4,4,0,4,4,0,1,2
"34272","ec91ab234c37cd9e53eb4b97c6384f07",148,85,47,22.0425531914894,99,49,3,3
"34273","ec92169e63ff0cf2505b17cbcd3e3170",27,27,0,27,27,0,1,2
"34274","ec926181c315b758d775ee64a6a8e033",76,59,35,15.2,76,0,2,1
"34275","ec92b39dd2edf6cd6a61bff515e6ad04",33,33,0,33,33,0,1,2
"34276","ec9392d1508d30a84c3f14a90fa60851",65,55,32,14.21875,24,41,2,1
"34277","ec95532b4795b1129635b40d86463763",92,85,35,18.4,92,0,3,3
"34278","ec9692e9e3606c272072a45fcc9841c3",114,84,51,15.6470588235294,114,0,3,3
"34279","ec96d15b0c96e1f16f5cfdb9ddb17e68",60,44,54,7.77777777777778,26,34,2,1
"34280","ec97f1131d1fdaa5eeaf86a919471fbe",107,57,33,22.6969696969697,107,0,2,3
"34281","ec98ff785f6c3d302c2d12578679c60c",32,32,0,32,0,32,1,2
"34282","ec9954cd5e8205de22a576d5b2b810f9",45,45,0,45,0,45,1,2
"34283","ec9b24d6e4097e1d21eb9ccac6f857e5",148,115,49,21.1428571428571,148,0,3,3
"34284","ec9dca8e645e50fe81374ad3498630a5",33,33,0,33,33,0,1,2
"34285","ec9dcc93d700e84e7b65b722ccafa78a",91,62,54,11.7962962962963,91,0,2,3
"34286","eca0a4550ffd17a2d2495621d5866b54",4,4,0,4,4,0,1,2
"34287","eca28ea33c20368107f87d1db86bad5a",32,32,0,32,32,0,1,2
"34288","eca4fa41dc00c46df3d5e6a0d78c619d",81,43,70,8.1,81,0,2,3
"34289","eca6293b7a6c60d3d7f0e2434e778e0b",14,14,0,14,14,0,1,2
"34290","eca63d276d905311348f55b8cb2030b0",63,55,60,7.35,63,0,2,3
"34291","eca721374a8756eaee1c762cbaffd195",27,27,0,27,27,0,1,2
"34292","eca7ad6296b90fa103df08870afb7ccc",1,1,0,1,1,0,1,2
"34293","ecacd8b4b72d02940806ac4a235d7798",53,49,53,7,29,24,2,1
"34294","ecb1e8489ac0f60ecdd907c2ceb5bf3e",48,48,0,48,48,0,1,2
"34295","ecb6252d0d8f4392edf49e04d1335a1a",1,1,0,1,1,0,1,2
"34296","ecb7bc32db0a0a7ae3a9f10a82ae52ef",35,35,0,35,0,35,1,2
"34297","ecbaec12a37a691f5c84d947d52473f4",55,31,72,5.34722222222222,36,19,2,1
"34298","ecbaf0b157d68ba073788cf64bea149b",136,76,74,12.8648648648649,98,38,3,3
"34299","ecbe702e0c30993aa532dd5880fe2774",37,37,0,37,37,0,1,2
"34300","ecc095ee63c1cf0988e4091fb8af9844",2,1,28,0.5,0,2,2,1
"34301","ecc380fb8c7cb7c666913f27bb9c1605",158,101,79,14,121,37,3,3
"34302","ecc49b015eca78ad70d39a1bbd13b773",101,43,79,8.94936708860759,101,0,2,3
"34303","ecc55eb881dd8129e7eeda7f02512a90",100,68,23,30.4347826086957,100,0,3,3
"34304","ecd43e67ed45df02b469483aa617471a",25,25,0,25,25,0,1,2
"34305","ecd5c615d846d2066cf855d9fbd8e165",187,110,74,17.6891891891892,140,47,3,3
"34306","ecd83385e0d7f18d6520fd095256fe3d",200,93,85,16.4705882352941,200,0,3,3
"34307","ecd9799fcf42532c27b818f5ad2e6a86",19,19,0,19,19,0,1,2
"34308","ecd9beff848843c9df20cb8c4b96255b",40,39,62,4.51612903225806,40,0,2,1
"34309","ecda9628a31db216af5a9c0c2e06adb4",217,102,62,24.5,217,0,3,3
"34310","ecdda789c7a278a2e6aa502944e93bae",42,42,0,42,42,0,1,2
"34311","ecdf010a0123ce8f6470cbcfef1deafc",14,14,0,14,0,14,1,2
"34312","ecdf0143de4a47e40b2f822b1fe02bb0",54,54,0,54,54,0,1,2
"34313","ecdf69def40425a1f8f2c0343751333e",30,30,0,30,30,0,1,2
"34314","ece0d391591165291418d6bc0caba170",21,21,0,21,21,0,1,2
"34315","ece0e623c641157bcf506771d3b039eb",32,32,0,32,32,0,1,2
"34316","ece12214d34901d7c84b9f97fa6697af",73,58,34,15.0294117647059,73,0,2,1
"34317","ece18cbbffc4df91488e0809377ea864",43,34,69,4.36231884057971,43,0,2,1
"34318","ece201bd9b1579da6cc92de2fdd1e6fe",24,24,0,24,24,0,1,2
"34319","ece2fd5a1a97b54733a6d3ab61b04042",23,23,0,23,0,23,1,2
"34320","ece50816d619624d03d0f0b9d722cfcb",21,21,0,21,21,0,1,2
"34321","ece5b11dee17185c3ee2c7d383aa2eb3",134,87,44,21.3181818181818,134,0,3,3
"34322","ece5eb4d0355a70aabaccb7e1fb1751d",18,18,0,18,0,18,1,2
"34323","ece6376229dd467d7759216df372c20f",63,48,29,15.2068965517241,37,26,2,1
"34324","ece8c2cb274726189780cc73f0e6c81d",140,63,69,14.2028985507246,140,0,3,3
"34325","ece90ac70c80fc26cf17776e737633bb",13,13,0,13,13,0,1,2
"34326","ece9923fd84ca8e25229ff23a3221e68",20,20,0,20,20,0,1,2
"34327","ecea644f108e7fe260c24c1b3bc4dda2",28,28,0,28,28,0,1,2
"34328","ecec5eb1804382552790fe89a20a9839",46,45,26,12.3846153846154,46,0,2,1
"34329","ecf1b415c2f423065266364082279a8c",35,33,5,49,35,0,1,2
"34330","ecf2c8e9d455bef01ca3bfd5cfb2d851",102,67,76,9.39473684210526,102,0,2,3
"34331","ecf2e8f53172f69f39c47cc1077cc000",32,28,5,44.8,9,23,1,2
"34332","ecf4e8f98cb1656372c958a771daf0f7",12,12,0,12,12,0,1,2
"34333","ecf92a776d53b06a94c266c8e987369f",135,107,52,18.1730769230769,135,0,3,3
"34334","ecf99f5a3cb1c0ab27946a64172a5634",10,10,4,17.5,10,0,1,2
"34335","ecfad1776c8ff180d13ba39febc2acf7",124,97,35,24.8,124,0,3,3
"34336","ecfd598c7d58dbccef5c744b8ea645c6",211,48,84,17.5833333333333,211,0,3,3
"34337","ecfff83c3abbd4896638caac7641b7b6",41,41,0,41,41,0,1,2
"34338","ed01fb4419faa3a0704a465941e213b0",22,22,59,2.61016949152542,2,20,2,1
"34339","ed026e6f75df66da3d48eb64346dd4f5",51,46,15,23.8,51,0,1,1
"34340","ed02a814e1f793a9f268aaa177e1507b",23,23,0,23,0,23,1,2
"34341","ed02dabfe082f64bc89c027a4bef1307",41,41,0,41,41,0,1,2
"34342","ed058835b8f700f6f5c4001c0f5adb70",167,147,29,40.3103448275862,121,46,3,3
"34343","ed0604897bd5818becfcf6d863677ec9",147,96,77,13.3636363636364,147,0,3,3
"34344","ed06418aad89403b07f3c1353d9b8302",104,79,62,11.741935483871,104,0,3,3
"34345","ed068287a7963e10e6024bb3f1d6eda5",183,111,88,14.5568181818182,183,0,3,3
"34346","ed076ed6f0b0f3f8552f60583e664a1a",71,44,63,7.88888888888889,71,0,2,3
"34347","ed093aef015b4525b07f3d57a21b6eba",123,80,53,16.2452830188679,93,30,3,3
"34348","ed0a2c50ac989495cf5cd468488a2ee8",21,21,0,21,21,0,1,2
"34349","ed0a7c0f4c946aabda92f9ae2f044f0d",29,27,6,33.8333333333333,29,0,1,2
"34350","ed0c5547d667d5543315c7f1589aefe2",76,69,32,16.625,21,55,2,1
"34351","ed0dda42a017769c8f2d9db1cf26ba78",84,45,44,13.3636363636364,50,34,2,1
"34352","ed138928be1e9a65e4e899dc1cb4aeae",44,44,0,44,44,0,1,2
"34353","ed19442cfd910efd5d9232d3608f0f03",32,32,0,32,32,0,1,2
"34354","ed1ae81b2f689b298c52853b74dd7be3",17,17,0,17,17,0,1,2
"34355","ed21429d0006e88f6bab3cea805df2d2",119,67,61,13.655737704918,91,28,3,1
"34356","ed218347d213eb2c708fffa1e1d7dce3",18,18,0,18,18,0,1,2
"34357","ed2961cbfe07952c89c0af01919c3852",21,21,0,21,0,21,1,2
"34358","ed2b0256a0205fbfc1ae1952163548e0",235,94,78,21.0897435897436,193,42,3,3
"34359","ed2f8f0245bb0a794fb235068a4d8f0c",102,77,66,10.8181818181818,56,46,2,3
"34360","ed31dc39378867c5b904ae6890bc1c7e",43,43,0,43,43,0,1,2
"34361","ed31fb4de945b742702539a420283b52",19,19,0,19,19,0,1,2
"34362","ed32b46d87f4366ea9a5f20dda99100e",20,15,68,2.05882352941176,17,3,2,1
"34363","ed32d934dbd2265a4accd3563ed5224c",27,27,0,27,27,0,1,2
"34364","ed331630841f97fca733379a6370fcdf",4,3,27,1.03703703703704,4,0,2,1
"34365","ed3538989672a59ab684b9aa128aaebb",74,16,61,8.49180327868853,63,11,2,1
"34366","ed356c9d9f0e66ce5371c528088fc0fb",86,70,32,18.8125,86,0,2,3
"34367","ed356eaa8dc1667af1db105a82db35f0",35,33,25,9.8,35,0,2,1
"34368","ed3b5a73a7593eb577b6f881d26f282d",28,28,0,28,28,0,1,2
"34369","ed3c7e073e6818b26b625fa876139659",145,80,57,17.8070175438597,104,41,3,3
"34370","ed3c7e0fb35769b80562ff47dfe33a61",66,36,67,6.8955223880597,66,0,2,1
"34371","ed3fb9d12358f7fb58e84fc3164227f0",199,137,77,18.0909090909091,199,0,3,3
"34372","ed402b929d3ea624132f202d7baf8b9b",45,45,0,45,45,0,1,2
"34373","ed40eda57944a9015a457a8f91755771",33,33,0,33,33,0,1,2
"34374","ed422416a14a974ea8921134f882d823",17,17,0,17,0,17,1,2
"34375","ed44071457832880697ffdc6e349d942",14,14,0,14,14,0,1,2
"34376","ed44d04acb08be15ee6d4018d4b27536",5,5,0,5,5,0,1,2
"34377","ed46931169a1ba7ff48df6beda618730",14,14,0,14,14,0,1,2
"34378","ed46f9d085e37077a11d0b1782b919f5",89,63,39,15.974358974359,49,40,2,3
"34379","ed476c059fba36474f1fc38eb96ffd21",200,91,66,21.2121212121212,200,0,3,3
"34380","ed479a0327b1b34b513ac0500e8700be",102,60,54,13.2222222222222,102,0,2,3
"34381","ed493d47bd7134bac577ef906d24a2a1",57,42,48,8.3125,57,0,2,1
"34382","ed496dd612785b77b139cd1577ad7a59",181,95,52,24.3653846153846,149,32,3,3
"34383","ed4d7785b6edad5ecd0c189eca4b35ac",84,63,23,25.5652173913043,39,45,2,3
"34384","ed5072c455eb857dce8b8a053f5719a5",128,81,66,13.5757575757576,128,0,3,3
"34385","ed519f4ed72f503d6a8a72d47c15a68a",70,43,69,7.10144927536232,70,0,2,1
"34386","ed53fdd2eae6152b53ff5c4da1e8fc30",125,66,76,11.5131578947368,125,0,3,3
"34387","ed547ed31e87e7ced5e075849c304751",29,29,0,29,29,0,1,2
"34388","ed550e96dfa0d41fb6883f7f63112186",20,20,0,20,20,0,1,2
"34389","ed571d7b2788811e0626ff616389f1b2",178,118,44,28.3181818181818,178,0,3,3
"34390","ed59cff0b8342e625e24296199df084b",17,10,52,2.28846153846154,17,0,2,1
"34391","ed5a87a034a1a27ebdc312276472e39b",105,91,36,20.4166666666667,105,0,3,3
"34392","ed60f293aeb8afa6d0a7c117f667243c",234,128,79,20.7341772151899,188,46,3,3
"34393","ed64c5895ac9cf447c300d58c712ce37",144,79,77,13.0909090909091,144,0,3,3
"34394","ed65504da8804b20d8c575385185836b",94,79,67,9.82089552238806,94,0,3,3
"34395","ed6601b278bb0fe76de06562b1818cd6",64,44,50,8.96,64,0,2,1
"34396","ed673a6e83bf5e1282f47c341500ed37",24,24,0,24,0,24,1,2
"34397","ed6d50d4e566f0adb666a9644dc75062",120,97,81,10.3703703703704,120,0,3,3
"34398","ed6dc75248429691f64bb5ac4a380b83",32,32,0,32,32,0,1,2
"34399","ed6e3f3fd91948e6a11a8291c8efd296",132,95,72,12.8333333333333,132,0,3,3
"34400","ed70439559f598758ab75e75783e6442",59,54,9,45.8888888888889,33,26,1,2
"34401","ed739646b5465357279e0ee589d7cfb3",25,25,0,25,25,0,1,2
"34402","ed7c971c1e87018fd0a262cb5cdafc2a",55,47,33,11.6666666666667,55,0,2,1
"34403","ed7dbc1df889f606b0c9c35d2c9027f3",31,31,0,31,31,0,1,2
"34404","ed8139d0cdef8e3945493a526221f58e",87,60,25,24.36,87,0,2,3
"34405","ed81ca606d2b2d5753e80695ec2762f9",159,92,55,20.2363636363636,159,0,3,3
"34406","ed81e63259ffb5e3e59fe9d453775211",30,29,9,23.3333333333333,30,0,1,2
"34407","ed85096458a7e3694b8790aaa01ed78a",34,34,0,34,0,34,1,2
"34408","ed863e4072229b3075797f2ee661f10f",106,76,58,12.7931034482759,72,34,3,3
"34409","ed878a7b7db4a2f263616aa82b7de5dd",126,83,64,13.78125,95,31,3,1
"34410","ed88118e1dbba215b8252658335085df",55,42,13,29.6153846153846,55,0,1,1
"34411","ed8856f19f9f0f0dffd5b0185fa03f1f",16,16,0,16,16,0,1,2
"34412","ed8a19be27967c7a08bb6b01dee79c68",186,88,58,22.448275862069,149,37,3,3
"34413","ed8baf2cafc6129661ab2dea30f42ba4",194,100,60,22.6333333333333,165,29,3,3
"34414","ed8c4ca907f308e20185dec8ab0d91fc",42,42,0,42,42,0,1,2
"34415","ed8f6d18d4e2a11012b5b04e8c891586",142,82,60,16.5666666666667,142,0,3,3
"34416","ed94c1d3e230c1a6c87227bf293264f1",99,84,39,17.7692307692308,99,0,3,3
"34417","ed960538683f763be53b6c2db20cf6aa",63,53,27,16.3333333333333,63,0,2,1
"34418","ed9734a5ca7ac1750ca07162169d73b3",41,41,0,41,41,0,1,2
"34419","ed9819cf746b73864731225300aacbae",45,40,40,7.875,30,15,2,1
"34420","ed9a7d09c240d991dbfd3a978c513fa2",22,22,0,22,22,0,1,2
"34421","eda0688eb4a93f0c697eab64694c1804",20,19,58,2.41379310344828,20,0,2,1
"34422","eda2e68513267604f195144817b1b19e",54,48,16,23.625,27,27,1,1
"34423","eda3571c9e426e1ab2e476986418f934",73,50,64,7.984375,73,0,2,3
"34424","eda494e67df06c830f1a660d181bc68f",43,43,0,43,43,0,1,2
"34425","eda65598e0e49e6070d68716046cee8b",38,34,41,6.48780487804878,38,0,2,1
"34426","eda804a90048797d06ff4fae8cbef87a",43,43,0,43,43,0,1,2
"34427","edaa7b506cf2ffbc704c2ac252edc07f",29,29,0,29,29,0,1,2
"34428","edab29028f33b857277eb1974de131d6",21,21,0,21,21,0,1,2
"34429","edb3d75c57f08ede4b7718f9362eb4bf",201,86,74,19.0135135135135,201,0,3,3
"34430","edb75ca08f72a03be0f57948bef6716e",9,9,0,9,9,0,1,2
"34431","edb7ba1396ba8ff53c1b87d67cac6aa7",37,37,0,37,37,0,1,2
"34432","edb91477ce3f719aaf7ae075f3c0d459",13,10,30,3.03333333333333,13,0,2,1
"34433","edbe14417daee468090817a965ba6d97",176,104,58,21.2413793103448,176,0,3,3
"34434","edbf759493d0196a1bd188d27960670a",14,14,0,14,14,0,1,2
"34435","edc1056e72abf984d91d0a4b05a7f0f8",64,27,83,5.39759036144578,64,0,2,1
"34436","edc13bc93a1ec09288a40b0bebe2a8d6",190,108,68,19.5588235294118,190,0,3,3
"34437","edc2e8c40210d515f526514fab58f7a8",107,76,50,14.98,107,0,3,3
"34438","edc4cf322a2eae16691c2de6e471804d",27,26,6,31.5,27,0,1,2
"34439","edc60fff69cf68edd79b6cd45f0032f6",194,107,69,19.6811594202899,194,0,3,3
"34440","edca8c86d3b6667444633ef7bc3ac88f",35,35,0,35,35,0,1,2
"34441","edcb30b0cf65e2875e0ee2d5159a57f0",42,37,15,19.6,42,0,1,1
"34442","edd5fce66391cc2ff096baf7e25f552a",1,1,0,1,1,0,1,2
"34443","edd62313cb2ac1c43112065905511978",40,38,14,20,40,0,1,1
"34444","edd6df85d7dcc6a64faea7141d754ee0",38,38,0,38,38,0,1,2
"34445","edd94719994a6e34d8c51cc923703f4c",48,33,61,5.50819672131148,48,0,2,1
"34446","eddc0810300b378a0350aedef6537ad4",67,55,48,9.77083333333333,67,0,2,3
"34447","eddc90a9e9c148c5a0689dd91e536c11",59,49,25,16.52,59,0,2,1
"34448","ede3ca671ffeeb414fd9b4508ab3fa73",5,5,0,5,5,0,1,2
"34449","ede50a6de7c2fae0c351b16b6576eca1",48,48,0,48,48,0,1,2
"34450","ede59059b72c6d8020d4a26856b23862",14,14,0,14,14,0,1,2
"34451","ede5d31f91b2d1e6f604a0a3d4947872",143,68,55,18.2,143,0,3,3
"34452","ede63438c16c37cfe0c3082c895fd563",80,54,57,9.82456140350877,80,0,2,3
"34453","ede885203ebc0f27a8cbb6aadc1cf13c",5,5,0,5,5,0,1,2
"34454","ede88bcc042885b73c806dc1be33700f",21,21,0,21,21,0,1,2
"34455","ede9d9a7ae93391a7422d8255939eaa3",21,21,0,21,21,0,1,2
"34456","edea92a5ed6823e7c3eaa2a309a818d6",46,46,0,46,46,0,1,2
"34457","edeaa9a1cb9aa8b7f3849d66b9e5dcc8",34,34,0,34,34,0,1,2
"34458","edeb98740604b1e7f66670e754a08d13",30,30,0,30,30,0,1,2
"34459","edebd0bd2835d31a91653bc1dc918e39",48,32,26,12.9230769230769,27,21,2,1
"34460","eded6fea7d837999f9f1e5691b474355",101,63,63,11.2222222222222,101,0,2,3
"34461","eded91d3423dea44612f54301493fd4e",214,105,79,18.9620253164557,214,0,3,3
"34462","edee9275cc08cacc18b375a63fcb14bf",99,69,61,11.3606557377049,99,0,2,3
"34463","edee9e76139d813800938cea96a6687a",38,38,0,38,38,0,1,2
"34464","edefedd52c4a997a61c364573c1fff7f",44,44,0,44,44,0,1,2
"34465","edf39e9775fe7fdc76c0e5fa94355e61",89,40,57,10.9298245614035,40,49,2,1
"34466","edfc48f9c5f846209bb3f53b36f9944b",70,51,79,6.20253164556962,70,0,2,3
"34467","edff1f758eac2c10f7237f4c0484b4e4",25,25,0,25,25,0,1,2
"34468","ee00025f9f3afc798442d8f8d6d0bdf2",137,89,81,11.8395061728395,137,0,3,3
"34469","ee024ce89344bdb11f98af195d5d1a9b",131,69,66,13.8939393939394,99,32,3,3
"34470","ee0283bc50ca3b4ce98a48781b05e547",163,106,46,24.804347826087,163,0,3,3
"34471","ee038a59a7b5267e8695d009f8bce9f2",23,23,0,23,23,0,1,2
"34472","ee04b9fdc514afe78c15a931034879ed",40,26,64,4.375,27,13,2,1
"34473","ee062b57025efef088b692c528059e2d",101,76,21,33.6666666666667,101,0,3,3
"34474","ee07a96568f3cbc200780e8b3e26d5a0",90,79,36,17.5,90,0,2,3
"34475","ee080a70ae2410cfbe88e4a064941d4a",28,28,0,28,28,0,1,2
"34476","ee08aed5a71a7d6924773762d5763155",74,65,33,15.6969696969697,74,0,2,1
"34477","ee08e8662ddca47aafa20b5d1e8cd05f",32,32,0,32,32,0,1,2
"34478","ee096b3ea9b2aa3d2a5e6642dacb7fcd",105,82,84,8.75,105,0,3,3
"34479","ee098ea8b4e1064c7f12f46612d2eff7",78,62,42,13,78,0,2,3
"34480","ee127419838cf144a0dc181ab7e3e524",97,77,66,10.2878787878788,97,0,3,3
"34481","ee1420b4e90268d2904b9da957ca2c39",43,42,7,43,43,0,1,2
"34482","ee1d6b792fe7edfa110b61cf191a6ca6",27,27,0,27,27,0,1,2
"34483","ee1da1d866702de24a5bb73a44f12579",62,40,69,6.28985507246377,62,0,2,1
"34484","ee231dfacea9384a904f9681d6cc978f",16,16,0,16,16,0,1,2
"34485","ee24503a377b789691e1546e01c62c3d",108,61,56,13.5,108,0,3,3
"34486","ee25a07210da3caf22784b0207180a6f",65,27,85,5.35294117647059,30,35,2,1
"34487","ee282918eba6f79c5cc706e12fda7c88",31,31,0,31,31,0,1,2
"34488","ee2841134e9cd944007b8e37bf975abe",15,15,0,15,15,0,1,2
"34489","ee288cb905af00289b39d976447f0a09",114,76,72,11.0833333333333,114,0,3,3
"34490","ee2caf02518959ad8a6f16998e83ab75",22,22,0,22,22,0,1,2
"34491","ee2dd6c8126d359438cb79ea5fd9d2b0",33,33,0,33,33,0,1,2
"34492","ee2e42a92d7604796fe92cf44ebb7a2d",23,23,0,23,23,0,1,2
"34493","ee2f72a90a3a8551bd4550e8926d15d7",25,25,0,25,25,0,1,2
"34494","ee305849ffc09f4e16968a0563be7f61",14,14,0,14,0,14,1,2
"34495","ee30b46cd7df912fb57d804f49644cd8",19,19,0,19,19,0,1,2
"34496","ee326316df356bac877338c5feff0279",54,39,36,10.5,54,0,2,1
"34497","ee341071becef6e290bb6eeaef2a4a17",94,72,70,9.4,81,13,2,1
"34498","ee34bdc13d328e58fe89e14444d01dea",40,40,0,40,40,0,1,2
"34499","ee370c05c4eed36ff86058a109c6d509",20,20,0,20,0,20,1,2
"34500","ee37b299e08deade42d53856a554d60e",28,28,0,28,28,0,1,2
"34501","ee39ece6f1c5b0fb8d17d0708453385b",33,30,32,7.21875,25,8,2,1
"34502","ee3b0ecd78c394bb70b5b7b5e68936aa",132,100,37,24.972972972973,88,44,3,3
"34503","ee3b86446d9846cceac434c73bd2d978",28,28,0,28,28,0,1,2
"34504","ee3c388efbee8650f4a8aece665e97c3",21,21,0,21,21,0,1,2
"34505","ee3c8ffa33ef8aa92e6a57b2303ba673",31,26,47,4.61702127659574,31,0,2,1
"34506","ee3d5a1037fc27d127b3f5dc54264f53",42,23,38,7.73684210526316,25,17,2,1
"34507","ee3dd279d7493b30f966fffa780c9221",47,45,40,8.225,20,27,2,1
"34508","ee3e5a432423cfe440e7c4b637f4cbc7",19,19,0,19,19,0,1,2
"34509","ee43917eed2aa45d22a859a65222fad4",107,64,51,14.6862745098039,107,0,3,3
"34510","ee442f2773f52682615b8336aa48184c",9,9,0,9,9,0,1,2
"34511","ee45c29ce5e9560920c0f29abdfb3c96",72,36,78,6.46153846153846,72,0,2,1
"34512","ee46399458605a32b9f764fadcac27c2",24,24,0,24,24,0,1,2
"34513","ee47d88450bd96835f4322a6deb329c1",25,25,0,25,0,25,1,2
"34514","ee4884c177a9dcbe291952e49b3e0d60",18,18,0,18,18,0,1,2
"34515","ee4948da2ec66a9fc653d14319f9d9f6",36,36,0,36,36,0,1,2
"34516","ee4a4e585bb531c94101fe0575d5f0d5",10,10,0,10,10,0,1,2
"34517","ee4ab84f37bdf53cb09aa9cac5c8576f",79,40,17,32.5294117647059,79,0,1,2
"34518","ee4da33bd6570da1001613f1536e2f71",10,10,0,10,10,0,1,2
"34519","ee4fcc2ed7edf07d4cb1d59cb47ba320",64,52,70,6.4,64,0,2,3
"34520","ee522769d7586079c1fae62f60192aca",138,57,76,12.7105263157895,97,41,3,3
"34521","ee55fc1cfae7c2aab7b2350fcbc3a4bd",12,12,0,12,12,0,1,2
"34522","ee57691d935c20fb8da7eba8f0f6395f",56,34,64,6.125,42,14,2,1
"34523","ee583404962b00c3d45e8dd44bdc3694",4,4,0,4,4,0,1,2
"34524","ee58f853884f7088cac12002d199f639",85,61,54,11.0185185185185,48,37,2,1
"34525","ee5eddec0c16576c9d3ef900d580f30b",98,83,41,16.7317073170732,98,0,3,3
"34526","ee5fd05ed65cb5270025d91ad9060886",109,67,77,9.90909090909091,87,22,3,1
"34527","ee65136e806cbbba48171e058986b44d",68,59,41,11.609756097561,68,0,2,3
"34528","ee68f4fa8d581b11ba207a9f083fba8e",142,101,77,12.9090909090909,142,0,3,3
"34529","ee6b71a290ba146fdb076e5f1f613838",10,10,0,10,10,0,1,2
"34530","ee6f110582c1ffed83ce9e94aa0a41c8",48,45,48,7,48,0,2,1
"34531","ee6f8c4494467bf47e4e9612332329b6",66,54,56,8.25,66,0,2,1
"34532","ee6f9420a74f16343825245b3c623b8b",70,60,35,14,70,0,2,3
"34533","ee72bddf182ab808ac8dca56f8709d2f",64,55,72,6.22222222222222,45,19,2,1
"34534","ee74a5c6f41214c0e8a4fa0277477255",34,34,36,6.61111111111111,34,0,2,1
"34535","ee7719f77614cb3d1cbd909f1eeafdea",40,33,15,18.6666666666667,40,0,1,1
"34536","ee78c5c26b2b8c4cbe77aac8bfb42dab",60,50,64,6.5625,60,0,2,3
"34537","ee7c7c5f932b33a5b0087ebf0d339faa",197,130,54,25.537037037037,167,30,3,3
"34538","ee7e7a1b7ab9c84639df75914d07d97e",8,8,0,8,0,8,1,2
"34539","ee81fbb527e0cab5f6a21f247d070b5f",93,68,28,23.25,93,0,2,3
"34540","ee84c6c29c15588866630ba409deb89e",38,38,0,38,0,38,1,2
"34541","ee8958a188244836479994328b779596",84,71,34,17.2941176470588,84,0,2,3
"34542","ee8ab87cd896fb8868dde666d0f49759",34,34,0,34,34,0,1,2
"34543","ee8aec55238bc3f7723a90a6f6b8b406",35,35,0,35,35,0,1,2
"34544","ee8d5aeeec4bdaec55ac6c0871f91a55",54,47,20,18.9,54,0,1,1
"34545","ee8e4c8fa4ad341d6fbf55a53dee345f",30,30,0,30,30,0,1,2
"34546","ee8f782958f49dd8d05e52a91b167ce3",24,19,25,6.72,24,0,2,1
"34547","ee90ea2d9f2aad156be05de706e99f7f",3,2,49,0.428571428571429,3,0,2,1
"34548","ee913a598bd7ef3a72f46e9d1d7f15f9",28,28,0,28,28,0,1,2
"34549","ee93010eec801931bd665e18785d1239",21,21,0,21,21,0,1,2
"34550","ee95b5b7c013f981e0c497d791c43406",77,58,48,11.2291666666667,77,0,2,3
"34551","ee966ccdfb6368cc17db18f0a65d2a29",84,68,37,15.8918918918919,41,43,2,1
"34552","ee9699daa31f66a26c3a8c22a61f51b6",19,19,0,19,0,19,1,2
"34553","ee974f938c16468a84cfeadb71261932",81,47,77,7.36363636363636,81,0,2,3
"34554","ee982be1748166d93fcd25185758be03",18,15,54,2.33333333333333,13,5,2,1
"34555","eea16d399b763c50f04823e39e6f36eb",96,44,62,10.8387096774194,96,0,2,3
"34556","eea1aa45d07ebb9de9aad487cf53935e",17,17,0,17,17,0,1,2
"34557","eea29db03e5503d322008c72fafacdf8",30,25,61,3.44262295081967,30,0,2,1
"34558","eea38b47ee41c6d9b16abc175c79a46d",76,50,10,53.2,56,20,1,2
"34559","eea4d9ccaae4c23b4d4e2bc5d6b940a7",30,30,0,30,0,30,1,2
"34560","eea55e8f6e0e8501695176672f32dbe6",17,13,22,5.40909090909091,17,0,1,1
"34561","eea6f892e10a33b74296bcfc43c0ac6c",14,14,0,14,14,0,1,2
"34562","eea869708765f0f4c6d2c14966fb0895",119,50,70,11.9,119,0,3,3
"34563","eea8f82043df12bf57572200ad2caea9",134,96,60,15.6333333333333,134,0,3,3
"34564","eeaa189399d98761c8a1006f616f9da4",72,51,22,22.9090909090909,72,0,2,1
"34565","eeacab5c178d5199cd20b17d5b881b89",26,26,0,26,0,26,1,2
"34566","eeae378fd498b5a03dcd1181bacb54aa",251,96,66,26.6212121212121,207,44,3,3
"34567","eeb28fbe2ad62f3f170f9954226ad420",12,12,0,12,12,0,1,2
"34568","eeb563c1c77c21191dbd3ff6ea57cc1f",115,63,60,13.4166666666667,74,41,3,3
"34569","eeb6e9433ed3973499b1205a08fe5bd8",51,51,0,51,51,0,1,2
"34570","eeb6f9d49218a7fd2122b170d5200d81",27,27,0,27,27,0,1,2
"34571","eeb7427a19dd1c93307842e1d82a0ce2",3,3,0,3,3,0,1,2
"34572","eec1fb834c891404e6a18fcaee3c3fd9",74,42,36,14.3888888888889,74,0,2,3
"34573","eec3246dcd87aad0cb3e481b828fdce1",38,37,0,38,38,0,1,2
"34574","eec3e5366249941573219ff0fa00567e",37,37,0,37,37,0,1,2
"34575","eec5a5580fd89ca3e2972d5146bd1877",47,44,22,14.9545454545455,47,0,2,1
"34576","eec790a9158e738c2199d449d74cc82b",100,67,66,10.6060606060606,100,0,2,3
"34577","eecb7964f2ee0cee158d447c5ec3652d",47,47,0,47,47,0,1,2
"34578","eecba8c5729ed318c226e042f0b174ea",39,39,0,39,39,0,1,2
"34579","eece99b86b5b420cb325d0f3f54d2664",11,11,0,11,0,11,1,2
"34580","eed347939445bc0eb3913dccae339e4e",130,85,41,22.1951219512195,85,45,3,3
"34581","eed3e954d371bd1630805b2b23ccf625",86,61,16,37.625,45,41,1,3
"34582","eed660bd0ce269f5ab5db180a7435bca",55,55,0,55,55,0,1,2
"34583","eed7caefbb2fbf629a905b16ea45ab67",34,30,22,10.8181818181818,27,7,2,1
"34584","eeda40ae2d385b0d3e07aaaffd18e635",20,20,0,20,20,0,1,2
"34585","eedb9c89d909cfac7cb30111eac79322",29,29,0,29,29,0,1,2
"34586","eedcec0ba9cc2a01c3345649ab0e072c",106,41,68,10.9117647058824,81,25,2,1
"34587","eeddbb0a0881ab1206985142aecd07c4",8,8,0,8,8,0,1,2
"34588","eee05f43f1fde97c275f701d7e900bc2",48,42,26,12.9230769230769,48,0,2,1
"34589","eee43a15be08c8242304a665c1d80bac",3,2,3,7,3,0,1,2
"34590","eee4e3020046063136ba725423a8c782",33,33,0,33,33,0,1,2
"34591","eee5a3c96acb3f56ea70bd70869f6be2",38,38,0,38,38,0,1,2
"34592","eee7c7d746795adb188814a6cc4cb52c",36,36,0,36,36,0,1,2
"34593","eee860e01d0a9b5ccc9672f9d9da1f4c",30,27,59,3.5593220338983,1,29,2,1
"34594","eee98b98796fd25a56ec997f95b3f7b7",56,56,0,56,56,0,1,2
"34595","eeeb370e30243df8c42438ecec95877c",186,51,79,16.4810126582278,172,14,3,3
"34596","eeebdfb080d5473c1222c60f44dbbbbb",5,5,0,5,0,5,1,2
"34597","eeebe142804e5c121419c8c4d4d3021a",53,45,86,4.31395348837209,19,34,2,1
"34598","eeedb046f1c284f34148dd1733102b61",22,22,0,22,22,0,1,2
"34599","eeeedb49249f9fc51b4fa8a1c5584326",59,37,58,7.12068965517241,59,0,2,1
"34600","eeef1d66cb98e97b6e8490c3e8e91a12",48,40,20,16.8,48,0,1,1
"34601","eeef71d39242def45f1282db2338c2ae",78,67,64,8.53125,78,0,2,3
"34602","eef0e687f6c986c7eed30573348e8df1",32,32,0,32,32,0,1,2
"34603","eef36ff41c040d688441d88bb6f2b564",151,83,51,20.7254901960784,151,0,3,3
"34604","eef4d6f800f46efdfa4b20a298310eb6",65,45,46,9.89130434782609,49,16,2,1
"34605","eef821ceda07490297bb71355936cd5c",115,71,77,10.4545454545455,75,40,3,3
"34606","eefbb9b293bc9a9f2f5c5e1a97507142",14,14,0,14,14,0,1,2
"34607","eefcade7be390c0a2ce23c6a9b767b38",7,7,0,7,7,0,1,2
"34608","eefe1f9563b64b09121c9225c2f98525",46,46,0,46,46,0,1,2
"34609","eeff21d549f49fc1b439ed2a63c0e180",33,18,48,4.8125,33,0,2,1
"34610","ef01f0b629bea26ae372e9e53faaa64e",102,69,42,17,102,0,3,3
"34611","ef04552b46902b69ac3193a7383cf2c7",14,14,0,14,14,0,1,2
"34612","ef0483ecaaa04992c623d3f77b049857",6,6,0,6,0,6,1,2
"34613","ef04c255a0456f1a3ffd4d572d3d8cb6",15,15,0,15,0,15,1,2
"34614","ef04dd79782bfb95fdf0802543c576ec",27,27,0,27,27,0,1,2
"34615","ef0d753c0f918f247787fe9efa49f0ac",76,41,64,8.3125,48,28,2,1
"34616","ef0e7fb4f01d02a9428f53954847c20a",4,4,14,2,4,0,1,1
"34617","ef1c9dc08b04bb3223a5f63195a9149b",41,41,0,41,41,0,1,2
"34618","ef1ca937fcc378e47b1dd2eb22565366",87,70,57,10.6842105263158,87,0,2,3
"34619","ef1e173f236f01a462641ac6e110ae77",130,97,56,16.25,130,0,3,3
"34620","ef201c1b987a331189d8a56c503a2353",26,26,0,26,26,0,1,2
"34621","ef211b4081676fa87e4039aa9b1b9c53",109,63,37,20.6216216216216,109,0,3,3
"34622","ef21386cedcd27170dd9215fdd9964f4",22,22,0,22,22,0,1,2
"34623","ef215df15bdeeddebd7dfebb02146f30",85,53,84,7.08333333333333,85,0,2,3
"34624","ef216b4d40325da9762edcda5d84fcc4",2,2,0,2,2,0,1,2
"34625","ef22ca142651d071134d2d50cfe11bcf",74,26,61,8.49180327868853,74,0,2,3
"34626","ef23cb77c518c3fcbef0106f47c7535a",25,22,72,2.43055555555556,25,0,2,1
"34627","ef24ecf130194c4fcae13100d387e978",2,2,0,2,2,0,1,2
"34628","ef258f582e3459130d9b167e86bf6ac6",117,88,66,12.4090909090909,79,38,3,3
"34629","ef25f4677ce655bf127362249a01b6c3",40,40,0,40,40,0,1,2
"34630","ef2655b09132bf2720e5f9f40d805301",7,7,0,7,7,0,1,2
"34631","ef272a4388f38f93fc7c4373ceaaadb1",97,75,72,9.43055555555556,97,0,3,3
"34632","ef28de99016976881e0d72a44c03e896",125,87,39,22.4358974358974,125,0,3,3
"34633","ef2a19bd40acca6db6e34c3f6d60aa7c",4,4,0,4,4,0,1,2
"34634","ef2aa31459bf1f718828a641ca9a0e24",31,31,0,31,31,0,1,2
"34635","ef33a8d03c559fe1dc405bb76aaa8dc7",19,19,0,19,19,0,1,2
"34636","ef33bfe23c3595357e25b6162414dc17",7,7,0,7,7,0,1,2
"34637","ef37af3f638e5062147d0ee0b4598441",69,54,82,5.89024390243902,36,33,2,1
"34638","ef3a314f6c2a1890ddc30a76b10ab800",23,17,38,4.23684210526316,23,0,2,1
"34639","ef3c7754fa5685b036edcde98532dea7",110,97,78,9.87179487179487,110,0,3,3
"34640","ef3eb6b05b7f50bf13d5dfbca3e35e06",208,100,60,24.2666666666667,208,0,3,3
"34641","ef4426df1724c0f0acbebc3040a62bb9",53,53,0,53,53,0,1,2
"34642","ef45abf2e6333f21631d5d74a50c0fa4",31,31,0,31,31,0,1,2
"34643","ef4a370d88463e78483489330c9676d9",40,40,0,40,40,0,1,2
"34644","ef4ad7578eb600641263fdccfa6eebfc",44,34,60,5.13333333333333,44,0,2,1
"34645","ef4c097ca19e1abc4954e996fbeaad0c",83,69,79,7.35443037974683,83,0,2,3
"34646","ef4c883d8749df46f83d5e687a0850b2",1,1,0,1,1,0,1,2
"34647","ef4f19fbd605ac40415585ff86cdd271",40,40,0,40,40,0,1,2
"34648","ef50170d04de2189d9289cb1a4b0ecc4",171,67,83,14.421686746988,171,0,3,3
"34649","ef506e001daa0328426bb958eea6a2a0",13,13,0,13,13,0,1,2
"34650","ef522ec602644588dc072759a8829296",7,7,0,7,7,0,1,2
"34651","ef54f292c90eb304a975f8f9043db851",39,36,20,13.65,39,0,1,1
"34652","ef582baab90e77e27bb07a1ec2ff4bdc",14,10,50,1.96,14,0,2,1
"34653","ef58d4e70b8698038c161afca831197e",14,14,0,14,0,14,1,2
"34654","ef58e85545b60f53899852edead5056a",123,89,62,13.8870967741935,123,0,3,3
"34655","ef593035f1c1a85699551b2308b06dd9",12,11,31,2.70967741935484,12,0,2,1
"34656","ef5b25ceb19bcbe40cca99e822e7625b",2,1,17,0.823529411764706,2,0,1,1
"34657","ef5c32ea8b32cab9f9e8f155718a34c7",160,57,82,13.6585365853659,126,34,3,3
"34658","ef5d9aa94a4f814008357b09065a437f",49,40,37,9.27027027027027,49,0,2,1
"34659","ef5d9c72100cdefeac956fedfffd83f2",49,23,44,7.79545454545455,49,0,2,1
"34660","ef5df3e18db479fe79d23ee4d805d399",95,73,38,17.5,95,0,2,3
"34661","ef60730a89d83ddef4f006de0ef627c9",29,29,0,29,29,0,1,2
"34662","ef61309bd52e631acb6376282ba8eb0f",145,101,63,16.1111111111111,104,41,3,3
"34663","ef63f29fc5fe9eb36ace0734f6b75af1",22,22,0,22,22,0,1,2
"34664","ef6427b4ddbdbe0e567b5b36cfb13e2d",178,128,51,24.4313725490196,178,0,3,3
"34665","ef69739be002624eab227ae7a76a2bb0",54,44,54,7,54,0,2,1
"34666","ef6b838c1098b2febd37252430bc0044",128,62,73,12.2739726027397,90,38,3,3
"34667","ef6b96cf3acf3fd5db5ac313585e91e8",50,45,31,11.2903225806452,26,24,2,1
"34668","ef6ddfe0289d2fdd18f60835748cbbf7",153,100,72,14.875,153,0,3,3
"34669","ef71b2859513d6023e6549b0a268259b",14,14,0,14,14,0,1,2
"34670","ef72071d07f35943001dba85e68ec073",16,15,68,1.64705882352941,16,0,2,1
"34671","ef757cc22464d58976f866af2caad396",34,34,0,34,34,0,1,2
"34672","ef7bb4013a1d5d06cc03688585441243",87,78,69,8.82608695652174,87,0,2,3
"34673","ef7ec7fc9ce15b304114a95626e3e567",48,46,18,18.6666666666667,48,0,1,1
"34674","ef81270e42e1fdd3b4708210ae9aa664",72,50,70,7.2,66,6,2,1
"34675","ef81e81c2188175fef50d5e1d23111d2",91,68,45,14.1555555555556,91,0,2,3
"34676","ef83a870665ed145e36ab204b1a43d57",33,33,0,33,33,0,1,2
"34677","ef8814a99e4ba701e47f1ad376fa15c5",25,25,0,25,25,0,1,2
"34678","ef8c8f7281ac9be453b3f8e2f0bb80f4",10,10,0,10,10,0,1,2
"34679","ef8ea05f713625b28eec411951744554",54,18,83,4.55421686746988,54,0,2,1
"34680","ef8fb45cc644b8edd23f598095f189c6",76,43,45,11.8222222222222,76,0,2,3
"34681","ef9129a4f55c2979ff96148adc3f9a50",13,13,0,13,0,13,1,2
"34682","ef92eb00c4c0e81ea77d52dadd690f01",84,60,51,11.5294117647059,58,26,2,1
"34683","ef9a2295e03d82ecacef93c100294ab0",94,53,38,17.3157894736842,64,30,2,1
"34684","ef9d90d415f6991c49b24aedee24d217",45,45,0,45,45,0,1,2
"34685","ef9e4af5c65d2d1f040035a8a2f6df1d",233,32,72,22.6527777777778,213,20,3,3
"34686","efa41348f8b4264d4ac0ad090ee97222",100,78,22,31.8181818181818,64,36,3,3
"34687","efa593bca43c4c298cf614f5d06a2f11",30,30,0,30,30,0,1,2
"34688","efa5d86711b0dafee88b110f4fd2cc31",158,91,63,17.5555555555556,158,0,3,3
"34689","efa99eaf57c18c7dfd3171f99e12595b",22,22,0,22,22,0,1,2
"34690","efa9b237f65ec79dc077260d0bebdf90",22,22,0,22,22,0,1,2
"34691","efad7f75e008161ed8cc3ee3b7ae0215",39,39,0,39,0,39,1,2
"34692","efafae9a22d197a8cbd6e8fdfda2badd",51,49,18,19.8333333333333,51,0,1,1
"34693","efb1f923036aed22a1a80cff78c4e674",38,38,0,38,38,0,1,2
"34694","efb52c509b6bfa9456630f0ee13e4587",51,37,51,7,19,32,2,1
"34695","efb791fa5792827c1260848423663fe8",29,29,0,29,0,29,1,2
"34696","efb93d8de63be4c09791dbe4d363cfa1",99,83,83,8.34939759036144,99,0,3,3
"34697","efba25e7c63df984e12f9f927c8d0e38",33,25,54,4.27777777777778,33,0,2,1
"34698","efbab26516cb23efc7b4303b45b80394",55,45,30,12.8333333333333,55,0,2,1
"34699","efbd75062d92ec90c2fede95c7a861a2",5,5,0,5,5,0,1,2
"34700","efbec21ace0e40adf7726ea276eb36c4",19,19,0,19,19,0,1,2
"34701","efbf7ba2dea7f1640454eba734f9e954",20,20,0,20,0,20,1,2
"34702","efc1954e1bb149852faf55035f8e2823",11,11,0,11,11,0,1,2
"34703","efc4938f24ed6ec94fd08191dbb455b2",89,41,40,15.575,45,44,2,1
"34704","efc4d87426ef6bc88a85f60d6263711b",106,74,61,12.1639344262295,106,0,3,3
"34705","efc656e76b0986f72a7a0210870d8adf",52,32,64,5.6875,52,0,2,1
"34706","efc7a17e77aa88c63069675f5b6bb054",62,45,45,9.64444444444444,62,0,2,1
"34707","efc8bfd7a62fb70f75df60e86274b436",16,15,38,2.94736842105263,16,0,2,1
"34708","efc9b3bc76e5e77204513ba5890414b8",84,57,68,8.64705882352941,84,0,2,3
"34709","efce1e118bd33dd8ea98513e92e9ac5f",36,36,0,36,36,0,1,2
"34710","efce697654733a702b678687360ae590",148,97,62,16.7096774193548,148,0,3,3
"34711","efcf1fddbbd3f9307eb2abebb59852ce",36,36,0,36,0,36,1,2
"34712","efd01846eae545c633e4bed7d4ab680c",16,9,49,2.28571428571429,16,0,2,1
"34713","efd103563a866e3a28ce57e84858f817",121,78,59,14.3559322033898,121,0,3,3
"34714","efd24e8522134978df1d767d42bbf23a",110,40,84,9.16666666666667,77,33,2,1
"34715","efd3d476d39d36fd623c4f6f055e89c5",30,30,0,30,30,0,1,2
"34716","efdb94189957303dcf11696400f8f387",211,130,70,21.1,183,28,3,3
"34717","efdc7392c3733852b234227a528492ae",86,63,34,17.7058823529412,86,0,2,3
"34718","efdcd3b9982d115879283995d947324a",238,121,71,23.4647887323944,211,27,3,3
"34719","efdd93d73ba0f5793fc3cf747db01214",169,77,84,14.0833333333333,169,0,3,3
"34720","efdf1f0aa1b3e4d8332ec9b4dfbad5b1",38,38,0,38,38,0,1,2
"34721","efdf27974eee121aacc26cec8c0b1f4d",80,52,79,7.08860759493671,80,0,2,3
"34722","efe06b96eb66c668fcec960772509aac",136,91,68,14,136,0,3,3
"34723","efe15f2534caf36818801ca3525ea723",86,68,25,24.08,41,45,2,3
"34724","efe1ff0c58400482e39363e750442ac1",35,31,44,5.56818181818182,35,0,2,1
"34725","efe60011b7ec9b2003692374a5fae34b",7,4,53,0.924528301886792,7,0,2,1
"34726","efe9ae3fc9ee1879f0186a1198f1094a",34,34,0,34,34,0,1,2
"34727","efed59c7c882e1b841f29b98094a540a",31,26,31,7,31,0,2,1
"34728","efef810b7ff01c79b1137b378e0421b9",33,30,21,11,33,0,1,1
"34729","eff0bfeca5ab43d32e8355af162bddd1",19,19,0,19,19,0,1,2
"34730","eff0ec69e7e213e18b216c55badec5cd",14,14,0,14,14,0,1,2
"34731","eff3032391b03aed68904dcf4d3dbf9d",50,50,0,50,50,0,1,2
"34732","eff6e0c63999eedf84a693ec21696027",29,29,0,29,29,0,1,2
"34733","eff9b414d1274beac5b61c9ec8295381",10,10,0,10,10,0,1,2
"34734","f000cd344aef9b6d68dc351b6d4cabb8",35,30,43,5.69767441860465,20,15,2,1
"34735","f00286f940c62c91e880dc1920ec33f9",99,62,62,11.1774193548387,99,0,2,3
"34736","f004a0a6670cbc361bfe7b860301c6b8",54,54,0,54,54,0,1,2
"34737","f0065d19f12ab47e5a09aa9870f87431",133,102,41,22.7073170731707,133,0,3,3
"34738","f008a7db55d9ca75f768ad2d363ed31f",68,53,10,47.6,68,0,1,2
"34739","f008bbe426c6a4055a1f7e2b3617aaf4",35,35,0,35,0,35,1,2
"34740","f0093a81edc3391a82784218c6108356",22,19,70,2.2,22,0,2,1
"34741","f00ad08346f3b903316025b5198c0e71",59,49,9,45.8888888888889,59,0,1,2
"34742","f00c2eeb69b7e45312f6f301596aa947",115,79,35,23,67,48,3,3
"34743","f00d888049c677214f0aa1742caaee41",72,62,37,13.6216216216216,32,40,2,1
"34744","f010e363fd4a2e4b1ebdb82b0d1deffa",152,96,82,12.9756097560976,152,0,3,3
"34745","f011f8483cd3056d498e39252304ef5e",163,85,65,17.5538461538462,136,27,3,3
"34746","f013b63324b1efad1c7bde8988ec7ef4",123,70,41,21,74,49,3,3
"34747","f013d1c7ffad5bc9381fcc1d765a62c7",26,26,0,26,26,0,1,2
"34748","f014dc6e2afc1a593088e8fa0d3dd766",62,49,24,18.0833333333333,62,0,2,1
"34749","f014ea67ec1b475e6694dd2af0a5f817",38,29,52,5.11538461538461,38,0,2,1
"34750","f0159c4519f7e8e641c432ffc53fcd7f",45,44,12,26.25,45,0,1,1
"34751","f015df950ac0638fbce89f31d0beaa48",49,49,0,49,49,0,1,2
"34752","f0179bee18d8f5fc0839393cee6772d2",19,19,0,19,19,0,1,2
"34753","f019b5764234020c0cb6da1415cb3d3a",143,93,63,15.8888888888889,143,0,3,3
"34754","f01d699a0133ea918b7646c51f447741",11,11,0,11,11,0,1,2
"34755","f01d9e211e387efd5ec52186ffc76c95",9,9,0,9,9,0,1,2
"34756","f01ede1a734ddb6f551c7d3d29099401",55,28,64,6.015625,55,0,2,1
"34757","f0213eb3a9f70a0f67fdf6e1c24a5091",153,52,68,15.75,123,30,3,3
"34758","f02305ede6ab7844f59b51227a04bfcf",36,36,0,36,36,0,1,2
"34759","f02501c1d2d78851c8b07c064fdce110",11,9,0,11,11,0,1,2
"34760","f02658f13f60c5ac78e6bdb126d8bea8",106,79,57,13.0175438596491,106,0,3,3
"34761","f029a601254301e74692d27e21292960",21,21,0,21,21,0,1,2
"34762","f029cf3002da75b9880b56b58b79ca36",43,36,40,7.525,25,18,2,1
"34763","f02a00bd245792311b8700423ceeb9c7",201,102,75,18.76,164,37,3,3
"34764","f02c1ee13723b0855e3500c1b5aa4767",56,44,8,49,56,0,1,2
"34765","f02eb3a26f9630115e5698611160ebe8",64,54,30,14.9333333333333,64,0,2,1
"34766","f030a6110e690bf41aa49942a4e4a44a",106,81,27,27.4814814814815,106,0,3,3
"34767","f033ead63f8a623efa6ec26f0aa93308",35,35,0,35,0,35,1,2
"34768","f035ed22961ef335a0061aad431f7d87",181,84,82,15.4512195121951,181,0,3,3
"34769","f03805ea9bc4dd4a975852d7912b25ba",39,36,42,6.5,39,0,2,1
"34770","f0397e6b61bb77dd26702bd8ad0e9e1e",80,60,42,13.3333333333333,80,0,2,3
"34771","f03a1fe54153c3e62778bc86e6b6f944",44,30,18,17.1111111111111,44,0,1,1
"34772","f03c212c90cc119294ea7e31a85b6193",18,18,0,18,18,0,1,2
"34773","f03da5a0fa20632289287955a1f2debe",1,1,0,1,1,0,1,2
"34774","f03ec17f19f1494eb27ed40355284da0",62,47,15,28.9333333333333,23,39,1,1
"34775","f03fd4f4a231e5bed9300389263b790e",29,29,0,29,0,29,1,2
"34776","f043788df0d63bfb7a17ac46ce1b1427",222,110,85,18.2823529411765,170,52,3,3
"34777","f043972a05f65f08dcc7c7c7b2a6fe41",36,36,0,36,36,0,1,2
"34778","f0459cbdfb8bd50d758d2701508fd818",30,30,0,30,30,0,1,2
"34779","f048f9f98e462c8dc4308d06dadd90de",124,65,77,11.2727272727273,124,0,3,3
"34780","f04a716983a5bb86abb05db60c62f69b",123,95,58,14.8448275862069,123,0,3,3
"34781","f04aaa261b1786e7234054a49774ce56",117,65,73,11.2191780821918,70,47,3,3
"34782","f04be1c4331239b9c55082a7b99772d6",17,17,0,17,17,0,1,2
"34783","f04d7a8d71b6d731b022fa2822a514bb",154,103,86,12.5348837209302,125,29,3,3
"34784","f04e5bea16af41043e3b980b1d50b2d3",82,56,19,30.2105263157895,82,0,1,2
"34785","f04e9691bce70d091f58da919af85ee5",51,51,0,51,51,0,1,2
"34786","f04fe74ca2cd80d99244cc8ff3e03277",21,10,77,1.90909090909091,21,0,2,1
"34787","f05104aba98871a98bc88c1ea98b2af3",17,17,0,17,0,17,1,2
"34788","f051db6d36f3de853b37d96375c911f2",10,8,37,1.89189189189189,7,3,2,1
"34789","f051dd2c172be2390504393b92ad010d",21,20,33,4.45454545454545,21,0,2,1
"34790","f0537f873b83680bf355f70930ff6e0e",30,30,0,30,30,0,1,2
"34791","f054948962fd50952930fe020ee0639a",22,22,0,22,22,0,1,2
"34792","f0566d3f38a6e4e35949d383c15a131c",105,89,14,52.5,105,0,3,2
"34793","f0581b046d46da22bd1d889ae83869ea",117,88,60,13.65,117,0,3,3
"34794","f05884c49adc657eb3c17275aac85979",10,10,0,10,10,0,1,2
"34795","f059b6b21b14f71a9b3bdb3a18d78fba",26,26,0,26,26,0,1,2
"34796","f05c425e8f876c0f7b814022da648ace",22,20,22,7,22,0,2,1
"34797","f05e76ef6789c3ce377e5696fd7f1cb0",73,47,63,8.11111111111111,59,14,2,1
"34798","f06382e33a3ac7555c7cef7d9d15ca8c",31,31,0,31,31,0,1,2
"34799","f0665e14f41b2579510ade889abca6fb",104,67,61,11.9344262295082,104,0,3,3
"34800","f0686dcf8ed05cef8b9bcf03c7e0f6b4",9,7,33,1.90909090909091,6,3,2,1
"34801","f06a8126832853ee2747b712ce71e2fd",71,50,21,23.6666666666667,71,0,1,1
"34802","f06b822495981dcaf10293a24029cfe8",17,17,0,17,17,0,1,2
"34803","f06c0ceb1a6e47ec5895dedf6dbca322",19,19,0,19,19,0,1,2
"34804","f06c4f01807381de0f16aee3ce6aa404",21,21,0,21,21,0,1,2
"34805","f0769205c5220ad4b383dbd4e8cc198a",89,75,52,11.9807692307692,89,0,2,3
"34806","f07759df217448160c2e63b8c787ce52",137,75,66,14.530303030303,137,0,3,3
"34807","f078dbbde9a7e8669ebeb28585c5f217",4,4,0,4,4,0,1,2
"34808","f07c32dedf9d31344aa3c9065248ebcd",97,54,69,9.84057971014493,97,0,2,3
"34809","f07d146e97e9330e0b1dd9eff492c203",84,62,77,7.63636363636364,40,44,2,3
"34810","f07e0bce3ae54803c9722668ecd8a481",198,133,54,25.6666666666667,198,0,3,3
"34811","f0833bf46eb61a1af21b5da63bffc020",51,51,0,51,0,51,1,2
"34812","f083bc6fb77a587f84afee1d3d026663",23,23,0,23,23,0,1,2
"34813","f08436bafad5cd6daa74122f19815c33",38,34,14,19,0,38,1,1
"34814","f084404d4c5b441575bf4253955d5c32",148,76,72,14.3888888888889,119,29,3,3
"34815","f08470d735e88b623c37f952f30a9ceb",23,23,0,23,23,0,1,2
"34816","f0861b2026bc3b2e0e27974bd115ee69",26,26,0,26,26,0,1,2
"34817","f086d7f062c53fbe9b4365961f022dc5",26,26,0,26,26,0,1,2
"34818","f087598c8e08a00b30b5cce0c66ea485",60,50,25,16.8,60,0,2,1
"34819","f08808c2cf55e8d73076ce4278c9a423",88,71,35,17.6,88,0,2,3
"34820","f08c0951e5cf45ed85cfd4516f34c31e",75,62,44,11.9318181818182,75,0,2,3
"34821","f08c7d212cc21335f8bde970c4db79c4",31,31,0,31,31,0,1,2
"34822","f08e8e70f4f6ed12a7e3b6b01c63e20d",56,46,38,10.3157894736842,56,0,2,1
"34823","f08f3fb9c3b0faae45cb60ef03e4a527",123,59,85,10.1294117647059,101,22,3,1
"34824","f09348dd040ece7b4a950b00e4aa4545",82,52,83,6.91566265060241,82,0,2,3
"34825","f09426c4ed5e2bf2a2139d40b428b286",133,113,51,18.2549019607843,133,0,3,3
"34826","f0949c52ecde99179ba778c33f4ebe94",218,118,61,25.016393442623,218,0,3,3
"34827","f094baa4f2f2418d6a1b0a3ab620d6c2",88,70,20,30.8,88,0,1,3
"34828","f09552347b76c90bbd1c022321db621e",44,44,0,44,44,0,1,2
"34829","f097a90fd1a15167aa58c791bdf510ae",32,32,0,32,32,0,1,2
"34830","f09b1374c732e2cdf1a285261b405ff1",163,72,70,16.3,163,0,3,3
"34831","f09cef2e8a466f1db4de2e4d87ced105",46,46,0,46,46,0,1,2
"34832","f0a68275b85d55ab74370b7df4fc1731",91,48,71,8.97183098591549,91,0,2,3
"34833","f0a837765d6208ecfe3339d7f4ba6bf4",216,104,75,20.16,216,0,3,3
"34834","f0a995e0dcd47605fa4bf574ab488fda",39,39,0,39,39,0,1,2
"34835","f0a9c212ee1377621a66850ebb160303",75,61,71,7.3943661971831,30,45,2,1
"34836","f0aea554b791b56d49c5b7b4c0b7851e",23,23,0,23,23,0,1,2
"34837","f0af6f742310653d0e0681a9a7a44416",20,20,0,20,20,0,1,2
"34838","f0b009be165eb723ee17d68df6fa6e3b",25,25,0,25,25,0,1,2
"34839","f0b461c470a7f16a5972cd59f55ae54b",10,10,0,10,10,0,1,2
"34840","f0b622d29e7a100c9ff7bb2e25cc329a",15,14,3,35,15,0,1,2
"34841","f0b6887feb89df8ee86a857c41914ce7",64,46,72,6.22222222222222,49,15,2,1
"34842","f0b714ec637c3a73b933a20f87a03b77",52,45,39,9.33333333333333,15,37,2,1
"34843","f0b9c87020117572409ca111c51954d0",48,48,0,48,48,0,1,2
"34844","f0c032911a0c62ab54a0ec637bdd065c",31,31,0,31,31,0,1,2
"34845","f0c4aafcac3eae64ad86fe6a056379d9",10,10,0,10,10,0,1,2
"34846","f0ca22119a241ca74d9989ae6702bfdf",31,31,0,31,0,31,1,2
"34847","f0cbcacb75c710b10771d13fe2fed9a9",145,103,78,13.0128205128205,145,0,3,3
"34848","f0cbd16298c6028a88098c659b9c01c6",30,11,45,4.66666666666667,30,0,2,1
"34849","f0cd7d2d4a24cfa551c9548baecdb6dc",13,13,0,13,13,0,1,2
"34850","f0cee991ba0fcac95c4411c00df3cc94",170,115,45,26.4444444444444,124,46,3,3
"34851","f0d08281b44df460ca8bb6ce0a46f5c3",172,58,73,16.4931506849315,172,0,3,3
"34852","f0d55614976c20f8e48f2e6a67a35eb0",17,17,0,17,17,0,1,2
"34853","f0d5dbcf4951b2b3d09952fe35c26f0f",38,35,14,19,38,0,1,1
"34854","f0d6005eccd9def427424d8b20a73119",44,44,0,44,44,0,1,2
"34855","f0d88b1d5da6b830136c2c982566558f",9,9,0,9,9,0,1,2
"34856","f0da772719b0e3866054b8670e610b81",42,42,0,42,42,0,1,2
"34857","f0de6bd22cc0b16dc2fde74c88bd2c90",12,12,0,12,12,0,1,2
"34858","f0e05eda1aecd9a80c5ad8f12404f953",4,4,0,4,4,0,1,2
"34859","f0e0ac89241628215cab7626d314ae52",75,55,46,11.4130434782609,75,0,2,3
"34860","f0e0e2593265f1dd5a4b626305d0ecd3",19,19,0,19,19,0,1,2
"34861","f0e6d70ee06800ec42c2eb0d71891a98",25,25,0,25,25,0,1,2
"34862","f0e75ec262e60615c95a096d4057fe3d",27,27,0,27,27,0,1,2
"34863","f0e901afbf5ea61f57994926b6e4a7e3",105,61,75,9.8,105,0,2,3
"34864","f0e935bf2cd548ef1bd09a6b27b1d362",34,34,0,34,34,0,1,2
"34865","f0e9e5da9a3697d736cb7b9cb70421c2",36,36,0,36,36,0,1,2
"34866","f0eb4a3dc85cd1cb0fe0a4a7e762c657",172,86,64,18.8125,172,0,3,3
"34867","f0ecdf3cd778afb22ca3b1e259e9eef6",63,48,21,21,63,0,1,1
"34868","f0ed336aeea4dc011dc30c6502733ba3",101,70,88,8.03409090909091,101,0,3,3
"34869","f0ee01eecd3ba7bcd03f7b55cc6cb408",24,24,0,24,24,0,1,2
"34870","f0ef273755c995696045c3a66c14413b",47,47,0,47,0,47,1,2
"34871","f0efb472d22f1023acb7f5ebce11b41b",87,46,71,8.57746478873239,73,14,2,1
"34872","f0f2f2d024ef88983f49da0dd1cfb8e6",39,39,0,39,39,0,1,2
"34873","f0f5709e16def26899c972dfa55fdcaa",64,55,28,16,45,19,2,1
"34874","f0f8db7a0526feffb8df734a160be668",213,96,66,22.5909090909091,213,0,3,3
"34875","f0fa2ef9c6bed3a8dc79a138fdcc6316",27,27,0,27,0,27,1,2
"34876","f0ff52d076cafce16879a545fdaf4202",14,14,0,14,14,0,1,2
"34877","f102c7003451081d9339b6b9d80675ff",45,45,0,45,45,0,1,2
"34878","f104fa7fbae44126e55365291a181a1c",29,28,34,5.97058823529412,29,0,2,1
"34879","f10647e0ccff24f83f181a65925d464b",108,89,55,13.7454545454545,108,0,3,3
"34880","f10663c6b1987695a2c2d932cc88b0ff",27,27,0,27,27,0,1,2
"34881","f106ae4df57a8a5c1c977fc284169f2a",175,87,27,45.3703703703704,175,0,3,3
"34882","f107e8782a552f76d1e073819c151a01",158,100,70,15.8,158,0,3,3
"34883","f108ceeabf2718ae56b9b71e36c8f060",38,33,18,14.7777777777778,38,0,1,1
"34884","f1099125bc7f7877e05f5148fd429af1",79,66,18,30.7222222222222,79,0,1,2
"34885","f10a05f767b0893420c8158da80327f2",21,21,0,21,21,0,1,2
"34886","f10b83b47b491b0059f7d2036bf3ce21",67,46,65,7.21538461538461,53,14,2,1
"34887","f10cc0f97648cd74b45a958207ac3a19",167,110,53,22.0566037735849,167,0,3,3
"34888","f10ddef134600f44f96ca339cad00c0b",7,5,41,1.19512195121951,7,0,2,1
"34889","f10e40dd535cebc05547c1795163b18c",39,30,35,7.8,39,0,2,1
"34890","f111b8d74971f22b134965bcadcac055",36,33,53,4.75471698113208,36,0,2,1
"34891","f1128dc5e9844dd4cd4b2c55c1b718a3",49,47,63,5.44444444444444,49,0,2,1
"34892","f1129b4007ccdf863c3c3c176ee4cb96",14,14,0,14,0,14,1,2
"34893","f11816a210fc0b8d7455da12ca68df6e",60,54,13,32.3076923076923,60,0,1,2
"34894","f1184e46207a4c75b362f5df9830eafb",28,28,0,28,28,0,1,2
"34895","f118764ca00fd906d73dbd4d3f63ea14",62,51,62,7,62,0,2,3
"34896","f119460b5d7e4771769f390e3802bd7b",30,27,12,17.5,17,13,1,1
"34897","f11ca6d2ffc78989a81faf2d7ddc7a9d",125,92,72,12.1527777777778,74,51,3,3
"34898","f11cb5466f241bc649adf649e9238b77",129,89,38,23.7631578947368,129,0,3,3
"34899","f11dbe3b9dd739bb510e1d7c2a2ff9dd",23,23,0,23,23,0,1,2
"34900","f11ea08d2f84cc55d24e46bdd6691736",18,18,0,18,18,0,1,2
"34901","f11ef76fef75b157230e9ae53c726d69",29,29,0,29,0,29,1,2
"34902","f120839770ee6b4ac4bd141d58fe78f1",73,61,42,12.1666666666667,73,0,2,3
"34903","f120b392b3a6db7e150cbcd128f3b20e",45,45,0,45,45,0,1,2
"34904","f123450a9421c041d5ae97bd3942521e",69,59,82,5.89024390243902,69,0,2,3
"34905","f1258bd96bcad7387fcc25707cb639b6",105,89,75,9.8,105,0,3,3
"34906","f125c11be8f2fea39cbd37aa9528f88f",19,19,0,19,19,0,1,2
"34907","f129e10e1ec6d03a6eb4405e82cdc982",52,52,0,52,52,0,1,2
"34908","f12d07aa0c5c69f6a93a58291171ccde",90,71,85,7.41176470588235,90,0,2,3
"34909","f12e6963525d5587e2fd5e77bb990ede",87,46,62,9.82258064516129,87,0,2,3
"34910","f130198d4cfa702e7087e1df09f0e35e",2,2,0,2,2,0,1,2
"34911","f13800a24c25092caea4b31372b5531a",39,39,0,39,39,0,1,2
"34912","f139d9aea0dae45b8498201a735cc48c",76,61,25,21.28,76,0,2,1
"34913","f13b1dcc0a1ed8d851454cd24c0424fc",12,11,27,3.11111111111111,8,4,2,1
"34914","f13b9e0b5d1a03e287412003f0136211",8,8,0,8,8,0,1,2
"34915","f13cfc80f4c1976893f327655d3778f8",8,6,65,0.861538461538461,8,0,2,1
"34916","f13db1f07eff7b7dcac1dd0c7a67b6ea",73,53,77,6.63636363636364,61,12,2,1
"34917","f13e9798f512df7eec6772ba45ef96dc",107,79,56,13.375,107,0,3,3
"34918","f141e32c227b52df65692c171fdbe49d",51,46,12,29.75,51,0,1,1
"34919","f1425702213a653e183a7da2f8e03895",120,76,72,11.6666666666667,102,18,3,1
"34920","f14309a5a486d1fb7daad91489fc9dfe",45,42,7,45,45,0,1,2
"34921","f147f8f6c5fbf92289ae605b90bd69db",38,27,75,3.54666666666667,38,0,2,1
"34922","f148ee88590b1ba844c0b97420a800c0",49,49,0,49,0,49,1,2
"34923","f14b647804eb06a56b9c7451072c4b1f",49,38,38,9.02631578947368,49,0,2,1
"34924","f14bcf7fed5f9de1ade236329bedc0df",26,26,0,26,26,0,1,2
"34925","f14c7d792a4dfb6662bc0b8ffe113124",28,28,0,28,28,0,1,2
"34926","f14df82292e91fb0dd9cdbc08b209f39",15,15,0,15,0,15,1,2
"34927","f15018651cc978d3a9a4c966bf2337ca",207,85,76,19.0657894736842,207,0,3,3
"34928","f152a80e0202048dcd6a2f7ab070d666",46,46,0,46,46,0,1,2
"34929","f157794576002953f199a78445fbc0bd",22,22,0,22,22,0,1,2
"34930","f15b6c97999e13c82db659bce671c993",159,97,77,14.4545454545455,133,26,3,3
"34931","f15d103dc6d8d604285a032c1a2dfab3",26,26,0,26,26,0,1,2
"34932","f15dbde58df0fa01be058dadcb53b719",21,21,0,21,21,0,1,2
"34933","f15e6ff08d2ee4b33b0a876f6adc69a9",37,37,0,37,37,0,1,2
"34934","f1606bf23193a849b9cc9b2325b0cdbb",5,5,0,5,0,5,1,2
"34935","f1622af4b6235c0ecb217878f0143677",29,29,0,29,29,0,1,2
"34936","f162d868b966a5e92a51fcb1c4c06fb4",28,24,37,5.2972972972973,10,18,2,1
"34937","f164aafeaee75b3a0c2a4fd0fc1d9857",32,32,0,32,32,0,1,2
"34938","f1669e24fe4c7504889b14bbe72f5df3",35,31,42,5.83333333333333,35,0,2,1
"34939","f167b51d75c8a8540f8015262179d897",57,42,30,13.3,57,0,2,1
"34940","f16c4a6298cc0d7ed1867fcaff40cfc2",67,56,48,9.77083333333333,67,0,2,3
"34941","f16c989e613f8a95bccf4a8432602e99",16,14,26,4.30769230769231,16,0,2,1
"34942","f16d1d91bfc3c2a6a852f17ee9299663",7,4,43,1.13953488372093,7,0,2,1
"34943","f16e12466de9feed371bf42913cea454",37,37,0,37,37,0,1,2
"34944","f16e45b1e012e39fb1cd19c0224c2d39",29,29,0,29,29,0,1,2
"34945","f16fa80eb288631bec667435c5031efe",96,77,28,24,96,0,3,3
"34946","f173533f7365c40789e74295cbee9b78",117,63,81,10.1111111111111,117,0,3,3
"34947","f17567b02d4322457416255a868e8f98",94,19,84,7.83333333333333,94,0,2,1
"34948","f1766f101e5b0f23c7c34938efae6842",28,26,35,5.6,28,0,2,1
"34949","f1767ac07e8c611b7922bd0210609a53",18,18,0,18,18,0,1,2
"34950","f17aad79fbbdc0a7a7718a3762882e6b",43,36,53,5.67924528301887,43,0,2,1
"34951","f17bc44f4afab88e48e768fd10544480",76,59,47,11.3191489361702,59,17,2,1
"34952","f17e47a47fd3385706e28011a7dc49ce",53,47,27,13.7407407407407,53,0,2,1
"34953","f181019b3560c13ab35c0f7a2a75dfa3",102,81,51,14,55,47,3,3
"34954","f1872f8ff9776575d48f1fe4ea9f5ca9",114,76,52,15.3461538461538,114,0,3,3
"34955","f187a055bec3ca98110a349ca1f54256",104,81,51,14.2745098039216,104,0,3,3
"34956","f18b2585de262b8599e0aa147db61c89",100,69,34,20.5882352941176,100,0,3,3
"34957","f18bf7cd28b762c5ecd40958af31d9e4",121,77,79,10.7215189873418,103,18,3,1
"34958","f18c5b0ad7eb9c45aaa39f9a8aaa0b07",26,26,0,26,26,0,1,2
"34959","f18d286f03442a15cf2e789b877bfd9d",51,36,30,11.9,24,27,2,1
"34960","f18db164e529ecab2b5b7b34cef4fef1",193,105,66,20.469696969697,193,0,3,3
"34961","f18e46da4b8b03a3785aef90824ce10a",34,34,0,34,0,34,1,2
"34962","f18e670f2ca637467e86c5b0273e73f8",29,29,0,29,29,0,1,2
"34963","f18f4c4dbf9af133d16276eff20e3936",107,77,50,14.98,107,0,3,3
"34964","f1907637e149e2e1b92df4d42d6c27a5",18,18,0,18,18,0,1,2
"34965","f19152629bd81dc9ac84594d02fbe967",63,54,27,16.3333333333333,63,0,2,1
"34966","f19259ab11bf04e0eaeba98655cd2ef2",36,35,5,50.4,36,0,1,2
"34967","f194edd82ce95f92a208a01c2e4739b5",34,34,0,34,34,0,1,2
"34968","f19622143ed2d4a45c6b3908e6d9bdef",24,24,0,24,24,0,1,2
"34969","f1983be2244e2601ab7139e8db59530d",24,17,57,2.94736842105263,24,0,2,1
"34970","f19877838e1f302e6a711d704ef2e5e6",65,50,54,8.42592592592593,38,27,2,1
"34971","f19879c886a3faf78c012b5032750fd2",61,48,61,7,61,0,2,3
"34972","f19b522e74c16b979dc9c7ce3040ea98",38,38,0,38,38,0,1,2
"34973","f19bc8c83a313f34ca2d1b57fe8f0588",97,69,58,11.7068965517241,97,0,2,3
"34974","f19c3bbdc1869ade50fc611b73b9ab68",39,39,0,39,39,0,1,2
"34975","f1a08dc4af91de617c1df1bb0da939b7",90,68,76,8.28947368421053,90,0,2,3
"34976","f1a25f1c7a5706249e24e7b8194d19dd",132,93,58,15.9310344827586,132,0,3,3
"34977","f1a2dd44f987b84ec91cace94a5a8ee4",41,37,13,22.0769230769231,41,0,1,1
"34978","f1a72dfd1e6a0a134d1b9975f31652d0",27,27,0,27,0,27,1,2
"34979","f1a95d43ed3d03abba95382607bd1d23",1,1,0,1,1,0,1,2
"34980","f1ab0c42bb79b4811b2db06856516ade",20,20,0,20,20,0,1,2
"34981","f1ac9a37ccdded5225d269b4c953e828",31,31,0,31,0,31,1,2
"34982","f1ae1cdcf48271e49d1b15270b827de2",59,42,71,5.8169014084507,59,0,2,1
"34983","f1afc5de11a0776eb41b77ce1203365b",10,10,0,10,10,0,1,2
"34984","f1b0497fd8cc7d645e7b35d6b7051f02",113,77,48,16.4791666666667,113,0,3,3
"34985","f1b219035d9903b22a33fd511705943e",50,50,0,50,0,50,1,2
"34986","f1b316cb1fa8cee015c250694ba09305",48,48,12,28,24,24,1,2
"34987","f1b3ee40067708cde8a4043bee20b4be",5,5,0,5,5,0,1,2
"34988","f1b6570bddf318af97be24e8baceacd7",19,19,0,19,19,0,1,2
"34989","f1b67e801d68f6ef53a02e293d647545",16,16,0,16,16,0,1,2
"34990","f1b90ffd0f2301b883c6a57ec6177e73",25,25,0,25,25,0,1,2
"34991","f1b9a14ddf8d7d6381130983443d6b97",4,4,0,4,4,0,1,2
"34992","f1bbc24addd06a53236452cb9f4b249b",33,33,0,33,33,0,1,2
"34993","f1be6e539e69f3385116becd7f9aa0f0",80,58,36,15.5555555555556,80,0,2,1
"34994","f1c18ee044ee2375c2ec4232e76adeb1",75,68,47,11.1702127659574,32,43,2,1
"34995","f1c3445960a161c7a97990649e8423e9",42,30,33,8.90909090909091,42,0,2,1
"34996","f1c53343368a59c83c1bcba70b170fbd",33,33,0,33,33,0,1,2
"34997","f1c5efcafed131d79adf6808e33824f0",153,90,62,17.2741935483871,153,0,3,3
"34998","f1ccdf2d90a3aa86a1349a3c67d8837f",112,77,59,13.2881355932203,112,0,3,3
"34999","f1cf6d0bc57590f9901c3ac41cd8245f",102,78,53,13.4716981132075,102,0,3,3
"35000","f1cffd5f5da9089cc92a6c650830ca3a",93,69,79,8.24050632911392,52,41,2,3
"35001","f1d0eba93cca5d1e4cdf375ebd34bd6a",159,85,61,18.2459016393443,159,0,3,3
"35002","f1d2bc3f28a4cb73fa92bb68f3e96134",19,19,0,19,19,0,1,2
"35003","f1d3df5b88b6d626dd0dbee714d1d539",49,41,32,10.71875,49,0,2,1
"35004","f1d423c88575edf503e2a6da90c1744f",63,51,35,12.6,63,0,2,1
"35005","f1d576db9527857010e8d7b7ea238346",39,39,0,39,39,0,1,2
"35006","f1d654e84a8a1f31d76adeb14997d590",38,38,0,38,38,0,1,2
"35007","f1d97eceb05c7b9a7390122525171f92",21,21,0,21,21,0,1,2
"35008","f1dcdd2c97d010a56a83c283c1b7d830",166,85,77,15.0909090909091,166,0,3,3
"35009","f1ddc175e7dfe21bfd479d4ecb1ea309",59,49,56,7.375,24,35,2,1
"35010","f1dee78ce23a6666523b497450a09419",44,44,0,44,44,0,1,2
"35011","f1dfbcb06fed9de28b0d2adadd9e7245",17,17,0,17,17,0,1,2
"35012","f1e54f4c96a5f4f863c23df587a75673",24,24,0,24,24,0,1,2
"35013","f1e595e58416fd045fe97558a88fff2b",46,46,0,46,46,0,1,2
"35014","f1e6484228259cdd59aeaacf70c46d4b",39,29,41,6.65853658536585,39,0,2,1
"35015","f1e6b7ecbe183e25506937064c1fea90",111,54,17,45.7058823529412,111,0,1,2
"35016","f1e853364c711d962d91f8ec7116abfd",143,84,78,12.8333333333333,143,0,3,3
"35017","f1eb8c36eb1de18eb91eb5506700cf54",20,20,0,20,20,0,1,2
"35018","f1ecda83f45f50f1951b320429e84d88",20,20,0,20,20,0,1,2
"35019","f1ee02228aef05db62d1473032f76909",49,33,31,11.0645161290323,49,0,2,1
"35020","f1ee6f7991dca2770f0b273aaafba215",25,25,23,7.60869565217391,13,12,2,1
"35021","f1ee7fb43b16714b1e6443ecf28a4c2f",44,44,0,44,44,0,1,2
"35022","f1f11bca7c9b4bb89f752596f6428831",41,41,0,41,41,0,1,2
"35023","f1f15e65e7b0ec225fb095324262d915",118,85,42,19.6666666666667,118,0,3,3
"35024","f1f1dcfeefb64a849b31c7674cb0ef82",49,40,40,8.575,49,0,2,1
"35025","f1f5515054559b3dd811d4d8d8382841",99,63,53,13.0754716981132,99,0,2,3
"35026","f1f64d3cbc703f74c497a7318f8c8c5a",69,53,42,11.5,69,0,2,3
"35027","f1f8e2c8596c6c2a22feb95bacf644da",136,70,73,13.041095890411,108,28,3,3
"35028","f1f9fb0590d083057f0456e33bc34a8e",36,35,57,4.42105263157895,36,0,2,1
"35029","f1fa70e407ec7987cdc6bb1f3682d832",18,9,43,2.93023255813953,18,0,2,1
"35030","f1faa3bb8e901053c769130cee3b63b4",10,10,0,10,10,0,1,2
"35031","f1fb2d76b2416dbf463a1f60b51c0113",38,37,75,3.54666666666667,22,16,2,1
"35032","f1fce403d3909b92c7b5d5478b020c7c",143,77,68,14.7205882352941,143,0,3,3
"35033","f1fef463679008090dca94c61895272b",82,56,68,8.44117647058824,82,0,2,3
"35034","f2002a2c645a0c2f3da9ddbef809326f",23,23,0,23,23,0,1,2
"35035","f2007f3cfdabba24be4ae2c6da76f6ec",63,45,68,6.48529411764706,63,0,2,1
"35036","f2038b676b408a9a1d3d93df9fd0bc62",41,41,0,41,41,0,1,2
"35037","f2072c0363de8b58fa3889905bcc307f",76,70,33,16.1212121212121,58,18,2,1
"35038","f20a559be18ef348dd8e9e676bf198c6",15,15,0,15,15,0,1,2
"35039","f20b4b1c4bb068a3929f35fd56eea49a",49,42,34,10.0882352941176,49,0,2,1
"35040","f20ca257cf18b5f550c3fa46e7211787",54,48,47,8.04255319148936,54,0,2,1
"35041","f20d5b9f69451d222c87e9eb68a44027",39,39,0,39,39,0,1,2
"35042","f20e00e117bf55da41e5fb195a307072",27,27,0,27,27,0,1,2
"35043","f20e0c971dcaf0072b3e3f989c1eb15a",31,31,0,31,0,31,1,2
"35044","f20e5b0abff51a282ab77005733931f5",24,24,0,24,24,0,1,2
"35045","f20f40b3b277a48954baee958a293a0f",57,40,76,5.25,47,10,2,1
"35046","f20fe28118045de25ca95a0e1e8e1503",184,108,86,14.9767441860465,184,0,3,3
"35047","f210150fbd7b100fcd2c278e32f4ba9e",142,76,83,11.9759036144578,142,0,3,3
"35048","f2114ff738a9d9bc12ab48b9bb3bd09d",24,24,0,24,24,0,1,2
"35049","f2134a95821549f66949dd7f4faa04ff",48,48,0,48,0,48,1,2
"35050","f2140589cd030b65f7a8b17ee826cbf4",103,90,68,10.6029411764706,103,0,3,3
"35051","f21790d98130566ae528c74d3ce19739",89,65,72,8.65277777777778,73,16,2,1
"35052","f218d845e6e434a656bfcd6af6ef9736",92,61,52,12.3846153846154,92,0,2,3
"35053","f2196bad32863dc680914db3c578151d",100,61,66,10.6060606060606,100,0,2,3
"35054","f21b4192cfa50045ff1880f2dcb18362",4,4,0,4,0,4,1,2
"35055","f21c722b3dc3e34d2b8bb9fc165bbe7c",30,30,0,30,30,0,1,2
"35056","f21d1da9f967567b2b796e4abb2f5882",114,69,84,9.5,114,0,3,3
"35057","f21d82b95772b579abe2f262f99780cb",32,28,15,14.9333333333333,32,0,1,1
"35058","f21dbf13f1e0a9fcedb53d9e9ead532d",1,1,0,1,1,0,1,2
"35059","f21dd7638954f44baf0825085be05c97",53,42,30,12.3666666666667,53,0,2,1
"35060","f21e8f59a7e2f2dd688eaa441785943e",86,76,14,43,86,0,1,2
"35061","f220e9e0b2e44ad14feac80f58ee2828",201,94,70,20.1,201,0,3,3
"35062","f221590dd72658ff1eeefca53c53e979",76,59,30,17.7333333333333,41,35,2,1
"35063","f222b84174019c95a8ae9fd136b5dc49",1,1,0,1,1,0,1,2
"35064","f2238b4d75d61787a3169f24518b33ba",162,81,70,16.2,162,0,3,3
"35065","f225746215378b65129c48d2380ff576",47,47,0,47,47,0,1,2
"35066","f2280d083a2f4e6244fef6c508d51def",28,28,0,28,28,0,1,2
"35067","f22a4baf2718ec64a65a299d4a092f3f",79,64,40,13.825,41,38,2,1
"35068","f22c1cb791ad6938659a295a2083ad88",33,33,0,33,33,0,1,2
"35069","f22e96ba8a0f31300af96599fe624304",9,9,0,9,9,0,1,2
"35070","f235fa757d6254b4cc0df0eaed7ebac5",81,76,26,21.8076923076923,47,34,2,3
"35071","f238aeb4266ea19409c115287d4c4622",78,54,40,13.65,36,42,2,1
"35072","f23b2ab44bec29f462dca45be76befbc",208,80,73,19.9452054794521,208,0,3,3
"35073","f23b465cf4c9f10bc0e19f09ea011082",13,13,2,45.5,13,0,1,2
"35074","f23c97606b7f5e87086e877baf56073d",33,33,0,33,33,0,1,2
"35075","f2401a082788097f2f55b255665a7aef",3,3,0,3,3,0,1,2
"35076","f241d67433f81d967d55d96c946336c9",16,14,40,2.8,16,0,2,1
"35077","f2421b15cdfa8a4002b75517fc615dd2",27,27,0,27,27,0,1,2
"35078","f2428f0f21375cf6e474f240169e9b72",23,23,0,23,23,0,1,2
"35079","f246110494b96585cb5bd3d31de71424",91,68,62,10.2741935483871,91,0,2,3
"35080","f24872bc4e1e71c1a5bce40a676d57fa",4,4,0,4,4,0,1,2
"35081","f24c53c95e39015de1a12c0349971bef",34,29,84,2.83333333333333,34,0,2,1
"35082","f250e71c44cbcc2b298b7c8bafcfd1ea",73,59,31,16.4838709677419,73,0,2,1
"35083","f25351013dd0575dade446f36447e1cc",17,17,0,17,0,17,1,2
"35084","f253cf2032a3b7139c6ce3c0397882e8",10,10,0,10,0,10,1,2
"35085","f2543c3fa75506baf68b8f835e0407d2",31,31,0,31,31,0,1,2
"35086","f254dfc49bccb2f444da0d3597d958dd",46,35,54,5.96296296296296,46,0,2,1
"35087","f25558dadda09029e0aa2401fb91bb1d",18,18,0,18,0,18,1,2
"35088","f257bdffe7f667593e9dbd3c3ff02205",54,27,8,47.25,54,0,1,2
"35089","f25b08859c404e20c010eea67397dcb5",34,23,81,2.93827160493827,31,3,2,1
"35090","f25ccf4820a09c4ad63cd29d7a44bc99",21,21,0,21,21,0,1,2
"35091","f2603ec6df697ef2d6cc78a4c9a003c2",24,24,0,24,24,0,1,2
"35092","f26144dddfe4fdc6fb3b6e2e613981de",49,40,19,18.0526315789474,49,0,1,1
"35093","f26303b2d022a09447adafa71b428b01",85,65,26,22.8846153846154,85,0,2,3
"35094","f2684577601ec5c2498eee4527b208d5",38,23,77,3.45454545454545,38,0,2,1
"35095","f2684a6855e1df6ee861dd6f20f75be3",54,54,0,54,54,0,1,2
"35096","f26a928ae368e668e029ffc920db28b5",145,77,56,18.125,145,0,3,3
"35097","f26ee8237ac35f44768dbf391711c6a0",6,6,0,6,6,0,1,2
"35098","f271c220c99902510e7470676c201db7",26,26,0,26,26,0,1,2
"35099","f27280b2e98d971b84cb3d80de1c5abb",81,62,73,7.76712328767123,60,21,2,1
"35100","f27589f6c4ddd6dfcf73d0fe35e2ec13",44,30,63,4.88888888888889,44,0,2,1
"35101","f278b9a566ee8c141763d5488b6fdf5c",23,23,0,23,23,0,1,2
"35102","f27ad0b84bb3aec68f83b1470e3169c4",28,28,0,28,28,0,1,2
"35103","f27b11c9d83a2b20bebe819dea0f3261",220,87,77,20,186,34,3,3
"35104","f27bb619e289b6c337e58720e187c782",3,3,0,3,3,0,1,2
"35105","f27c506b5b51ff528a2c1e4198249a10",29,29,0,29,29,0,1,2
"35106","f27d60ad877e73adf780fc26761e9008",49,49,0,49,49,0,1,2
"35107","f27d67c44faa39236dc25db7f7f38d7b",98,67,58,11.8275862068965,69,29,2,1
"35108","f27e0573c9dda01c4ff7d590084c3948",39,26,31,8.80645161290323,18,21,2,1
"35109","f27eafa6d166a1461f1467e066ea15aa",26,26,0,26,0,26,1,2
"35110","f2821b621bffcd08125bc637c7f10206",88,64,29,21.2413793103448,57,31,2,3
"35111","f282c509718e08632247e3364e0a06ae",37,37,0,37,37,0,1,2
"35112","f28348332cf98c42108984642966e72f",72,57,76,6.63157894736842,36,36,2,1
"35113","f284ebf92bf71a2f9960238ee6815e55",76,57,13,40.9230769230769,76,0,1,2
"35114","f2857a28a12a24f7977b0fdfc37abda7",83,61,50,11.62,83,0,2,3
"35115","f2860a149b6991231156d6877778db80",46,46,0,46,46,0,1,2
"35116","f28bdb6134eaa5110661a291535dc2b8",56,49,31,12.6451612903226,56,0,2,1
"35117","f28d2a6bacda929559ba02e3d2c0f5a6",129,96,62,14.5645161290323,129,0,3,3
"35118","f28dcc0f4fb4404c7fa0fd39cf6d6cfb",78,54,62,8.80645161290323,78,0,2,3
"35119","f296e4a1e4dd8da6f8fd9d5509b49250",106,50,60,12.3666666666667,106,0,2,3
"35120","f29c1ffa88c5e81e4d6623aca33dbf75",88,61,65,9.47692307692308,88,0,2,3
"35121","f29c5d9c62efdfc1a94c5e9401c7723f",36,30,77,3.27272727272727,36,0,2,1
"35122","f29cd2fad74690c3c1eb4fbb74fd6916",160,79,67,16.7164179104478,141,19,3,3
"35123","f29d14b0ebfa7d5bb719379f8c987eb0",17,17,0,17,17,0,1,2
"35124","f2a153c9d7143b7188d334135b39511e",53,33,24,15.4583333333333,53,0,2,1
"35125","f2a2167b693bc39d147a9ee3a64da42c",23,23,0,23,0,23,1,2
"35126","f2a25e9638e979bc167c3d157d651ab8",13,13,0,13,13,0,1,2
"35127","f2a5410a952e789b54aa309660ce61be",24,21,50,3.36,24,0,2,1
"35128","f2a54e892fa79784b78e8f434600a86b",103,55,64,11.265625,103,0,2,3
"35129","f2a7826fa515c27ddc7a6bf3553ffa8d",34,34,0,34,34,0,1,2
"35130","f2a7c99e2cd09a6db35af2174caa9315",159,91,34,32.7352941176471,126,33,3,3
"35131","f2a8f73eb170d544c21d450857af4f03",125,88,70,12.5,84,41,3,3
"35132","f2a9a2046cc7b2ab21e46b499cd66ad7",14,14,0,14,0,14,1,2
"35133","f2abf3109fc7af79670599fafe4b3a8e",31,31,0,31,31,0,1,2
"35134","f2ae5c3a98fd92d624f01476b3b6a29b",117,81,61,13.4262295081967,117,0,3,3
"35135","f2b6a973ac1b3bcee888303bc9670ab1",24,24,0,24,24,0,1,2
"35136","f2b9ab86a8956117ed7754c465f61ccc",77,59,25,21.56,77,0,2,1
"35137","f2b9c3b2248712d2a6eb06889f545ddb",33,33,0,33,33,0,1,2
"35138","f2bb25cae63388873d0dc6ad782ac769",92,63,54,11.9259259259259,92,0,2,3
"35139","f2bca69de2d74de5a3a0b01b3a2a87c0",25,22,53,3.30188679245283,25,0,2,1
"35140","f2be52eec2aa3270ff558c4accb236c0",77,60,37,14.5675675675676,77,0,2,1
"35141","f2becb9f929ca51e98638a565059f373",28,28,0,28,28,0,1,2
"35142","f2c10dd6e5ddb6402e881bff42eec0ae",15,15,0,15,15,0,1,2
"35143","f2c49e10d603201262c4091ba815e0bc",38,31,10,26.6,38,0,1,2
"35144","f2ca546ad6a1364869882571d63dc92c",111,98,32,24.28125,77,34,3,3
"35145","f2caa653722978a5b9fe4f3c9bd8e42b",13,13,0,13,13,0,1,2
"35146","f2cd8ee69e705b4e72dbeb46a5a1b1c0",35,35,0,35,35,0,1,2
"35147","f2cf1ad3d1ceb70da9165ebf91ded8a9",94,72,77,8.54545454545454,94,0,2,3
"35148","f2d00f9ddfcb9b38964d06dcf3ed8355",68,54,44,10.8181818181818,68,0,2,3
"35149","f2d29ef23175ff9183ba6c3ebcff83e2",11,11,0,11,11,0,1,2
"35150","f2d36c2e3143eb418d53973b6c2068d3",97,82,79,8.59493670886076,97,0,3,3
"35151","f2d384c4b5a42dcb6be0a27a8f0902af",21,17,52,2.82692307692308,11,10,2,1
"35152","f2d8ef0e18d2285434a7b82797cfcf29",151,110,61,17.327868852459,111,40,3,3
"35153","f2d9521f7ac5f1213aaab5cb7d97afa0",26,26,0,26,26,0,1,2
"35154","f2dcb98e740b79a9d4b0a0b91a291a9a",25,25,0,25,0,25,1,2
"35155","f2dd37768b27046b949d293df030e23d",26,25,72,2.52777777777778,5,21,2,1
"35156","f2ddabcb84e07520f7d11bb5ae987c0e",80,49,54,10.3703703703704,66,14,2,1
"35157","f2ddee4a10cce2fc421583363a705a93",158,104,78,14.1794871794872,126,32,3,3
"35158","f2deaae09413d4da77e2da1b16e4f572",3,3,0,3,0,3,1,2
"35159","f2e0653cb207baff53406a5063b4058d",35,35,0,35,35,0,1,2
"35160","f2e1341bef5184c7351b9e66c13a91f1",44,44,0,44,44,0,1,2
"35161","f2e44c366624f131d0116e6467be30a6",178,47,63,19.7777777777778,178,0,3,3
"35162","f2e49a85ba463632686e5638f53dae6e",17,17,0,17,17,0,1,2
"35163","f2e59a2acaf690dce780a3bb3646e21c",165,72,43,26.8604651162791,165,0,3,3
"35164","f2e59e361a31539fc01ced0d00d3205a",48,48,0,48,48,0,1,2
"35165","f2e5aa9e370dbbe8e0f80b7add8a4449",6,6,0,6,6,0,1,2
"35166","f2e61c4a35c528c7c97c985f826970d3",64,58,21,21.3333333333333,64,0,2,1
"35167","f2e62d57b8a78ac56e7a65a5bee095c0",24,24,0,24,24,0,1,2
"35168","f2e79cfde841571e27d43dfb5197c7f8",13,13,0,13,13,0,1,2
"35169","f2e94d412cd0cc1ac83ecf893ef67a9c",122,80,69,12.3768115942029,122,0,3,3
"35170","f2ea27220eac78f717e0ef42042a8f0f",163,91,85,13.4235294117647,113,50,3,3
"35171","f2eacefceaac588678c7e8a294cf700e",33,33,0,33,33,0,1,2
"35172","f2ed515e603feed12fecb7ee9ecc5a8b",18,18,0,18,18,0,1,2
"35173","f2edc1703c9f36791dc08f86de64c6c1",13,13,0,13,13,0,1,2
"35174","f2f29ee1fd26ee3d5a89d82000b6c55e",145,70,67,15.1492537313433,145,0,3,3
"35175","f2f3c45da8f215677364ed0530017bff",38,38,0,38,38,0,1,2
"35176","f2fa3ffea5598ccfc3b153d4b8b8aa8a",186,117,64,20.34375,140,46,3,3
"35177","f2fb94c6ba64ca1f3054ff0eb9aef025",140,103,75,13.0666666666667,113,27,3,3
"35178","f2fce67fed6f5c924c7fa36ec5cf75bc",62,40,61,7.11475409836066,48,14,2,1
"35179","f2ff4f3fc046d34114e65786f84c119b",52,45,56,6.5,52,0,2,1
"35180","f300f05555dbc2e7d8a050629d5b0535",21,18,39,3.76923076923077,21,0,2,1
"35181","f30185047ea9f4b9edd79f6531488698",8,8,0,8,8,0,1,2
"35182","f301fe2e4f01594a0e5285584dcf3814",1,1,0,1,1,0,1,2
"35183","f30229ea31226bc56270248c4b5631d7",9,9,0,9,9,0,1,2
"35184","f30357d602f63e57d287336425494ab2",15,15,0,15,15,0,1,2
"35185","f30414b22057627f035b3f41cbe94c0b",118,89,50,16.52,118,0,3,3
"35186","f3043966e47bd932e34de11bd030f542",18,17,27,4.66666666666667,18,0,2,1
"35187","f307eb2f29df922a40773e05230f25c9",47,47,0,47,0,47,1,2
"35188","f30808ce6806c7dc367376ebe55674fb",53,52,33,11.2424242424242,53,0,2,1
"35189","f3081952c9694f4f445a0a1a0c4e9af1",205,87,69,20.7971014492754,205,0,3,3
"35190","f30a08319b2fb7169f6ba338c5853ff5",140,89,62,15.8064516129032,140,0,3,3
"35191","f30cd55340f45cca5e0662dfa5d99921",44,32,54,5.7037037037037,44,0,2,1
"35192","f30d00fe14247cf342c96cebc8527742",24,24,0,24,24,0,1,2
"35193","f3106b51e0df995e664b4e394f1707b4",92,76,36,17.8888888888889,59,33,2,3
"35194","f311a872b8ec90a9b2f23a4ffe55f5fe",24,24,0,24,24,0,1,2
"35195","f311de031081147684165928caeaaa93",46,46,0,46,0,46,1,2
"35196","f31381e51d63eeed566a0390ccb64f6d",191,81,67,19.955223880597,191,0,3,3
"35197","f3165c99023f7ff495d3b54350fb37ff",32,32,0,32,32,0,1,2
"35198","f3175972956e9c5ffa85ca76a26cf94c",18,18,0,18,18,0,1,2
"35199","f3179caf28ba5a555ba0da3f1cb1ba1b",4,4,0,4,4,0,1,2
"35200","f317eab542a18d73a27408403faf9087",13,13,0,13,13,0,1,2
"35201","f318007586ca32aa66538b3f7f909ddf",9,7,39,1.61538461538462,9,0,2,1
"35202","f31d5312f229af6f573109e7d52beb6b",24,24,0,24,24,0,1,2
"35203","f31db5762692d287ba8747b8f5df7e06",104,58,65,11.2,68,36,2,1
"35204","f32129e6412c645b268313a5c6a278a0",114,68,67,11.910447761194,114,0,3,3
"35205","f323022957e4bd6fdcad81efb0e49a5a",31,31,0,31,0,31,1,2
"35206","f32b0ee1291317186a3c9686103ade34",67,44,14,33.5,25,42,1,1
"35207","f32b9c03eef7f8a976eb4ad9c7bd3f5c",3,3,0,3,3,0,1,2
"35208","f32c7b8f5cd9bc01670f07ed6ee90926",19,12,57,2.33333333333333,19,0,2,1
"35209","f32dbd83d813c158f6d5703adb088620",22,22,0,22,0,22,1,2
"35210","f32f9313fbb315583f74c17ccd8a8db7",16,16,0,16,16,0,1,2
"35211","f33688396833236bbd31c65657c7b2b9",86,54,27,22.2962962962963,86,0,2,3
"35212","f337af93c1b2872087cf490f008a7775",75,62,18,29.1666666666667,75,0,1,2
"35213","f33923e179138a880b6ae8d352a8be14",25,25,0,25,25,0,1,2
"35214","f33f024b4e1c4872f82bc971cf8122e3",61,43,57,7.49122807017544,61,0,2,1
"35215","f340d953181f0de7526f3ae04e8cc399",96,59,60,11.2,96,0,2,3
"35216","f3450dbdf1f1acaa5380a673fdc3d21d",12,11,26,3.23076923076923,9,3,2,1
"35217","f345106047a44cf5295d14a624885867",47,47,0,47,47,0,1,2
"35218","f345e5a9ae4cccef224aeeba9fcc1818",76,65,70,7.6,76,0,2,3
"35219","f345f460ce1c9bf3efebb6cab2223d05",75,70,60,8.75,49,26,2,1
"35220","f345f501a938c5c735c64e9281601cbe",21,21,0,21,21,0,1,2
"35221","f346d1e811827f704b4b5e3448fca68e",137,56,66,14.530303030303,85,52,3,3
"35222","f348f5f0dc2ef0b8cc0a2cc2e6f27981",127,63,36,24.6944444444444,88,39,3,3
"35223","f34bec389b1938647be3ee19c12d8cd1",40,40,0,40,40,0,1,2
"35224","f350b919a1367fb7e2785102e98b70da",12,12,0,12,12,0,1,2
"35225","f3510b6b5aee8a8ce684d9af0c586b93",55,44,49,7.85714285714286,55,0,2,1
"35226","f351a96213def530858577e7a0b3ac8b",81,49,58,9.77586206896552,27,54,2,1
"35227","f35256f29c242f8ff6a73368b0e72549",43,40,22,13.6818181818182,43,0,2,1
"35228","f353e2ba57f73a83d29b562864522ca9",20,20,0,20,20,0,1,2
"35229","f3572f198cecdf330ac1775dfca7cd2c",100,62,41,17.0731707317073,100,0,2,3
"35230","f35a80d6b31d69d7ab9624e5f4935a65",27,27,0,27,27,0,1,2
"35231","f35d82f2bdff068e79c011970f3e8eeb",63,47,35,12.6,63,0,2,1
"35232","f35ec27198227009c52a78bb92ed56f5",105,85,58,12.6724137931034,105,0,3,3
"35233","f35f2e4fb50575d35cb73e73d7534c23",18,18,33,3.81818181818182,18,0,2,1
"35234","f360050f3742af3b72ccaa511bad3438",40,40,0,40,40,0,1,2
"35235","f36155b32b94bc0cfdec201c9f64cf67",39,29,28,9.75,39,0,2,1
"35236","f362f34b08bd5e4648d7abef13950cc3",27,27,0,27,27,0,1,2
"35237","f364cf077d277f5cec818f06b4a4fab7",70,59,35,14,70,0,2,3
"35238","f36646a5a93badd65f5af87e98bc0f9f",94,62,30,21.9333333333333,94,0,2,3
"35239","f366968385d485d5c26845b9de6b8e86",254,141,80,22.225,205,49,3,3
"35240","f3681ed8649da18707604c3a47ccd37a",143,62,81,12.358024691358,143,0,3,3
"35241","f36974df6366c3d699f15ddd06867b21",15,15,0,15,15,0,1,2
"35242","f369c3086969e51d79d71aa6450fbf4e",20,20,0,20,20,0,1,2
"35243","f36ab3c756ba007e7a88d3ed00b37887",68,56,71,6.70422535211268,68,0,2,3
"35244","f36af6861aaa75b89b1903ecf78e2cb6",44,44,0,44,44,0,1,2
"35245","f36c97bccfc1ed7392c1d8cd28f44c66",23,23,0,23,23,0,1,2
"35246","f36cfe76342d95239a2de1e5cde1df50",140,86,37,26.4864864864865,140,0,3,3
"35247","f3726aeca21ca63bb69d36a8fc4b2101",58,42,39,10.4102564102564,30,28,2,1
"35248","f37cef9cdf963b394aeedab892fbbb8b",38,30,54,4.92592592592593,38,0,2,1
"35249","f37d67bf9a47c0f96816d456599115bd",123,71,63,13.6666666666667,123,0,3,3
"35250","f37f0043b2d14bd7de878200f4850397",117,76,58,14.1206896551724,117,0,3,3
"35251","f3810f65292321c7e4f1be3e94c0ea1c",89,60,55,11.3272727272727,59,30,2,1
"35252","f3826ca60bf88eba6546dc26c5cc692a",8,8,0,8,8,0,1,2
"35253","f3895ab5c6a2ea8eb4d2a3871c34f2ee",89,77,68,9.16176470588235,56,33,2,3
"35254","f3898e2ea53fb0b4336aae4a1ead50d9",209,120,84,17.4166666666667,209,0,3,3
"35255","f38a89c2306e93e3e80db91bb99c3cab",48,48,0,48,48,0,1,2
"35256","f38b1fe0b0a6798882ac4ecae07d3571",113,81,21,37.6666666666667,113,0,3,3
"35257","f38def8908cc85ab0715995ebeba2fcb",117,67,58,14.1206896551724,117,0,3,3
"35258","f38e85d0eb96b6d3cb714e8a4fe1000d",34,27,28,8.5,27,7,2,1
"35259","f38f8e6ea17e1f23760908af7c7014aa",5,5,0,5,5,0,1,2
"35260","f3904f93a464a87cae5da8725fb27240",77,58,43,12.5348837209302,77,0,2,3
"35261","f392ff01bf60e208a76aaf6e33e39e21",9,9,0,9,9,0,1,2
"35262","f393f8410ee62baefc316f2ac63b1eeb",33,28,56,4.125,0,33,2,1
"35263","f3940a58e4c081a3bddf9e2e09a5c0d4",94,61,65,10.1230769230769,63,31,2,1
"35264","f3941754ca79067180d10a1677e24a58",20,20,0,20,20,0,1,2
"35265","f395ac2378b2207a973671622f4c34b9",52,50,9,40.4444444444444,52,0,1,2
"35266","f39a8dd7327e6df672906bb2eebf19fe",8,4,64,0.875,8,0,2,1
"35267","f39cb4e37ce23aa280780d4a2fe383ef",54,42,41,9.21951219512195,19,35,2,1
"35268","f39d891406589ae0d34e73ffda955594",197,144,82,16.8170731707317,197,0,3,3
"35269","f3a095635cb60b4c2a2756a42049bec5",164,103,69,16.6376811594203,164,0,3,3
"35270","f3a1f776d08e411392c92980e9340dd2",191,112,80,16.7125,139,52,3,3
"35271","f3a32df9fa8e3581d88c0d6e4348177b",133,82,50,18.62,133,0,3,3
"35272","f3a5d56383e7753d93fcdc70fb6470af",46,46,0,46,46,0,1,2
"35273","f3a5f1c13549f0533af3a03865759093",11,11,0,11,11,0,1,2
"35274","f3a7799182707db22215454f7448a0f2",15,11,33,3.18181818181818,15,0,2,1
"35275","f3abf072f613207379a01e60b4ee288c",80,64,62,9.03225806451613,80,0,2,3
"35276","f3ac62d67f21e0661f506f1d7be7f2d3",38,28,56,4.75,38,0,2,1
"35277","f3aeacacae68ff5eaf6a85095473068c",107,72,61,12.2786885245902,87,20,3,1
"35278","f3b2e0e9b956e0d120dd1568f8b93a4f",31,31,0,31,31,0,1,2
"35279","f3b3513350a1cc236734f98ab8b400ea",40,29,30,9.33333333333333,40,0,2,1
"35280","f3b45b7d562ce3deefa2509a6914716b",190,120,47,28.2978723404255,190,0,3,3
"35281","f3b489d415666dc51755a433ca3eeb28",106,87,45,16.4888888888889,94,12,3,1
"35282","f3b59ad90eff3c10668b5c7fd2722318",59,50,21,19.6666666666667,59,0,2,1
"35283","f3b5bbfbbb8dc940a671da326ae8925d",101,67,77,9.18181818181818,101,0,2,3
"35284","f3b70a24dcd1b35c47f870154526e079",17,17,0,17,0,17,1,2
"35285","f3ba42aa7a38c66ed56f6375cd4fab74",1,1,0,1,1,0,1,2
"35286","f3c0cd5ee4248d7aa9831522b02834b0",43,43,0,43,43,0,1,2
"35287","f3c0dd32dab34dbbf8c48a30f60aabc3",6,6,0,6,6,0,1,2
"35288","f3c1a8ea4ecddc15234570c64914b287",22,22,0,22,22,0,1,2
"35289","f3c27de4a3510154fd789a740bf8e6d1",133,74,68,13.6911764705882,133,0,3,3
"35290","f3c3b770d840bde7210a8f479afbbfa1",7,7,0,7,7,0,1,2
"35291","f3c478cb6072d6e2422cdbb95aa7d9fa",34,34,0,34,34,0,1,2
"35292","f3c47b6a61c81482fdb31585a8cf52a6",14,14,0,14,14,0,1,2
"35293","f3c6caa283a3e0d78351950fc347791d",31,31,0,31,31,0,1,2
"35294","f3c95970cddee621a02655a7b4503283",105,73,63,11.6666666666667,105,0,3,3
"35295","f3cb17e6a2db35c12f0b8b6ca603e21c",85,69,46,12.9347826086957,42,43,2,1
"35296","f3cb4d0e5fd70e5bdb4eed53687c9d61",130,88,60,15.1666666666667,130,0,3,3
"35297","f3cb7692197880161d3aabffc9e1c5d7",134,65,70,13.4,107,27,3,3
"35298","f3cc62d02fcb855744ae4e0fdb717221",52,28,84,4.33333333333333,52,0,2,1
"35299","f3ce4095269fd33100e4b07ec8e5b01a",45,45,0,45,45,0,1,2
"35300","f3d00f82c8f2a173534560a8b5564cb2",207,65,78,18.5769230769231,207,0,3,3
"35301","f3d01eb941094e9316bb65b4588002d1",66,50,66,7,66,0,2,3
"35302","f3d03a38892c18f098772316ec31999d",16,16,0,16,16,0,1,2
"35303","f3d1090c8f27626ec13149ff1ab88d3a",109,72,73,10.4520547945205,61,48,3,3
"35304","f3d2df51fbc96b7a19b93f396ece0561",193,118,63,21.4444444444444,193,0,3,3
"35305","f3d37aa64503a8f162aea3ecab8976ce",83,62,68,8.54411764705882,29,54,2,3
"35306","f3d41d90ace4317410fa38ab066c0b90",18,18,0,18,0,18,1,2
"35307","f3d81863fdd9a25818af8441fafe0628",148,61,70,14.8,148,0,3,3
"35308","f3e8f099b9239c6f825e96e5ec1210ac",42,37,56,5.25,12,30,2,1
"35309","f3eaa1b73c6a66767e913302d386cb69",3,3,0,3,3,0,1,2
"35310","f3eb159598ed3e86b8d7e6b06b8bced7",84,63,67,8.77611940298507,84,0,2,3
"35311","f3ec3fba2ee7ffce494ae1874c030b38",24,20,26,6.46153846153846,24,0,2,1
"35312","f3edb2a3890f733cd483f3e5aadc2aa6",26,26,0,26,26,0,1,2
"35313","f3ee8e8c956648202446e38b518706ee",52,41,13,28,52,0,1,1
"35314","f3ef2c873b9c8a6457a8fb889e573bda",23,23,0,23,23,0,1,2
"35315","f3ef7ec9d71e635483c49d5876de8c15",99,75,89,7.78651685393258,74,25,2,1
"35316","f3f2b1af9da7f381c62392dcb1d9512d",39,39,0,39,39,0,1,2
"35317","f3f3f0cb3f5a122948e6dfb06f5c0e53",69,20,71,6.80281690140845,60,9,2,1
"35318","f3f46b7fee48399a647910d740fa6762",69,33,63,7.66666666666667,69,0,2,1
"35319","f3f614df501bd3cb75fc39837e018fd3",52,45,51,7.13725490196078,29,23,2,1
"35320","f3f80beb1d7f327dae62a002135abaa0",53,53,0,53,53,0,1,2
"35321","f3fa946d2cfb510cd704e6362bfd3dec",17,17,0,17,17,0,1,2
"35322","f3fab2dcf72750df66386bccd199f052",13,13,0,13,13,0,1,2
"35323","f3fd2050a9f9e8c6fc54eb66fb904b0b",43,39,28,10.75,43,0,2,1
"35324","f3fe003721bb71522dac2bae5713077c",9,9,0,9,9,0,1,2
"35325","f3ffe0d06447d26135fe682a73975ef8",22,22,0,22,22,0,1,2
"35326","f4012255effa6ca4241446d2f4ec4ff1",74,29,57,9.08771929824561,74,0,2,3
"35327","f401582da142f12c61ab80d39fdc6d15",31,31,0,31,31,0,1,2
"35328","f40289150d251dabea3194cde967b783",161,119,48,23.4791666666667,161,0,3,3
"35329","f403d10f520afb612241a0f6b0a28f46",1,1,0,1,1,0,1,2
"35330","f4053c5bf86e150c3a83395ea1f11977",20,20,0,20,20,0,1,2
"35331","f405c7b7b271253bc75968e6453e9229",41,18,55,5.21818181818182,41,0,2,1
"35332","f40781402c7ac19e6a0ea1619eefe4e6",85,67,44,13.5227272727273,85,0,2,3
"35333","f4093a621aec447297c03cd60f18422c",32,32,0,32,32,0,1,2
"35334","f40c4cf1e57e05e68cc2c0d2df69e570",33,25,58,3.98275862068965,33,0,2,1
"35335","f40ee2bbb680f59ecb18656453aa55f2",6,6,0,6,6,0,1,2
"35336","f40fab585f615f8ef27daa4549fa1c71",14,14,0,14,14,0,1,2
"35337","f4127e27615d6a6e3078413de72e3b2c",41,41,0,41,41,0,1,2
"35338","f41342f3bee9024e1f4e58e76b413dcf",109,74,39,19.5641025641026,71,38,3,3
"35339","f414bc45cf748e6f7c7de70d5739612c",23,22,64,2.515625,23,0,2,1
"35340","f41df403737f92fc2c644197d7da5c34",11,11,0,11,0,11,1,2
"35341","f41f4627fada5a98b64b01713955450a",144,92,58,17.3793103448276,95,49,3,3
"35342","f41f6c57f02bc3187b2a4d97aef9c9ab",9,9,0,9,9,0,1,2
"35343","f41fd00aa94420b4ef92088107943b62",139,89,86,11.3139534883721,120,19,3,3
"35344","f4232d51af90d70ac1ad6efb0c56d2bf",93,37,69,9.43478260869565,93,0,2,3
"35345","f423db79e0bd9ff315f60839117db218",19,19,0,19,19,0,1,2
"35346","f4277e49e11df957e41aabd3719a6e37",45,35,34,9.26470588235294,45,0,2,1
"35347","f428417b952988ad259cca12837ad6e8",49,49,0,49,49,0,1,2
"35348","f4302a47adc2b2e7f62438f8a2b180ee",24,24,0,24,24,0,1,2
"35349","f431bf40ece707ff05ec312a84fd4a1f",214,141,62,24.1612903225806,214,0,3,3
"35350","f432350f4a945f6028417f8e040862c2",183,104,82,15.6219512195122,183,0,3,3
"35351","f433df4c4ddb0295d6303112cfcff8f4",21,21,0,21,21,0,1,2
"35352","f4352ba02712c3f76ff5c31e6df25537",177,99,77,16.0909090909091,177,0,3,3
"35353","f436c450c21e1aedc756c0ffa564787a",116,85,57,14.2456140350877,85,31,3,3
"35354","f436e812f1153471e28932a5c7268b47",19,19,0,19,19,0,1,2
"35355","f437c733c8b217374036b17e23250719",31,31,0,31,31,0,1,2
"35356","f438c22cc98af075fd270325b68fb343",94,64,27,24.3703703703704,65,29,2,1
"35357","f439bc6213c82820423e95c98f9124d8",84,63,42,14,84,0,2,3
"35358","f43a1b90148ed6ccec42035093b8381f",113,77,62,12.758064516129,113,0,3,3
"35359","f43a4977433357eed430bd6eac99f7d8",18,18,0,18,0,18,1,2
"35360","f43da5b2534f5df7bc43ab7b71f480d1",103,81,55,13.1090909090909,103,0,3,3
"35361","f43dc2a74ebdc8bd820418d2f758c30d",118,64,46,17.9565217391304,118,0,3,3
"35362","f43ed00289579486324d936776836a95",35,30,42,5.83333333333333,35,0,2,1
"35363","f442ce77b688182e7e194a4695e24690",50,50,0,50,50,0,1,2
"35364","f442f4e749cb382e3e841c731d60de96",44,39,34,9.05882352941177,44,0,2,1
"35365","f446c50644ef2b7990632e439c768155",27,25,62,3.04838709677419,1,26,2,1
"35366","f448887257464213326132d7e22f68b9",27,27,0,27,27,0,1,2
"35367","f4492bf8d34f1d3f7acb291621137818",31,26,33,6.57575757575758,31,0,2,1
"35368","f44cdf94beb5834dc815b0f61b3c0257",34,34,0,34,34,0,1,2
"35369","f44e32e60467e19c4b3f682095812920",55,48,71,5.42253521126761,55,0,2,1
"35370","f44eef3d0201365ef5ac45c08e8a2939",12,12,0,12,0,12,1,2
"35371","f452a9af9bff51091a9fbf8b1238866f",20,20,0,20,20,0,1,2
"35372","f4537d336b881bac42ff858f59ef7ccb",23,23,0,23,23,0,1,2
"35373","f4551be0a72a21a867470e51f8217336",73,66,52,9.82692307692308,52,21,2,1
"35374","f458b9b89730044eebb82fbf8b444268",23,23,0,23,23,0,1,2
"35375","f459790e689ecec7b74131d825363c8e",110,60,75,10.2666666666667,110,0,3,3
"35376","f459ec66c24c79929addf079f5bdb86d",121,71,55,15.4,88,33,3,1
"35377","f45b1da5fc39b6fe1439569d8becae1d",160,106,71,15.7746478873239,116,44,3,3
"35378","f45ba24da29ae9533e94bf9b6c35b895",23,23,0,23,23,0,1,2
"35379","f4619cff83c08aa076f4f23bf4b25e3f",135,60,77,12.2727272727273,135,0,3,3
"35380","f4655940ae52f85e6009fcd33baefecf",6,6,0,6,6,0,1,2
"35381","f46897399c1f70d14e9be16d1b71d2be",53,41,72,5.15277777777778,21,32,2,1
"35382","f46a64efe08d52ca575778d6f15dd985",186,96,77,16.9090909090909,186,0,3,3
"35383","f46d567845274b065e869cb96a43a2dd",20,17,42,3.33333333333333,0,20,2,1
"35384","f470e3fb581fdffca33f6d000c80b57e",61,46,43,9.93023255813953,61,0,2,1
"35385","f4715311d0f51c14c113ec2e2a472f34",22,22,0,22,22,0,1,2
"35386","f47506d035f012d6a84ffa555e0c9a14",16,16,0,16,16,0,1,2
"35387","f4752ac3ee424f3c49c2818b07364f87",85,55,62,9.59677419354839,85,0,2,3
"35388","f4785830477beeb26bdc5ec95efb219c",90,45,65,9.69230769230769,90,0,2,3
"35389","f4790d94cb7a15012e9c2f82f21b8766",39,39,0,39,39,0,1,2
"35390","f47b69e4db8d36dc6ab1da57aa27950f",53,46,56,6.625,53,0,2,1
"35391","f47d2de2726d03cb1e3c335a23e5f18a",17,17,0,17,17,0,1,2
"35392","f47d5f89af1f5d8f448b2a7fd90a4880",74,58,68,7.61764705882353,74,0,2,3
"35393","f47fd7b59ac30d464536bb6d041db1e7",52,52,0,52,0,52,1,2
"35394","f480d01da3c0c6735f0f3c1ca0a13d8b",26,26,0,26,26,0,1,2
"35395","f484d05ffa08c129f88530b332c2164b",105,79,38,19.3421052631579,55,50,3,3
"35396","f484d49b652bcbdeaa8fdebb195bd55b",134,78,45,20.8444444444444,134,0,3,3
"35397","f485953b9c3b96d8f6bf1d1f6c484a62",126,100,65,13.5692307692308,126,0,3,3
"35398","f487adeb9d4696449d073c1589798b8c",40,40,0,40,40,0,1,2
"35399","f48a59f80f6393f9ed99a7029a977c3d",55,48,26,14.8076923076923,55,0,2,1
"35400","f48c26493dda637729ea3b38ea848c65",50,42,46,7.60869565217391,50,0,2,1
"35401","f491842073b7890d6d3c1b2a43b71ac8",86,66,85,7.08235294117647,34,52,2,3
"35402","f491f45c3b9939854774899ba3179497",40,40,0,40,0,40,1,2
"35403","f4945bf69d082b6644298be65d8c85c7",78,56,51,10.7058823529412,61,17,2,1
"35404","f497636d5d4dd7a4a598e304bf1db0d2",43,43,0,43,43,0,1,2
"35405","f498c7ffbb0505d0e1f8854926de5708",59,35,80,5.1625,59,0,2,1
"35406","f499e1a6e0b122d686fe123036cd3ec8",174,131,60,20.3,174,0,3,3
"35407","f499eb943693954634c3b3f80c635f05",26,26,0,26,0,26,1,2
"35408","f49b0e261fb9268997ec2dddc0f40c64",30,30,0,30,0,30,1,2
"35409","f49f25c0d59b5828621db85bec99bd0d",184,112,83,15.5180722891566,141,43,3,3
"35410","f49fe83c0e757304ba1892d53025068c",58,52,33,12.3030303030303,58,0,2,1
"35411","f4a01cd5f04a4519e5452cf8d3cfd655",20,20,0,20,20,0,1,2
"35412","f4a08ddee974b9e1da3c0128b1f37451",36,32,42,6,36,0,2,1
"35413","f4a2fddc4bfc22ee2a2eda471a067d7d",33,33,0,33,33,0,1,2
"35414","f4a495820c1862711f9c72555dceda5e",89,53,47,13.2553191489362,89,0,2,3
"35415","f4a4cc813721e0a47d6dfb9b190e6f42",73,65,35,14.6,73,0,2,3
"35416","f4a541e7e9021458e94ba94a96985261",59,48,25,16.52,37,22,2,1
"35417","f4a5593d43be61870cad2da2418feec1",69,49,70,6.9,69,0,2,3
"35418","f4abc69937c2caf88f155a5b1ba6cd4e",64,45,76,5.89473684210526,64,0,2,1
"35419","f4abdc5050b44360f1ed6740e9f5781d",61,44,26,16.4230769230769,33,28,2,1
"35420","f4ac4d70843d522ac7fd5d26988215f4",13,13,0,13,13,0,1,2
"35421","f4b1943ad745befb55c9cbc3da2f08b7",98,63,65,10.5538461538462,98,0,2,3
"35422","f4b2408506c76f2662276ad6d96addd0",36,36,0,36,0,36,1,2
"35423","f4b41e65f3400307a5f045a2afa847a4",65,55,24,18.9583333333333,65,0,2,1
"35424","f4b6b96a1f430daf7c2679b44670d593",33,33,0,33,33,0,1,2
"35425","f4b759be799493db7f8c58f32f7bef7a",30,30,0,30,30,0,1,2
"35426","f4b88670fea02214fa7ca5b29cd4fd0b",7,7,0,7,7,0,1,2
"35427","f4ba00e76de8fd4fc54606ac0422f1a8",41,41,0,41,41,0,1,2
"35428","f4ba787ab79082ed3396177947a25647",44,44,0,44,44,0,1,2
"35429","f4bae9422e883716ec44a3c99847e0c2",33,33,0,33,33,0,1,2
"35430","f4bfe5eb5088abe2c7e5bd4434a8f316",38,27,29,9.17241379310345,19,19,2,1
"35431","f4c0aee2fcdf5bd33f2bc4d99f63e677",13,12,12,7.58333333333333,13,0,1,1
"35432","f4c4565feb9bef5ebceb8537eb1358d1",91,61,26,24.5,91,0,2,3
"35433","f4c62a0ff5080c4922f1c17a7a4710a7",30,26,60,3.5,14,16,2,1
"35434","f4c8e4e0df738f4f4ad445799a8b76bc",23,23,0,23,23,0,1,2
"35435","f4c90c1e67362f0a7baf2dab2ced9bc1",65,41,51,8.92156862745098,65,0,2,1
"35436","f4c9ccf37f2f917a724c343ae4c8190e",27,27,0,27,27,0,1,2
"35437","f4cb9135021938be0f3dcd2c1067232e",182,102,74,17.2162162162162,182,0,3,3
"35438","f4cd591f425471a5aab3eac62f10a6b1",3,3,0,3,3,0,1,2
"35439","f4d177bfd882d3e214ffc3b2ec78f2c5",40,40,0,40,0,40,1,2
"35440","f4d2ff80ab2e098adcf1f5f6aaf10aeb",6,6,0,6,6,0,1,2
"35441","f4d35c731b6fa264ddbfb018397297ff",14,14,0,14,14,0,1,2
"35442","f4d3a807326531ffc384d8bd78cc1128",77,70,52,10.3653846153846,77,0,2,3
"35443","f4d50be1ededb182f0a22ec0fbb891e1",39,39,0,39,39,0,1,2
"35444","f4d55af8ef6f478ec81c93691d4414f0",30,26,24,8.75,14,16,2,1
"35445","f4d577589f8b335a6afffd93b2624391",157,80,67,16.4029850746269,122,35,3,3
"35446","f4d64420390dd009c1febc9689ed15e9",48,38,27,12.4444444444444,48,0,2,1
"35447","f4d73501900da321efa685a85aad929c",19,17,28,4.75,19,0,2,1
"35448","f4d83783531e99fab16ee52ae8af51c6",222,92,49,31.7142857142857,183,39,3,3
"35449","f4d90b6bf730eb2cf083e296f367d297",25,25,0,25,0,25,1,2
"35450","f4dcb1c6302c561516d7e8a8103c8146",63,41,42,10.5,63,0,2,1
"35451","f4de0aec0cae4a0863c1ed1d4ddae7b8",14,14,0,14,14,0,1,2
"35452","f4de55b9a3e5a1fab960426e59cfc0d4",194,61,77,17.6363636363636,159,35,3,3
"35453","f4dfaae94348ace612728d9714c0d1e7",22,22,0,22,22,0,1,2
"35454","f4dffc4a54f4451c22b96a4aef25f0f4",54,44,31,12.1935483870968,54,0,2,1
"35455","f4e1d5ed94f542e8dd18bec736343ab5",6,6,0,6,6,0,1,2
"35456","f4e374faa80fafc8e670e7ac40966702",127,81,57,15.5964912280702,127,0,3,3
"35457","f4e37f2390eff357ff4966842144d6ca",21,21,0,21,21,0,1,2
"35458","f4e45392d675373cdb33301fea8ea1f3",22,21,22,7,22,0,2,1
"35459","f4e5093ec0a19fbbd7f5160b4a3c487d",51,51,0,51,51,0,1,2
"35460","f4e61fc1b08e1366045331cd519c8afe",54,50,39,9.69230769230769,19,35,2,1
"35461","f4e7863f960a417c7aafed01587024f1",2,1,8,1.75,2,0,1,1
"35462","f4e83163f65ff6088fac18243275fbef",21,21,0,21,21,0,1,2
"35463","f4e88e46249477bea6c60701eb064c84",21,16,7,21,21,0,1,2
"35464","f4ec58562ffd11e651ed9f9dffc88f52",160,74,52,21.5384615384615,160,0,3,3
"35465","f4efd3749778bc3fe16ac63b4321f959",79,61,58,9.53448275862069,39,40,2,1
"35466","f4f09c8ee49d0394db1bb33be076c13a",10,10,0,10,10,0,1,2
"35467","f4f3cf15985c0dc0b0358c112cc0395c",34,34,0,34,34,0,1,2
"35468","f4f3f2e702f66ed4cb932983e8b633a1",52,46,28,13,52,0,2,1
"35469","f4f4ebdf5fb932d240e96607407414be",172,102,70,17.2,123,49,3,3
"35470","f4f4f6ae847500f01246277ba2ff30c5",7,4,56,0.875,7,0,2,1
"35471","f4f84a533658a4c5c64b5645e1f26db1",23,23,0,23,23,0,1,2
"35472","f4f8eb79debb19eadc51251131214ed3",96,71,39,17.2307692307692,96,0,2,3
"35473","f4fb48209b956f176c8c75384aeb326c",34,34,0,34,34,0,1,2
"35474","f4fcf66b0cba513487aed5a946d2f490",31,31,0,31,31,0,1,2
"35475","f504935aa50f4b69e5639ede80267273",75,42,17,30.8823529411765,41,34,1,2
"35476","f506cfe01ef9156fe458321e57284ad2",23,23,0,23,23,0,1,2
"35477","f50824b24f043d294eca889a0afe8475",22,22,0,22,0,22,1,2
"35478","f50b210128539c60faf13303220e12c7",19,19,0,19,19,0,1,2
"35479","f50d4607672e8aa4e57cc32a62db760c",35,35,0,35,35,0,1,2
"35480","f50d777101f5701c3b7ca1f8b3450fe6",9,9,0,9,9,0,1,2
"35481","f50dc9836593afb682b2e5be4cd2f700",75,39,63,8.33333333333333,75,0,2,3
"35482","f510748014d647ff010f8f3f0c93ea2c",38,38,0,38,0,38,1,2
"35483","f511e00b709996ed4185ff334c1e7512",52,50,18,20.2222222222222,52,0,1,1
"35484","f51826aad69cd719545dcc8290e79bf4",28,28,0,28,28,0,1,2
"35485","f518285077048c8f9209afeffee2fdf8",47,47,0,47,47,0,1,2
"35486","f51961a232d6c6b6087309c724da35af",29,29,0,29,29,0,1,2
"35487","f51c045c36ccec8c7fbbdc35332902d1",40,40,0,40,40,0,1,2
"35488","f51cacb55541c22bf6c9328cd21efcd8",16,16,0,16,16,0,1,2
"35489","f51fdef54627e9e3bb46781868ccff64",11,11,0,11,11,0,1,2
"35490","f525d984faa084e01ad969a6db1e4128",37,37,0,37,37,0,1,2
"35491","f529c095d9691379d320f9180bb2eddb",41,41,0,41,41,0,1,2
"35492","f529c9f652e97019e87c6eaca01bf353",97,60,60,11.3166666666667,97,0,2,3
"35493","f52a7a61917760a45c3d78a7ef1c3c00",68,53,66,7.21212121212121,33,35,2,1
"35494","f52c537d4f1c805a3f962f1cf9e1ee5f",74,56,77,6.72727272727273,34,40,2,1
"35495","f52c565e9cf7ff1aae10301722086bfc",69,46,56,8.625,69,0,2,3
"35496","f52d05c7c011643bf4d67e7a8d92b002",39,34,35,7.8,39,0,2,1
"35497","f52f5f71fedbc63bf0fc00e49d677d3a",13,13,0,13,13,0,1,2
"35498","f52fcfec0c7db46d55194345c47ef956",24,24,0,24,24,0,1,2
"35499","f531106ef07e029d51b5679104970786",97,61,67,10.134328358209,42,55,2,3
"35500","f532b4d2c3cccb2d63c528247f0db2de",56,56,0,56,56,0,1,2
"35501","f532f9b142eec07224af8446c644672b",3,2,4,5.25,3,0,1,2
"35502","f537bc98e7fd6210333df7d3bb1d3fa8",206,130,77,18.7272727272727,173,33,3,3
"35503","f53a1d689689eb1baa45557dc71078d9",7,7,0,7,7,0,1,2
"35504","f53a7e4b4b800dddb3b7421a5916dcc4",24,24,0,24,24,0,1,2
"35505","f53b6681f305221cd377aae6556d034e",21,20,8,18.375,9,12,1,1
"35506","f53b78fad6dbb8846f075b457b56bb89",11,11,0,11,11,0,1,2
"35507","f53c931f1991b1957223497ae14f4d89",51,48,29,12.3103448275862,51,0,2,1
"35508","f53f940080320bfeca3194d9ac37b170",114,64,77,10.3636363636364,82,32,3,1
"35509","f5405a07bfc5f09daa9712e78fa8b05b",82,61,38,15.1052631578947,82,0,2,1
"35510","f5412dad789cd26597415e8ac683e6e7",71,62,47,10.5744680851064,71,0,2,3
"35511","f5451ccfe0d2282c2e1bb909d1b1eea6",74,63,56,9.25,19,55,2,1
"35512","f54d069243c69342618029bdf8f159bd",70,57,26,18.8461538461538,70,0,2,1
"35513","f54e0c58800bc7c7d17bfb7306692d3d",25,25,0,25,0,25,1,2
"35514","f551d926f661c8ac573a76a832d5f56c",23,23,0,23,23,0,1,2
"35515","f5522e6039cd7274d947cc22d387caf8",22,22,0,22,22,0,1,2
"35516","f557bb2ed210060ad27d1d349cd59fcb",15,14,3,35,14,1,1,2
"35517","f5585332bf86dd9088c2a433b65d2abe",34,34,0,34,34,0,1,2
"35518","f5593359cccf85746a5e1fa2be37bb37",80,59,65,8.61538461538461,37,43,2,1
"35519","f559710146d67c46439272fcb2b3c685",12,10,6,14,12,0,1,2
"35520","f55c6c93967dce142a19ac86d4945581",25,25,0,25,25,0,1,2
"35521","f55cee364f431be7f3c9ca056942e851",220,133,63,24.4444444444444,188,32,3,3
"35522","f55e20fdb25b744772c2608d0084a7a0",20,20,0,20,20,0,1,2
"35523","f561282f8aba94440b15b81d06826db4",97,70,83,8.18072289156627,60,37,2,3
"35524","f56213c48bfecdfb626b03d9f6eac94a",37,29,28,9.25,37,0,2,1
"35525","f5629cd15cb475fa56ec87ce09cd56c0",39,33,78,3.5,20,19,2,1
"35526","f563a4b853d7f770f7674981cf1e827c",15,15,0,15,15,0,1,2
"35527","f5679ac34e6bc825e86079a3c2da0671",51,43,55,6.49090909090909,51,0,2,1
"35528","f567a1a605839535559517cf95a99eb6",90,70,36,17.5,42,48,2,1
"35529","f568287525593ef88f7faad2fc06c92e",156,103,50,21.84,102,54,3,3
"35530","f56bebcf077db1130ad8073f8e0a59d1",22,22,0,22,22,0,1,2
"35531","f56cd2a6380f90bb150a62751892e764",59,49,63,6.55555555555556,59,0,2,3
"35532","f56e83f2e397e8d9d5cb3d77ab56db4d",39,37,5,54.6,39,0,1,2
"35533","f5728712b5c4aa3fc6159881459775b0",135,68,35,27,135,0,3,3
"35534","f5754d27e1561c86ecbd2cf0ca399197",9,9,0,9,9,0,1,2
"35535","f575bddb0c316d788056f7047ea20e95",88,68,45,13.6888888888889,58,30,2,1
"35536","f576a4538ea05cf8e83181990a9448b5",214,116,82,18.2682926829268,214,0,3,3
"35537","f57886cd95bd6d9e6af39cabb4df93c7",52,46,61,5.9672131147541,52,0,2,1
"35538","f579ecc965fe9fb940d1f74d2de346ea",72,56,55,9.16363636363636,72,0,2,3
"35539","f57b5cf2ce4fae4c87750b09238bbdcd",130,90,88,10.3409090909091,130,0,3,3
"35540","f57c19256b94a79b9273781c6ba6c7d0",44,29,47,6.5531914893617,44,0,2,1
"35541","f57e16b94c06d4e3ca9c31af2f6913ae",58,50,50,8.12,58,0,2,1
"35542","f57ffb7a7aeb8387e105bac2d80d21ed",22,17,35,4.4,22,0,2,1
"35543","f5811fcf4e061b04da13e822e2a6062b",1,1,0,1,1,0,1,2
"35544","f583d1c557d5e65af1388fdb2a7b72b2",19,12,47,2.82978723404255,19,0,2,1
"35545","f58507d5c6dd9387e5ff787e081d82ef",31,31,0,31,31,0,1,2
"35546","f5862c1cb9e075f65a4778dbfb081215",85,65,27,22.037037037037,85,0,2,3
"35547","f587745ee9c7c8481dbd7fe1ef7d6b44",19,16,43,3.09302325581395,19,0,2,1
"35548","f587d1dd4d86ab229a733c5df54e7ee3",1,1,0,1,0,1,1,2
"35549","f588b2479baaf36920f1803f30e0bfe2",33,33,0,33,33,0,1,2
"35550","f588b689af6c651b6a361c6e06d84e86",33,33,0,33,33,0,1,2
"35551","f588ea285cf6b0e823dd3dbdd2398e84",35,30,32,7.65625,35,0,2,1
"35552","f58a1701540d80c4898bb96ec0f4bc88",26,23,10,18.2,26,0,1,1
"35553","f58b4d09a6d9d254ead1afae46a7c8a6",27,27,0,27,27,0,1,2
"35554","f58c94043c4643c522e274e0183ad13f",16,16,0,16,16,0,1,2
"35555","f58dabb26cfa9426317e359c0b7ff6e6",166,128,50,23.24,166,0,3,3
"35556","f58e05558e9e9def591eb998b469f8f8",50,37,42,8.33333333333333,22,28,2,1
"35557","f58e67f555102e7b2efcf921185985d7",63,52,38,11.6052631578947,63,0,2,3
"35558","f5916a498ac2c567e7be97afb6fff8cd",15,9,64,1.640625,15,0,2,1
"35559","f591725671ece1755d2b666e06bcc780",134,99,51,18.3921568627451,86,48,3,3
"35560","f594fe7856c1a86632fc881216650c66",158,91,83,13.3253012048193,108,50,3,3
"35561","f595910cabcc97baeeb20f768a5f2fb2",130,67,71,12.8169014084507,130,0,3,3
"35562","f596feef395c782153399c6ed7ba45b7",49,37,59,5.8135593220339,49,0,2,1
"35563","f598786d6666024840cd9e5596b3bbcb",38,38,0,38,0,38,1,2
"35564","f59d4b1d1464e9e1b20c330ac7514e6c",85,74,66,9.01515151515152,85,0,2,3
"35565","f59d9ed03352b4fc141a6c4f181fd14e",39,39,0,39,39,0,1,2
"35566","f59f68c81e3558469e303fd19c1141ba",73,60,41,12.4634146341463,73,0,2,3
"35567","f5a0e972e85fda6dfec1c8025aebd782",3,1,90,0.233333333333333,3,0,2,1
"35568","f5a1a6663020e8662620b6fdc10ac625",13,13,0,13,0,13,1,2
"35569","f5a21583823540a5fc6d7f72de569e2a",24,24,0,24,24,0,1,2
"35570","f5a6448b18d88b277ccfff3343363190",75,58,42,12.5,75,0,2,3
"35571","f5a68eaca1c3e2e55d7142a192fd9c43",40,40,0,40,40,0,1,2
"35572","f5a693d07b19a71e111e7ac37a39bd1c",39,39,0,39,0,39,1,2
"35573","f5a7a02af866b569abf6868419cf5d53",166,111,84,13.8333333333333,121,45,3,3
"35574","f5a829abdd332e1651269b0a1a97c84a",23,23,0,23,23,0,1,2
"35575","f5a82b7b1d969c3264a8ac4ed55fa3ae",31,31,0,31,31,0,1,2
"35576","f5ac2782f10efaccf0beb885be1dd457",189,124,73,18.1232876712329,189,0,3,3
"35577","f5b0098d6b711dcbc12121889d84036d",54,54,0,54,54,0,1,2
"35578","f5b11c7b1ad9d7567019236e8e51e2d5",31,25,53,4.09433962264151,31,0,2,1
"35579","f5b16c23e13f431266cd0409dccd425c",58,42,33,12.3030303030303,24,34,2,1
"35580","f5b565eed20c6a9b0c68e2414c628d66",7,7,0,7,7,0,1,2
"35581","f5b87646f516b69a2e4812f3057c4998",68,51,40,11.9,68,0,2,3
"35582","f5ba95bc123c4ff2305283b2655e55d4",104,81,47,15.4893617021277,76,28,3,1
"35583","f5bb40461bf1627439243c71e60d8156",9,6,50,1.26,9,0,2,1
"35584","f5c0e30528b11b9fe829a37dadff8920",63,45,43,10.2558139534884,63,0,2,1
"35585","f5c1891d5485ce35fdff6260f1f410dc",26,26,0,26,0,26,1,2
"35586","f5c2ab18418704b4f3085a754c09b181",19,19,0,19,19,0,1,2
"35587","f5c2ab6ab33bbb40821ac22ecb4dad44",123,95,78,11.0384615384615,123,0,3,3
"35588","f5c2e1595717d3ffd3ec6369ad1033f2",46,46,0,46,46,0,1,2
"35589","f5c398e9b562dcbf3dca595c4e89d219",30,30,0,30,30,0,1,2
"35590","f5c52a3ffb7879ad4b2505859d00ac21",90,71,65,9.69230769230769,50,40,2,3
"35591","f5c6a2792cc630f91f75b0f0dfbdaf4c",8,8,0,8,8,0,1,2
"35592","f5c6abbcfe50b92b93538b8efc394771",151,103,63,16.7777777777778,112,39,3,3
"35593","f5c8cbd42656884859b169aa96d8ff6a",36,32,36,7,36,0,2,1
"35594","f5cb6b4002257285fd70e386d66cc917",17,17,0,17,0,17,1,2
"35595","f5d005b397d1b1f8bfeca1a3d28672be",14,14,0,14,14,0,1,2
"35596","f5d19fd1209f1050103d17a06e74fe01",29,23,7,29,29,0,1,2
"35597","f5d34044061cd78101375fa2970a558f",90,70,68,9.26470588235294,90,0,2,3
"35598","f5d4a4a46af99c5a5bd0516cf97c6a39",126,93,42,21,126,0,3,3
"35599","f5d9248a8a672c39711b9f3668483c0f",91,66,38,16.7631578947368,91,0,2,3
"35600","f5db52eb957d770a2d509703ac7c5f63",21,21,0,21,21,0,1,2
"35601","f5e18f8b7e36be5893a2483b6bc65069",99,68,35,19.8,99,0,2,3
"35602","f5e1cd0c22e2710a4dbb83aa44b8eccd",123,69,70,12.3,100,23,3,1
"35603","f5e23291d449433ca7746b2e6564b136",32,22,63,3.55555555555556,32,0,2,1
"35604","f5e61ff190a4877479a1b66fc5cf0b62",114,72,72,11.0833333333333,114,0,3,3
"35605","f5e6901cc702e94582f279e4fd4f085b",56,52,16,24.5,56,0,1,1
"35606","f5e75f06460256975b6d634d4753f542",22,22,0,22,22,0,1,2
"35607","f5e7e8d2e6e9cf9fc7bc49044b163d54",21,21,0,21,21,0,1,2
"35608","f5e8df0022da26249e1e5fa203dabcaf",187,107,61,21.4590163934426,149,38,3,3
"35609","f5e9bcdb392bf902691248a3ce6cf4d7",40,40,0,40,40,0,1,2
"35610","f5ea630ba6927cb4b7e41835aed071b3",46,45,11,29.2727272727273,46,0,1,1
"35611","f5ea6fdd1aa7a6fae25d7d75975fadcd",80,61,45,12.4444444444444,80,0,2,3
"35612","f5ed9f934db7d1ef8ec530a03ab8b50f",14,13,3,32.6666666666667,14,0,1,2
"35613","f5eea28593746058e4796970340be768",98,78,34,20.1764705882353,98,0,3,3
"35614","f5f3958a42b02a76a06fa80ef825fe32",57,50,37,10.7837837837838,57,0,2,1
"35615","f5f3bfc7ddc42e254d250e6c7605e24c",3,3,0,3,3,0,1,2
"35616","f5f592e6bf0ceaa9882ccbebd7e773d1",66,54,38,12.1578947368421,24,42,2,1
"35617","f5f9dbeaa2abcf1fdca152d87224076d",2,1,55,0.254545454545455,2,0,2,1
"35618","f5fb11677c6847741e0d2d7b565dc85c",61,44,84,5.08333333333333,61,0,2,1
"35619","f5fb891c42af15143013f542ee529a9a",33,23,57,4.05263157894737,33,0,2,1
"35620","f5fe04bdf03fd057a04c493e9bc9d643",28,26,8,24.5,15,13,1,1
"35621","f5fe2b43f9375d6e11f1f00b240c405b",118,76,46,17.9565217391304,118,0,3,3
"35622","f5fe46734ada3e4bc59ac8371c1c53fd",92,75,45,14.3111111111111,38,54,2,1
"35623","f5fe47d34a624e30dd4145aa23dabec2",52,42,8,45.5,52,0,1,2
"35624","f5fff4eec650b071bcfea91e15c18b6d",189,66,72,18.375,159,30,3,3
"35625","f6029015b7abc66decc821c7fe7743fa",23,23,0,23,23,0,1,2
"35626","f60490934fc985d60e7f51579544d6fc",43,43,0,43,43,0,1,2
"35627","f60b262b96d51d994107981c0764a571",48,48,0,48,0,48,1,2
"35628","f60dabdc4d4db0fadb9fad84631c45ab",17,17,0,17,17,0,1,2
"35629","f60ead1d68a242891efe932cfc87d79e",28,28,0,28,28,0,1,2
"35630","f60f384de293e9a61ab8b43af1269aac",62,53,54,8.03703703703704,31,31,2,1
"35631","f60f55c7470f4675d6ec34767e30672e",208,115,48,30.3333333333333,208,0,3,3
"35632","f60faf3a4f3b264809550efc3d44f265",85,57,71,8.38028169014085,49,36,2,3
"35633","f61010927a9d2bc4db7d6132881086fd",26,21,47,3.87234042553191,14,12,2,1
"35634","f6118393ec5e03ff961e08cf4c3702eb",30,27,37,5.67567567567568,30,0,2,1
"35635","f613119f85120c487d9d1459e712a7cd",23,23,0,23,23,0,1,2
"35636","f614a30530de43ebae937ad98cda2070",114,71,62,12.8709677419355,114,0,3,3
"35637","f615117ed89ae011a0cea2319f22a167",10,10,0,10,10,0,1,2
"35638","f617d8e1818b56d9a4e874e03b3d0a3c",197,78,86,16.0348837209302,161,36,3,3
"35639","f6189118ce73d9680da88d1c36ee1681",40,40,0,40,40,0,1,2
"35640","f61bcac6eca717592f3d586f14976d20",41,41,0,41,41,0,1,2
"35641","f61d02aada511b5466d9de3fcf931098",36,36,0,36,36,0,1,2
"35642","f6205cb4f86f3f1b6d30ca77010874ef",51,47,73,4.89041095890411,51,0,2,1
"35643","f623ceea4ba1d5f0c3307f925cf169f2",28,28,0,28,28,0,1,2
"35644","f62616dcdd36c8c842352ee180b3489f",50,46,37,9.45945945945946,50,0,2,1
"35645","f629610e6e7281677e181fb9599da486",20,20,0,20,20,0,1,2
"35646","f62a2a2761035c8b8fd84f5be3d897fd",27,27,0,27,27,0,1,2
"35647","f630f01014752b5a649be245650b099c",14,13,63,1.55555555555556,14,0,2,1
"35648","f634df2ead09b01a073b73e7ad3e1d5e",113,75,63,12.5555555555556,78,35,3,3
"35649","f6363de91dbfdc5335533d237b4d8e89",1,1,0,1,0,1,1,2
"35650","f6368d457f2c01ce9a83ccbb09f43022",43,38,61,4.9344262295082,43,0,2,1
"35651","f6371252cc496e4b49341e11d0943ce1",18,18,0,18,18,0,1,2
"35652","f638e5065ad0b85cfbc15b001f0c86bf",109,81,48,15.8958333333333,109,0,3,3
"35653","f63bf8df5d5387ff2a8ecf00a330c88e",175,116,76,16.1184210526316,175,0,3,3
"35654","f63c3ceb951c3ca524199ecd35d330ab",48,48,0,48,48,0,1,2
"35655","f63c46fa9924abafa9cf7a6cab569e12",137,82,49,19.5714285714286,137,0,3,3
"35656","f64212cf776de71d8c6644363738f66c",78,58,71,7.69014084507042,78,0,2,3
"35657","f645510e5ff532986598731d6d063123",6,6,0,6,6,0,1,2
"35658","f646129ba2b0c20d2cd95b72819f86e7",26,26,0,26,26,0,1,2
"35659","f646c6bd1335a6c4268ab8fe057ed39f",34,34,0,34,34,0,1,2
"35660","f648e9bea03f4105d35092d1b643fc83",4,4,0,4,4,0,1,2
"35661","f649487be1a1d1f599480a10bee8c1ef",32,32,0,32,0,32,1,2
"35662","f64a3b2ad4ccc7ebe9dcca79e1d3265a",187,102,61,21.4590163934426,187,0,3,3
"35663","f64a8b518e08c13efcf9596256555f57",177,91,73,16.972602739726,150,27,3,3
"35664","f64eca423f15b08e95a044444027749f",111,73,70,11.1,111,0,3,3
"35665","f6521325742f2ad0e13db3feab0202e2",126,78,49,18,79,47,3,3
"35666","f652669384d5f618c74e2ea536e58152",24,24,0,24,24,0,1,2
"35667","f65358556e57f574ccd21891ee308ef3",10,10,0,10,10,0,1,2
"35668","f65378e562ee6e520b393ee2cfdb1131",52,48,56,6.5,52,0,2,1
"35669","f655f835886a66be5f243e3b0cb48542",17,17,0,17,17,0,1,2
"35670","f65bb1b0e84035ee6eb8ae498a27b087",111,70,60,12.95,111,0,3,3
"35671","f65e49a20421c9de3d4cee1e16b3ede5",25,25,0,25,25,0,1,2
"35672","f6621e89855ace7fcb35e53a699c3ed2",7,7,0,7,7,0,1,2
"35673","f66478299fe401d6e2449b5f930580d3",8,8,0,8,0,8,1,2
"35674","f66505eb823e0ba7fd91787a5f14485e",36,36,0,36,36,0,1,2
"35675","f667c0089996705dc51313ba0af8e638",24,16,16,10.5,14,10,1,1
"35676","f667d3c6f9587a36dbd0a78992a1c129",32,29,35,6.4,32,0,2,1
"35677","f66a3a9235fe9adb356bcf0133d26731",14,14,0,14,14,0,1,2
"35678","f66ed000138d008468824e0e5d7520e2",63,46,46,9.58695652173913,63,0,2,1
"35679","f66fa63e55b340feb514cdad376f4cd0",105,85,65,11.3076923076923,105,0,3,3
"35680","f67020a202861e66c107d2042c62a989",56,52,27,14.5185185185185,56,0,2,1
"35681","f6739b47ebb5e8d4cc3301ab816e0c86",15,15,0,15,15,0,1,2
"35682","f6750a6b34573c28bbb127a5fa045d17",6,6,0,6,6,0,1,2
"35683","f67841d371d2a71cc8ca757fe7a9f6cc",144,100,65,15.5076923076923,144,0,3,3
"35684","f67a1c68c5de202cdf2c5c4de7556e56",11,11,0,11,11,0,1,2
"35685","f67b2100ef3b746202eb8fc55e27df61",167,90,64,18.265625,167,0,3,3
"35686","f67e26cff04be5d78f4123f0921a9032",56,56,0,56,56,0,1,2
"35687","f682e4f3eff2546ca9344b05f2bcae11",78,68,40,13.65,35,43,2,1
"35688","f683b712d8da49add40bcad6f9495b27",91,68,82,7.76829268292683,91,0,2,3
"35689","f684393891a71d068a69887686cb8183",16,15,31,3.61290322580645,16,0,2,1
"35690","f684d2c6ae948c05c54e5e8b7b6ce1a6",26,26,0,26,26,0,1,2
"35691","f6861cde5d24dd5e4b471d3872953857",45,37,64,4.921875,45,0,2,1
"35692","f687c4534327af3c035d194281fc423c",40,33,57,4.91228070175439,40,0,2,1
"35693","f689a325dd887a7e94fa33500881f3c0",70,60,53,9.24528301886792,46,24,2,1
"35694","f68f4f9f134ebc280adabc1faf488101",124,81,77,11.2727272727273,124,0,3,3
"35695","f68f7d743a724ddc2183fca90c3608b9",53,46,36,10.3055555555556,28,25,2,1
"35696","f69476cfe36e23ad97b34d1bfe2ec5aa",154,84,71,15.1830985915493,154,0,3,3
"35697","f69854b62189baf57c1866db4bf9e506",34,34,0,34,0,34,1,2
"35698","f69939e2772832b30a77d0498aa26985",131,69,61,15.0327868852459,131,0,3,3
"35699","f69a00b902a3264cfac58edf631bf177",119,85,63,13.2222222222222,119,0,3,3
"35700","f69a4025d8d2a4b3865b21e38975f4ea",53,53,0,53,0,53,1,2
"35701","f69bc06f0fd25e9ffdc1912924626de2",29,29,0,29,29,0,1,2
"35702","f69c4d48b9305432c6943e5d4c2c6490",39,39,0,39,0,39,1,2
"35703","f69dd40665f6a99813c90aefca9761a3",42,37,28,10.5,42,0,2,1
"35704","f69e5b2b3a9fb3a4e91159a2e0b47c35",85,63,45,13.2222222222222,85,0,2,3
"35705","f6a003e4441b31c760cd114c98b29901",33,33,0,33,33,0,1,2
"35706","f6a0adac8472ba1886d39c68df0303cd",67,59,58,8.08620689655172,67,0,2,3
"35707","f6a97212b755380124aa831257488942",15,15,0,15,15,0,1,2
"35708","f6aa932c681a75809df7f5e7495c7299",15,15,0,15,0,15,1,2
"35709","f6ab8433ffd3de448147e0167e2770d7",61,58,34,12.5588235294118,61,0,2,3
"35710","f6ac166ad13f698beb365026ce082995",112,84,83,9.44578313253012,112,0,3,3
"35711","f6ac73aab33f4da5ced8205ded2adfec",19,19,0,19,0,19,1,2
"35712","f6afc87e5fe0fbfb616eebd4add5f0b0",98,66,74,9.27027027027027,55,43,2,3
"35713","f6b3ba99c4bccd6b1564c20cab401dd6",13,13,0,13,13,0,1,2
"35714","f6b457cd76fb26c7acfd65cdf7f900aa",91,69,79,8.06329113924051,64,27,2,1
"35715","f6b4b580a8363d175d7005d4db14b996",37,37,0,37,0,37,1,2
"35716","f6b76e10cb6e700a668aed896af2c639",18,18,0,18,18,0,1,2
"35717","f6b85fe5861945d1a8fed924e25955fb",181,117,49,25.8571428571429,131,50,3,3
"35718","f6b99ffd1c52b28f3d5a7b803b08a9bf",31,31,0,31,0,31,1,2
"35719","f6baf35f058c5755579bf55790e0d412",32,32,0,32,32,0,1,2
"35720","f6bd08e5f2ddc5c972b40069dcd528b5",87,66,21,29,87,0,1,2
"35721","f6be588ec6f31cd571deb5253a0240fe",178,108,69,18.0579710144928,178,0,3,3
"35722","f6be7edf74ae709c730f28dbaff0c552",112,88,75,10.4533333333333,112,0,3,3
"35723","f6c1d11078f6aa9c23e5ebb0d23cd264",17,17,0,17,17,0,1,2
"35724","f6c29e78162e343a1949a601b9075d5e",28,28,0,28,28,0,1,2
"35725","f6c2b12eae2cbe1bdb7da639ee92edd8",85,51,52,11.4423076923077,85,0,2,3
"35726","f6c3b4c0ab9cf6f2078ce314ccca8348",104,58,68,10.7058823529412,104,0,2,3
"35727","f6c79d9fd9c22d8966f5b6ed2ead9323",125,106,27,32.4074074074074,125,0,3,3
"35728","f6c92df57b2ceacbd33021975cd53007",79,67,46,12.0217391304348,43,36,2,3
"35729","f6ce783cf7f316bca67a071f920aad57",13,8,56,1.625,13,0,2,1
"35730","f6cf0af23168338e4721585d2657cc5e",50,50,0,50,50,0,1,2
"35731","f6d004f3baabda229a5dd1623db7d5ba",16,16,0,16,16,0,1,2
"35732","f6d2a9593e326dfffa0ea9220c077a6a",27,27,0,27,27,0,1,2
"35733","f6d68e3a2b4c141468885c9e03c6b71d",79,67,73,7.57534246575342,66,13,2,1
"35734","f6d7c6ec16cb601f5ca0304002d3e7fd",25,25,0,25,25,0,1,2
"35735","f6d99098c32ff633a589cb4cf21f066a",79,43,62,8.91935483870968,79,0,2,3
"35736","f6d9afdb6976c07c6bf6a8c7517de7dc",26,26,0,26,26,0,1,2
"35737","f6d9e081c551a2e1283c71bb89642568",79,73,10,55.3,79,0,1,2
"35738","f6e038b72620d1475f7605e0c55d62ba",134,55,62,15.1290322580645,134,0,3,3
"35739","f6e332a678c423472d47df1914663944",29,29,0,29,29,0,1,2
"35740","f6e6a9afa3d089da38416f72e9dafee9",19,19,0,19,19,0,1,2
"35741","f6e96206edee441c4df3332415a52623",79,46,67,8.25373134328358,71,8,2,1
"35742","f6ed306f36a2284e6d1b412d7790211e",130,78,86,10.5813953488372,130,0,3,3
"35743","f6efe0e4084c0cdfe436e6413abdedf4",58,42,56,7.25,58,0,2,1
"35744","f6f0b40148dd861590a80476df5aeae8",80,73,10,56,47,33,1,2
"35745","f6f0fadcafa264ba1a6760a87916d6b7",155,84,89,12.1910112359551,118,37,3,3
"35746","f6f21cc91af08f058a9441809877d890",134,94,88,10.6590909090909,112,22,3,3
"35747","f6f2dfe0aaf51598c3ab947e134db15c",191,78,86,15.546511627907,175,16,3,3
"35748","f6f3cf3f585622aabbbd7e1a7d5a67dc",54,51,52,7.26923076923077,33,21,2,1
"35749","f6f68ec39e0b61d2cecc71ebc5549128",66,55,46,10.0434782608696,66,0,2,3
"35750","f6f6b016adea86d74ef81381c82bc506",27,24,17,11.1176470588235,27,0,1,1
"35751","f6f7310250724f2286425e5460ce9963",199,67,83,16.7831325301205,181,18,3,3
"35752","f6fc2307fce2726e5262d23bad54e666",119,99,61,13.655737704918,119,0,3,3
"35753","f70007cf15bcfee56de63b78382fa108",21,21,0,21,21,0,1,2
"35754","f7024724c44fda8a41c4d95f5d6ebc5e",46,41,39,8.25641025641026,46,0,2,1
"35755","f70281fdf2269c5f1d8ed390335a5e0b",102,47,67,10.6567164179104,67,35,2,1
"35756","f706895917d4818585688b6856fd354b",86,52,62,9.70967741935484,86,0,2,3
"35757","f7073d19a35a0a0f67089f34b7480bd9",35,35,0,35,35,0,1,2
"35758","f708d1842ee3c1bf4dc5bcdb361a1d65",19,19,0,19,19,0,1,2
"35759","f70971e66450c96a536807cd24f4857b",37,37,0,37,37,0,1,2
"35760","f70f5835761b914ebf5b901618de9d7b",46,42,0,46,46,0,1,2
"35761","f7127d3eb8e9e6f6bdce3759d58d4670",12,12,0,12,12,0,1,2
"35762","f7132cb02785fbc0e2094e1c4ad5a799",4,4,0,4,0,4,1,2
"35763","f7134c03d9c98714dce40146e5a805dd",44,44,0,44,44,0,1,2
"35764","f716c662f3631ae460f1a4cc85a77b25",14,14,0,14,14,0,1,2
"35765","f717d8f6031c89ea33a290d634abe4fc",104,50,89,8.17977528089888,104,0,2,3
"35766","f71b17d2f19bba340425bbb5897daf7a",87,64,86,7.08139534883721,65,22,2,1
"35767","f71ba2bb40f49f1de34f7e30c887bf20",101,75,28,25.25,101,0,3,3
"35768","f71ccba39b51fc7ac4f75ccf090f105b",121,74,75,11.2933333333333,121,0,3,3
"35769","f71ccebf69e5e191b2631b7586bc0604",1,1,0,1,1,0,1,2
"35770","f71ceb1f6e283e60ee6f2de86bac257b",212,109,88,16.8636363636364,194,18,3,3
"35771","f7206300d28543f2d9a3d0d32108bbb5",181,86,84,15.0833333333333,181,0,3,3
"35772","f72116a673c783e6aa71aadb7c841a3b",2,2,0,2,2,0,1,2
"35773","f72406af36cb5a706c59cf7a0e17fe31",45,45,0,45,0,45,1,2
"35774","f724bdf29cd2c1b47e26fc77042ea97b",23,23,0,23,23,0,1,2
"35775","f724cd844d658cf9898e5ed98bdf4e32",42,42,0,42,42,0,1,2
"35776","f725b4123c559f21e8d4fc8102a7cbd8",53,46,10,37.1,53,0,1,2
"35777","f7260b878a9f1ad4f0ec231f9efa5f4e",16,12,23,4.8695652173913,8,8,2,1
"35778","f726b7e1a5aae5727ff7a0b8aeec498a",21,21,0,21,21,0,1,2
"35779","f727311cabde1a739c051ba59a886780",15,15,0,15,15,0,1,2
"35780","f727f224a205ee46455470a76067a3a5",4,4,0,4,4,0,1,2
"35781","f72d9b7e3e36499e4f5e647448157fe7",17,17,0,17,17,0,1,2
"35782","f72dbdf5606b62ddb733b4c46689f9b0",77,69,70,7.7,77,0,2,3
"35783","f72e19a444e85767aa014d806a6324f7",21,21,0,21,21,0,1,2
"35784","f72f21acde54a8b89ed25b1f9523690a",154,102,68,15.8529411764706,124,30,3,3
"35785","f731ebae22226940340cf63f815d9a7a",29,29,0,29,29,0,1,2
"35786","f7332046215552ed38662ad39845ebe2",29,29,0,29,29,0,1,2
"35787","f7332ca0ae406769e1a7c8ef72931911",79,64,62,8.91935483870968,79,0,2,3
"35788","f73504f112d2d31b874595f066a47514",140,99,77,12.7272727272727,108,32,3,3
"35789","f7361537a6abec275377f540607bd530",30,26,51,4.11764705882353,21,9,2,1
"35790","f738077e5ec92b4d952149cd9a3532db",102,76,61,11.7049180327869,102,0,3,3
"35791","f739cae8d0f7f9957b8bc287a3e0a96e",50,49,62,5.64516129032258,50,0,2,1
"35792","f73bf78aecac1bf3c4cd6aa5f2523574",59,42,24,17.2083333333333,59,0,2,1
"35793","f73c3b2692156a0134629c3bea29cdcc",12,12,0,12,12,0,1,2
"35794","f73ced5da4a42aecbc2998a921815499",41,37,26,11.0384615384615,21,20,2,1
"35795","f73e39b8acd5a1dd941f93eee0bda47e",48,48,0,48,48,0,1,2
"35796","f73f1b20148752b12003ae646ad2da87",54,54,0,54,54,0,1,2
"35797","f7403eae0fa07abe9cd80b5adab11898",52,52,0,52,0,52,1,2
"35798","f743b84400f101a59b6b75a24b704cdf",3,3,0,3,3,0,1,2
"35799","f7452e5d3d76f11669dfcc499d09fdee",97,81,29,23.4137931034483,97,0,3,3
"35800","f745fe3ebf7f35aa84430b41a6699777",18,15,22,5.72727272727273,18,0,1,1
"35801","f74790c3ba3bffd2eb105cf0f1fbac4c",58,35,77,5.27272727272727,58,0,2,1
"35802","f74dfc45cc1bbae73a6258068c724e7a",83,52,34,17.0882352941176,54,29,2,1
"35803","f74e5b1ad07cac746eef4a25f76cc739",54,35,61,6.19672131147541,54,0,2,1
"35804","f75100caa41df53230d7a22d340255eb",34,34,0,34,34,0,1,2
"35805","f75297f5d9305fe287e10dfd16198096",38,38,0,38,38,0,1,2
"35806","f752b44a3844650d8def0d27074d8851",22,22,0,22,22,0,1,2
"35807","f754e9cf69be116be2f2c16705340738",29,29,0,29,29,0,1,2
"35808","f7553bb6458807994da8ef1a491aa7c4",17,17,0,17,0,17,1,2
"35809","f75655766d1927b13fd41f2bab676377",79,66,25,22.12,61,18,2,1
"35810","f75677a68a38cc2b16422ad955db1f0a",52,52,0,52,52,0,1,2
"35811","f7597d30c8acd758aca4d45764fecbf6",33,28,5,46.2,33,0,1,2
"35812","f75e726546014c0dbee1d94420ec4da1",37,23,35,7.4,28,9,2,1
"35813","f7628c6f77cfcb5bc01159f1dd6e0710",104,86,51,14.2745098039216,104,0,3,3
"35814","f76333d4339c16a793ce0c6ff7ad9e7a",63,57,63,7,63,0,2,3
"35815","f766fbda56df03a617d8a17d9c334bff",32,32,0,32,32,0,1,2
"35816","f768956f842c99bf6312715730b5380e",76,53,31,17.1612903225806,76,0,2,1
"35817","f768f51689895136ebfaa99f9ad20372",19,19,0,19,19,0,1,2
"35818","f76a897e3eace6c6c69af3c32eb2604d",69,59,47,10.2765957446809,69,0,2,3
"35819","f76e48484e72d5452d1726dfc9059d87",147,105,80,12.8625,147,0,3,3
"35820","f777307b846f029165b77d904acf6ec9",8,4,77,0.727272727272727,8,0,2,1
"35821","f7797eaab41ef79bc2a10e6a485f0079",39,39,0,39,39,0,1,2
"35822","f77d7bff47f59aa9e9a4575963d379d4",37,37,0,37,37,0,1,2
"35823","f77d835250e13903b5afc86d9bace632",40,40,0,40,0,40,1,2
"35824","f77e70d23def2ee3b2972e4e8aad9205",25,25,0,25,25,0,1,2
"35825","f77e8f14e5a0222d502a63290f4997fb",96,55,47,14.2978723404255,96,0,2,3
"35826","f7806b68aa28eed7c35fefb9b93d4b2b",30,30,0,30,30,0,1,2
"35827","f7817325657311459b5147ab28c21681",186,95,65,20.0307692307692,186,0,3,3
"35828","f78c31ac1ee54c4218962269516b146c",43,34,20,15.05,28,15,1,1
"35829","f78cbb513f953166e4fd206c92edf4d6",33,33,0,33,33,0,1,2
"35830","f78d43f2fac98b3a7b413ae8049be428",32,32,0,32,32,0,1,2
"35831","f790f13c971372341d92c34215db0bba",42,34,67,4.38805970149254,42,0,2,1
"35832","f791adea005f30703bfa62d25fe65dc1",117,66,59,13.8813559322034,117,0,3,3
"35833","f79477131ed8cf495cf23586f43c8e4b",180,80,64,19.6875,180,0,3,3
"35834","f794b2125988a39cf868af2792083957",46,45,24,13.4166666666667,1,45,2,1
"35835","f7959f5b1022a80318ef7c14af292bdd",64,40,49,9.14285714285714,64,0,2,1
"35836","f7961f2f0ef6299f1be6b30302c5c6f0",18,18,0,18,18,0,1,2
"35837","f7966a3ca759e72b46f853ddf72c729f",201,97,83,16.9518072289157,166,35,3,3
"35838","f798c02f8b726114764e339ba60ea1fe",80,52,20,28,43,37,1,1
"35839","f79a6c8df660d73381c67cff8b0dc509",183,119,67,19.1194029850746,134,49,3,3
"35840","f79b2e950c1e81d6578ce0678b92b327",118,64,70,11.8,118,0,3,3
"35841","f79dd1d6b87492b8e3c7b2cd6809c29d",133,90,42,22.1666666666667,133,0,3,3
"35842","f79dfd3b53f99d4fbb844a8cf4e72c6e",29,24,30,6.76666666666667,18,11,2,1
"35843","f7a06fcafb37cbeaa0ed1ed1e6451ad2",15,15,0,15,0,15,1,2
"35844","f7a2503a987345a36b441f161d9a510e",20,20,0,20,20,0,1,2
"35845","f7a30fe50b04a57eaf83dd4910fa2aba",72,45,14,36,72,0,1,2
"35846","f7a3408de5573a461f029432f3468baa",35,32,15,16.3333333333333,19,16,1,1
"35847","f7a353f1766b0b555d3efac95eaa7c04",25,25,0,25,25,0,1,2
"35848","f7a6f9298c6bba9d2ac76a7ea8df423f",16,16,0,16,16,0,1,2
"35849","f7a740d16dfdf345a85b0f7afb6d8546",49,44,19,18.0526315789474,26,23,1,1
"35850","f7af2b8e80c159552251d789afb5e9ca",54,53,41,9.21951219512195,54,0,2,1
"35851","f7b0bd06091adfb7e187c4f1311da04b",54,33,58,6.51724137931034,54,0,2,1
"35852","f7b0fbea18b0c8ad443aa9c4289e53e5",116,88,31,26.1935483870968,116,0,3,3
"35853","f7b4852a541b2af7b36d5741073e1edb",37,37,0,37,37,0,1,2
"35854","f7b7607273752ea8fc866c85728bfcca",142,60,82,12.1219512195122,122,20,3,3
"35855","f7b8ad408e09ce0c7bc0b0ddbdb29f6c",30,30,0,30,0,30,1,2
"35856","f7b8badb428578be5f711514eb862539",27,27,0,27,27,0,1,2
"35857","f7b93e44f75318ac2f1df451a511a7d4",44,44,0,44,44,0,1,2
"35858","f7b994210b861b133ada8a1779c0c060",98,76,48,14.2916666666667,98,0,3,3
"35859","f7be66a2c3cdf4b75b6bee3d53a89482",140,77,63,15.5555555555556,140,0,3,3
"35860","f7c0a43a87016cbd0c0215694f670845",73,54,52,9.82692307692308,73,0,2,3
"35861","f7c2de3cdc84e516fdfa7d7a68abee38",140,93,73,13.4246575342466,119,21,3,3
"35862","f7c6b2f9e1b12e3c2f25bd6c35d33c67",79,59,25,22.12,36,43,2,1
"35863","f7cdaf036cbf5c3a61e55402054ac05d",145,94,73,13.9041095890411,145,0,3,3
"35864","f7ce61cd6a94aca39f8e1db28d11e58a",18,18,0,18,18,0,1,2
"35865","f7ce8b042da4e383a4825a8ddf989a2d",18,18,0,18,18,0,1,2
"35866","f7cebbe69c2f484bef2b4630c9c40c45",7,7,0,7,7,0,1,2
"35867","f7cf25a5ee3b1c5f85ee95f15a15d361",39,34,22,12.4090909090909,39,0,2,1
"35868","f7cf2daee23e0d925cdf13cec5d940cf",30,30,0,30,30,0,1,2
"35869","f7d3afb9e5904fbe92237329829e78a8",60,57,44,9.54545454545454,15,45,2,1
"35870","f7d4c2d70958a55e1188abb800a5240f",109,76,22,34.6818181818182,109,0,3,3
"35871","f7d68ad164798ea71496896a322cac9f",10,10,0,10,10,0,1,2
"35872","f7d91bf7a86e97aa83a5911edc5e9f4f",32,27,7,32,32,0,1,2
"35873","f7d9c9bd91c2b6d2dd9c9d567e7d9725",79,42,75,7.37333333333333,79,0,2,3
"35874","f7da656cea4866dd918fbd16ddada2ac",51,51,0,51,51,0,1,2
"35875","f7dbdbfbbadc99e18486e42d1cb82877",11,11,0,11,11,0,1,2
"35876","f7de76da22644c4fe94e5bfa080713c6",116,89,81,10.0246913580247,65,51,3,3
"35877","f7df9aff2a340703b022d86567f6ac5d",35,35,0,35,35,0,1,2
"35878","f7e12c8ded9ccf5b689e01fbd900aa0a",20,13,54,2.59259259259259,9,11,2,1
"35879","f7e3708c2fe7354c1f156578e8314b90",146,97,64,15.96875,146,0,3,3
"35880","f7e40e81082704d5469c1bd3ae8d8693",80,52,60,9.33333333333333,33,47,2,1
"35881","f7e4f94e409682c16cb2f44b7bd91563",67,52,63,7.44444444444444,67,0,2,3
"35882","f7e70edf45f77b52736026dbc8dd780c",142,60,71,14,142,0,3,3
"35883","f7e77f5eaf1e7b4e9fd0f308a6d70e01",20,20,0,20,20,0,1,2
"35884","f7e80f16bd3cba4e824a5b7e0d6890e3",163,93,71,16.0704225352113,129,34,3,3
"35885","f7ea6c872fe77f6c9a1f2095dc42fcd0",24,24,0,24,24,0,1,2
"35886","f7ea96e0df2118c729f23083a9396225",215,94,77,19.5454545454545,177,38,3,3
"35887","f7eace16e07e3799bef7b1c29db1d7b3",115,79,65,12.3846153846154,115,0,3,3
"35888","f7ec1827dfd77df25a9012368809e98b",157,105,62,17.7258064516129,157,0,3,3
"35889","f7ed6eb9d58ab83b4a7a5491175f95d0",2,2,0,2,2,0,1,2
"35890","f7eda7a46ac023fe22b8133f871da228",30,30,0,30,30,0,1,2
"35891","f7f189bb2642e45c9f2fe2e34057e6d8",40,40,0,40,40,0,1,2
"35892","f7f1ad5e08a158b9868b27a31272831d",43,27,47,6.40425531914894,43,0,2,1
"35893","f7f20c0ebe24d9eef289217c2d27528f",222,87,74,21,180,42,3,3
"35894","f7f2d1fd697fafe9bbccbc519e96aadd",13,13,0,13,13,0,1,2
"35895","f7f500b289373d2259ab44f36274520d",19,19,0,19,19,0,1,2
"35896","f7f76db78802bb32d00639fbb5c7f2eb",9,9,0,9,9,0,1,2
"35897","f7f792f9d761ef05f85e26f44c1eb6c0",96,66,56,12,96,0,2,3
"35898","f7fb06a5b173f8c336a6c3aa28ff4d4c",46,33,37,8.7027027027027,40,6,2,1
"35899","f7fc404c490ed340245a837ec95b7a01",51,44,11,32.4545454545455,51,0,1,2
"35900","f7fc4a29b02de772a56b5dd7c2973068",73,60,38,13.4473684210526,73,0,2,3
"35901","f7fcbbf0a02dd9838326bf83a99d0477",189,114,29,45.6206896551724,189,0,3,3
"35902","f7fd70478353148cf165304d5bd26569",19,19,0,19,19,0,1,2
"35903","f7fdc82d9e268f3b898cd2f2b8cbc941",40,34,45,6.22222222222222,18,22,2,1
"35904","f802aee8fd260abe801e992f2a90f52b",97,63,19,35.7368421052632,97,0,1,2
"35905","f803e92386f83d662cbc092b90011cf5",26,25,28,6.5,0,26,2,1
"35906","f804303c052495dac2df20a4b79880a4",5,5,0,5,5,0,1,2
"35907","f8045c24189d4f00a586e7628fc900ed",14,14,0,14,14,0,1,2
"35908","f8048be239ff67457f0f47cb4fff2835",58,40,42,9.66666666666667,58,0,2,1
"35909","f80581594902d16c92ce408bfe9b1a76",110,82,27,28.5185185185185,57,53,3,3
"35910","f805b249bbafaa2a91aa8249860952b4",4,3,36,0.777777777777778,4,0,2,1
"35911","f808649d2e406e12c9a3223b5bc9d6cd",42,42,0,42,0,42,1,2
"35912","f80b378367ab23dd428a73a82b432703",43,43,0,43,0,43,1,2
"35913","f80b81d9e8953483ec2a0e60d84f4caf",90,40,54,11.6666666666667,73,17,2,1
"35914","f80bc8061ff2d524b2c5f8b9b8e1d06f",137,96,69,13.8985507246377,137,0,3,3
"35915","f80e5613e7378c49c30f9f748f140e5e",37,37,0,37,37,0,1,2
"35916","f80efc65aa803101c927166f86457aae",4,4,0,4,4,0,1,2
"35917","f811888117a5dc4f370bb4feaa26e79c",34,34,0,34,34,0,1,2
"35918","f8121ba43b3664eb27ab476210c87371",52,52,0,52,52,0,1,2
"35919","f81551ce67fa4a02b18c38a447dc5e3d",58,52,41,9.90243902439024,58,0,2,3
"35920","f8182a44f8e537114ae5c51dcd31aa9c",20,20,0,20,20,0,1,2
"35921","f81a43037adaa061eec453de7f2c2996",112,64,74,10.5945945945946,112,0,3,3
"35922","f81b90fce2d0e0828055699997a3864d",46,38,28,11.5,46,0,2,1
"35923","f81e98fc92ee977f2ba6dec5888e39ae",183,91,81,15.8148148148148,156,27,3,3
"35924","f81ecdc4972d4732367a51a415e2f1de",133,100,64,14.546875,133,0,3,3
"35925","f81f8860ad071192706cdca6a76cf9d6",40,40,0,40,40,0,1,2
"35926","f823b141737d69bb354243b457de2c41",153,94,78,13.7307692307692,109,44,3,3
"35927","f824c8d0f1c923ee7aa4f085e829b953",29,29,0,29,29,0,1,2
"35928","f8272dd51ceff3139aabe52b1fdc7cd6",155,90,32,33.90625,155,0,3,3
"35929","f827dfe776c6ae307af0262fd2d9b310",66,47,50,9.24,66,0,2,3
"35930","f8299bbea530fd715cd0be220d9f0acf",47,47,0,47,47,0,1,2
"35931","f82adf41fff51f8dc18b5016c2027fd9",63,47,41,10.7560975609756,63,0,2,1
"35932","f82b7a84bac3ca10cbd9bb5a24245a0a",31,28,10,21.7,31,0,1,2
"35933","f82cde1fd7feae168830b91cfa7fc4a6",149,104,60,17.3833333333333,149,0,3,3
"35934","f82fea5ff14d50f9e65f5cd7d0ea26df",30,30,0,30,30,0,1,2
"35935","f8321c9640b01e7e175c2e5db33df41c",30,26,16,13.125,16,14,1,1
"35936","f832bbc1e880720ca901789e800f8f0f",13,13,0,13,13,0,1,2
"35937","f83330849f114bccdabfe3364be83543",50,50,0,50,50,0,1,2
"35938","f834991f7ffc6e75101e75534d60bcd1",24,24,0,24,24,0,1,2
"35939","f834cdbd2c9acb6750a4a54dfea2679c",37,37,0,37,37,0,1,2
"35940","f835ddd1f3c5097e7a33e085fdf9a0f6",44,44,0,44,44,0,1,2
"35941","f838ae697c7158118bc98f10fdbec9f5",23,23,0,23,0,23,1,2
"35942","f83ccbfd7ed14c98ae383c1c961182fa",31,31,0,31,31,0,1,2
"35943","f83dc6ade675b838566c27502d2cb7be",31,31,0,31,31,0,1,2
"35944","f83e5051abd6b9b9e381baa59e7ae7c7",25,25,0,25,25,0,1,2
"35945","f83fe2ae5ada3b799e199f4bb52724c1",198,104,42,33,198,0,3,3
"35946","f8411dab884be87b42eb1eb39e677110",31,31,0,31,31,0,1,2
"35947","f8416557d3dee6bc388e4578e403fbbc",134,95,50,18.76,134,0,3,3
"35948","f8469cf3b3bc32165c6a29cd23553bc6",151,116,42,25.1666666666667,151,0,3,3
"35949","f8487210fd0a7e2a06fda14447e25264",55,46,61,6.31147540983607,55,0,2,1
"35950","f848eaced9426ed3bb48a11761d27f4a",21,17,31,4.74193548387097,21,0,2,1
"35951","f849da7459e5f85789a897d574fdca24",10,10,0,10,0,10,1,2
"35952","f84ab687d642d2b2da20b9f27673d64b",22,22,0,22,22,0,1,2
"35953","f84b3e3f1bb5ef71132c6a6486dda94e",31,31,0,31,31,0,1,2
"35954","f84d2f220248040b6f53778b08770530",58,53,71,5.71830985915493,58,0,2,3
"35955","f84dbe4540a54e065eab71ea98e0aa43",54,33,68,5.55882352941177,39,15,2,1
"35956","f84e7921b4ca376c90ea8d1a1d072471",132,89,66,14,92,40,3,3
"35957","f85078fed8376d006f0ae33c91d35281",36,36,0,36,36,0,1,2
"35958","f8528a25b5ce816e50890dcf679726cc",39,28,49,5.57142857142857,39,0,2,1
"35959","f852b25d86fd77e29d1d5bc65418c3be",30,30,0,30,30,0,1,2
"35960","f85389c8a74bbc574a176cdf4c3092a0",111,60,73,10.6438356164384,111,0,3,3
"35961","f853aca75ece2a515e0595bc53c1a9ff",64,49,40,11.2,42,22,2,1
"35962","f85627f0076629aa253a0d65bf9d5c4a",114,69,58,13.7586206896552,114,0,3,3
"35963","f857321d9504c0648f669337359c8620",28,28,0,28,28,0,1,2
"35964","f857b1499950fd57f881b8237abf93db",97,53,63,10.7777777777778,65,32,2,1
"35965","f8589496553a6dcac0f702150c0f43d3",80,67,16,35,48,32,1,1
"35966","f85a78b158ae6f43afe968ef6569b1df",74,48,70,7.4,74,0,2,3
"35967","f85aa2f172ee1ad04db4bab2112ec259",36,36,0,36,0,36,1,2
"35968","f85baf99bbad96a3eb2d70e507ac8b9d",108,63,65,11.6307692307692,108,0,3,3
"35969","f85cb098d77800cd1c20c01c30c0184a",46,28,49,6.57142857142857,46,0,2,1
"35970","f86143191da2509fc656c21583806130",44,34,44,7,22,22,2,1
"35971","f862f6ec6e22ecd99511bde47d5fff2f",112,74,69,11.3623188405797,66,46,3,3
"35972","f863e2a3fb4eeb9aa85166daf1f1871b",6,6,0,6,6,0,1,2
"35973","f86535051ccc5de4aee0a71dd2126ad5",10,7,67,1.04477611940299,10,0,2,1
"35974","f8692fa7945a2bee56ae3f7fd3006fb5",98,55,64,10.71875,84,14,2,1
"35975","f86999a0d640a81ae40db0dde3e80743",41,41,0,41,41,0,1,2
"35976","f86c73b043369fff6a59c0584e385f35",96,69,69,9.73913043478261,96,0,2,3
"35977","f86d6c2f5a53152edf5bb4d993d81f8e",96,68,70,9.6,96,0,2,3
"35978","f872444221452dbcbeeef039b49d6550",2,2,0,2,0,2,1,2
"35979","f872e062e93afbd4a57e810346871816",192,111,71,18.9295774647887,163,29,3,3
"35980","f8744126d6f331e4d6f893928b339804",73,53,63,8.11111111111111,57,16,2,1
"35981","f874ff90c40a5deb1029789b8d2502b4",136,77,72,13.2222222222222,103,33,3,3
"35982","f87aabbcdceb962ff5b46eee7e2ecdb2",5,5,0,5,0,5,1,2
"35983","f87debe05ae02015361c9a96ba6b5aab",107,71,49,15.2857142857143,107,0,3,3
"35984","f87f26cbf04b2ac4405531b5d8c00e61",121,72,61,13.8852459016393,121,0,3,3
"35985","f8802c74b4e81f2d3ad3559d0d61d89b",24,24,0,24,0,24,1,2
"35986","f88168e9190d3dcd1ee5ab362d037fab",30,30,0,30,30,0,1,2
"35987","f8819b6b8235a5ba1469dfaee1579181",174,132,82,14.8536585365854,120,54,3,3
"35988","f88213fe485e439875696c6937340fa8",27,27,0,27,27,0,1,2
"35989","f884cf8b52b10702cd64182e3ddf9b9e",187,138,89,14.7078651685393,187,0,3,3
"35990","f886d61f501ff8f3db1781d5e4f697a1",42,35,66,4.45454545454545,17,25,2,1
"35991","f88734803d7592eef19e843d452e6a4c",27,15,72,2.625,27,0,2,1
"35992","f88a1f080351d5cd6b40d2442c90bf00",26,25,30,6.06666666666667,26,0,2,1
"35993","f88cff2ce4a16438a70d16c44518137f",21,21,0,21,21,0,1,2
"35994","f88cffd781bf4687f22e68fb7c2fddfe",118,69,61,13.5409836065574,118,0,3,3
"35995","f88e0bf0aaf43f2cd2d8695d91b45176",66,54,49,9.42857142857143,66,0,2,3
"35996","f890265f7ad5505ffbde1c5224c2d181",99,52,52,13.3269230769231,65,34,2,3
"35997","f890ee9fa7f81c22b5e307f21acd4e3d",110,48,65,11.8461538461538,84,26,2,1
"35998","f892255c6e8db22d1f499e23d2b9ff94",106,72,35,21.2,106,0,3,3
"35999","f892530bb89f85022d59e3385fa6f5e9",12,12,0,12,12,0,1,2
"36000","f892cbe1f8b036fc9a0552cc1b7c19d8",39,39,0,39,39,0,1,2
"36001","f89534da1a54ba9aa02657e83e67773e",28,28,0,28,28,0,1,2
"36002","f89a8dccdc03ef2c487a2d09c277531d",41,41,0,41,41,0,1,2
"36003","f89bcc09007ebbab63f42693b410e0d3",13,13,32,2.84375,13,0,2,1
"36004","f89fc432aaa4d53be403956bf6ceb15e",146,64,64,15.96875,146,0,3,3
"36005","f8a1359a1b5209d5bd1abae02ffae2fc",59,52,38,10.8684210526316,59,0,2,3
"36006","f8a16946a5ffc6739b219a620cdd4d62",79,66,36,15.3611111111111,35,44,2,1
"36007","f8a6917dafe5590788fbb9d2e5ec7b2e",9,9,0,9,9,0,1,2
"36008","f8a7425a1706550769c176535882b618",86,66,22,27.3636363636364,55,31,2,1
"36009","f8a81d47920e9fde658ab4aba5d91f2b",10,9,28,2.5,10,0,2,1
"36010","f8a946f10dc4fad4e36f99117357d3a4",52,46,47,7.74468085106383,52,0,2,1
"36011","f8abab893a16ef79519b56e0d8c8cea4",35,35,0,35,35,0,1,2
"36012","f8af5c8f4650e6cadde969f3e9342603",22,22,0,22,0,22,1,2
"36013","f8b050c8148f5ebf084f810c24aeb13d",23,18,30,5.36666666666667,23,0,2,1
"36014","f8b119f3f330b5643b780a3a2793e95a",13,13,0,13,13,0,1,2
"36015","f8b35570161d6bb3cc9a8b536c60cb23",51,42,34,10.5,51,0,2,1
"36016","f8b3fd877b8dee3e2807bfb49ef39f7c",12,12,0,12,12,0,1,2
"36017","f8b4ed4097f0c30186eba60b1d1e3798",172,105,61,19.7377049180328,132,40,3,3
"36018","f8b77f8e2ba826d0ee898d5b0cbf4f30",21,21,0,21,21,0,1,2
"36019","f8b8a3e5e3296234b0b51b1724a72a67",133,70,81,11.4938271604938,133,0,3,3
"36020","f8b8d64bc821cb7523f676c9643c24f9",70,59,23,21.304347826087,70,0,2,1
"36021","f8b9206847db9f1ab3c84401d95363b7",35,35,0,35,0,35,1,2
"36022","f8b9cc4c0453916773c3e0fb17f54be2",159,97,64,17.390625,159,0,3,3
"36023","f8ba17c802d0d11a005da3b772c2a6bf",101,66,67,10.5522388059702,101,0,2,3
"36024","f8ba24a2aa8607ec49e1cdfaee27e464",10,10,0,10,0,10,1,2
"36025","f8bbbd4cfd6e704fe2c57f7fdb6d79cb",45,44,11,28.6363636363636,45,0,1,1
"36026","f8bd9e9321fa519cf24ded3de74e8f17",49,49,0,49,0,49,1,2
"36027","f8bf140d176736d6f1e375f6e60f3a01",62,54,18,24.1111111111111,62,0,1,1
"36028","f8c05c3003b88c07ddf0adc5787697f8",27,27,0,27,27,0,1,2
"36029","f8c1c25d823b1d24205690998b5cfb4b",46,46,0,46,46,0,1,2
"36030","f8c48865c19a8f5433ead4cd61eaf402",202,75,89,15.8876404494382,182,20,3,3
"36031","f8c5ab5618c25cfec16ee1a3612437c3",71,60,53,9.37735849056604,47,24,2,1
"36032","f8c6a1f227ff8baac79d1fb210a6cb63",29,29,0,29,29,0,1,2
"36033","f8c8ed7072dfe988a69951004c11d9e2",92,64,75,8.58666666666667,63,29,2,1
"36034","f8ca1710e748ea25cb38892ab8dc4287",45,45,0,45,0,45,1,2
"36035","f8cb96ea4387d78a96d04ab0d13a9cbe",6,6,0,6,6,0,1,2
"36036","f8cbbf5b3783088e737baa282dd97d3c",27,27,0,27,27,0,1,2
"36037","f8cc6adf91b3c623d37c6162cb9fe9f3",95,80,70,9.5,95,0,3,3
"36038","f8cdea591fa986a34e9b4dab99733f4a",65,45,59,7.71186440677966,65,0,2,1
"36039","f8ce16ca48e2f191af93e5e582d74273",1,1,0,1,1,0,1,2
"36040","f8d093f4cd17f9724f9e71da27c4d2a7",37,34,8,32.375,37,0,1,2
"36041","f8d1ef2b893ea1ed067bf1af036fa60d",19,19,0,19,19,0,1,2
"36042","f8d70706455f8ff26d249f8d25a10974",27,26,4,47.25,1,26,1,2
"36043","f8da1a04758d9d6bc7638d80bbc43a35",70,58,16,30.625,70,0,1,2
"36044","f8da61a4bc395ea93523fe1e076004b7",26,26,0,26,26,0,1,2
"36045","f8dca56ec660cf29bf6d77dae62264d5",4,4,0,4,4,0,1,2
"36046","f8dd45c98555fec15a786f7cbef60266",58,45,53,7.66037735849057,26,32,2,1
"36047","f8df84f9246a372be15b2ec692ac695c",29,29,0,29,29,0,1,2
"36048","f8e09a3df715f6d10769f762b241237a",15,15,0,15,15,0,1,2
"36049","f8e0e1103d260cef5ea65a91ea4445a7",100,47,90,7.77777777777778,100,0,2,3
"36050","f8e2732078ceffd31c9beb89b551c201",33,33,0,33,33,0,1,2
"36051","f8e2b101e28799f7d532ad684cf0d1ff",19,19,0,19,0,19,1,2
"36052","f8e3feb6788016cb54835e83dac64e73",36,29,35,7.2,0,36,2,1
"36053","f8e687f46a56131e25ecf361e1266188",39,39,0,39,39,0,1,2
"36054","f8e82339395f17f53664eea02a1685e4",88,76,35,17.6,88,0,2,3
"36055","f8e9b98a650d786e218db5743404ea24",33,33,0,33,33,0,1,2
"36056","f8ea82ccc0e6e1334c6d662e9a16b82f",36,36,0,36,0,36,1,2
"36057","f8ebe1775b330f8e4406d7205a38d7a8",5,5,0,5,5,0,1,2
"36058","f8ed12ad8b73ac716e8fea294bc6119b",82,65,72,7.97222222222222,82,0,2,3
"36059","f8eedb50e28e0edd56427d7b6a6605d5",152,79,59,18.0338983050847,117,35,3,3
"36060","f8f067625b6609148277b63d90bd9e72",74,61,14,37,74,0,1,2
"36061","f8f13d343b82e03b607ab4fa39135147",25,16,69,2.53623188405797,25,0,2,1
"36062","f8f2bc7859f738c11535f04589d9b4da",19,19,0,19,19,0,1,2
"36063","f8f44e2f7aa2917693ab83b6c1d15944",168,106,62,18.9677419354839,168,0,3,3
"36064","f8f45a18b4324c8fafa121379984290a",124,102,30,28.9333333333333,124,0,3,3
"36065","f8f758a8b24728f571c1b5667cfff4ca",4,4,0,4,4,0,1,2
"36066","f8f8f6b7b7b170656bff734e3f7516bd",105,69,60,12.25,65,40,2,3
"36067","f8f932d6d9596fb1455c04b9dde6079b",107,70,44,17.0227272727273,107,0,3,3
"36068","f8f9fa4184bb436153721647371428ba",12,12,0,12,0,12,1,2
"36069","f90081cba33133f04c79ade72c84c041",73,64,28,18.25,73,0,2,1
"36070","f90205ca1c0209da59ce6f7929347854",7,6,14,3.5,7,0,1,1
"36071","f9020e314680b4b1af572d34c2605e96",117,87,60,13.65,94,23,3,1
"36072","f90316566d5a936f97b27ee41d2dd7b4",3,3,0,3,3,0,1,2
"36073","f9039fad22384b54a3374d2a7d2ef24e",33,33,0,33,33,0,1,2
"36074","f90584490cdd5e816694a97225041f0e",75,53,35,15,75,0,2,1
"36075","f905e6fd9ecbc166ea46936a73896244",138,106,56,17.25,138,0,3,3
"36076","f90632d396055b473ee1fd372633127d",14,9,50,1.96,8,6,2,1
"36077","f906ddef7ca3b6b291268917d35c4d7a",37,37,0,37,0,37,1,2
"36078","f9088298484a4df0185661ef0e9c898f",197,107,56,24.625,197,0,3,3
"36079","f9098299a0bed2f3758a843008717165",87,69,63,9.66666666666667,32,55,2,3
"36080","f90d3c3c529b79e3c501624369e3aa28",85,54,77,7.72727272727273,85,0,2,3
"36081","f9113b15bc27ce5e2a8e1e7c7fb5ce7c",158,76,63,17.5555555555556,136,22,3,3
"36082","f912f8a25a92ab077f93d2edbdc553f6",16,16,0,16,16,0,1,2
"36083","f9160f17cae812931d16f135881d3121",35,32,57,4.29824561403509,35,0,2,1
"36084","f916f7c56f5b5aaa1929dd32b921e41d",23,23,0,23,23,0,1,2
"36085","f919a54ad5355412ad2a550bcd597966",85,60,44,13.5227272727273,85,0,2,3
"36086","f91a8ed4189a21b4a3b304d16859bf5b",39,39,0,39,39,0,1,2
"36087","f91aad2ef78f84c493f8ea55f98576b2",48,34,53,6.33962264150943,18,30,2,1
"36088","f91b13cff9792c7bf494c4f6511cd9d1",63,46,54,8.16666666666667,63,0,2,1
"36089","f91dddd892b85fc630fc356c9ee7ff98",38,32,15,17.7333333333333,38,0,1,1
"36090","f91df941767ed3db374d70609bec03ef",34,34,0,34,0,34,1,2
"36091","f91e22603e0dbbae468d34c89c51a18d",21,21,0,21,21,0,1,2
"36092","f91e8f4db07e21bebbeceeb54a4ecde2",31,31,0,31,31,0,1,2
"36093","f91f49c80cce8992912fcd35a333d0c3",121,74,28,30.25,121,0,3,3
"36094","f920bfab71847038505835e49eb9c6ea",9,9,0,9,9,0,1,2
"36095","f922866af3e84735ff35a58719ba8713",20,20,0,20,20,0,1,2
"36096","f92427b0536cf58341f3d10c7af1e287",106,61,56,13.25,106,0,2,3
"36097","f925335911bba823f5f8f65eded2face",104,86,65,11.2,104,0,3,3
"36098","f925ae0c6aaaacb4ea86f01ef49f29eb",69,61,79,6.11392405063291,50,19,2,1
"36099","f9261b60e82d390ba6295e162c03fd04",34,34,0,34,34,0,1,2
"36100","f926748be840f5784b0c561324828f6f",24,24,0,24,24,0,1,2
"36101","f9267e48fa9db68ac067c066f939cc3e",47,47,0,47,47,0,1,2
"36102","f926cf0bb1d235ee8e9ea16efd421f27",25,23,22,7.95454545454546,11,14,2,1
"36103","f927cd204bd6488356a071524aa6ce17",80,70,84,6.66666666666667,80,0,2,3
"36104","f929187e00377074e88cf8df727228b3",22,19,58,2.6551724137931,22,0,2,1
"36105","f92ab96e914cb90e1ca9c3dc01b97f05",20,20,0,20,20,0,1,2
"36106","f92ef32a670584512b4da074cd11a104",62,45,45,9.64444444444444,62,0,2,1
"36107","f92efa047eeccfe5009b9b547b81c88a",48,45,32,10.5,29,19,2,1
"36108","f931ff31b0c1de40c8220c560bc5c7ed",34,34,0,34,0,34,1,2
"36109","f933f4d16771a9140511d2e619c1f0a3",25,25,0,25,25,0,1,2
"36110","f934213d6e873f3c279e7793de2189ce",51,42,51,7,51,0,2,1
"36111","f934d0bf7f8a35ba0233a2108e791ee3",40,40,0,40,40,0,1,2
"36112","f935796ada083b43cb2c881f3e72ac65",92,68,56,11.5,69,23,2,1
"36113","f935a0820bee8b2331cf18b181f334bc",82,66,59,9.72881355932203,82,0,2,3
"36114","f93652ee16e8e047334265af97443dcf",59,47,56,7.375,59,0,2,1
"36115","f9374ed7cc415bb36e32a4361bc3dad3",26,26,0,26,26,0,1,2
"36116","f93b2a4db6ffd080b7aa3822bc3ef2eb",220,115,70,22,191,29,3,3
"36117","f93c32c70f8a2ae2353c1fd01a1704be",27,27,0,27,27,0,1,2
"36118","f93da6532346aa56651a4d6e3b9201a5",45,45,0,45,45,0,1,2
"36119","f93e1c0ac0ec2c1c14f0c4e238d24477",24,24,0,24,24,0,1,2
"36120","f94038a8391472fd2e89b23f8902a00c",53,53,0,53,53,0,1,2
"36121","f940819d270332d04c015a1567bf067c",182,84,72,17.6944444444444,182,0,3,3
"36122","f941fe09ad7c5c17421f4fcfca029d24",9,9,0,9,0,9,1,2
"36123","f94638abe31989e5696ae22851d28d35",22,22,0,22,22,0,1,2
"36124","f94811772a45f34764ed3e7dc9e1d0d5",8,8,0,8,8,0,1,2
"36125","f949f3ee7647b6c7a875bdbe93f6005a",18,18,0,18,0,18,1,2
"36126","f94b93dc402803e828a99f302a01db66",32,21,50,4.48,32,0,2,1
"36127","f94d0e04ee5113a103e9b0a626e89a75",81,65,68,8.33823529411765,81,0,2,3
"36128","f94e75ac58fae714eee935e903b379c1",34,23,47,5.06382978723404,34,0,2,1
"36129","f94e7872d479ce781cc0f5dd915868c4",11,11,0,11,11,0,1,2
"36130","f952f74da2ec0d6eef4e92a5f575a1b9",76,51,13,40.9230769230769,76,0,1,2
"36131","f954f66f239da4f67dd0679ae05e3c05",31,31,0,31,31,0,1,2
"36132","f95666e65e99671927540361d5f8ff1d",161,84,81,13.9135802469136,118,43,3,3
"36133","f958d5523b15792fa8a6e65ce38f0596",51,43,49,7.28571428571429,51,0,2,1
"36134","f95ae4af64e55aece24b208e1986706c",18,18,0,18,18,0,1,2
"36135","f95b75cd94fb14b0e7404f4b3f111804",114,94,57,14,114,0,3,3
"36136","f95bd85afe554a25f3a98eaf70501d78",50,29,64,5.46875,50,0,2,1
"36137","f965215ac76097795240699b6b5f8d19",36,36,0,36,36,0,1,2
"36138","f96e9498b7f4200788cb9a1b77ea495a",177,75,77,16.0909090909091,161,16,3,3
"36139","f97a50fbaf400bc4c9cc8a7b16cd35ac",42,42,0,42,42,0,1,2
"36140","f97d51ff6936946b3b6c7d90e5246435",74,51,32,16.1875,74,0,2,1
"36141","f97d6b6c7b97203bd6fa1a61f9456fa2",191,98,75,17.8266666666667,191,0,3,3
"36142","f97d98a3fda8a9ff8cddebc4134352b7",230,55,84,19.1666666666667,214,16,3,3
"36143","f97fc00e9419e2f1995174a865655ded",32,32,0,32,32,0,1,2
"36144","f97fc3aa9144f9a62e2f400b17702b07",88,69,55,11.2,88,0,2,3
"36145","f981bc405f0d2e8f06ccba514875bfc4",23,23,0,23,23,0,1,2
"36146","f98258582e587a639d93a11a1ab245eb",30,30,0,30,30,0,1,2
"36147","f9852aca230a9b775875ca9eb4a72c94",119,59,58,14.3620689655172,119,0,3,3
"36148","f9853d8527127e5b87fce896351006ef",73,49,75,6.81333333333333,41,32,2,1
"36149","f98ed076dd79b7fff91070c8fc933094",13,13,0,13,13,0,1,2
"36150","f9908c5f6553eec13ad144f7245b3c4c",10,10,0,10,0,10,1,2
"36151","f991602eeebfe3c60fdae944d69dd142",54,45,37,10.2162162162162,54,0,2,1
"36152","f99178cffd94c9cb47106e345df7292d",47,45,38,8.6578947368421,47,0,2,1
"36153","f994494614d49d71300d84253a52ea4b",22,22,0,22,22,0,1,2
"36154","f996448685ff5c218f9b4bdbc66dcc06",18,18,0,18,0,18,1,2
"36155","f99675ee7cd1245e678206f549c4f88d",74,49,70,7.4,74,0,2,3
"36156","f996c86f1e4bf87136a4a89d3df56acd",32,32,0,32,32,0,1,2
"36157","f9980c16edd2f562292c2e0b8e07f9d1",175,121,47,26.063829787234,175,0,3,3
"36158","f9991fbc6f1bd36d42fa5681089b271f",28,28,0,28,0,28,1,2
"36159","f999b6c47c9d3b314ec182cfa92ee8de",70,55,30,16.3333333333333,70,0,2,1
"36160","f99afa853fffe5dc55a1540886c7f517",115,45,16,50.3125,115,0,1,2
"36161","f9a2aedb93101762ccecf21e102e62a9",76,66,38,14,48,28,2,1
"36162","f9a451a978ef50633aa725ff754191b4",12,12,0,12,12,0,1,2
"36163","f9a470a1287b3625a87deb875e88634c",48,48,0,48,0,48,1,2
"36164","f9a5fda5da8fb9b378d95a329e3410ef",8,6,56,1,8,0,2,1
"36165","f9a98afc76b67fb8042dfcf3a6e90c48",94,60,76,8.6578947368421,94,0,2,3
"36166","f9ac4cf5333d436cbd884981bf5c7436",65,52,18,25.2777777777778,37,28,1,1
"36167","f9b2b419d98a70d7b93bc26a6581a230",9,8,2,31.5,9,0,1,2
"36168","f9b4bd6e46b22d62d037171c3ec45816",40,30,13,21.5384615384615,40,0,1,1
"36169","f9b631cf65cc28cc886752a5edf60448",110,75,56,13.75,110,0,3,3
"36170","f9b6a397943adf88ef37a0d9f977806e",71,63,70,7.1,71,0,2,3
"36171","f9ba7a1b990a6900f78e9fce99f854b4",52,44,48,7.58333333333333,52,0,2,1
"36172","f9ba9f49996d7e638866790689c694c6",29,29,0,29,29,0,1,2
"36173","f9bb88f8dd1ac063e76657d3a2af1621",13,5,60,1.51666666666667,13,0,2,1
"36174","f9bce63fccbc0661422a20daf7355afa",46,33,61,5.27868852459016,26,20,2,1
"36175","f9bf0f423e62acbdeeb5dff1606ec20c",40,37,0,40,40,0,1,2
"36176","f9bffdf404e3db732573f11f42a4c9e5",1,1,0,1,1,0,1,2
"36177","f9c0f8c7617f9882ebd01692c6464afb",94,51,49,13.4285714285714,74,20,2,1
"36178","f9c12bc4f0af36e46970ea3d93b8cb0d",44,44,0,44,0,44,1,2
"36179","f9c1a490bcef8ad3ebcee37996d87ebb",102,73,68,10.5,102,0,3,3
"36180","f9c2553c6595193ad5e18c3556910abe",61,48,57,7.49122807017544,61,0,2,1
"36181","f9c2768f6ae128f03a01f58e6f1d6d08",1,1,0,1,1,0,1,2
"36182","f9c466831ee7734c1abe1614bb963373",15,15,0,15,15,0,1,2
"36183","f9c56a1bca2c92dc528bb975bd206b29",14,14,0,14,14,0,1,2
"36184","f9c59c8862d01ad486fb937541a00079",48,48,0,48,48,0,1,2
"36185","f9c610b2f2a948e99a0f7ed5ea499cf8",77,34,86,6.26744186046512,58,19,2,1
"36186","f9c7bb29f9d1842bea7c8d6c16a17791",70,60,84,5.83333333333333,36,34,2,1
"36187","f9ccded020a49bfc5b32eb6d2f74d846",55,46,12,32.0833333333333,41,14,1,2
"36188","f9ce8293af99a82fb3bd79823c51cbdc",157,109,73,15.0547945205479,109,48,3,3
"36189","f9cf16ce4a42578ca34b49e2dd45da8f",43,25,65,4.63076923076923,15,28,2,1
"36190","f9d17f928658c35645716a5cef2150e7",167,108,73,16.013698630137,167,0,3,3
"36191","f9d86e1a551d589d723f303d7ca03c48",91,52,58,10.9827586206897,49,42,2,1
"36192","f9d8718788838d1415b4c46051aef0a1",60,59,43,9.76744186046512,60,0,2,3
"36193","f9da49f18aa0cae6e09d55c4994355cf",54,54,0,54,0,54,1,2
"36194","f9dc379416b5223a13ed17a536e38da7",41,41,0,41,41,0,1,2
"36195","f9de915335ac23daef1dff6892579b87",26,26,0,26,26,0,1,2
"36196","f9df703d55f956a036f5a2a45b8da5ed",62,43,38,11.4210526315789,62,0,2,1
"36197","f9e0080ff997195ce6cc342d1b25766a",19,17,25,5.32,19,0,2,1
"36198","f9e05362d993fbd93c614dd378d58482",88,74,34,18.1176470588235,88,0,2,3
"36199","f9e1b7534779580c8a552ac41e25606f",86,63,57,10.5614035087719,86,0,2,3
"36200","f9e56b2e139c2919d0c93a218bea3868",13,13,0,13,13,0,1,2
"36201","f9e6c57a7fb97d8ac6e96fc9434a0197",32,32,0,32,0,32,1,2
"36202","f9e7cd1ffd3d75e9cdbd069d681d4ae1",108,78,18,42,54,54,3,3
"36203","f9eb01480a2dcb2d12aa21ca17649bda",26,26,0,26,0,26,1,2
"36204","f9ed35304d2e7fe708a94c07df1afc64",39,39,0,39,39,0,1,2
"36205","f9ee587a09aaf5dced164269a65dc540",27,7,70,2.7,27,0,2,1
"36206","f9f03e801a2bec50b8982be52776c0ea",134,94,37,25.3513513513514,134,0,3,3
"36207","f9f39c80f9a2ad48a6dd22538d42aa36",25,25,0,25,25,0,1,2
"36208","f9f662be5019e72820971627d219cccf",10,10,0,10,10,0,1,2
"36209","f9f7b99b317b2826355bc089ee418655",27,24,53,3.56603773584906,25,2,2,1
"36210","f9f896c72a1df450d36943384ab4cafc",109,81,48,15.8958333333333,67,42,3,3
"36211","f9fa2ee03b8ad5a9b929d2cee20b94c7",39,35,56,4.875,39,0,2,1
"36212","f9fa7eb7908fefb6d4dfc99c1f247e36",47,39,78,4.21794871794872,30,17,2,1
"36213","fa00fd36516f0c9a46c06984a60d4217",96,71,42,16,96,0,2,3
"36214","fa0267569bae371ddcfa7c654302a029",64,53,79,5.67088607594937,50,14,2,1
"36215","fa02e52b44549d3b20fe0eb811568c8d",101,75,40,17.675,50,51,2,3
"36216","fa04fb6b0dce66a6f3e1d9d97d9c8a49",27,27,0,27,27,0,1,2
"36217","fa0880f42d4375270035a2f4c30b8361",20,20,0,20,20,0,1,2
"36218","fa0895dd5a7f86cab997fdb4038a9579",77,51,46,11.7173913043478,36,41,2,1
"36219","fa0fe14ad0f312e5ab6ddee5253496bf",30,30,0,30,30,0,1,2
"36220","fa12f4e2808df686cbf4ac924db2e73a",37,37,0,37,37,0,1,2
"36221","fa15d5166ea9283a2264a100c04428ac",27,27,0,27,27,0,1,2
"36222","fa160e28454949e208981adc666ae8de",35,23,36,6.80555555555556,35,0,2,1
"36223","fa1a286a65cddd0c4b6b2b1832360255",12,12,0,12,0,12,1,2
"36224","fa1c12a41febce4f948d9dcff2cb1f5b",45,43,62,5.08064516129032,45,0,2,1
"36225","fa1d12c73241a016886a4da0a2592150",25,25,0,25,25,0,1,2
"36226","fa1d53c8c55c18aeada2d1da3f9da30c",33,33,0,33,0,33,1,2
"36227","fa1e31823778fc94f31ff77c712a50d9",96,73,62,10.8387096774194,96,0,2,3
"36228","fa1fe285fbc6e665eebc60e017308ac6",40,40,0,40,40,0,1,2
"36229","fa216e391827565b0499a3e71729f53f",34,34,0,34,34,0,1,2
"36230","fa24a4ea62c3af08b29ff52b21f2a436",1,1,0,1,1,0,1,2
"36231","fa25ffab4c12a3d3de437827d6c27e78",88,70,54,11.4074074074074,88,0,2,3
"36232","fa280fd3e854d90f7716cea23362d8e3",41,38,49,5.85714285714286,41,0,2,1
"36233","fa28a77b461d3106e0dd564611f21293",37,37,0,37,37,0,1,2
"36234","fa2907da4d271b6a8db8fd1168833c18",27,26,10,18.9,27,0,1,1
"36235","fa2a42720ebb3f3dfd3c31730e20855a",30,30,0,30,0,30,1,2
"36236","fa2b4db05575152df875a750d7fe4104",38,38,0,38,38,0,1,2
"36237","fa2db3e9ddf4cd09cd0858ce5f6dff5e",108,90,48,15.75,108,0,3,3
"36238","fa2e341fe8c7621ec71eae84bd8a963b",14,12,37,2.64864864864865,14,0,2,1
"36239","fa2f8deda5777a473c797502619c9bd7",100,73,68,10.2941176470588,100,0,3,3
"36240","fa3064a2e7db1ab45098df4e3b0ac728",161,92,84,13.4166666666667,140,21,3,3
"36241","fa31b3b1afdb4c3d95c18f140279c1f9",30,30,0,30,30,0,1,2
"36242","fa333356afa593f2d2ecd96ddec45ba6",26,26,0,26,26,0,1,2
"36243","fa349ecbbaaeb8f2db9d02e525dfee32",33,33,0,33,0,33,1,2
"36244","fa36f02073e5ed81ce280aa973632101",13,13,0,13,13,0,1,2
"36245","fa3a4eac01b43089fa5fb7161eb41edb",65,53,60,7.58333333333333,25,40,2,1
"36246","fa3d4d266346b48ee581fcca7ffcff2a",16,16,0,16,0,16,1,2
"36247","fa3d99ae5e524aa786718e96fab7bb58",72,55,39,12.9230769230769,32,40,2,1
"36248","fa3f04877e1645098d02e6ebde41259f",46,46,0,46,46,0,1,2
"36249","fa3f5ee0a1af054fde1fbdcaa4e8aa5f",54,39,54,7,54,0,2,1
"36250","fa3fc486e1be0eca5f82fe5ff29b820c",6,6,0,6,6,0,1,2
"36251","fa411ed51196fbed48b615cb8a8f83d3",32,29,77,2.90909090909091,0,32,2,1
"36252","fa419a50f8560f33a87bf0f89fad10c1",7,7,0,7,7,0,1,2
"36253","fa443d6ff6060a2fb591c7706f26a8a9",26,26,0,26,26,0,1,2
"36254","fa449489410e0f09839d4e5cc215c6bc",1,1,0,1,0,1,1,2
"36255","fa46f5239072abcf2060fccbc7d48f48",47,47,0,47,0,47,1,2
"36256","fa4894d02e34a34f9106e450e72e92f6",18,18,0,18,18,0,1,2
"36257","fa4a32004e2554b591bbf1bdcd6dadfa",14,14,0,14,14,0,1,2
"36258","fa4d9ff2d01f09a4a05e7c364cd515c6",45,43,64,4.921875,4,41,2,1
"36259","fa4fdca33a71d05f850130de948a1a13",203,116,67,21.2089552238806,203,0,3,3
"36260","fa51baf913cd036145e978268e744393",25,25,0,25,0,25,1,2
"36261","fa561f32b05e2093a078c7d76f79074b",88,61,47,13.1063829787234,88,0,2,3
"36262","fa56c73f98f1d743a1d3de86dac9ad91",84,66,45,13.0666666666667,84,0,2,3
"36263","fa585eb191546f7159a10f2cde47f169",79,59,23,24.0434782608696,79,0,2,2
"36264","fa5bf2d53d4df2bbaa914efd1d20463a",24,24,0,24,24,0,1,2
"36265","fa5dd43f0a55bfa534639e313f1d8450",124,73,53,16.377358490566,74,50,3,3
"36266","fa5fe66fba1867ccd96eca9b883662b7",148,110,35,29.6,148,0,3,3
"36267","fa6393ed068ba3a7859c949c53308af6",62,53,34,12.7647058823529,62,0,2,3
"36268","fa63ef4a6d88927c844bc4eb27db4dde",32,32,0,32,32,0,1,2
"36269","fa64472780b62cc3d59c839bb1f8f47c",105,60,73,10.0684931506849,52,53,2,3
"36270","fa6591f7c6c27c4ab595991632d95655",47,39,30,10.9666666666667,17,30,2,1
"36271","fa65b0ae2a3d6cb184dd10625b9f42bb",66,58,21,22,66,0,2,1
"36272","fa66346ed448d05695e18ea5734e2b74",69,56,74,6.52702702702703,69,0,2,3
"36273","fa66a6ce942a674e0e63f5b468b8a283",215,93,75,20.0666666666667,215,0,3,3
"36274","fa671e2f5e58a9508b8a1d6957982d9c",31,25,11,19.7272727272727,31,0,1,1
"36275","fa6b3c1eeb35ab54237a36750dea40a2",181,113,69,18.3623188405797,181,0,3,3
"36276","fa6b857489cf0664bcd0197ea69af6a0",46,35,28,11.5,0,46,2,1
"36277","fa6e853f31efc911ec11db8db381b398",53,39,59,6.28813559322034,39,14,2,1
"36278","fa70372ca9b19914489b3ec94ad4009a",158,104,28,39.5,138,20,3,3
"36279","fa73074abdedf2699cf3401521a914c0",13,13,0,13,13,0,1,2
"36280","fa737189e7547577b0bf6039043b3166",16,16,0,16,16,0,1,2
"36281","fa762596679d1bfe60fffd7a8c2fdaa1",9,9,0,9,9,0,1,2
"36282","fa79196c3c1264ce5d60711adfdbd4d4",79,56,22,25.1363636363636,79,0,2,2
"36283","fa791e758ee60766ec9b5b23657a8e40",121,59,63,13.4444444444444,121,0,3,3
"36284","fa7c2f2606b1ff488ebcb377d652ddf6",15,15,0,15,15,0,1,2
"36285","fa7c3a53d467075fee47ca22d4c3d32b",67,42,50,9.38,27,40,2,1
"36286","fa7ff6a6d6bbf0fc2e384dd97301f901",48,30,54,6.22222222222222,48,0,2,1
"36287","fa81198d45f976210520262da035784d",15,9,69,1.52173913043478,15,0,2,1
"36288","fa84f67b8c929651b08e82140dd52451",151,80,83,12.7349397590361,151,0,3,3
"36289","fa85d912bda8bf0d7ef1086927912ed9",27,27,0,27,27,0,1,2
"36290","fa863bdd4e05926e840b218f36c43fdb",20,20,0,20,20,0,1,2
"36291","fa864240788288b0fe992f117f8d3149",52,33,50,7.28,52,0,2,1
"36292","fa899306f0abe99d4ad5b6d9d43febbf",176,102,70,17.6,140,36,3,3
"36293","fa8b62d6acc2b6520c391c3eff44f35a",11,11,0,11,0,11,1,2
"36294","fa8b8531963db27db6923739166ddc3a",60,42,30,14,60,0,2,1
"36295","fa8f8c1e99d1d8f55c424af27d9af349",18,16,76,1.65789473684211,18,0,2,1
"36296","fa92533b15949d7000d660d437a36f82",42,29,57,5.15789473684211,42,0,2,1
"36297","fa93a2e19fb3b1424e254276dff5ea61",13,10,43,2.11627906976744,13,0,2,1
"36298","fa97187ded114fc5d421d65e208b9033",45,26,62,5.08064516129032,28,17,2,1
"36299","fa976ba3ed27db19d997efc33fbd3448",93,69,67,9.71641791044776,93,0,2,3
"36300","fa9c9aef90c87b9fcfeef76ee4fb1ae3",42,42,0,42,42,0,1,2
"36301","fa9cc8dbd9e71b408bf70d136d0f1062",13,13,0,13,13,0,1,2
"36302","fa9e3f934f11e29bbeb37f70c11d607f",6,5,28,1.5,6,0,2,1
"36303","faa1236d415209ff36b6ee565fc27923",17,17,0,17,17,0,1,2
"36304","faa2bca355e7ad68a9cca11bd38233a8",184,82,85,15.1529411764706,184,0,3,3
"36305","faa4644a795913faa12d391819c96876",29,21,67,3.02985074626866,9,20,2,1
"36306","faa5a73dfe8779c4208541fa4963c22f",12,12,0,12,0,12,1,2
"36307","faa7590063196a768b792e9cc62b40b3",64,54,64,7,50,14,2,1
"36308","faa9a63eb3b9a96e9c72746c370732f0",153,51,82,13.0609756097561,153,0,3,3
"36309","faaa8797dcb75f388ee6b30bbe2ef779",43,43,0,43,0,43,1,2
"36310","faaac2cb413e70c2f566cbf6284a4f51",21,21,0,21,0,21,1,2
"36311","faabf24ad8fa841e247bdeb58e9db846",101,63,48,14.7291666666667,73,28,2,1
"36312","fab17d6148adf3670e29df9e959a6f8d",109,87,43,17.7441860465116,109,0,3,3
"36313","fab401b97f71b446ee6b0294a1bf8082",42,34,47,6.25531914893617,26,16,2,1
"36314","fab4956b41027960c0ede6829e3457d2",138,66,70,13.8,117,21,3,1
"36315","fab9b0c383671386bd052a516a85d160",154,84,63,17.1111111111111,154,0,3,3
"36316","fab9c68d6959edf4085968e12d00671f",132,83,68,13.5882352941176,132,0,3,3
"36317","faba8daabaa121ba63ccf0e54688a28c",8,8,0,8,8,0,1,2
"36318","fabaaae099ded97abfc895639fd1eac6",7,7,0,7,7,0,1,2
"36319","fabac5d0f11665df9ca7de425e9ac359",59,45,32,12.90625,59,0,2,1
"36320","fabe91a465da1a33cd866640924c8c3c",39,37,7,39,39,0,1,2
"36321","fabf34850a88191f4589da12c0cdb552",1,1,0,1,1,0,1,2
"36322","fac171a08a290f13edc82a88131f1288",37,31,79,3.27848101265823,19,18,2,1
"36323","fac18c0e2f5cc44dd8461d8c488ef125",23,23,0,23,23,0,1,2
"36324","fac195a0613ff61cfddc84746899ee44",215,128,70,21.5,215,0,3,3
"36325","fac203cb3d78818fe22b3921f898023a",110,78,63,12.2222222222222,110,0,3,3
"36326","fac2d65d41d7083dbc1389774b1aeca6",103,70,83,8.68674698795181,63,40,2,3
"36327","fac37c235d1c86d5248f3dabe3a06e4a",23,23,0,23,23,0,1,2
"36328","fac41eb8081282a6c2080d23e0939515",91,46,77,8.27272727272727,66,25,2,1
"36329","fac4e5e1f290c94a5d874cab015617fd",2,1,36,0.388888888888889,2,0,2,1
"36330","fac677cf80194c1ab6a43bd6e5deaf86",31,31,0,31,31,0,1,2
"36331","fac78cfbaa5264491871abfff9474e8a",36,36,0,36,36,0,1,2
"36332","fac89333cda6af693ce7922ac4bccc89",94,69,75,8.77333333333333,94,0,2,3
"36333","fac8b9d4eb6a1975177ae5c65a1ed133",32,32,0,32,32,0,1,2
"36334","facac2738ec8f7865f1d574e0145e3f5",47,47,0,47,47,0,1,2
"36335","facd47ec1d0874abae2d5af67bd3dbad",46,43,25,12.88,46,0,2,1
"36336","facdf42ac1963d51fdc7c0b863d1ed59",143,82,50,20.02,143,0,3,3
"36337","face3c923973bc77dd3bf8b4a3a89138",50,46,28,12.5,50,0,2,1
"36338","facf76e679713cf6868e2bdc09984f59",130,99,81,11.2345679012346,130,0,3,3
"36339","facffd353946e0094f430e40bf57e611",32,32,0,32,32,0,1,2
"36340","fad048c8abf6942521ae324ddb0d67e5",215,108,74,20.3378378378378,215,0,3,3
"36341","fad06360b9a177db037473a90bc67621",219,98,82,18.6951219512195,200,19,3,3
"36342","fad11911c4986d8cad0b8e14bb693d04",19,19,0,19,19,0,1,2
"36343","fad3a0288b09ca78644012ca4c528a2b",34,34,0,34,34,0,1,2
"36344","fad5505d486b4069e6acd9aeb4b2d2c2",56,51,32,12.25,43,13,2,1
"36345","fad69f1009bb96f7507564a9f2e0b6b0",53,53,0,53,0,53,1,2
"36346","fad6b2d4c2347848a543035f7142ee0d",81,60,53,10.6981132075472,81,0,2,3
"36347","fadb987fb6e9e92cb45bebedb528570f",111,83,78,9.96153846153846,84,27,3,1
"36348","fadc4fd572071bbb119c305cbb39d154",45,39,35,9,45,0,2,1
"36349","fadcc5fe11d88eab2f9dedbcb225d919",174,111,39,31.2307692307692,134,40,3,3
"36350","fadda161898d3882a6359a59655e9da6",95,82,62,10.7258064516129,66,29,2,1
"36351","fade28d59e45fb07d2151790d9e05d93",52,43,46,7.91304347826087,52,0,2,1
"36352","fae0251eed6967833d32aafd2a45c8d0",30,30,0,30,30,0,1,2
"36353","fae41046639ab9503c6e7e14ca0f655e",21,21,17,8.64705882352941,21,0,1,1
"36354","faec6c175c6c31a12ae0f2f350b38eaa",70,53,41,11.9512195121951,70,0,2,3
"36355","faecf93c9dbad0903ad4a26e2f842f50",29,29,0,29,29,0,1,2
"36356","faedf9c1f5cdb33cc7dfa95de35e7a67",38,38,0,38,38,0,1,2
"36357","faef0d51a5eafc7b71d7287c27a1f6be",75,65,31,16.9354838709677,75,0,2,1
"36358","faf3093c0f2f360095ca2cfc70ff98bb",52,28,27,13.4814814814815,52,0,2,1
"36359","faf5778336ecee095258d877d3515897",12,12,0,12,12,0,1,2
"36360","fafcaff2e515f4f9b21a8969cf1e177f",32,32,0,32,32,0,1,2
"36361","fafcfe81e5b40c006f8700b0a52e00e2",194,90,69,19.6811594202899,194,0,3,3
"36362","faff237a4d8d5d82920d95d01f7bedfc",22,22,0,22,22,0,1,2
"36363","fb01f96dee408bac951400413aefdae2",31,26,33,6.57575757575758,24,7,2,1
"36364","fb06f5aa72f2f259061f397bd17c30f8",30,30,0,30,30,0,1,2
"36365","fb0eb83e5d5ae013cc9353b8f561b4a3",15,15,13,8.07692307692308,15,0,1,1
"36366","fb102c174dbd893b64001dbb2c0716ba",27,25,41,4.60975609756098,11,16,2,1
"36367","fb132ab4037b317b6707c9bf20c5f5b1",20,15,50,2.8,20,0,2,1
"36368","fb140444013371dedb66ad65caac692e",18,18,0,18,18,0,1,2
"36369","fb1a1a2a9b034b88f5ca8784b10d90b4",21,21,0,21,21,0,1,2
"36370","fb1c5c4338944d952d0b256a58ea786f",12,12,0,12,12,0,1,2
"36371","fb2182549def4bed42096a3b32f87154",96,39,78,8.61538461538461,48,48,2,3
"36372","fb21d8a2ea1ac9faace2cf526c3de854",21,21,0,21,21,0,1,2
"36373","fb23193daf018d77d393b9e4ae91da2c",48,48,0,48,48,0,1,2
"36374","fb239b0ca79d4f0c34fa1c1aac33c974",16,16,0,16,16,0,1,2
"36375","fb26541cf1af1004e109fbed2417b4f7",23,23,0,23,23,0,1,2
"36376","fb2a03287d152d9d4dc942c2d74636eb",39,39,0,39,39,0,1,2
"36377","fb2bb84ffef5aa8c826a144e84f9940d",26,26,0,26,26,0,1,2
"36378","fb2c76f67f7d7a90648c5eb8dd15a0b8",47,29,35,9.4,47,0,2,1
"36379","fb2fd49e97fda920e3c01c2341986db5",117,101,49,16.7142857142857,117,0,3,3
"36380","fb33933e04570e6f8a844388a06f2110",16,16,0,16,16,0,1,2
"36381","fb3735d02e4594236a170e7b98220a29",53,44,44,8.43181818181818,53,0,2,1
"36382","fb38433c1795cdce87bde239295a3090",1,1,0,1,1,0,1,2
"36383","fb39254e6f79ff956af9d5951c7113da",25,19,65,2.69230769230769,12,13,2,1
"36384","fb3f18dcb3db05b1477b62e47256078a",40,40,0,40,40,0,1,2
"36385","fb3f5ee2ba27f5b23b1064c67b557649",45,45,0,45,45,0,1,2
"36386","fb3f729e0cd31b494d47d3645d4c0b3d",43,43,0,43,43,0,1,2
"36387","fb40ee630134be32bf57efb4df6e66a0",84,60,42,14,84,0,2,3
"36388","fb41670a135f1c1689bf293ddcadbd05",70,62,49,10,70,0,2,3
"36389","fb484f772347a10b7b5d8168237e13b1",7,7,0,7,7,0,1,2
"36390","fb4950064ec23df10cbd7f35a0083eff",97,54,70,9.7,97,0,2,3
"36391","fb49b715f1f2b98362a92cc866544cb3",55,55,0,55,55,0,1,2
"36392","fb50c6b4cdd5ff2847f8eb20a86a575e",16,15,3,37.3333333333333,16,0,1,2
"36393","fb51793685ab63bb822c4593b98890a9",22,22,0,22,22,0,1,2
"36394","fb540ed34cdbacf828977741313cf3cd",126,82,62,14.2258064516129,126,0,3,3
"36395","fb5897e0f0cc7bb2835eb7a41aed4e24",18,18,0,18,18,0,1,2
"36396","fb58993becc34474fa66a4dcb14a6835",28,28,0,28,28,0,1,2
"36397","fb5ae78eb8a37e666df002590d48c3d5",46,36,30,10.7333333333333,46,0,2,1
"36398","fb5c7aae68f0f47fcf95feb26ba7c92c",67,54,42,11.1666666666667,67,0,2,3
"36399","fb5d9808fc27d2d3429e32a1bae54481",77,47,56,9.625,77,0,2,3
"36400","fb5e1908d318e77450f2106a968bad73",19,19,0,19,19,0,1,2
"36401","fb63e3d28353a32217b1b63755f98391",132,72,52,17.7692307692308,110,22,3,1
"36402","fb65ca555abd15d75a5f854236637fa6",27,27,0,27,27,0,1,2
"36403","fb6a75d9dd9a06d212b9e5ff51b2381d",96,55,55,12.2181818181818,96,0,2,3
"36404","fb6a9880b92bd6b7508bde02506ebfc3",203,125,65,21.8615384615385,203,0,3,3
"36405","fb6ed65a29790f027c756b8caf71a6e5",123,88,34,25.3235294117647,123,0,3,3
"36406","fb726bec912452785a2ed724fa50c15c",210,106,64,22.96875,210,0,3,3
"36407","fb7342c40e389e31379354b8fa4ffde4",216,141,54,28,216,0,3,3
"36408","fb73d423c3de7523077a76eb709cc69b",117,91,66,12.4090909090909,90,27,3,1
"36409","fb7b0bf0a5dbcfbcecf29885176b3146",123,82,80,10.7625,123,0,3,3
"36410","fb7b6ca5312d230a3ec58a8ad13427b0",8,8,0,8,8,0,1,2
"36411","fb7c40197702e766e8579e37d8086bb9",39,39,0,39,39,0,1,2
"36412","fb7cade977d0a68feffa09915cb5512a",89,68,24,25.9583333333333,89,0,2,3
"36413","fb7cf2d98e09fac847e419228cb389df",32,25,34,6.58823529411765,16,16,2,1
"36414","fb7e1ab6a25539ee14ab79c9550ee0e3",30,23,54,3.88888888888889,30,0,2,1
"36415","fb7e85e7e476066e9ea4ab4910206a28",160,101,89,12.5842696629213,160,0,3,3
"36416","fb808f72d1c6371ad04d658195b9ef74",28,28,0,28,28,0,1,2
"36417","fb82abd9158a9bc4c882189463e91d19",24,24,0,24,24,0,1,2
"36418","fb8c6792010e8fcaad67c4e28e8600ff",5,5,0,5,5,0,1,2
"36419","fb8e01dc2d46ec8a112c6e446f012045",48,48,0,48,48,0,1,2
"36420","fb8e85c442d9ed114325962383f23adf",46,41,9,35.7777777777778,27,19,1,2
"36421","fb8ee8d624adc6b07fc5d4634bbb42c1",54,54,0,54,54,0,1,2
"36422","fb91843064585ff73b91cc01fcee8c50",41,29,72,3.98611111111111,19,22,2,1
"36423","fb9401a87fb27f902047d01d1490d8b2",58,45,82,4.95121951219512,58,0,2,1
"36424","fb945133aa8a903a79344401a0d8db65",36,21,88,2.86363636363636,36,0,2,1
"36425","fb94e436533160f5cd9c0899dcbbb0e4",111,55,71,10.943661971831,111,0,2,3
"36426","fb95eeba4303ac73a61d73a538177eb5",158,109,71,15.5774647887324,103,55,3,3
"36427","fb990c3561fa49d23a1545b5128d2592",9,9,0,9,9,0,1,2
"36428","fb9d12ef314c129a29aa784c46cc3c15",18,18,0,18,18,0,1,2
"36429","fb9ee700a788adbe0d99fd92d307cbb7",40,40,0,40,40,0,1,2
"36430","fba0102109976604c00cc8e117d12c8d",222,133,68,22.8529411764706,180,42,3,3
"36431","fba0f6cd68dee277317e3d14dac6ca05",106,84,20,37.1,68,38,3,3
"36432","fba2a78a012e8db8609c663145106422",44,44,0,44,44,0,1,2
"36433","fba5f1787f982d1872863417a235fe26",132,99,30,30.8,132,0,3,3
"36434","fbafb5d862fe3bfe89be1b2b623a1d49",1,1,0,1,1,0,1,2
"36435","fbb0464fc41df8379c5a7052f8f60173",14,14,0,14,0,14,1,2
"36436","fbb0ab445af1365ec413f264e6eca0c1",102,58,63,11.3333333333333,102,0,2,3
"36437","fbb16fc213804dce4fa06fbf4dfc8a76",15,15,0,15,15,0,1,2
"36438","fbb18cb7f51e22c1964079e767180746",13,13,0,13,0,13,1,2
"36439","fbba0d0f875f6b5e2e7ddf5f7dc8475b",101,71,47,15.0425531914894,101,0,3,3
"36440","fbbb07453e0506501e42fb4d2b42bdf4",29,29,0,29,29,0,1,2
"36441","fbbb7582dd3dc8b26fe30bb1ed0e3598",22,22,0,22,22,0,1,2
"36442","fbbdc924ebf7cb9eb695c4b1bb8fa03f",159,97,55,20.2363636363636,159,0,3,3
"36443","fbbe47a6fcd8ad4dfc6daa9d47e08217",30,30,0,30,0,30,1,2
"36444","fbbf55c4c310843f2d0d787a67bf6e17",21,21,0,21,21,0,1,2
"36445","fbc0782d565d3c8d5a6ebe89d383afce",13,13,0,13,13,0,1,2
"36446","fbc2daa723fae81165d6bbb9799d169b",31,30,28,7.75,31,0,2,1
"36447","fbc5498afbe6d9606c7f40fe5125b5f4",237,153,75,22.12,185,52,3,3
"36448","fbc6108c520c34189030dcf619462525",115,97,63,12.7777777777778,115,0,3,3
"36449","fbc6fad010a6d004368a0e676d483549",40,40,0,40,40,0,1,2
"36450","fbc7deaa3ba1e5b588d702f2ce60730a",27,17,15,12.6,27,0,1,1
"36451","fbc98dadcac3a65fdf3d686d5a1b3fd4",1,1,0,1,1,0,1,2
"36452","fbcbbe017f99def139347cd1c26e5eed",13,13,0,13,13,0,1,2
"36453","fbcbcf7e848d4b99d262a5313517b86d",17,17,0,17,17,0,1,2
"36454","fbcc67c6ea5f3c9f3917ee2d55c093ee",251,142,80,21.9625,196,55,3,3
"36455","fbced8cb4cf2395aa9dca7de6b80bac9",138,111,35,27.6,138,0,3,3
"36456","fbd183760e2abf3d1ea136bfed574c9c",30,26,60,3.5,30,0,2,1
"36457","fbd418dd611f18167bc1625ca3bfe714",10,10,0,10,10,0,1,2
"36458","fbd45d352f928f871fbfb575c16cf93a",1,1,0,1,1,0,1,2
"36459","fbd6172f8d84ac3141e0fe201f7e837c",16,16,0,16,16,0,1,2
"36460","fbd839573f1ef97442787e32aac323ca",147,63,83,12.3975903614458,118,29,3,3
"36461","fbd97c1debaa44b293199bbbf8548df0",48,35,22,15.2727272727273,27,21,2,1
"36462","fbda6f6f5cbc067ec1872087846db5bd",25,25,0,25,25,0,1,2
"36463","fbdc7499c0eb6e73ae8d0c070500e1cf",64,53,28,16,64,0,2,1
"36464","fbe0826ad7d543a6ad4ea898024b3dce",20,17,20,7,20,0,1,1
"36465","fbe2f4e51b6073a7a7b86274c734ab63",84,58,50,11.76,84,0,2,3
"36466","fbe3c563c18ecc1161c8e688035d0b5e",62,38,49,8.85714285714286,62,0,2,1
"36467","fbe49277f99a933ef66408fc29657725",71,59,51,9.74509803921569,71,0,2,3
"36468","fbe711dd35398d9d3d01d1dee6218e90",60,46,39,10.7692307692308,60,0,2,1
"36469","fbe92635bc2e4c57cdfc41595965b7cb",49,37,68,5.04411764705882,34,15,2,1
"36470","fbeb77e524ead988d487d0053ff9fee6",27,22,50,3.78,27,0,2,1
"36471","fbee75da25f36de71508d050dd19ab39",92,67,29,22.2068965517241,68,24,2,1
"36472","fbef3c135c51d5381aaffdd07d358873",38,30,43,6.18604651162791,38,0,2,1
"36473","fbefc597e4c9b16963c1dd5b8da884ce",46,46,0,46,46,0,1,2
"36474","fbf024df49579f4cf1e604709549e9df",138,74,52,18.5769230769231,138,0,3,3
"36475","fbf02761382ae34959d88cd0b7e1b9ad",34,34,0,34,34,0,1,2
"36476","fbf1feb8b0d792ea8fd59ad14e3b0417",201,82,79,17.8101265822785,201,0,3,3
"36477","fbf3131cf7568f630f35c5adb714263e",167,85,77,15.1818181818182,115,52,3,3
"36478","fbf3327d34565451c2f7813b490f2861",106,56,53,14,74,32,2,1
"36479","fbf4b76a33a35f8d9784e59414335da2",19,19,0,19,19,0,1,2
"36480","fbf529075c6e07d1fb9e98a3a8d316ac",15,15,0,15,15,0,1,2
"36481","fbf5b72ec187ed1a7716a2cdac43d0f5",111,63,65,11.9538461538462,111,0,3,3
"36482","fbf807961594b3847f504864b04c1988",34,33,0,34,34,0,1,2
"36483","fbfc3cc05e34fb555f5d3027ffc1b34c",28,28,0,28,28,0,1,2
"36484","fbfc64ef3188318f325ce24e1ab63055",94,58,61,10.7868852459016,94,0,2,3
"36485","fbfcdc96b8ae854aa73663e4c3556121",77,63,37,14.5675675675676,77,0,2,3
"36486","fbfe24796db00e7bada7661c06f2c881",17,17,0,17,17,0,1,2
"36487","fc00390a4cc9b9a9073546eed7c4c008",21,21,0,21,21,0,1,2
"36488","fc060d9b04bdda9f5d33311b28855265",161,89,85,13.2588235294118,161,0,3,3
"36489","fc089e1065c2c2275b9194e2c950cab7",53,27,62,5.98387096774194,53,0,2,1
"36490","fc08fd050e9634c4c06cf1406f7cd241",95,72,37,17.972972972973,95,0,2,3
"36491","fc0e0167b7f477df3a5d52777478c836",75,46,75,7,61,14,2,1
"36492","fc0f08f2009fa25d804a69a3c60e4480",132,60,71,13.0140845070423,121,11,3,1
"36493","fc0f569d25a3cdfcf2c41418e551bff3",25,21,46,3.80434782608696,25,0,2,1
"36494","fc1119f1d0beb30d782114dc3a30b11f",33,33,10,23.1,3,30,1,2
"36495","fc1179b9de7d8e6cdd0d28c647c6e488",28,28,57,3.43859649122807,20,8,2,1
"36496","fc1180523c6ab4a520db17163260feca",90,51,69,9.1304347826087,76,14,2,1
"36497","fc11ff703bfd7b32acdf237d6e3b6c09",112,85,50,15.68,112,0,3,3
"36498","fc178f9d60055b0c8b49a0c477f7090e",192,133,63,21.3333333333333,192,0,3,3
"36499","fc1c6b7596af5f8b1165687fa614d760",138,80,47,20.5531914893617,138,0,3,3
"36500","fc1e32cd71ff406fb0afeeda42c74b95",216,147,77,19.6363636363636,216,0,3,3
"36501","fc2155be40ac3df0ada68d279dcadc94",46,37,17,18.9411764705882,22,24,1,1
"36502","fc22309552598022e753bd5a1687d2e3",36,36,0,36,36,0,1,2
"36503","fc2262d24e539815f015459769cabc77",101,75,39,18.1282051282051,101,0,3,3
"36504","fc22ed949fdfed3bdd1b45717a1895ac",41,37,44,6.52272727272727,30,11,2,1
"36505","fc2476cb82384157b0082d76e0d3ad13",63,49,32,13.78125,63,0,2,1
"36506","fc248fbd2b3afee7e54b8105b20ef2fc",84,75,48,12.25,84,0,2,3
"36507","fc264ca9b3db7c3cccce2c13e009c28c",76,50,57,9.33333333333333,76,0,2,3
"36508","fc27e10a9d88b4b46016ad25505a8179",13,9,40,2.275,13,0,2,1
"36509","fc2e0de4156ff238dd9bd1262c51491d",41,36,65,4.41538461538461,41,0,2,1
"36510","fc2ff2cdee6a8008410ab27db8284813",98,73,60,11.4333333333333,98,0,2,3
"36511","fc3087397ecfeeed3467a48f32f38009",7,7,0,7,7,0,1,2
"36512","fc30ea25a034dc1d7ddbd98a91062508",30,30,0,30,0,30,1,2
"36513","fc30ead38bbde86326bdea98116570d4",91,76,37,17.2162162162162,45,46,2,3
"36514","fc315225aeb41b7a77c553e8d7315c13",31,31,0,31,31,0,1,2
"36515","fc323525a07c50b510ba7ec0a1f7884f",23,23,0,23,23,0,1,2
"36516","fc3596b9d381254a7e737a0322c9be09",52,27,60,6.06666666666667,45,7,2,1
"36517","fc387aebbfcc6ff1590bc8f2d19bd3cb",26,26,0,26,26,0,1,2
"36518","fc39297947a91392ddae48a69ef6ed20",8,7,56,1,8,0,2,1
"36519","fc39c76472896d5e2b484fd0f3464ea9",101,71,70,10.1,101,0,3,3
"36520","fc3a3caebfbdefc32aa187cc818e4c9d",25,25,0,25,25,0,1,2
"36521","fc3a59f6a1b72faf4c63f3eb850c9933",5,5,0,5,5,0,1,2
"36522","fc3acef5d739e31c9c14ca6ce7ded908",18,18,0,18,0,18,1,2
"36523","fc3b6a55214d376ef2fb44342fdebc37",1,1,0,1,1,0,1,2
"36524","fc3c8182b16b0efe191c4d6701b5972a",22,22,0,22,22,0,1,2
"36525","fc3eb091e7c3a44caf4beb9a9117ec92",92,71,58,11.1034482758621,92,0,2,3
"36526","fc408cb3fc61cdc1f74167c18ccc8239",64,19,48,9.33333333333333,64,0,2,1
"36527","fc43175a34e259320b8f1857742221f7",37,37,0,37,0,37,1,2
"36528","fc43589447a4e968c1d3fe4aea5e73ca",120,93,46,18.2608695652174,120,0,3,3
"36529","fc4394703d73ed369d0735adf9fadbe6",40,40,0,40,40,0,1,2
"36530","fc443320bface6ae2bb8c612337fb998",123,77,64,13.453125,69,54,3,3
"36531","fc463c1a8dcd16fe6b558d519ddfcdbd",53,53,0,53,0,53,1,2
"36532","fc47ea725d633cb4b73987ad278fbeb0",38,38,0,38,38,0,1,2
"36533","fc4876cd6cc60becffa903bc13d784cf",22,22,0,22,22,0,1,2
"36534","fc488c893827a7a83474ac26d9fcd43b",88,79,43,14.3255813953488,88,0,2,3
"36535","fc4a2b833fbce2a219ae82e994f925ca",77,40,52,10.3653846153846,77,0,2,3
"36536","fc508b1eee8b44e9a21b3ff74ff500be",27,27,0,27,27,0,1,2
"36537","fc52bdca7465b00b1eb48d1bc36a0037",12,12,0,12,12,0,1,2
"36538","fc52e68032891522d4d24c6c1fa15f64",154,112,75,14.3733333333333,154,0,3,3
"36539","fc537042eaaea4f91e8293eec7147c93",13,12,67,1.35820895522388,6,7,2,1
"36540","fc53966a0f92cfcf56be0af45309b51f",13,9,73,1.24657534246575,6,7,2,1
"36541","fc556a19d78b2717d1ac24703f8289e7",26,26,0,26,26,0,1,2
"36542","fc55a756ff6d598aa94ec8c4d3aef7bf",25,25,0,25,25,0,1,2
"36543","fc56ea4f96ff097d3c9404bfd431a818",115,66,57,14.1228070175439,83,32,3,3
"36544","fc5bdbd503252e80ffbf6bb296d8c002",105,70,74,9.93243243243243,89,16,3,1
"36545","fc5d1a4b0751740a67d0aaaec19e3b71",26,26,0,26,26,0,1,2
"36546","fc5d4da92887a98b7a48b48f79ea14d3",49,49,0,49,49,0,1,2
"36547","fc5f08fe338738038da90227b89f310b",63,50,57,7.73684210526316,63,0,2,1
"36548","fc5f2110e058d031be34152c954be0da",26,25,18,10.1111111111111,26,0,1,1
"36549","fc609e5dc44a239e951247365168de9a",193,97,82,16.4756097560976,193,0,3,3
"36550","fc60cb42cbd6a7d2ae3f47d6bdbd109f",11,6,68,1.13235294117647,11,0,2,1
"36551","fc61439c6357ab7bb609eb158770ada8",20,20,0,20,20,0,1,2
"36552","fc628adcd58a1909ece5bdebca10983a",13,13,0,13,13,0,1,2
"36553","fc6371b9f14e3962bef18e48d89b958d",40,29,8,35,40,0,1,2
"36554","fc64a887c577d71884cfe2a70fc716bc",74,57,42,12.3333333333333,74,0,2,3
"36555","fc64f7d3fb8205923aae909d51df5539",97,73,48,14.1458333333333,49,48,2,3
"36556","fc6778ffd03b7d09da097d1797a64a3a",58,41,14,29,58,0,1,1
"36557","fc6a53f81cdbb4557a50ee21ad7a5938",41,41,0,41,41,0,1,2
"36558","fc76c211745a3977c89060e27d1c9b35",90,45,61,10.327868852459,90,0,2,3
"36559","fc7708e49274fa418ca4aaeb9ca4fc8f",125,82,46,19.0217391304348,125,0,3,3
"36560","fc7d14d7f919f4ed9f5de2b2401d7365",28,28,0,28,28,0,1,2
"36561","fc80f0f51fea102690704dac47ac0f6f",21,21,0,21,21,0,1,2
"36562","fc813d1d574d0c69c788a1939f12aca6",79,57,70,7.9,79,0,2,3
"36563","fc82e1fcd02d9f99f3f9fc39420f0fa7",21,16,58,2.53448275862069,12,9,2,1
"36564","fc846046770bd4d6d08e644e06ddba01",34,34,0,34,34,0,1,2
"36565","fc8a33097f0f588651d8e3953c85c9cc",18,18,0,18,18,0,1,2
"36566","fc902ca924b76d29d20febcdf8c6bd61",18,18,0,18,18,0,1,2
"36567","fc9297586c5af940d3a65de15e395757",23,21,20,8.05,23,0,1,1
"36568","fc93685d510779963f069225aa23da37",75,41,76,6.90789473684211,58,17,2,1
"36569","fc95f15dcb52d8c77d75f6836da49714",18,18,0,18,18,0,1,2
"36570","fc96be52a196b8db79ce4630985144db",21,21,0,21,21,0,1,2
"36571","fc9b3b11539c1a4c5358b84ea292d126",84,59,71,8.28169014084507,69,15,2,1
"36572","fc9bf482c25a32c100ab135efbdea277",36,32,20,12.6,36,0,1,1
"36573","fc9f7af70af60db77d4d84b977451957",71,39,70,7.1,71,0,2,1
"36574","fca0b89006d2d77e953263fead6ffbc5",22,22,0,22,22,0,1,2
"36575","fca152088ea1623bbe53ec3734044e11",17,17,0,17,17,0,1,2
"36576","fca25b7a01eccef23863ee4a36d870bf",32,24,28,8,32,0,2,1
"36577","fca393262d60a987e1711827d3c61006",16,11,42,2.66666666666667,16,0,2,1
"36578","fca665372fa3695bfedeef1b990182df",175,130,72,17.0138888888889,175,0,3,3
"36579","fca791727da316629c3a0e8cef4c9877",15,15,0,15,15,0,1,2
"36580","fcaa905ca7bed6dbe7f5cf0cbfd5f56b",162,112,70,16.2,162,0,3,3
"36581","fcab282ae72a0dd42d5e6673b4ac5282",106,78,54,13.7407407407407,75,31,3,1
"36582","fcace2187559fbc0a427fb5d851637a4",48,48,0,48,48,0,1,2
"36583","fcacfda7aca631c76927767e5b8585c9",34,34,0,34,34,0,1,2
"36584","fcaebe352e4bfc9c24dfbced2987051b",58,51,56,7.25,58,0,2,1
"36585","fcb2bf94d23523bdc787d0f5fb6d0acc",25,25,0,25,25,0,1,2
"36586","fcb3991f604828bdd0f675608a9070b7",16,16,0,16,16,0,1,2
"36587","fcb44ac1e0a614fa045dc2be7020e727",17,17,0,17,17,0,1,2
"36588","fcb736955b6796862180d3b5637fb9dc",19,19,0,19,19,0,1,2
"36589","fcb891f41f1df551ecdb05a7d85118de",38,38,0,38,38,0,1,2
"36590","fcbababf9374b37aa87130a0cccaf06a",206,94,65,22.1846153846154,171,35,3,3
"36591","fcbd8e9bc4cecf3d0c0439c4ce088af7",138,90,74,13.0540540540541,138,0,3,3
"36592","fcbfb72f9466f10bbaa3d152c0d0b9de",15,15,0,15,15,0,1,2
"36593","fcc10aec505c15d6cf7c04e9555ce9d8",116,70,68,11.9411764705882,116,0,3,3
"36594","fcc25eb5f7c40cc09521e6c891f59f63",7,7,0,7,7,0,1,2
"36595","fcc37b03d0818b84618ad5114d460496",80,62,23,24.3478260869565,39,41,2,1
"36596","fcc64e490561c3d697dc2415a6ca381f",216,81,72,21,185,31,3,3
"36597","fcc8063539ce2385eace1c6eb0139628",98,80,52,13.1923076923077,80,18,3,1
"36598","fccb5dae7681a75258cbe6095acb2056",125,94,40,21.875,125,0,3,3
"36599","fccf15429ea200af5e3ccfda40bb4c60",81,63,87,6.51724137931034,63,18,2,1
"36600","fccfa18909f41db7007b45b1b938cf9e",89,55,70,8.9,89,0,2,3
"36601","fcd07da0e7508bf52d72d86b35c4842f",145,94,63,16.1111111111111,120,25,3,3
"36602","fcd113bcf0836f648ced5f2519ed0973",19,19,0,19,0,19,1,2
"36603","fcd52ff42dfa2fe1885d145fea0867b0",54,47,14,27,54,0,1,1
"36604","fcd59580a3af2338b9472d5acdc7c629",86,59,66,9.12121212121212,31,55,2,3
"36605","fcd64185c1981aa22763e5df0407d909",26,26,0,26,26,0,1,2
"36606","fcd69fb353325d4312243d1717e56bdc",10,10,0,10,10,0,1,2
"36607","fcd8e45d817f4e0951be7ea456f00289",25,25,0,25,0,25,1,2
"36608","fcdb4b8ad8e0b0667386503d1a10b2d6",32,32,0,32,32,0,1,2
"36609","fce0f12a7b26f49ef09388f6dcd975ab",38,38,0,38,38,0,1,2
"36610","fce3c7a8d41824e4f3e63509a267519d",23,20,31,5.19354838709677,7,16,2,1
"36611","fce45e8bc8368f474b683be73bd71cc0",128,64,63,14.2222222222222,128,0,3,3
"36612","fce83813407729f295bc884b38e0e933",131,96,63,14.5555555555556,131,0,3,3
"36613","fce8f5aea7225e646a1830443d6ff353",40,38,51,5.49019607843137,40,0,2,1
"36614","fceb94d0d858c939e1be2abc05220afa",45,36,42,7.5,45,0,2,1
"36615","fcef0b01a67b2298b5cad37b098e0fa8",57,50,24,16.625,57,0,2,1
"36616","fcf045e95f78fbdf05f1badea142b832",36,30,47,5.36170212765957,36,0,2,1
"36617","fcf13757377ddd3564fda993857b94c0",67,53,80,5.8625,67,0,2,3
"36618","fcf22933921e851fda93c02d4b98eefc",179,78,56,22.375,179,0,3,3
"36619","fcf66d8695003f9b66c5c4d77bdaf4c3",85,68,26,22.8846153846154,42,43,2,3
"36620","fcf98f33e656bdea719718a0e66c45e0",133,101,60,15.5166666666667,133,0,3,3
"36621","fcfae49c85cdc435861211435956e0bd",32,29,87,2.57471264367816,19,13,2,1
"36622","fcfcc53f7d13c8ff550fbabbb294447d",89,68,37,16.8378378378378,45,44,2,1
"36623","fcfed44000963b8bd8268ee6daccc421",31,31,0,31,31,0,1,2
"36624","fcffbd0b166c0659b1eed2f798e1464d",57,55,20,19.95,57,0,2,1
"36625","fd0009a3bc5707481c4b8b4430f5973a",134,81,71,13.2112676056338,134,0,3,3
"36626","fd0077b994f91a2207579f52cd5ef5c2",19,19,0,19,19,0,1,2
"36627","fd018e312d50b2c37b51030dd61db3ba",114,90,61,13.0819672131148,62,52,3,3
"36628","fd04ef799974fa144081aade79051123",18,18,0,18,18,0,1,2
"36629","fd0508075dad6b226556cfaf5073befd",128,62,74,12.1081081081081,115,13,3,1
"36630","fd06893eb85b0e323910c52c994884e6",86,37,79,7.62025316455696,86,0,2,3
"36631","fd075d9cb0da70d53bd02d2ad49d29a3",22,22,0,22,22,0,1,2
"36632","fd09b5d8598befe0bfd91ac4ee206add",88,72,22,28,88,0,2,3
"36633","fd0d619d340f8ed7c2da86b261306f0b",97,65,59,11.5084745762712,71,26,2,1
"36634","fd0dcada72d7419cc81d20750619a68b",111,79,70,11.1,111,0,3,3
"36635","fd0dcb49425e909864f2e5e649e38bd1",30,24,49,4.28571428571429,0,30,2,1
"36636","fd0eca8cde8f64aab7cfd820ba092c9e",75,33,68,7.72058823529412,75,0,2,3
"36637","fd153206e013529594c3526f32ac7d9e",33,33,0,33,33,0,1,2
"36638","fd198399ebd1cb601fa09587394e60cd",27,23,34,5.55882352941177,27,0,2,1
"36639","fd1a4f1680a6668e82c57d2c90028960",43,43,0,43,0,43,1,2
"36640","fd1a9c0a4c7346572a2757043d77efbe",23,19,16,10.0625,23,0,1,1
"36641","fd1ebb155cb435a278ebc9fd49d4953d",68,35,65,7.32307692307692,68,0,2,1
"36642","fd20ae50dfd3cb5c7717d8afecc5ac21",83,58,52,11.1730769230769,83,0,2,3
"36643","fd21857726e88023a55ac3fef022f11c",18,18,0,18,18,0,1,2
"36644","fd2238292d2505799c13347ccf2fa9da",135,76,77,12.2727272727273,135,0,3,3
"36645","fd22c6a0e471952f1711c1b64740813f",121,64,78,10.8589743589744,121,0,3,3
"36646","fd27810626a2990fa5ccb0e7ae12cbf6",66,58,15,30.8,66,0,1,2
"36647","fd286c27e41bb3bba42fd58b043d3ddc",102,58,74,9.64864864864865,102,0,2,3
"36648","fd2ab965c4ff282fe75525bb645e0b2d",15,12,21,5,15,0,1,1
"36649","fd2b83a3fa13235da237e9d969a165c2",6,6,0,6,0,6,1,2
"36650","fd2df5ac42d1bafe1a026efec5c2095c",116,66,63,12.8888888888889,116,0,3,3
"36651","fd2ef6b70aa2b69402824b9c4cefd88d",40,40,0,40,40,0,1,2
"36652","fd31fe4e4d8838b0649f0cd0e2cc73f5",79,53,32,17.28125,79,0,2,1
"36653","fd32a018916097dbcd8052c267ab5fc3",15,15,0,15,15,0,1,2
"36654","fd3a625adc1bdda46ca7121566edd84e",42,41,7,42,42,0,1,2
"36655","fd3c4371c5a8170a8f39183791527033",155,130,63,17.2222222222222,155,0,3,3
"36656","fd3d0f25d08b25df67d84945889d0a27",202,103,53,26.6792452830189,153,49,3,3
"36657","fd3e3a3b336cc110bd94b3edf73433cc",35,35,0,35,35,0,1,2
"36658","fd3e735902fd7dd55755c18478a6e1da",136,76,48,19.8333333333333,136,0,3,3
"36659","fd3f1a769cfbcf7af7e4f567dfc35eef",26,14,74,2.45945945945946,26,0,2,1
"36660","fd40583705966902605d53813188b91a",50,29,67,5.22388059701493,50,0,2,1
"36661","fd405ad937ca03f5df5535e9705ceab6",181,91,84,15.0833333333333,181,0,3,3
"36662","fd44d5ef7b8466d18ff2ea539e08bd23",88,77,18,34.2222222222222,88,0,1,2
"36663","fd45bf456bc1e32cb375537887d62205",66,43,59,7.83050847457627,66,0,2,1
"36664","fd463e729a19069f5d55f127987b2d6b",16,16,0,16,16,0,1,2
"36665","fd488ec83eafbbfadd8bd360bfc28e31",43,43,0,43,43,0,1,2
"36666","fd48c65e51ca0cda4621ce3f6f44a7b1",44,44,0,44,44,0,1,2
"36667","fd4c9903f2d216fa4ea8491dc191c441",11,8,37,2.08108108108108,7,4,2,1
"36668","fd4cbfc2177eee3e532546b3aae659a7",30,30,0,30,30,0,1,2
"36669","fd4df2d40bff844780e0900e08b0b23d",115,76,52,15.4807692307692,71,44,3,3
"36670","fd4f3653f1b2f6c3b5374d935f21a9f2",16,16,0,16,16,0,1,2
"36671","fd519272214d7d06ad2e1266d614dc8b",74,57,31,16.7096774193548,74,0,2,1
"36672","fd52ed9b74f923d273ed6249653c6694",5,5,0,5,5,0,1,2
"36673","fd55efb36c822e2ad8e366bfffdfcbf4",10,10,0,10,0,10,1,2
"36674","fd58f1188692e562b80c5922504599d0",39,39,0,39,39,0,1,2
"36675","fd596a236487befb19391862d04f6f3e",46,46,0,46,46,0,1,2
"36676","fd5e20cdd7d7d550d77ab80802227ca5",30,30,0,30,30,0,1,2
"36677","fd5e539c29431a75ea8ae554b49810a8",64,34,60,7.46666666666667,64,0,2,1
"36678","fd5f127c3111c7cf46ea5a5ec8cf2e8f",104,59,61,11.9344262295082,104,0,2,3
"36679","fd5f3b5a0d9ba9e1f7367ed44092c193",25,25,0,25,25,0,1,2
"36680","fd610e8ac088b1709c612ba8b45b7dbb",42,18,81,3.62962962962963,42,0,2,1
"36681","fd61eae1820149443b3c93e6cef419d6",125,81,62,14.1129032258065,125,0,3,3
"36682","fd638a53340856838277307255a19148",130,83,27,33.7037037037037,130,0,3,3
"36683","fd63ec31e5b7b6c83e177314e1d6539b",5,5,0,5,5,0,1,2
"36684","fd63f73c51ba8ccabd85d9604bd7f2e1",15,15,0,15,15,0,1,2
"36685","fd65a548c7f07c51396bb522826bc444",42,42,0,42,42,0,1,2
"36686","fd6799ca4e0e516da3fbbf5ff39e1362",39,37,42,6.5,39,0,2,1
"36687","fd679f811e39563e342e70f5bd9026d5",88,77,49,12.5714285714286,88,0,2,3
"36688","fd67f72ae05d84b0023cd0c0dee0c4e5",76,67,77,6.90909090909091,76,0,2,3
"36689","fd682c465035a7ab4d038a45f6aade8a",30,27,14,15,0,30,1,1
"36690","fd6ca9aa93608278199747226708fd4e",74,50,43,12.046511627907,74,0,2,3
"36691","fd6e9f5e106133869ea5d89cd79d2ed6",1,1,0,1,1,0,1,2
"36692","fd7063459bd0804ad355746523ec91b3",20,20,0,20,20,0,1,2
"36693","fd71b77653d63b1e124f1ecf60f37e4f",137,89,73,13.1369863013699,93,44,3,3
"36694","fd74ea5e14ad82b18ace7f0f64d2ac35",71,53,42,11.8333333333333,71,0,2,3
"36695","fd75fc41c5e9f10cf98b76fbe12331d3",28,28,0,28,28,0,1,2
"36696","fd7606aab83f60c1bad201727ba22d1c",14,8,52,1.88461538461538,14,0,2,1
"36697","fd793eaa93c46ffdbdb1288bb1ec2c73",14,14,39,2.51282051282051,14,0,2,1
"36698","fd7a2b25a95954e9bef9c6cceed21d12",18,17,6,21,18,0,1,2
"36699","fd7d52dcdda444a72537f8bafc04e5f9",26,26,0,26,26,0,1,2
"36700","fd8122e220e3e91a8154ba6b3e947c3f",174,80,69,17.6521739130435,174,0,3,3
"36701","fd836df218ffa77dae4b9d20a946bd1a",85,75,55,10.8181818181818,85,0,2,3
"36702","fd83a2d751cb4a84d78f8fb4d3fdd2c0",95,75,48,13.8541666666667,95,0,2,3
"36703","fd84792643b0899ff770106e33135f2c",59,37,69,5.98550724637681,59,0,2,1
"36704","fd85e4ae53e915537a1dfda9b426dfde",195,97,66,20.6818181818182,157,38,3,3
"36705","fd87bb084e5340a31e7f65092fa27748",52,46,7,52,0,52,1,2
"36706","fd889a41fa56cfc1aa6e1712d97788a0",11,7,25,3.08,6,5,2,1
"36707","fd8a8576507b79db0cf022d85430dde1",46,42,25,12.88,46,0,2,1
"36708","fd8b064adc17c10c05095361ff9a3181",21,20,0,21,21,0,1,2
"36709","fd8b156bf3dd821731a4c644282186f4",21,21,0,21,21,0,1,2
"36710","fd8d43d6a6e3cb4df54f2379d6975c18",64,50,29,15.448275862069,64,0,2,1
"36711","fd8f405feae0aad9f0439f1721f1c1c0",68,64,31,15.3548387096774,30,38,2,1
"36712","fd8fd45e34c77d6b3c380f730fba3aea",68,56,41,11.609756097561,68,0,2,3
"36713","fd9153e42a4db73bb0c5a767f4e97212",36,34,20,12.6,36,0,1,1
"36714","fd916f4177c8786d995b9e19830a49ed",85,64,36,16.5277777777778,85,0,2,3
"36715","fd994b056a0cee8d55f0fb4c320e4f04",9,9,0,9,9,0,1,2
"36716","fd99c3cd845d22843ea6e33da884bc23",49,44,17,20.1764705882353,30,19,1,1
"36717","fd9a25c56d05f172d4b829392388e386",89,49,65,9.58461538461538,89,0,2,3
"36718","fd9b98cdf663c2fa9b19f182c1356d91",135,93,45,21,104,31,3,3
"36719","fd9bf5d2b02a52465494be57d75f6756",50,34,64,5.46875,50,0,2,1
"36720","fd9ca4795f29b55169d997c15013d187",42,36,56,5.25,0,42,2,1
"36721","fda3b8493446be45011c8b8d368f2854",101,63,80,8.8375,101,0,2,3
"36722","fda443a84257461f86011b730a7b2af0",134,86,84,11.1666666666667,134,0,3,3
"36723","fda628594afff9cc123e14686b1c4b3a",64,55,18,24.8888888888889,64,0,1,1
"36724","fda6e3a7167f013de17c99e4f5380a29",18,18,0,18,18,0,1,2
"36725","fda750461d47c4040413527634c091ed",40,26,65,4.30769230769231,40,0,2,1
"36726","fda8571b66f5e811a4206e91ac4ed5f8",6,6,0,6,6,0,1,2
"36727","fda914c43288327361de52a7dd072324",24,24,0,24,0,24,1,2
"36728","fdaabbe42d67ae8935c85f1341c6b9ac",48,39,50,6.72,48,0,2,1
"36729","fdad011a49a2c7127a6db8f13fa0a5d3",83,55,59,9.84745762711864,60,23,2,1
"36730","fdadae966d6d72389c682f74bbb9dd8c",53,29,21,17.6666666666667,53,0,1,1
"36731","fdaee47413d1a2123b34bee8e0f2489a",58,46,37,10.972972972973,58,0,2,1
"36732","fdafe3d02b8eaaeebecd757a2e88c7e9",113,68,61,12.9672131147541,113,0,3,3
"36733","fdb395f50c9c5645d939406c17426736",63,48,61,7.22950819672131,40,23,2,1
"36734","fdb5f44a72a1ecec8807b6404db44b4a",25,25,0,25,25,0,1,2
"36735","fdb65cf0b1f049944e0dbca69a473b1b",37,37,0,37,37,0,1,2
"36736","fdb9ea660e5aef6bf42802120a60cb3c",29,16,71,2.85915492957746,29,0,2,1
"36737","fdbaef616d6b9bdc13601cbbc4592cfd",31,29,43,5.04651162790698,31,0,2,1
"36738","fdbbbd219923bcd1f6450ddd83df2fe2",88,78,21,29.3333333333333,88,0,3,3
"36739","fdbd789e05ea0f781e53a2b3c4c24802",43,38,46,6.54347826086957,43,0,2,1
"36740","fdbe35dcc92c82a5317fe670e0d78ad5",10,6,23,3.04347826086957,10,0,1,1
"36741","fdbe7c68cb201b708a9288a1f50f4f2f",23,22,5,32.2,23,0,1,2
"36742","fdbee87770fc990df75a775892792696",76,62,28,19,76,0,2,1
"36743","fdc0c2bda1a902e2a888b40fa12592c1",29,28,10,20.3,29,0,1,1
"36744","fdc20a1a5935d8ec1ec688f676d05f38",52,52,0,52,52,0,1,2
"36745","fdc28aeaabec4a4280f4015a03b294c1",26,16,58,3.13793103448276,10,16,2,1
"36746","fdc517d3cc01d940c636cf17039ce0ac",2,2,0,2,2,0,1,2
"36747","fdc7b8fab179b9bc7a6276b69518df81",23,23,0,23,23,0,1,2
"36748","fdc99261b6e4b6e3ef152bb21e110bf3",31,31,0,31,0,31,1,2
"36749","fdcaa52a2961ec00c154d6179f28c6d1",86,60,61,9.8688524590164,86,0,2,3
"36750","fdcb55430594b93c81e56c2147a904eb",216,114,73,20.7123287671233,216,0,3,3
"36751","fdcc25e59ef52a3363364cff83211b09",41,41,0,41,41,0,1,2
"36752","fdcc65f01dd18f2c2ff79f994ea231d2",25,25,0,25,0,25,1,2
"36753","fdd24c9d038fcf5ee80991995ab2d57a",44,44,0,44,44,0,1,2
"36754","fdd7f751e6bad5908b5421121eb403df",106,85,66,11.2424242424242,53,53,3,3
"36755","fdd84a81c571dc7bd3869136eb83fe60",82,67,29,19.7931034482759,82,0,2,3
"36756","fdd9894760fc99cefbbacb887b380577",174,123,85,14.3294117647059,158,16,3,3
"36757","fddaee3af28543232ce50ec8e5bb080b",5,5,0,5,5,0,1,2
"36758","fddb3fac2a9eb66db786b96cac0aaf15",14,14,0,14,14,0,1,2
"36759","fddb9ea8fe615dc56961242a3ff71196",58,32,64,6.34375,58,0,2,1
"36760","fddc2401fe5f90bf437119c867200a0e",108,70,40,18.9,73,35,3,3
"36761","fddc2f0e6ff1b73d87e8f5849d606c79",81,66,19,29.8421052631579,45,36,1,1
"36762","fddc6a897b1e8541a776e885ab9680d9",68,53,21,22.6666666666667,68,0,1,1
"36763","fddcd825fe9b00fbb040a5b910b7f406",37,37,0,37,37,0,1,2
"36764","fddd2cc3a480872f18c42391f7da1849",33,30,59,3.91525423728814,17,16,2,1
"36765","fddeea7b3614c9f989b475340f39d69d",1,1,0,1,1,0,1,2
"36766","fddf86ba5b7ffa1bbd78171e0f006f9a",19,19,0,19,19,0,1,2
"36767","fde4160634005c9db6f751d0d7eae4d2",24,24,0,24,0,24,1,2
"36768","fde70bb608f9baa0d3dd104253528763",27,27,0,27,0,27,1,2
"36769","fde7e070b675864c57030af8a8887c3e",161,103,61,18.4754098360656,161,0,3,3
"36770","fde7e7f0036dd9a0ce0f79ed0a1897dc",30,30,0,30,30,0,1,2
"36771","fde877ba6b4ec5ebb99a55f4a1929da2",151,73,74,14.2837837837838,151,0,3,3
"36772","fde8a7a4f567e55c01e0a5655010f14a",22,22,0,22,22,0,1,2
"36773","fded3005207f1a906b109405bbe9587f",181,105,70,18.1,181,0,3,3
"36774","fdeda3ef93baeca2380b9aaa86164bce",77,52,21,25.6666666666667,77,0,1,2
"36775","fdf27aee25e073768e6e5c74de23a4ba",30,30,0,30,30,0,1,2
"36776","fdf40e677dd408d96bb5c5c148166ce8",201,76,84,16.75,167,34,3,3
"36777","fdf5067327e911ff34d9b6ebb794ab17",78,61,35,15.6,78,0,2,1
"36778","fdf74cd801fc521451ba25c1124b5264",122,82,70,12.2,122,0,3,3
"36779","fdfa22c2a14cbf64c5ae430d4a66df6e",37,37,0,37,37,0,1,2
"36780","fdfa89b0d0ad442c22aa8ba063e552c1",170,101,60,19.8333333333333,170,0,3,3
"36781","fdfe6d9770e8b6dbb9e4225d0817fceb",19,14,20,6.65,19,0,1,1
"36782","fe00e5290de5426631d74ac95e2646a7",21,21,0,21,21,0,1,2
"36783","fe01768511ea793a3bcdaf2cd3bc45f2",32,32,0,32,32,0,1,2
"36784","fe020b6d6af3fb16a8d2c85ca36d6e10",26,26,0,26,0,26,1,2
"36785","fe0344d9be8573a402c6045bdee8fe8d",21,21,0,21,21,0,1,2
"36786","fe04d78ac6f81b9d10b270737ec21ad9",42,39,49,6,42,0,2,1
"36787","fe05fa80774452489eacb7f24407165c",37,37,0,37,0,37,1,2
"36788","fe0823dc9a79dda294b64ed6260433a1",35,35,0,35,35,0,1,2
"36789","fe0ace677f413a86c68679f544dd5c73",25,25,55,3.18181818181818,15,10,2,1
"36790","fe0c43f0865b04529a08e196e21d8f5a",175,44,84,14.5833333333333,175,0,3,3
"36791","fe0c52bab8e830a6ba7a1a7b754b4461",44,44,0,44,44,0,1,2
"36792","fe0cf6eac48ba1b584b4eb244d7c69c9",151,98,79,13.379746835443,121,30,3,3
"36793","fe112c7b293b8113d65887651178d921",36,23,33,7.63636363636364,36,0,2,1
"36794","fe11f0d89948b744121ef0b1ee7e84d5",242,145,65,26.0615384615385,192,50,3,3
"36795","fe19f9302d0897ca621ca96c2f07365c",45,31,41,7.68292682926829,45,0,2,1
"36796","fe1d22d3e6d15c0aa55fb96ef017f963",11,11,0,11,0,11,1,2
"36797","fe1dd15db97da38dc07ac5ffd0195c2f",13,13,0,13,13,0,1,2
"36798","fe1df997f5963f3a0ccf85b719389304",89,68,28,22.25,89,0,2,3
"36799","fe1eaa589cb44f80f6cdeac444581e4e",201,102,76,18.5131578947368,163,38,3,3
"36800","fe21b09f55e84b25d4dca80a49633c5e",49,49,0,49,49,0,1,2
"36801","fe21e5b002ead2908d2e07cf5795bd36",43,28,56,5.375,43,0,2,1
"36802","fe255b74f513a2f8c02ebe795544a0c8",1,1,0,1,1,0,1,2
"36803","fe28c2852d2811e5aca0a144a4f95060",34,34,0,34,34,0,1,2
"36804","fe29cb0914852b391ccfea6d5a99f81a",14,14,0,14,14,0,1,2
"36805","fe2b3372d8a4f5af6837def20eb9d444",81,63,54,10.5,81,0,2,3
"36806","fe2ca727109fb85d6ff322496f41372c",53,36,33,11.2424242424242,53,0,2,1
"36807","fe310ade34bedd29f52a2af41e331583",17,17,0,17,17,0,1,2
"36808","fe320419c8dad02c8a0a69b6d30be8dd",103,72,59,12.2203389830508,66,37,2,3
"36809","fe3542ef2dd535941da2bf79bb74f0b3",20,20,0,20,20,0,1,2
"36810","fe35b0da5004c1adccbb8be8b8daaa34",74,57,33,15.6969696969697,74,0,2,1
"36811","fe36b84b0c2f4fe178b3000549f674ea",104,64,84,8.66666666666667,104,0,2,3
"36812","fe38e469095a1c740782d10da18c9d8b",38,38,0,38,38,0,1,2
"36813","fe3b16b26f50a3944aa5ddbf891d58a3",21,21,0,21,21,0,1,2
"36814","fe3bdd7132fbd22034f915b98df5951a",63,60,13,33.9230769230769,23,40,1,1
"36815","fe3c28a0b9c60ba33b4d4e883b7be5c0",30,30,0,30,0,30,1,2
"36816","fe3cbc6dbb7627b62cecf30bee9bbfc3",53,45,22,16.8636363636364,53,0,2,1
"36817","fe44130ef191302f9eb306f7a94191b9",27,26,43,4.3953488372093,27,0,2,1
"36818","fe44c1fb80136a3cc311ca20736411ed",30,30,0,30,30,0,1,2
"36819","fe44dfb99c79a82e305416053764e132",96,56,56,12,96,0,2,3
"36820","fe455fcc882da710bfac7241638ee6c9",133,89,88,10.5795454545455,133,0,3,3
"36821","fe46c3bd010a318620823a91b2ec4d32",60,41,59,7.11864406779661,47,13,2,1
"36822","fe479c6caa76370332a018506313f0d1",24,24,0,24,24,0,1,2
"36823","fe4d2d3d9bae5d509557b07d827f69b6",136,77,63,15.1111111111111,136,0,3,3
"36824","fe501fb498421173fa12b96889971106",34,34,0,34,34,0,1,2
"36825","fe52021eac363e9c1dc5883dca7b18a4",14,14,0,14,14,0,1,2
"36826","fe52adba501079fbdf0a76b87caa3a96",21,11,18,8.16666666666667,21,0,1,1
"36827","fe53816e0e90c45636e8e3b50e267556",157,111,73,15.0547945205479,157,0,3,3
"36828","fe54d2f2292640529a4bb6bfc37b1a9c",22,22,0,22,22,0,1,2
"36829","fe565f7693888b180c19006d33ea7c05",7,7,0,7,7,0,1,2
"36830","fe59cecfa9303ff10376f5162ffbc4ab",13,13,0,13,13,0,1,2
"36831","fe5a2cb46c404879ec19bf3751aa21bd",45,38,13,24.2307692307692,45,0,1,1
"36832","fe5c468ecc50e63b53240f1b9f1722a7",31,25,36,6.02777777777778,31,0,2,1
"36833","fe5eb277dbbe021e84360b45042fcc97",16,16,0,16,0,16,1,2
"36834","fe60145bcba9b1fbdd403259e8d49a33",22,22,0,22,22,0,1,2
"36835","fe60923157d39d5d4442391570cf4129",84,49,42,14,84,0,2,3
"36836","fe61cb187b275057ea97338482cbc5a2",4,4,0,4,0,4,1,2
"36837","fe62017d8992c89aa9040dc5c43d2135",132,81,72,12.8333333333333,132,0,3,3
"36838","fe622a0fa882d53679af36c5fd6bdc5b",64,47,79,5.67088607594937,64,0,2,3
"36839","fe691783bb1dccb74fb05dc442b37b7c",95,53,73,9.10958904109589,95,0,2,3
"36840","fe6a1f40cc89865544887248ba8405ce",29,27,51,3.98039215686275,12,17,2,1
"36841","fe6a3f020cf2851e0b3bc7d0e4537d4a",14,14,0,14,14,0,1,2
"36842","fe6af3560e436a52edf1a477215f9a46",146,93,70,14.6,146,0,3,3
"36843","fe6b776a0b20fb79c96cb0b13a8a2201",188,95,73,18.027397260274,139,49,3,3
"36844","fe6cb5f9c2fdf677ef534224f96bc3a3",140,86,86,11.3953488372093,85,55,3,3
"36845","fe6d1210660153fc9f94553763b5429c",73,58,20,25.55,73,0,1,2
"36846","fe6e18aa50936d34e467ef11633a07bc",52,34,38,9.57894736842105,31,21,2,1
"36847","fe6e1abb8460782bdb374cd3ec87e0ff",180,91,90,14,141,39,3,3
"36848","fe6f76c19cd2f2827e180977a64640aa",29,29,0,29,29,0,1,2
"36849","fe70190fcc29307e0c43ea7435060277",102,70,21,34,102,0,3,3
"36850","fe703b94074b2ec78e7a9f114cce8e33",28,28,0,28,28,0,1,2
"36851","fe70a3332304461839db0b9e55656fff",48,37,52,6.46153846153846,48,0,2,1
"36852","fe70af09246725a7ab51a195794d1650",36,26,74,3.40540540540541,36,0,2,1
"36853","fe712ffd57b25a0a0927ad8539feee33",38,38,0,38,0,38,1,2
"36854","fe7145dff319c39f88011ef0063142c7",68,38,56,8.5,68,0,2,1
"36855","fe72101547fdb4943c460e9152f67177",176,83,63,19.5555555555556,152,24,3,3
"36856","fe7496fb7d51c67855ed8ee6b8b985f8",164,86,38,30.2105263157895,164,0,3,3
"36857","fe764aa30740e1d16bf091079bd0b142",47,27,43,7.65116279069767,21,26,2,1
"36858","fe7d40396ce8ee9356b2335506f7e568",7,7,0,7,7,0,1,2
"36859","fe7dd267e5f6d658f8fefad8d5a1820d",37,37,0,37,37,0,1,2
"36860","fe8288a864d6b78633331a47f7cb7120",68,50,26,18.3076923076923,68,0,2,1
"36861","fe841722e26a5a036bcb1e037e3ad4da",17,17,0,17,17,0,1,2
"36862","fe854b99caa7c5de06ac39f9fd86c2d9",81,49,35,16.2,52,29,2,1
"36863","fe870324b68027e966d3473409e4f260",71,47,69,7.20289855072464,71,0,2,3
"36864","fe8b13d6ecf5e11ddb2249488a0ce016",44,44,0,44,0,44,1,2
"36865","fe8bc7d4079268393362a4916cf6f7be",17,17,0,17,17,0,1,2
"36866","fe8d7ffa85fb2fb0d8bd837f312aec3b",18,10,7,18,18,0,1,2
"36867","fe8dde5189e093db024b60a47585fae3",24,24,0,24,0,24,1,2
"36868","fe8eb4a3620f5379f9ace8a0930015a8",21,21,0,21,0,21,1,2
"36869","fe901d5f273fcb02310bd59e298dac69",163,69,44,25.9318181818182,119,44,3,3
"36870","fe95c3f87ae0420681464ce78e97a8cd",23,22,74,2.17567567567568,23,0,2,1
"36871","fe96c572ac46a3b2a96e5827803f7683",84,49,21,28,84,0,1,2
"36872","fe971ec1d829e114690337b02e0851a0",73,53,77,6.63636363636364,73,0,2,3
"36873","fe98e268be54fce0bbbb271245e40d43",53,28,68,5.45588235294118,53,0,2,1
"36874","fe9bf7a5c284204d5e7721a7b9d6cb3c",162,80,86,13.1860465116279,136,26,3,3
"36875","fea0f5a2023b345ab03115480a9af0aa",169,72,54,21.9074074074074,135,34,3,3
"36876","fea1a5927c60cb53f5665a54003d69ae",103,88,28,25.75,103,0,3,3
"36877","fea218f736050d94d12adec947de9884",37,32,48,5.39583333333333,37,0,2,1
"36878","fea2dd594b548b22d1d620ef8211dff3",20,20,0,20,20,0,1,2
"36879","fea334d973ddc2dc12da0fdc7dbd9a68",21,19,56,2.625,21,0,2,1
"36880","fea5268a81dab43e7b5daff47ead106e",98,70,49,14,98,0,2,3
"36881","fea559ca08d18e0e81e18c3e3e3b469d",143,71,56,17.875,143,0,3,3
"36882","fea6aaa462d73da6126b5ed916242ea6",16,16,0,16,16,0,1,2
"36883","fea6fa367a46f25ce0a0fc0a4a7302cc",26,26,0,26,26,0,1,2
"36884","fea8b40988a335c7ea1a73a3ab3f3395",133,100,36,25.8611111111111,133,0,3,3
"36885","fea97331b593f0cb886bfa599f2d358f",65,44,28,16.25,65,0,2,1
"36886","fea9e38e93f023645cb436cea403553d",14,14,0,14,14,0,1,2
"36887","feaa81b6cf2a285e113fc0d95682ce58",50,40,14,25,0,50,1,1
"36888","fead4919a3e92c454ace8e88d346e119",36,36,0,36,0,36,1,2
"36889","feada3425bf74df46bc622170c9694d2",33,28,80,2.8875,33,0,2,1
"36890","feaf8b5217696ef6b162d0f0b60e2d5f",15,14,64,1.640625,15,0,2,1
"36891","feb017ca9df3b10fbe5758ffca3559cd",24,24,0,24,24,0,1,2
"36892","feb3f2844c40606f0307fd661a0925a4",11,6,77,1,11,0,2,1
"36893","feb524cdbb7d30fcb8c627dc4419246f",88,64,34,18.1176470588235,88,0,2,3
"36894","feb87110dd7312dddd4aaa552a15834a",31,31,0,31,31,0,1,2
"36895","febab9334055fdcd1a6406c1ca8a33dd",195,126,82,16.6463414634146,195,0,3,3
"36896","febb1838852695897d43a37dfae3ec7a",32,32,0,32,32,0,1,2
"36897","febd9d4544e8a859535520c19409cfdf",50,50,0,50,50,0,1,2
"36898","febe115e6d2ef4d0f4c4771b6883c3cf",134,83,67,14,113,21,3,3
"36899","febe1f1d30222fc12827880a8e291659",32,32,0,32,0,32,1,2
"36900","febf796505d83a58f025cba2f4bbb789",76,58,76,7,64,12,2,1
"36901","fec329a01fd17b22a88b68fb390c67ac",30,30,0,30,30,0,1,2
"36902","fec38048c527165843f8fa0b70c4f4ba",136,102,29,32.8275862068965,136,0,3,3
"36903","fec4a3d7b94d4f047aeaac1405c4406a",141,95,66,14.9545454545455,141,0,3,3
"36904","fec84d021c650a47490574b149e4abfe",43,43,0,43,43,0,1,2
"36905","fec86a4b90245ca4893d7eb1b22fe250",20,20,0,20,20,0,1,2
"36906","feca188f123decaad910f3c5b1c7d27c",22,20,35,4.4,22,0,2,1
"36907","feca630e9cce63cab43c45ac89912ad1",24,24,0,24,24,0,1,2
"36908","fecb44c0ef3398b2692a855f1b7d0e42",15,15,0,15,15,0,1,2
"36909","fecbaae24663be27666d07e4f45e8f66",39,39,0,39,39,0,1,2
"36910","fecd4f4ba202861e55ad3d9c53ed6609",59,49,19,21.7368421052632,59,0,1,1
"36911","fed17537f598d0df96fedf9e789526a9",13,13,0,13,13,0,1,2
"36912","fed2af2e79866a79f40eb19c632b39bd",18,18,0,18,18,0,1,2
"36913","fed74879d4b1f2744942e2b1cbca9b0c",50,43,14,25,50,0,1,1
"36914","fed870336348fef2d0ff143aa30da587",54,54,0,54,0,54,1,2
"36915","feda4dcea675e4ce02e45162af37f04b",124,78,43,20.1860465116279,94,30,3,3
"36916","fedac70459f136fd34dc4dd850c38858",34,21,64,3.71875,21,13,2,1
"36917","fedca09ba092d82774f709217d07006b",144,82,44,22.9090909090909,118,26,3,3
"36918","feddfeebce0b4ea5e102fffda5f21cdc",32,22,65,3.44615384615385,32,0,2,1
"36919","fede9817faeb3a5c54ab7fd7b51ebe7c",66,60,72,6.41666666666667,25,41,2,1
"36920","fee19c3faeafbbad46403f021db83c14",38,38,0,38,38,0,1,2
"36921","fee1bdec8d79dfbd486c953d7f4b284a",2,2,0,2,2,0,1,2
"36922","fee1eaafafdf65c7daf35d7ed2dc2fd7",117,80,69,11.8695652173913,117,0,3,3
"36923","fee26b6dbd75af103a48752b71e308c1",58,52,60,6.76666666666667,58,0,2,1
"36924","fee3553607cd9469ff462e8db93fada9",45,40,18,17.5,45,0,1,1
"36925","fee3a44843d978fda1fdafe447164437",93,59,80,8.1375,66,27,2,1
"36926","fee4954c9296d0eaf6eb830309831bea",39,39,0,39,0,39,1,2
"36927","fee4e5862081039f4d83130c4da145ce",25,25,0,25,25,0,1,2
"36928","fee8fa652973aa80ab2197ab128cc17e",112,86,74,10.5945945945946,112,0,3,3
"36929","fee998d5daea99e78de7b2fecaee6095",79,63,65,8.50769230769231,38,41,2,1
"36930","feeb8983f2979e971779a26ef77304cf",58,48,35,11.6,58,0,2,1
"36931","feebc2ec99545d97b72f20e6e391797d",49,49,0,49,49,0,1,2
"36932","feeddedc060ef9e3aa8dadbd684af605",24,24,0,24,24,0,1,2
"36933","feee0af215f9b2d9813b5f19c5c1d090",87,63,38,16.0263157894737,87,0,2,3
"36934","feee92fd3fbc649055fad2d780dcdd02",23,23,0,23,23,0,1,2
"36935","fef3522c4cf9f04dcd19bd6610e84dc6",56,51,39,10.0512820512821,56,0,2,1
"36936","fef3b01e6b307cd13843ecfc146275f5",86,57,37,16.2702702702703,86,0,2,1
"36937","fefc23ecb68ccb447e922e2a15bba812",43,39,33,9.12121212121212,20,23,2,1
"36938","fefcd80fdd264be3b05cac5c89428bd3",15,11,56,1.875,15,0,2,1
"36939","feff2ee9019d24988a210d13b23ebbdb",25,24,15,11.6666666666667,25,0,1,1
"36940","ff01adbf02589e7aa162c336f18f6811",50,50,0,50,50,0,1,2
"36941","ff0272f331403d4daaa476aa31103c99",136,69,76,12.5263157894737,107,29,3,3
"36942","ff033903d8da8f8b4f491d3e5fdea047",66,42,71,6.50704225352113,66,0,2,1
"36943","ff035de849818e924ec2a0057f1718fb",37,35,15,17.2666666666667,37,0,1,1
"36944","ff036af27a508d75164de77255cf691c",24,24,0,24,24,0,1,2
"36945","ff0440b094a05bbd12bca9c1533a0783",14,14,0,14,14,0,1,2
"36946","ff054d1f3f2acbe0937710fb1d10a074",66,30,53,8.71698113207547,44,22,2,1
"36947","ff09c846b08c10802eecd3afcc20ee80",33,33,0,33,33,0,1,2
"36948","ff0ac916553e5b74aaeada10b448a73a",23,23,0,23,23,0,1,2
"36949","ff0b1f60f4bae0bd6b6078e5dae7a296",33,30,36,6.41666666666667,10,23,2,1
"36950","ff0b902adcc19f6e735d9835b7bd6d80",172,112,69,17.4492753623188,172,0,3,3
"36951","ff0c0874e1fbd054aff055a721a31038",203,141,48,29.6041666666667,203,0,3,3
"36952","ff10de70298e48217dbdbe1dc323f2fa",28,23,22,8.90909090909091,28,0,2,1
"36953","ff125041f4ef2aec160103506c24da13",26,26,0,26,0,26,1,2
"36954","ff133da29771a792806eee66dcbb9a74",21,20,9,16.3333333333333,21,0,1,1
"36955","ff16e02f3cf7f356a5c39446ca7574b4",24,24,0,24,24,0,1,2
"36956","ff186b1455bd43ecc5b7ca2f8220a6c1",23,23,0,23,23,0,1,2
"36957","ff19527d278e13cf30d2e5b2410aeecc",10,10,0,10,10,0,1,2
"36958","ff19d5799e79175fad5e7557ad2bde23",42,31,28,10.5,42,0,2,1
"36959","ff1a09d590559834e73a6bc832067eb9",1,1,0,1,1,0,1,2
"36960","ff1d82f5efb097a5024a7e54d00f3dde",89,63,38,16.3947368421053,67,22,2,1
"36961","ff1d9a6f39fe426d8d70f72707f75fec",29,29,0,29,29,0,1,2
"36962","ff1db0b02089695907abeac5bd44246e",69,60,34,14.2058823529412,69,0,2,3
"36963","ff1dd0eaacd6f13528fca26eacead4b1",74,56,39,13.2820512820513,35,39,2,1
"36964","ff21a4a76e93a1bade7deedc0355097f",94,57,67,9.82089552238806,94,0,2,3
"36965","ff22a726f073731281f69d76370c0abc",123,77,78,11.0384615384615,93,30,3,3
"36966","ff230a5192f572ec8aff19c9eecb0bdd",49,49,0,49,49,0,1,2
"36967","ff24e388fe3ab889d9689030c420feef",63,59,11,40.0909090909091,63,0,1,2
"36968","ff254c518464f2c7283bff58d1086343",92,55,14,46,92,0,1,2
"36969","ff257617057acecdde8c98e941ce9101",63,37,63,7,10,53,2,1
"36970","ff28b14782c6b369b889460448ed80a2",39,39,0,39,39,0,1,2
"36971","ff2b5a6acd93c603f7dd853bbd10effe",74,63,75,6.90666666666667,74,0,2,3
"36972","ff2ed8ac688f1297e62abba20674606d",86,60,70,8.6,86,0,2,3
"36973","ff301dbe8bce32204753afa5a0f5ae76",41,41,0,41,41,0,1,2
"36974","ff31f697c5fd66cf0024096893f371d8",34,17,80,2.975,20,14,2,1
"36975","ff334b778424f7de5aab15e2941b12fc",52,52,0,52,52,0,1,2
"36976","ff348bc5e7b6a9b89633c3f25091ca77",87,63,56,10.875,87,0,2,3
"36977","ff362d66a5c2544564d3c3ffddc3f239",130,82,35,26,101,29,3,3
"36978","ff363142dc7d5d6f1cd66f901d69ed35",143,110,63,15.8888888888889,143,0,3,3
"36979","ff363cc2cbed48bb1f91ce848eef336f",92,59,62,10.3870967741935,62,30,2,1
"36980","ff3814cce94faddf8477c5df7792fdf3",88,74,15,41.0666666666667,88,0,1,2
"36981","ff390e8d17944e0a324bd0885af7c87d",16,16,0,16,16,0,1,2
"36982","ff393db108aa0a5fc7921278b6d9958f",67,65,48,9.77083333333333,38,29,2,1
"36983","ff3d2870480ea9bb356506d8b75b0d76",34,29,13,18.3076923076923,34,0,1,1
"36984","ff3da59e7bc020c2bc70ee13d4462eb8",24,24,0,24,24,0,1,2
"36985","ff3dea05ccd64e33016733b979333cee",43,38,24,12.5416666666667,43,0,2,1
"36986","ff3ea925baa267845bb07a3553d8b3a7",22,22,0,22,22,0,1,2
"36987","ff3f02455f6ef9dece9543293aae6641",20,20,0,20,0,20,1,2
"36988","ff401247be230166611a332e807f7475",97,73,72,9.43055555555556,97,0,2,3
"36989","ff42a07cfbc7ca5ffcbb0b34c6f82670",141,101,34,29.0294117647059,141,0,3,3
"36990","ff450c0b61d6782d14587707b8f96581",77,36,67,8.04477611940299,50,27,2,1
"36991","ff452248dc798ccdf48e07ea4fe74da4",30,30,0,30,30,0,1,2
"36992","ff4547c759cb2a2160f645b8b47afa71",102,65,77,9.27272727272727,102,0,2,3
"36993","ff48a19f6408187556bfd944fb1c6edb",91,59,65,9.8,75,16,2,1
"36994","ff48fd23c4dd19a8ce4608432adc1a39",18,18,0,18,18,0,1,2
"36995","ff4a9aa4ca1ed313e3ddbc4a3a0c6c9d",69,49,42,11.5,69,0,2,3
"36996","ff4b61b8121e67a818af9de14e5ac300",87,76,37,16.4594594594595,52,35,2,3
"36997","ff50f639df92a2092e31150c1c53bc55",69,38,50,9.66,25,44,2,1
"36998","ff52e1053d0bbd801ea028c1df8f6724",177,93,74,16.7432432432432,177,0,3,3
"36999","ff5317d15a0ef0f9f2a6b185e4759c7d",52,46,42,8.66666666666667,52,0,2,1
"37000","ff55f75e749fbcb094203f143c6758cd",38,38,0,38,38,0,1,2
"37001","ff562e1e23324f7cedcce6a4f114eaff",15,6,73,1.43835616438356,6,9,2,1
"37002","ff57ff076179ca8dadf09fedf094b4eb",27,27,0,27,0,27,1,2
"37003","ff58bf54eec1e04a0c8a6dbe8721d573",171,132,39,30.6923076923077,171,0,3,3
"37004","ff58f5aec82fa7ad0645e25abdb9ca43",11,11,0,11,11,0,1,2
"37005","ff5fb0f25632e101aa20b0ccabe104e0",124,85,51,17.0196078431373,124,0,3,3
"37006","ff60721c5bf34b66aa0c268e5c138143",84,66,65,9.04615384615385,54,30,2,1
"37007","ff6611d37d557859f81f3d1f2b41be3a",14,14,0,14,0,14,1,2
"37008","ff66fd43cf192d82d3c33a5e820a17a8",203,92,73,19.4657534246575,203,0,3,3
"37009","ff686493ee1157663504cc3450e64ec0",35,30,18,13.6111111111111,14,21,1,1
"37010","ff6e4cebfd801cc20f2eae35bc9d553f",150,75,61,17.2131147540984,106,44,3,3
"37011","ff6ecf8289119fb3dc9112782e56389f",24,20,74,2.27027027027027,20,4,2,1
"37012","ff6ffa5acb2d6d63bd90b85ee514d851",19,19,0,19,0,19,1,2
"37013","ff71b963e95b5fb9ae3dd2f6ce1582ef",13,13,0,13,13,0,1,2
"37014","ff7214b44f11482353fdcdc1c6c7051c",120,84,68,12.3529411764706,90,30,3,1
"37015","ff72a29e8ce5db2dbd7de59da4061cac",16,16,0,16,16,0,1,2
"37016","ff73dbad4d5ad56e0cc662cdf8937090",55,46,9,42.7777777777778,20,35,1,2
"37017","ff78c15536ea0fd97a0224c7376b11d9",13,13,0,13,0,13,1,2
"37018","ff7f7b59ef53c675d95c0ea721717ecc",43,43,0,43,43,0,1,2
"37019","ff82a7d9ffed4125ef5139039b66bad1",52,52,0,52,52,0,1,2
"37020","ff85e6d669db060a6aad5f6709993124",141,86,56,17.625,96,45,3,3
"37021","ff8cf3fff6ed343fff4ebb63d7984797",29,29,0,29,0,29,1,2
"37022","ff90c8f91e68a2eb90c90436ccb966ad",109,78,58,13.1551724137931,85,24,3,1
"37023","ff961fc521cc4020e3739d0fcea77de8",49,42,17,20.1764705882353,25,24,1,1
"37024","ff9791cf288db6d33a5cc73dd1012d61",15,15,0,15,0,15,1,2
"37025","ff97edbbc4f71795ef44105879567331",18,18,0,18,18,0,1,2
"37026","ff9893e014cd54b371ca532a51278d24",16,16,0,16,16,0,1,2
"37027","ff9a22ddbcbd51a525c7191e77ab75bc",75,44,71,7.3943661971831,75,0,2,3
"37028","ff9be7a6f7a315ce0759904e9e7eaacc",190,83,66,20.1515151515152,190,0,3,3
"37029","ff9e953f5a16ee50ae341bb8cae2fe41",42,42,0,42,0,42,1,2
"37030","ffa7bbd9f036dd10bc023f0477c8a80b",37,27,34,7.61764705882353,37,0,2,1
"37031","ffa8b59845b3067cf7f61e50a1ea0f1d",201,119,76,18.5131578947368,156,45,3,3
"37032","ffaa7f5ecdcf5c39692f3407ce7442c6",30,30,0,30,30,0,1,2
"37033","ffacd38ff85daa06403d86e4b756a4bc",11,11,0,11,11,0,1,2
"37034","ffaf060e452f3ffdbef8bc1d1d63a452",22,22,0,22,22,0,1,2
"37035","ffaf8689d788e65d2e2b0e78a0f369e2",106,88,70,10.6,106,0,3,3
"37036","ffb00d93801db76ca527807f4817b831",203,109,54,26.3148148148148,203,0,3,3
"37037","ffb1595be55d1b6eef503f589e539f49",37,37,0,37,37,0,1,2
"37038","ffb1b9f6f8706cb112ab2c9e95df8128",108,65,62,12.1935483870968,108,0,3,3
"37039","ffb22fdfd60b89c96532b682a1ad2341",100,49,71,9.85915492957747,71,29,2,1
"37040","ffb3393cc494e4c8b71f7695cb7f8a89",146,92,60,17.0333333333333,146,0,3,3
"37041","ffb6e5a0de078912d381181d937237f7",65,50,74,6.14864864864865,33,32,2,1
"37042","ffb719f69b9a6863201a474b71e1b0ea",11,11,0,11,11,0,1,2
"37043","ffb7cfe63297cf9b2047fdca82713259",107,34,81,9.24691358024691,107,0,2,3
"37044","ffb817698c22766308bac0d02e6c9741",27,27,0,27,27,0,1,2
"37045","ffb84af8df6ab620376830ef0d57846f",131,94,88,10.4204545454545,131,0,3,3
"37046","ffba763e90e79a877dafd5ff6f01159a",16,16,0,16,16,0,1,2
"37047","ffbd7b851aa01e7169b669ca2fafb69a",82,38,70,8.2,82,0,2,3
"37048","ffbdc58fc398e416e1c39c0d9a2c77eb",43,43,0,43,43,0,1,2
"37049","ffbe5be5384038ad79c0aff7021b7f8b",99,70,45,15.4,59,40,2,3
"37050","ffbf2b56e6a828527c6f05fbf15f95af",35,35,0,35,35,0,1,2
"37051","ffc0b24efe010537c5d0d94954633c58",22,22,0,22,22,0,1,2
"37052","ffc1587c15d49b588feab22cc494e4cb",89,63,64,9.734375,89,0,2,3
"37053","ffc7ade03e4ef101f51d99b3b139a2ab",24,22,35,4.8,24,0,2,1
"37054","ffcc4a3ea52ad0acea723cd4d7c15166",49,49,0,49,49,0,1,2
"37055","ffce7b57c2852a7cd0657071eaed0427",6,6,0,6,6,0,1,2
"37056","ffceae3567a396c24b3bd91ffad9c772",91,66,41,15.5365853658537,91,0,2,3
"37057","ffcf4a3d2bba61815acd585461d5547b",35,32,25,9.8,35,0,2,1
"37058","ffd19c46525dd731294b262ccb8c08fb",31,31,0,31,31,0,1,2
"37059","ffd1aa2826d7677163758c30a314697a",195,86,62,22.0161290322581,195,0,3,3
"37060","ffd1ae7e92c11dc75f74f00186d4aaf9",23,23,0,23,23,0,1,2
"37061","ffd30e040aab8678fdc1aba49c111245",36,36,0,36,36,0,1,2
"37062","ffd49b7e6148f2a95f8f0111ff85a966",66,53,21,22,66,0,1,1
"37063","ffd54cefa23b8526e603fcda633a75ef",10,10,0,10,10,0,1,2
"37064","ffd5c6466830f80d6bd9b549fd69a070",13,13,0,13,13,0,1,2
"37065","ffd7ab90f35cd5c108fc937c13b2e5df",140,104,69,14.2028985507246,120,20,3,3
"37066","ffd8125220f57e8859ccb20fec1b5505",47,39,39,8.43589743589744,47,0,2,1
"37067","ffd97b017d5c5a6b131bde1ace296ec2",147,81,70,14.7,147,0,3,3
"37068","ffd9915d58cf5a464405df0c6a5a82df",85,57,63,9.44444444444444,85,0,2,3
"37069","ffdacd29e2dfe3ed3bf9e0152d2bba15",33,28,29,7.96551724137931,33,0,2,1
"37070","ffdbbdb96c8a8712b84b44c0ceb74a45",32,32,0,32,32,0,1,2
"37071","ffdd73c54876e1abb98150e94d45c00c",84,56,48,12.25,63,21,2,1
"37072","ffdf29ba6ccc03c8038d003811e41439",24,24,0,24,24,0,1,2
"37073","ffe007e71c1ba4cadcf6e62299a8b7be",48,48,0,48,48,0,1,2
"37074","ffe0098165dbbe445032991836b24217",169,107,67,17.6567164179104,169,0,3,3
"37075","ffe1ca1c66b079ce01e2ea9b26702c29",19,19,0,19,19,0,1,2
"37076","ffe2feb2bb2fd5a502494cd273977c4f",13,13,0,13,13,0,1,2
"37077","ffe3457be0c2fb8686873afcff829379",14,5,57,1.71929824561404,9,5,2,1
"37078","ffe61a854b5e90f45100540248aa039e",19,19,0,19,19,0,1,2
"37079","ffe7f240147bc4f6dc2b488b329073e6",167,93,64,18.265625,131,36,3,3
"37080","ffe88fd9f1d1a1713ffb8715b5d9c693",25,20,36,4.86111111111111,25,0,2,1
"37081","ffea03079d0def9995d5e7111c1fc60f",122,66,63,13.5555555555556,122,0,3,3
"37082","ffee77bf8e9f36c3aa965d5f88c91c99",141,103,77,12.8181818181818,141,0,3,3
"37083","ffef18e32a09c7f5aa3bde2316d1b921",17,17,0,17,17,0,1,2
"37084","ffefb4c6ecde4a05cafe9c0dcdfa3f48",47,42,77,4.27272727272727,47,0,2,1
"37085","ffefc00ce76c88831236aa7edc244e0b",48,44,74,4.54054054054054,48,0,2,1
"37086","fff0859ed2f4315760b7f9a4c67f2658",39,39,0,39,39,0,1,2
"37087","fff0d23c2c485a854a7f6461e5212a46",68,49,69,6.89855072463768,68,0,2,3
"37088","fff39234b274f2f6fd12e43da7881398",11,11,0,11,11,0,1,2
"37089","fff58701d0b7ebd3c8cc03f76ce66526",12,12,0,12,12,0,1,2
"37090","fff6ee1f1d21178f7268ebee87e0b2b6",37,37,0,37,37,0,1,2
"37091","fff884357609da6ca15b373660f2f1f6",112,75,67,11.7014925373134,112,0,3,3
"37092","fff8df7c5dd582d051e4bb7786da22f5",31,31,0,31,31,0,1,2
"37093","fff9471d42e08fa9d30f1460526cd892",1,1,0,1,1,0,1,2
"37094","fffb92c1a8e51b709efb7567837b73e2",107,59,81,9.24691358024691,107,0,2,3
"37095","fffc4c83a4c402f783f1d41fab0b0154",31,28,41,5.29268292682927,31,0,2,1
